country,year,iso2,iso3,g.whoregion,e.pop.m04,e.pop.m514,e.pop.m014,e.pop.m1524,e.pop.m2534,e.pop.m3544,e.pop.m4554,e.pop.m5564,e.pop.m65,e.pop.m15plus,e.pop.f04,e.pop.f514,e.pop.f014,e.pop.f1524,e.pop.f2534,e.pop.f3544,e.pop.f4554,e.pop.f5564,e.pop.f65,e.pop.f15plus,e.pop.15plus,e.pop.num,pop
Aruba,1950,AW,ABW,AMR,3432,4851,8283,3287,2773,2538,1181,459,248,10486,3500,4963,8463,3783,2898,2521,1295,635,432,11564,22050,38797,38797
Aruba,1951,AW,ABW,AMR,3634,5039,8673,3392,2788,2584,1310,497,253,10824,3641,5161,8802,3901,2912,2591,1409,674,441,11928,22752,40231,40231
Aruba,1952,AW,ABW,AMR,3812,5242,9054,3517,2812,2619,1470,545,261,11224,3761,5389,9150,4017,2937,2655,1535,725,460,12329,23553,41758,41758
Aruba,1953,AW,ABW,AMR,3962,5464,9426,3659,2836,2635,1638,599,285,11652,3866,5641,9507,4119,2974,2700,1673,777,483,12726,24378,43305,43305
Aruba,1954,AW,ABW,AMR,4083,5698,9781,3804,2871,2643,1799,660,304,12081,3969,5889,9858,4216,3033,2732,1812,834,510,13137,25218,44869,44869
Aruba,1955,AW,ABW,AMR,4173,5973,10146,3953,2919,2647,1952,728,331,12530,4061,6145,10206,4317,3119,2754,1949,898,546,13583,26113,46464,46464
Aruba,1956,AW,ABW,AMR,4244,6277,10521,4097,2977,2655,2095,801,358,12983,4134,6415,10549,4412,3226,2772,2080,964,584,14038,27021,48094,48094
Aruba,1957,AW,ABW,AMR,4319,6593,10912,4237,3039,2666,2224,879,395,13440,4196,6684,10880,4511,3347,2785,2203,1039,626,14511,27951,49747,49747
Aruba,1958,AW,ABW,AMR,4391,6891,11282,4391,3112,2682,2342,968,430,13925,4233,6948,11181,4619,3483,2800,2316,1115,678,15011,28936,51404,51404
Aruba,1959,AW,ABW,AMR,4450,7151,11601,4575,3197,2691,2447,1070,474,14454,4252,7196,11448,4764,3626,2812,2420,1199,731,15552,30006,53044,53044
Aruba,1960,AW,ABW,AMR,4489,7387,11876,4792,3277,2690,2518,1165,513,14955,4263,7412,11675,4948,3760,2809,2509,1287,786,16099,31054,54608,54608
Aruba,1961,AW,ABW,AMR,4487,7631,12118,4948,3345,2682,2538,1249,546,15308,4263,7588,11851,5109,3870,2794,2561,1366,829,16529,31837,55811,55811
Aruba,1962,AW,ABW,AMR,4445,7872,12317,5035,3416,2669,2511,1340,580,15551,4246,7727,11973,5236,3947,2771,2574,1444,872,16844,32395,56682,56682
Aruba,1963,AW,ABW,AMR,4390,8070,12460,5125,3491,2674,2457,1434,620,15801,4224,7837,12061,5374,3997,2784,2563,1529,911,17158,32959,57475,57475
Aruba,1964,AW,ABW,AMR,4324,8211,12535,5246,3565,2696,2383,1529,657,16076,4172,7933,12105,5519,4035,2821,2523,1611,954,17463,33539,58178,58178
Aruba,1965,AW,ABW,AMR,4235,8308,12543,5393,3635,2722,2306,1606,700,16362,4092,8015,12107,5673,4068,2869,2475,1691,995,17771,34133,58782,58782
Aruba,1966,AW,ABW,AMR,4126,8369,12495,5568,3689,2751,2237,1670,743,16658,3986,8067,12053,5832,4091,2924,2425,1760,1046,18078,34736,59291,59291
Aruba,1967,AW,ABW,AMR,3979,8365,12344,5706,3749,2780,2169,1721,796,16921,3843,8055,11898,5953,4131,2977,2375,1817,1097,18350,35271,59522,59522
Aruba,1968,AW,ABW,AMR,3796,8315,12111,5760,3834,2819,2098,1755,866,17132,3668,7979,11647,6012,4196,3033,2322,1860,1161,18584,35716,59471,59471
Aruba,1969,AW,ABW,AMR,3615,8254,11869,5776,3911,2876,2026,1767,935,17291,3492,7894,11386,6032,4274,3100,2261,1883,1230,18780,36071,59330,59330
Aruba,1970,AW,ABW,AMR,3444,8156,11600,5805,3959,2940,1973,1751,1010,17438,3333,7778,11111,6035,4354,3168,2203,1893,1302,18955,36393,59106,59106
Aruba,1971,AW,ABW,AMR,3298,8007,11305,5869,3954,3021,1944,1705,1091,17584,3195,7625,10820,6048,4405,3241,2152,1883,1373,19102,36686,58816,58816
Aruba,1972,AW,ABW,AMR,3200,7831,11031,6044,3931,3116,1956,1656,1169,17872,3103,7461,10564,6156,4435,3338,2128,1873,1455,19385,37257,58855,58855
Aruba,1973,AW,ABW,AMR,3147,7644,10791,6296,3948,3220,2012,1620,1241,18337,3055,7298,10353,6340,4494,3467,2157,1875,1545,19878,38215,59365,59365
Aruba,1974,AW,ABW,AMR,3123,7426,10549,6547,4000,3333,2093,1587,1323,18883,3032,7113,10145,6528,4578,3610,2220,1876,1636,20448,39331,60028,60028
Aruba,1975,AW,ABW,AMR,3121,7182,10303,6788,4074,3441,2187,1554,1400,19444,3035,6911,9946,6707,4669,3750,2290,1877,1734,21027,40471,60715,60715
Aruba,1976,AW,ABW,AMR,3134,6873,10007,6933,4194,3524,2281,1535,1473,19940,3051,6636,9687,6811,4784,3873,2384,1869,1835,21556,41496,61193,61193
Aruba,1977,AW,ABW,AMR,3157,6538,9695,6957,4368,3573,2371,1539,1542,20350,3072,6323,9395,6820,4926,3984,2497,1861,1937,22025,42375,61465,61465
Aruba,1978,AW,ABW,AMR,3182,6270,9452,6898,4572,3594,2465,1573,1601,20703,3092,6063,9155,6757,5098,4055,2628,1858,2035,22431,43134,61738,61738
Aruba,1979,AW,ABW,AMR,3205,6067,9272,6784,4760,3613,2554,1621,1651,20983,3113,5859,8972,6628,5267,4126,2786,1862,2104,22773,43756,62006,62006
Aruba,1980,AW,ABW,AMR,3225,5931,9156,6634,4904,3643,2669,1660,1694,21204,3128,5726,8854,6423,5420,4205,2968,1875,2165,23056,44260,62267,62267
Aruba,1981,AW,ABW,AMR,3243,5886,9129,6408,5054,3679,2797,1677,1752,21367,3148,5694,8842,6159,5550,4280,3169,1857,2264,23279,44646,62614,62614
Aruba,1982,AW,ABW,AMR,3274,5853,9127,6174,5257,3753,2927,1683,1806,21600,3177,5676,8853,5932,5699,4377,3336,1820,2369,23533,45133,63116,63116
Aruba,1983,AW,ABW,AMR,3313,5796,9109,5983,5465,3876,3041,1704,1850,21919,3214,5624,8838,5760,5857,4491,3446,1816,2446,23816,45735,63683,63683
Aruba,1984,AW,ABW,AMR,3350,5739,9089,5755,5644,4037,3129,1754,1877,22196,3249,5566,8815,5563,6012,4618,3531,1855,2493,24072,46268,64174,64174
Aruba,1985,AW,ABW,AMR,3377,5637,9014,5451,5812,4272,3216,1812,1890,22453,3269,5471,8740,5302,6180,4773,3598,1901,2515,24269,46722,64478,64478
Aruba,1986,AW,ABW,AMR,3382,5490,8872,5067,5981,4568,3298,1868,1894,22676,3272,5324,8596,4963,6368,4969,3638,1944,2519,24401,47077,64553,64553
Aruba,1987,AW,ABW,AMR,3368,5317,8685,4636,6125,4906,3362,1922,1918,22869,3259,5152,8411,4558,6573,5213,3647,1980,2526,24497,47366,64450,64450
Aruba,1988,AW,ABW,AMR,3341,5186,8527,4216,6212,5242,3425,1974,1948,23017,3231,5019,8250,4139,6725,5488,3653,2025,2511,24541,47558,64332,64332
Aruba,1989,AW,ABW,AMR,3296,5246,8542,3935,6195,5492,3526,2051,1968,23167,3186,5075,8261,3832,6705,5761,3716,2125,2497,24636,47803,64596,64596
Aruba,1990,AW,ABW,AMR,3234,5632,8866,3952,6013,5603,3654,2185,1954,23361,3125,5460,8585,3795,6414,5994,3875,2331,2480,24889,48250,65712,65712
Aruba,1991,AW,ABW,AMR,3163,6375,9538,4357,5638,5576,3772,2394,1934,23671,3057,6201,9258,4112,5852,6155,4127,2662,2489,25397,49068,67864,67864
Aruba,1992,AW,ABW,AMR,3086,6913,9999,4748,5418,5654,3894,2596,1938,24248,2985,6744,9729,4493,5513,6350,4366,2962,2528,26212,50460,70192,70192
Aruba,1993,AW,ABW,AMR,3027,7056,10083,4944,5486,5921,4048,2745,1986,25130,2934,6899,9833,4775,5574,6642,4576,3146,2588,27301,52431,72360,72360
Aruba,1994,AW,ABW,AMR,2996,7149,10145,5176,5597,6173,4238,2879,2063,26126,2914,7001,9915,5082,5700,6939,4808,3317,2681,28527,54653,74710,74710
Aruba,1995,AW,ABW,AMR,3039,7088,10127,5397,5792,6409,4459,2994,2147,27198,2959,6955,9914,5384,5929,7204,5034,3471,2791,29813,57011,77050,77050
Aruba,1996,AW,ABW,AMR,3159,6928,10087,5557,6060,6681,4699,3083,2234,28314,3062,6821,9883,5604,6274,7478,5262,3605,2906,31129,59443,79417,79417
Aruba,1997,AW,ABW,AMR,3297,6819,10116,5630,6324,6999,4959,3156,2337,29405,3181,6742,9923,5695,6632,7809,5533,3714,3033,32416,61821,81858,81858
Aruba,1998,AW,ABW,AMR,3423,6783,10206,5628,6565,7362,5230,3236,2443,30464,3290,6729,10019,5718,6941,8200,5823,3809,3178,33669,64133,84355,84355
Aruba,1999,AW,ABW,AMR,3516,6833,10349,5586,6734,7784,5489,3338,2540,31471,3376,6784,10160,5717,7157,8652,6114,3909,3344,34893,66364,86867,86867
Aruba,2000,AW,ABW,AMR,3522,6938,10460,5650,6767,8105,5741,3461,2649,32373,3389,6871,10260,5798,7234,8981,6434,4045,3515,36007,68380,89101,89101
Aruba,2001,AW,ABW,AMR,3439,7036,10475,5759,6667,8239,5993,3602,2776,33036,3326,6946,10272,5889,7223,9102,6776,4206,3708,36904,69940,90691,90691
Aruba,2002,AW,ABW,AMR,3324,7105,10429,5829,6493,8268,6251,3771,2909,33521,3230,6996,10226,5920,7163,9130,7115,4373,3909,37610,71131,91781,91781
Aruba,2003,AW,ABW,AMR,3201,7148,10349,5933,6291,8242,6532,3936,3044,33978,3117,7022,10139,6005,7012,9117,7449,4552,4096,38231,72209,92701,92701
Aruba,2004,AW,ABW,AMR,3071,7170,10241,6047,6091,8200,6818,4088,3180,34424,2990,7039,10029,6102,6856,9087,7773,4739,4294,38851,73275,93540,93540
Aruba,2005,AW,ABW,AMR,3028,7182,10210,6112,5913,8154,7078,4273,3329,34859,2941,7030,9971,6155,6723,9024,8098,4947,4496,39443,74302,94483,94483
Aruba,2006,AW,ABW,AMR,3093,7211,10304,6116,5806,8049,7346,4490,3474,35281,2987,7017,10004,6147,6597,8965,8412,5205,4689,40015,75296,95606,95606
Aruba,2007,AW,ABW,AMR,3175,7250,10425,6126,5739,7894,7606,4730,3625,35720,3050,7029,10079,6099,6533,8876,8696,5482,4868,40554,76274,96787,96787
Aruba,2008,AW,ABW,AMR,3253,7288,10541,6180,5673,7735,7836,4981,3779,36184,3112,7055,10167,6047,6530,8722,8967,5775,5065,41106,77290,97996,97996
Aruba,2009,AW,ABW,AMR,3308,7328,10636,6290,5594,7556,8044,5228,3950,36662,3160,7087,10247,6027,6527,8557,9198,6083,5280,41672,78334,99212,99212
Aruba,2010,AW,ABW,AMR,3298,7303,10601,6545,5536,7388,8198,5474,4118,37259,3155,7064,10219,6164,6434,8384,9357,6402,5526,42267,79526,100341,100341
Aruba,2011,AW,ABW,AMR,3253,7184,10437,6797,5527,7222,8280,5737,4304,37867,3119,6927,10046,6409,6329,8219,9445,6729,5804,42935,80802,101288,101288
Aruba,2012,AW,ABW,AMR,3218,7065,10283,6897,5573,7044,8303,6018,4514,38349,3094,6780,9874,6576,6292,8093,9473,7067,6108,43609,81958,102112,102112
Aruba,2013,AW,ABW,AMR,3171,6991,10162,6909,5658,6880,8282,6296,4733,38758,3054,6687,9741,6643,6299,7976,9454,7410,6431,44213,82971,102880,102880
Aruba,2014,AW,ABW,AMR,3121,6959,10080,6843,5783,6722,8226,6567,4973,39114,3005,6645,9650,6615,6341,7882,9405,7744,6767,44754,83868,103594,103594
Aruba,2015,AW,ABW,AMR,3071,6943,10014,6719,5929,6586,8135,6814,5237,39420,2957,6632,9589,6510,6421,7807,9324,8060,7118,45240,84660,104257,104257
Aruba,2016,AW,ABW,AMR,3016,6930,9946,6576,6079,6471,8011,7042,5519,39698,2901,6629,9530,6354,6530,7747,9225,8353,7486,45695,85393,104874,104874
Aruba,2017,AW,ABW,AMR,2956,6916,9872,6451,6204,6389,7864,7250,5822,39980,2837,6626,9463,6191,6633,7716,9111,8613,7863,46127,86107,105439,105439
Aruba,2018,AW,ABW,AMR,2890,6878,9768,6361,6276,6345,7694,7423,6150,40249,2770,6604,9374,6057,6706,7707,8990,8832,8267,46559,86808,105962,105962
Aruba,2019,AW,ABW,AMR,2826,6825,9651,6333,6279,6346,7514,7564,6497,40533,2698,6562,9260,5978,6722,7722,8869,9009,8691,46991,87524,106442,106442
Aruba,2020,AW,ABW,AMR,2706,6731,9437,6420,6218,6336,7334,7663,6800,40771,2580,6476,9056,6019,6638,7674,8738,9130,9120,47319,88090,106585,106585
Aruba,2021,AW,ABW,AMR,2530,6602,9132,6629,6177,6338,7160,7716,7047,41067,2413,6352,8765,6191,6506,7567,8601,9193,9513,47571,88638,106537,106537
Aruba,2022,AW,ABW,AMR,2354,6464,8818,6802,6155,6374,7003,7736,7279,41349,2248,6218,8466,6351,6382,7489,8475,9208,9900,47805,89154,106445,106445
Aruba,2023,AW,ABW,AMR,2198,6321,8519,6875,6106,6398,6861,7730,7565,41535,2105,6072,8177,6456,6260,7421,8364,9196,10349,48046,89581,106277,106277
Aruba,2024,AW,ABW,AMR,2066,6164,8230,6914,6070,6433,6728,7696,7892,41733,1984,5915,7899,6538,6146,7363,8261,9164,10841,48313,90046,106177,106177
Aruba,2025,AW,ABW,AMR,1978,5973,7951,6925,6058,6470,6610,7623,8227,41913,1905,5727,7632,6578,6059,7319,8163,9100,11327,48546,90459,106043,106043
Aruba,2026,AW,ABW,AMR,1952,5731,7683,6894,6082,6502,6511,7512,8567,42068,1882,5495,7377,6571,6015,7282,8067,9018,11802,48755,90823,105881,105881
Aruba,2027,AW,ABW,AMR,1955,5476,7431,6825,6135,6530,6423,7373,8910,42196,1882,5248,7130,6526,6005,7244,7984,8906,12263,48928,91124,105689,105689
Aruba,2028,AW,ABW,AMR,1958,5234,7192,6732,6215,6542,6355,7214,9236,42294,1886,5012,6898,6448,6034,7197,7912,8776,12714,49081,91375,105461,105461
Aruba,2029,AW,ABW,AMR,1962,5006,6968,6614,6307,6533,6308,7048,9546,42356,1890,4792,6682,6343,6091,7135,7837,8639,13147,49192,91548,105204,105204
Aruba,2030,AW,ABW,AMR,1965,4796,6761,6496,6410,6501,6282,6886,9832,42407,1894,4590,6484,6227,6172,7056,7759,8504,13555,49273,91680,104924,104924
Aruba,2031,AW,ABW,AMR,1973,4597,6570,6373,6515,6441,6285,6731,10080,42425,1898,4406,6304,6110,6272,6946,7677,8380,13941,49326,91751,104612,104612
Aruba,2032,AW,ABW,AMR,1981,4424,6405,6240,6610,6372,6302,6592,10281,42397,1905,4240,6145,5982,6379,6807,7599,8266,14288,49321,91718,104275,104275
Aruba,2033,AW,ABW,AMR,1991,4263,6254,6103,6686,6314,6327,6467,10455,42352,1918,4097,6015,5846,6479,6668,7529,8163,14614,49299,91651,103910,103910
Aruba,2034,AW,ABW,AMR,2007,4132,6139,5959,6735,6265,6361,6345,10598,42263,1932,3969,5901,5698,6558,6533,7463,8065,14900,49217,91480,103526,103526
Aruba,2035,AW,ABW,AMR,2024,4046,6070,5775,6751,6245,6394,6239,10720,42124,1946,3889,5835,5521,6600,6433,7411,7971,15157,49093,91217,103120,103120
Aruba,2036,AW,ABW,AMR,2040,4020,6060,5542,6724,6257,6423,6151,10813,41910,1963,3874,5837,5296,6589,6367,7368,7880,15377,48877,90787,102689,102689
Aruba,2037,AW,ABW,AMR,2059,4025,6084,5296,6663,6302,6447,6076,10882,41666,1980,3877,5857,5057,6543,6345,7326,7801,15566,48638,90304,102241,102241
Aruba,2038,AW,ABW,AMR,2072,4038,6110,5062,6575,6371,6462,6019,10930,41419,1992,3883,5875,4828,6463,6357,7273,7728,15720,48369,89788,101769,101769
Aruba,2039,AW,ABW,AMR,2081,4052,6133,4841,6465,6457,6451,5980,10959,41153,2000,3899,5899,4620,6360,6400,7208,7658,15841,48087,89240,101272,101272
Aruba,2040,AW,ABW,AMR,2083,4071,6154,4635,6352,6549,6418,5961,10962,40877,2002,3917,5919,4424,6245,6469,7122,7582,15953,47795,88672,100745,100745
Aruba,2041,AW,ABW,AMR,2081,4090,6171,4446,6234,6643,6361,5966,10956,40606,2001,3934,5935,4247,6122,6551,7006,7505,16053,47484,88090,100194,100194
Aruba,2042,AW,ABW,AMR,2074,4111,6185,4276,6107,6731,6292,5988,10932,40326,1994,3954,5948,4087,5994,6646,6864,7433,16126,47150,87476,99615,99615
Aruba,2043,AW,ABW,AMR,2061,4133,6194,4128,5976,6800,6230,6016,10893,40043,1981,3977,5958,3950,5856,6734,6723,7363,16188,46814,86857,99010,99010
Aruba,2044,AW,ABW,AMR,2046,4152,6198,3998,5838,6839,6189,6052,10851,39767,1967,3994,5961,3833,5709,6800,6589,7305,16233,46469,86236,98391,98391
Aruba,2045,AW,ABW,AMR,2025,4170,6195,3918,5661,6848,6166,6086,10802,39481,1947,4008,5955,3760,5531,6829,6483,7255,16257,46115,85596,97746,97746
Aruba,2046,AW,ABW,AMR,1998,4186,6184,3903,5431,6819,6180,6121,10754,39208,1920,4023,5943,3742,5304,6809,6415,7216,16251,45737,84945,97069,97069
Aruba,2047,AW,ABW,AMR,1966,4192,6158,3911,5191,6751,6225,6147,10705,38930,1889,4030,5919,3753,5065,6752,6389,7176,16234,45369,84299,96374,96374
Aruba,2048,AW,ABW,AMR,1928,4188,6116,3926,4959,6657,6295,6161,10661,38659,1856,4027,5883,3767,4839,6660,6397,7124,16199,44986,83645,95655,95655
Aruba,2049,AW,ABW,AMR,1889,4177,6066,3946,4748,6547,6377,6156,10634,38408,1814,4014,5828,3786,4628,6551,6437,7063,16157,44622,83030,94925,94925
Aruba,2050,AW,ABW,AMR,1846,4159,6005,3967,4548,6428,6470,6131,10615,38159,1772,3995,5767,3806,4437,6426,6502,6980,16102,44253,82412,94185,94185
Afghanistan,1970,AF,AFG,EMR,988432,1394195,2382627,1005236,779357,575993,389981,233396,146813,3130776,964357,1358437,2322794,990073,717168,504732,346120,219137,139546,2916776,6047552,10752971,10752971
Afghanistan,1971,AF,AFG,EMR,1018309,1437549,2455858,1022728,794508,585158,398355,237700,148800,3187249,992934,1399854,2392788,1006676,737071,515912,353528,223701,143072,2979960,6167209,11015857,11015857
Afghanistan,1972,AF,AFG,EMR,1048813,1482154,2530967,1042277,809026,594382,407107,242398,150816,3246006,1022065,1442545,2464610,1023118,758033,527741,361113,228398,146768,3045171,6291177,11286753,11286753
Afghanistan,1973,AF,AFG,EMR,1080929,1529368,2610297,1066535,822091,604245,416362,247533,152940,3309706,1052649,1487801,2540450,1041603,779847,540236,369198,233341,150628,3114853,6424559,11575305,11575305
Afghanistan,1974,AF,AFG,EMR,1113810,1577564,2691374,1093786,833761,614005,425347,252769,155233,3374901,1083866,1533980,2617846,1063043,800270,552163,377377,238331,154575,3185759,6560660,11869879,11869879
Afghanistan,1975,AF,AFG,EMR,1146160,1624852,2771012,1122697,843534,622961,433457,257829,157631,3438109,1114527,1579195,2693722,1089034,815808,562904,385220,243135,158444,3254545,6692654,12157386,12157386
Afghanistan,1976,AF,AFG,EMR,1176504,1669578,2846082,1151775,850780,630658,440332,262465,160014,3496024,1143282,1621859,2765141,1116652,827006,572340,392359,247541,162125,3318023,6814047,12425267,12425267
Afghanistan,1977,AF,AFG,EMR,1206448,1713652,2920100,1180388,858114,638114,446533,266732,162340,3552221,1171659,1663795,2835454,1143750,837777,581505,399260,251669,165562,3379523,6931744,12687301,12687301
Afghanistan,1978,AF,AFG,EMR,1235160,1757098,2992258,1207808,864552,645127,451678,270417,164187,3603769,1198840,1704966,2903806,1170547,847988,590780,405858,255423,168435,3439031,7042800,12938862,12938862
Afghanistan,1979,AF,AFG,EMR,1243126,1774398,3017524,1215820,856448,641760,448787,269547,162939,3595301,1205979,1720654,2926633,1180296,845039,592078,406107,255161,168237,3446918,7042219,12986369,12986369
Afghanistan,1980,AF,AFG,EMR,1197631,1717304,2914935,1172622,812326,611514,426553,257273,154551,3434839,1161374,1664152,2825526,1140947,806290,570057,389180,244177,160683,3311334,6746173,12486631,12486631
Afghanistan,1981,AF,AFG,EMR,1071677,1544152,2615829,1051411,716042,541069,376305,228241,136145,3049213,1038755,1495218,2533973,1025019,713843,511113,346575,217123,142510,2956183,6005396,11155195,11155195
Afghanistan,1982,AF,AFG,EMR,969827,1406153,2375980,954601,639203,483183,335524,204812,121016,2738339,939475,1360464,2299939,933451,639853,464714,312873,195495,127643,2674029,5412368,10088289,10088289
Afghanistan,1983,AF,AFG,EMR,956867,1395626,2352493,945083,625023,468759,326408,200202,117133,2682608,926368,1349275,2275643,927585,627709,460601,308197,192111,124511,2640714,5323322,9951449,9951449
Afghanistan,1984,AF,AFG,EMR,984469,1445848,2430317,975901,637726,473366,330741,203338,117698,2738770,952632,1396854,2349486,963407,646280,475559,316516,197032,126318,2725112,5463882,10243686,10243686
Afghanistan,1985,AF,AFG,EMR,1009861,1493555,2503416,1004134,648255,475161,333314,204990,117272,2783126,976811,1441857,2418668,998844,668505,486862,323971,201483,127344,2807009,5590135,10512221,10512221
Afghanistan,1986,AF,AFG,EMR,1007467,1489547,2497014,1002361,640069,461571,325628,200554,113977,2744160,973993,1436722,2410715,1000653,669643,480777,320793,199652,125046,2796564,5540724,10448442,10448442
Afghanistan,1987,AF,AFG,EMR,1002925,1471714,2474639,995903,629078,447000,316899,195566,111023,2695469,968989,1418359,2387348,993803,664373,471961,315589,196754,122820,2765300,5460769,10322758,10322758
Afghanistan,1988,AF,AFG,EMR,1019056,1477425,2496481,1007573,630584,441208,314606,194315,110631,2698917,983734,1422996,2406730,1003018,670410,471016,316297,197373,123220,2781334,5480251,10383460,10383460
Afghanistan,1989,AF,AFG,EMR,1060056,1513272,2573328,1041413,647434,445687,319808,197564,113328,2765234,1022128,1456928,2479056,1032409,690309,479495,324380,202189,126771,2855553,5620787,10673168,10673168
Afghanistan,1990,AF,AFG,EMR,1074833,1512067,2586900,1048015,648712,438961,316972,195646,113181,2761487,1035072,1455329,2490401,1034740,692457,475091,325009,201627,127085,2856009,5617496,10694796,10694796
Afghanistan,1991,AF,AFG,EMR,1091675,1517526,2609201,1055645,652247,433577,314614,194180,113493,2763756,1050020,1460081,2510101,1038412,696027,471248,326879,201679,127859,2862104,5625860,10745167,10745167
Afghanistan,1992,AF,AFG,EMR,1236631,1703098,2939729,1185043,732799,479586,348238,215495,127604,3088765,1188214,1638105,2826319,1162497,781030,522259,367021,225657,144157,3202621,6291386,12057433,12057433
Afghanistan,1993,AF,AFG,EMR,1448854,1979146,3428000,1375359,853477,551943,398139,247942,148782,3575642,1390962,1903057,3294019,1344742,906131,600002,425748,261066,168412,3706101,7281743,14003760,14003760
Afghanistan,1994,AF,AFG,EMR,1613969,2187483,3801452,1514655,945542,604359,431943,270871,164634,3932004,1548228,2102697,3650925,1475783,998203,656297,467748,286307,186837,4071175,8003179,15455555,15455555
Afghanistan,1995,AF,AFG,EMR,1729509,2330780,4060289,1602941,1008574,637909,450248,284494,175018,4159184,1657592,2239712,3897304,1557338,1057946,694409,491381,301762,199304,4302140,8461324,16418912,16418912
Afghanistan,1996,AF,AFG,EMR,1814255,2440516,4254771,1661427,1056124,661749,459738,293008,182357,4314403,1737075,2344307,4081382,1609736,1099248,722070,504742,311834,208406,4456036,8770439,17106595,17106595
Afghanistan,1997,AF,AFG,EMR,1894358,2556312,4450670,1716484,1104286,685380,469356,301303,189391,4466200,1811667,2454477,4266144,1659537,1139955,748773,518393,321806,217345,4605809,9072009,17788819,17788819
Afghanistan,1998,AF,AFG,EMR,1971630,2682549,4654179,1771333,1154065,710312,479386,309953,196316,4621365,1882935,2574264,4457199,1710455,1182010,776629,532434,332452,226416,4760396,9381761,18493132,18493132
Afghanistan,1999,AF,AFG,EMR,2050582,2823996,4874578,1831414,1208320,738788,490942,319842,203918,4793224,1955095,2708417,4663512,1766987,1228061,807503,547752,344925,236295,4931523,9724747,19262847,19262847
Afghanistan,2000,AF,AFG,EMR,2072144,2896007,4968151,1846931,1232038,749917,490215,321802,206384,4847287,1972341,2775936,4748277,1780477,1242506,818018,548528,349596,240133,4979258,9826545,19542982,19542982
Afghanistan,2001,AF,AFG,EMR,2074649,2947740,5022389,1853936,1246393,757297,486589,321433,207424,4873072,1971775,2823757,4795532,1786148,1247999,823224,545164,352664,242431,4997630,9870702,19688632,19688632
Afghanistan,2002,AF,AFG,EMR,2196141,3171553,5367694,1975555,1333821,811378,513014,339647,221093,5194508,2084714,3035882,5120596,1902076,1326999,877698,574166,376957,259562,5317458,10511966,21000256,21000256
Afghanistan,2003,AF,AFG,EMR,2347674,3444812,5792486,2133079,1441829,880405,549381,361840,238466,5605000,2226726,3294618,5521344,2052398,1426359,946628,612791,407131,280998,5726305,11331305,22645130,22645130
Afghanistan,2004,AF,AFG,EMR,2415262,3606925,6022187,2226685,1502317,923210,569023,371405,247894,5840534,2290107,3446116,5736223,2141260,1478593,985483,633091,423124,293043,5954594,11795128,23553551,23553551
Afghanistan,2005,AF,AFG,EMR,2461377,3743465,6204842,2328345,1570762,971040,590344,379609,257163,6097263,2333998,3572889,5906887,2240201,1539802,1026926,656260,434858,304153,6202200,12299463,24411191,24411191
Afghanistan,2006,AF,AFG,EMR,2521258,3897193,6418451,2452747,1651915,1029024,617872,390180,268256,6409994,2391224,3716058,6107282,2361850,1615050,1077850,686544,448382,317537,6507213,12917207,25442944,25442944
Afghanistan,2007,AF,AFG,EMR,2565475,4033222,6598697,2497839,1637888,1043063,626128,392659,271679,6469256,2433072,3840974,6274046,2397155,1595606,1087134,699899,455926,325573,6561293,13030549,25903301,25903301
Afghanistan,2008,AF,AFG,EMR,2593097,4167497,6760594,2571386,1633092,1062832,637517,396568,277010,6578405,2459390,3964668,6424058,2461424,1586005,1100954,715707,464576,335466,6664132,13242537,26427199,26427199
Afghanistan,2009,AF,AFG,EMR,2620553,4306018,6926571,2725019,1697786,1117303,665162,407399,288734,6901403,2486083,4093647,6579730,2610165,1646586,1146547,745057,478453,350792,6977600,13879003,27385307,27385307
Afghanistan,2010,AF,AFG,EMR,2649145,4431475,7080620,2858827,1738590,1159299,688811,416035,298194,7159756,2513757,4209822,6723579,2736472,1683191,1180333,770314,490179,365232,7225721,14385477,28189672,28189672
Afghanistan,2011,AF,AFG,EMR,2681470,4559927,7241397,3032700,1823339,1220189,722608,428922,311126,7538884,2545844,4329678,6875522,2905469,1764290,1231958,803590,504832,383218,7593357,15132241,29249157,29249157
Afghanistan,2012,AF,AFG,EMR,2722000,4690361,7412361,3224797,1935819,1292200,763497,444977,325454,7986744,2586520,4452130,7038650,3093585,1873672,1294390,842260,521522,403304,8028733,16015477,30466479,30466479
Afghanistan,2013,AF,AFG,EMR,2784639,4797156,7581795,3387078,2028134,1351505,801231,460514,336321,8364783,2648391,4552429,7200820,3248880,1962894,1345489,877446,537404,421706,8393819,16758602,31541209,31541209
Afghanistan,2014,AF,AFG,EMR,2865567,4890484,7756051,3558923,2140610,1417185,844190,478906,348021,8787835,2727897,4641260,7369157,3413902,2072778,1403301,916415,556605,440161,8803162,17590997,32716210,32716210
Afghanistan,2015,AF,AFG,EMR,2943516,4980803,7924319,3702727,2235922,1470623,883999,496606,357245,9147122,2804346,4727769,7532115,3548849,2165939,1450645,952007,577691,454799,9149930,18297052,33753499,33753499
Afghanistan,2016,AF,AFG,EMR,3017710,5064049,8081759,3818612,2313183,1510076,920090,513214,363928,9439103,2876924,4808053,7684977,3654026,2240986,1485728,983758,598881,466992,9430371,18869474,34636207,34636207
Afghanistan,2017,AF,AFG,EMR,3085420,5155572,8240992,3948663,2415719,1556389,961576,532141,373212,9787700,2943316,4897509,7840825,3777061,2343747,1529001,1020016,621906,482161,9773892,19561592,35643418,35643418
Afghanistan,2018,AF,AFG,EMR,3145247,5257352,8402599,4075644,2527558,1602759,1004845,552555,383903,10147264,3002108,4997383,7999491,3900157,2459054,1574602,1058004,646430,499181,10137428,20284692,36686784,36686784
Afghanistan,2019,AF,AFG,EMR,3203228,5364055,8567283,4200719,2650196,1651379,1050189,574854,395779,10523116,3059163,5102175,8161338,4021247,2585590,1623421,1097753,672347,517392,10517750,21040866,37769499,37769499
Afghanistan,2020,AF,AFG,EMR,3259886,5480939,8740825,4337298,2796206,1711983,1099713,599195,407079,10951474,3115208,5216885,8332093,4153475,2734917,1684126,1141134,699319,534861,10947832,21899306,38972230,38972230
Afghanistan,2021,AF,AFG,EMR,3318057,5594232,8912289,4457891,2930198,1771261,1145885,622635,414713,11342583,3172497,5328222,8500719,4269263,2873191,1745013,1182170,724926,549299,11343862,22686445,40099462,40099462
Afghanistan,2022,AF,AFG,EMR,3378310,5698115,9076425,4561443,3045707,1826916,1188197,646341,421408,11690012,3231791,5430885,8662676,4367592,2993657,1804034,1220647,750375,563351,11699656,23389668,41128771,41128771
Afghanistan,2023,AF,AFG,EMR,3436627,5820174,9256801,4659578,3171636,1893577,1233133,673714,431256,12062894,3289542,5551373,8840915,4461194,3123067,1874090,1261956,778485,580445,12079237,24142131,42239854,42239854
Afghanistan,2024,AF,AFG,EMR,3489767,5955777,9445544,4745320,3299141,1967583,1278788,704310,444274,12439416,3342338,5684992,9027330,4542805,3252013,1951669,1304455,808920,600795,12460657,24900073,43372950,43372950
Afghanistan,2025,AF,AFG,EMR,3534469,6088676,9623145,4833624,3426635,2049104,1324741,737691,460237,12832032,3387241,5816211,9203452,4627231,3379483,2037151,1347879,841274,624149,12857167,25689199,44515793,44515793
Afghanistan,2026,AF,AFG,EMR,3569435,6226954,9796389,4919740,3552670,2139165,1370215,773242,478149,13233181,3422905,5952470,9375375,4710177,3504526,2131644,1391618,875086,649554,13262605,26495786,45667550,45667550
Afghanistan,2027,AF,AFG,EMR,3598498,6360174,9958672,5011107,3677024,2238387,1415001,810491,497166,13649176,3452736,6083886,9536622,4798915,3626686,2235714,1435625,909990,676218,13683148,27332324,46827624,46827624
Afghanistan,2028,AF,AFG,EMR,3624296,6479502,10103798,5112274,3798710,2346277,1459662,849186,517460,14083569,3479332,6202103,9681435,4897583,3745039,2348813,1480527,945900,704257,14122119,28205688,47990912,47990912
Afghanistan,2029,AF,AFG,EMR,3648062,6590463,10238525,5218445,3916241,2461715,1505120,889145,539233,14529899,3503801,6312503,9816304,5001343,3858331,2469819,1527214,982923,733708,14573338,29103237,49158072,49158072
Afghanistan,2030,AF,AFG,EMR,3672604,6689206,10361810,5332668,4029377,2581965,1553639,929943,562609,14990201,3528645,6411642,9940287,5112990,3966339,2595921,1577826,1020894,764562,15038532,30028733,50330837,50330837
Afghanistan,1950,AF,AFG,EMR,618463,941561,1560024,760894,576490,422069,312124,210477,120183,2402237,629819,879013,1508832,664602,487334,351985,250290,162322,92831,2009364,4411601,7480461,7480461
Afghanistan,1951,AF,AFG,EMR,618503,957704,1576207,770034,585517,426185,312309,209976,121368,2425389,628354,900886,1529240,676660,495354,356900,253254,163811,94717,2040696,4466085,7571537,7571537
Afghanistan,1952,AF,AFG,EMR,620918,972993,1593911,779121,594965,430954,312602,209283,122472,2449397,627302,923857,1551159,689415,503517,361913,256297,165372,96549,2073063,4522460,7667533,7667533
Afghanistan,1953,AF,AFG,EMR,627297,985180,1612477,787847,604232,436016,312867,208505,123554,2473021,627426,946476,1573902,702000,511596,366866,259306,167000,98367,2105135,4578156,7764546,7764546
Afghanistan,1954,AF,AFG,EMR,636897,995784,1632681,796475,613087,441221,313281,207850,124604,2496518,630920,967457,1598377,713838,519773,371880,262366,168703,100147,2136707,4633225,7864285,7864285
Afghanistan,1955,AF,AFG,EMR,649850,1005942,1655792,805483,621729,446787,314128,207494,125684,2521305,641280,984399,1625679,725398,528386,377220,265658,170552,101944,2169158,4690463,7971931,7971931
Afghanistan,1956,AF,AFG,EMR,665870,1015806,1681676,814992,630231,452654,315383,207445,126850,2547555,656471,998876,1655347,737227,537451,382884,269178,172560,103843,2203143,4750698,8087727,8087727
Afghanistan,1957,AF,AFG,EMR,682522,1027090,1709612,825279,638616,458653,316976,207683,128146,2575353,672230,1014205,1686435,749701,546926,388815,272853,174684,105816,2238795,4814148,8210201,8210201
Afghanistan,1958,AF,AFG,EMR,699248,1038779,1738027,836086,646364,464614,318798,208083,129512,2603457,688026,1029294,1717320,762684,556364,394738,276484,176870,107885,2275025,4878482,8333826,8333826
Afghanistan,1959,AF,AFG,EMR,716984,1051889,1768873,848420,654247,471370,321380,208673,130817,2634907,704826,1044833,1749659,777665,566305,401140,280402,179232,110034,2314778,4949685,8468211,8468211
Afghanistan,1960,AF,AFG,EMR,736518,1067716,1804234,863111,663065,479457,325087,209552,132014,2672286,723440,1061613,1785053,796108,577231,408472,284934,181886,112263,2360894,5033180,8622466,8622466
Afghanistan,1961,AF,AFG,EMR,757212,1085888,1843100,878959,672432,488430,329640,210682,133122,2713265,743197,1078782,1821979,817201,589031,416389,289847,184776,114555,2411799,5125064,8790140,8790140
Afghanistan,1962,AF,AFG,EMR,778965,1106948,1885913,894683,682284,498168,334956,212029,134138,2756258,763980,1096408,1860388,839944,601918,424764,295081,187874,116915,2466496,5222754,8969047,8969047
Afghanistan,1963,AF,AFG,EMR,801687,1132534,1934221,908424,692519,508259,340828,213572,135133,2798735,785738,1115677,1901415,863241,615266,433513,300563,191162,119349,2523094,5321829,9157465,9157465
Afghanistan,1964,AF,AFG,EMR,825469,1162059,1987528,921223,703064,518314,347027,215400,136261,2841289,808483,1138861,1947344,885590,628344,442623,306286,194652,121854,2579349,5420638,9355514,9355514
Afghanistan,1965,AF,AFG,EMR,850350,1195649,2045999,933718,714039,528285,353586,217595,137577,2884800,832203,1169209,2001412,904338,641284,452185,312331,198358,124435,2632931,5517731,9565147,9565147
Afghanistan,1966,AF,AFG,EMR,876019,1232525,2108544,945723,725331,538051,360327,220083,139107,2928622,856703,1204344,2061047,920583,654343,462056,318585,202222,127145,2684934,5613556,9783147,9783147
Afghanistan,1967,AF,AFG,EMR,902645,1270676,2173321,958964,737257,547677,367163,222834,140889,2974784,882204,1240658,2122862,937547,667960,472271,325052,206225,129998,2739053,5713837,10010030,10010030
Afghanistan,1968,AF,AFG,EMR,930333,1310358,2240691,973423,750284,557229,374282,225933,142850,3024001,908749,1278458,2187207,955127,682656,482886,331805,210380,133019,2795873,5819874,10247780,10247780
Afghanistan,1969,AF,AFG,EMR,958879,1351419,2310298,988707,764274,566586,381843,229438,144832,3075680,936080,1317617,2253697,972647,698807,493699,338791,214669,136200,2854813,5930493,10494489,10494489
Afghanistan,2031,AF,AFG,EMR,3694225,6782688,10476913,5446213,4142858,2704273,1607455,971143,587745,15459687,3550625,6505882,10056507,5224352,4074023,2724025,1634409,1059580,796943,15513332,30973019,51506437,51506437
Afghanistan,2032,AF,AFG,EMR,3713394,6875374,10588768,5553376,4258436,2827694,1666707,1012652,614820,15933685,3570291,6599265,10169556,5330162,4183519,2852683,1697106,1098992,830991,15993453,31927138,52685458,52685458
Afghanistan,2033,AF,AFG,EMR,3732373,6960539,10692912,5676136,4358490,2951759,1731660,1054192,643827,16416064,3589574,6685408,10274982,5451558,4278107,2981037,1766208,1138995,866692,16482597,32898661,53866558,53866558
Afghanistan,2034,AF,AFG,EMR,3749579,7037757,10787336,5811719,4445625,3076608,1802922,1095588,674757,16907219,3606940,6763826,10370766,5585751,4360777,3108865,1842294,1179535,904084,16981306,33888525,55046630,55046630
Afghanistan,2035,AF,AFG,EMR,3764921,7107780,10872701,5944729,4535351,3201515,1881092,1136801,707506,17406994,3622623,6835111,10457734,5717653,4446508,3235537,1926031,1220624,943064,17489417,34896411,56226855,56226855
Afghanistan,2036,AF,AFG,EMR,3781465,7165806,10947271,6083095,4623246,3325340,1967358,1177493,742068,17918600,3639465,6894806,10534271,5854644,4531006,3360121,2018569,1261953,983718,18010011,35928611,57410144,57410144
Afghanistan,2037,AF,AFG,EMR,3800801,7215481,11016282,6216482,4716246,3447694,2062263,1217652,778436,18438773,3658853,6946307,10605160,5986782,4621225,3481985,2120393,1303600,1026056,18540041,36978814,58600249,58600249
Afghanistan,2038,AF,AFG,EMR,3821211,7261710,11082921,6336191,4818697,3567599,2165345,1257782,816481,18962095,3679352,6994161,10673513,6105771,4721247,3600205,2230969,1346144,1070080,19074416,38036511,59792941,59792941
Afghanistan,2039,AF,AFG,EMR,3842901,7304124,11147025,6447572,4925825,3683559,2275519,1298735,856237,19487447,3701076,7037930,10739006,6216924,4826189,3713478,2349190,1390426,1115909,19612116,39099563,60985590,60985590
Afghanistan,2040,AF,AFG,EMR,3866381,7345378,11211759,6546843,5040508,3795227,2390200,1342523,897394,20012695,3724459,7080293,10804752,6316823,4938729,3821481,2472318,1438431,1163351,20151133,40163828,62180342,62180342
Afghanistan,2041,AF,AFG,EMR,3889447,7384876,11274323,6640849,5154293,3907129,2506815,1391133,939700,20539919,3747435,7120864,10868299,6411782,5050789,3929042,2597374,1492068,1212252,20693307,41233226,63375847,63375847
Afghanistan,2042,AF,AFG,EMR,3910424,7424650,11335074,6733964,5261736,4020982,2624490,1444683,983173,21069028,3768297,7161599,10929896,6505831,5157202,4038292,2722968,1551480,1262706,21238479,42307507,64572473,64572473
Afghanistan,2043,AF,AFG,EMR,3930664,7465285,11395949,6819598,5384139,4119852,2742780,1503370,1027538,21597277,3788382,7203032,10991414,6592668,5278937,4132819,2848290,1616920,1314551,21784185,43381462,65768823,65768823
Afghanistan,2044,AF,AFG,EMR,3951479,7505432,11456911,6897372,5518905,4206273,2861862,1567709,1072661,22124782,3809034,7243752,11052786,6671811,5413289,4215611,2973146,1688917,1367735,22330509,44455291,66964990,66964990
Afghanistan,2045,AF,AFG,EMR,3971976,7545491,11517467,6968050,5651236,4295228,2981070,1638215,1118444,22652243,3829221,7284393,11113614,6743851,5545384,4301442,3096944,1768090,1422235,22877946,45530189,68161269,68161269
Afghanistan,2046,AF,AFG,EMR,3991832,7586305,11578137,7026958,5788820,4382453,3099352,1715892,1164647,23178122,3848570,7325739,11174309,6804356,5682524,4386082,3218809,1855481,1477857,23425109,46603231,69355671,69355671
Afghanistan,2047,AF,AFG,EMR,4009749,7627760,11637509,7077661,5921624,4474641,3216351,1801189,1211231,23702697,3865977,7367465,11233442,6856707,5814890,4476414,3338144,1951538,1534718,23972411,47675108,70546052,70546052
Afghanistan,2048,AF,AFG,EMR,4024895,7669533,11694428,7124945,6041203,4576023,3331164,1893659,1258555,24225549,3880640,7409478,11290118,6905411,5934263,4576463,3454063,2055755,1593323,24519278,48744827,71729374,71729374
Afghanistan,2049,AF,AFG,EMR,4037305,7713148,11750453,7168444,6152738,4682008,3442366,1992354,1307318,24745228,3892603,7453226,11345829,6950029,6045886,4681403,3565308,2167124,1654514,25064264,49809492,72905780,72905780
Afghanistan,2050,AF,AFG,EMR,4046800,7758210,11805010,7210770,6252546,4795375,3549608,2095018,1358920,25262237,3901774,7498121,11399895,6993219,6146375,4793883,3671552,2283139,1719925,25608093,50870330,74075234,74075234
Angola,1970,AO,AGO,AFR,596591,871419,1468010,537519,403833,295806,163891,111264,96032,1608345,583780,783581,1367361,491084,443446,306367,162079,101005,82001,1585982,3194327,6029700,6029700
Angola,1971,AO,AGO,AFR,604672,898865,1503537,556436,402201,305478,169206,110592,96644,1640557,597342,817871,1415213,500688,441580,320729,168585,103058,83094,1617734,3258291,6177049,6177049
Angola,1972,AO,AGO,AFR,615004,925682,1540686,582937,406456,317314,176431,110750,97722,1691610,611134,853325,1464459,519311,443895,337304,177141,105819,84511,1667981,3359591,6364731,6364731
Angola,1973,AO,AGO,AFR,628599,951366,1579965,614766,413591,329686,185037,111561,98877,1753518,626301,889102,1515403,544618,447730,354500,187320,109071,86101,1729340,3482858,6578230,6578230
Angola,1974,AO,AGO,AFR,645464,975665,1621129,649615,421262,340732,194523,112918,99882,1818932,643318,924409,1567727,574562,450477,370689,198607,112566,87806,1794707,3613639,6802494,6802494
Angola,1975,AO,AGO,AFR,664977,998753,1663730,683854,431789,349881,204669,114774,100596,1885563,662453,958459,1620912,605854,454784,385274,210828,116239,89529,1862508,3748071,7032713,7032713
Angola,1976,AO,AGO,AFR,686976,1020544,1707520,716233,445603,357214,215304,117110,101015,1952479,684063,990614,1674677,637071,461798,397970,223948,120094,91234,1932115,3884594,7266780,7266780
Angola,1977,AO,AGO,AFR,711419,1041981,1753400,748849,462400,363517,226577,120053,101270,2022666,708097,1021775,1729872,670233,471128,409222,238111,124231,93025,2005950,4028616,7511895,7511895
Angola,1978,AO,AGO,AFR,737664,1064754,1802418,781345,482669,369467,238385,123690,101487,2097043,733924,1053387,1787311,704918,483535,419290,253271,128835,94969,2084818,4181861,7771590,7771590
Angola,1979,AO,AGO,AFR,765474,1089667,1855141,812809,505458,375310,250386,128011,101761,2173735,761283,1085996,1847279,740172,498497,428073,269135,134108,97081,2167066,4340801,8043218,8043218
Angola,1980,AO,AGO,AFR,795134,1117203,1912337,843409,530807,381730,262452,133035,102134,2253567,790435,1119849,1910284,776226,516493,436081,285512,140189,99358,2253859,4507426,8330047,8330047
Angola,1981,AO,AGO,AFR,826854,1147773,1974627,872720,558165,388917,274459,138750,102657,2335668,821652,1155103,1976755,812639,537282,443375,302150,147150,101812,2344408,4680076,8631457,8631457
Angola,1982,AO,AGO,AFR,860793,1181779,2042572,900435,587281,396801,286248,145141,103396,2419302,855091,1192040,2047131,849004,560883,449884,318787,155101,104487,2438146,4857448,8947152,8947152
Angola,1983,AO,AGO,AFR,896594,1219436,2116030,926515,618769,404886,297313,152071,104227,2503781,890358,1230979,2121337,885491,588435,455547,334924,163959,107201,2535557,5039338,9276707,9276707
Angola,1984,AO,AGO,AFR,934376,1260872,2195248,950632,652329,413040,306977,159510,105148,2587636,927501,1272414,2199915,921179,620106,460023,350002,173628,109968,2634906,5222542,9617702,9617702
Angola,1985,AO,AGO,AFR,974419,1306235,2280654,973125,685246,423864,315184,167548,106381,2671348,966807,1317262,2284069,954957,652730,466020,363725,184138,112982,2734552,5405900,9970621,9970621
Angola,1986,AO,AGO,AFR,1015835,1355781,2371616,993798,716339,437869,322130,176112,107958,2754206,1007458,1366275,2373733,986067,684775,474621,375868,195459,116236,2833026,5587232,10332574,10332574
Angola,1987,AO,AGO,AFR,1056368,1408724,2465092,1012471,745364,453261,327538,184751,109547,2832932,1047321,1418671,2465992,1015189,717126,484538,386285,207401,119502,2930041,5762973,10694057,10694057
Angola,1988,AO,AGO,AFR,1095578,1464467,2560045,1031765,772556,470501,332016,193373,111267,2911478,1086027,1473817,2559844,1044463,749830,496496,395226,219907,122965,3028887,5940365,11060261,11060261
Angola,1989,AO,AGO,AFR,1133952,1523469,2657421,1053750,798801,489872,336477,202151,113520,2994571,1124040,1532160,2656200,1074797,782797,510698,403024,232967,127018,3131301,6125872,11439498,11439498
Angola,1990,AO,AGO,AFR,1170783,1585545,2756328,1078454,823594,510821,341189,210827,116216,3081101,1160600,1593585,2754185,1106281,815744,527081,409904,246327,131678,3237015,6318116,11828638,11828638
Angola,1991,AO,AGO,AFR,1207364,1650311,2857675,1106273,846835,533079,346523,219596,119655,3171961,1196809,1657775,2854584,1138240,847660,545308,416017,259970,137280,3344475,6516436,12228691,12228691
Angola,1992,AO,AGO,AFR,1242111,1716710,2958821,1137113,868120,556290,352227,228079,123547,3265376,1231020,1723749,2954769,1171229,878510,565487,421212,273493,143603,3453534,6718910,12632507,12632507
Angola,1993,AO,AGO,AFR,1275133,1784478,3059611,1169983,885946,580171,357478,235642,127669,3356889,1263511,1791312,3054823,1206732,909111,588605,425377,286499,150618,3566942,6923831,13038270,13038270
Angola,1994,AO,AGO,AFR,1309542,1854102,3163644,1206802,902124,605826,362996,242438,132582,3452768,1297475,1860869,3158344,1245664,939616,615586,428712,298937,158766,3687281,7140049,13462031,13462031
Angola,1995,AO,AGO,AFR,1344780,1924674,3269454,1251308,921467,633229,371909,248909,138589,3565411,1332311,1931431,3263742,1288348,969255,644031,433763,310445,167797,3813639,7379050,13912253,13912253
Angola,1996,AO,AGO,AFR,1380575,1995421,3375996,1302486,943341,661319,384512,255027,145467,3692152,1367843,2002254,3370097,1335204,997358,672720,441514,320770,177541,3945107,7637259,14383350,14383350
Angola,1997,AO,AGO,AFR,1417857,2065690,3483547,1357661,966178,689701,399252,260513,152857,3826162,1405031,2072770,3477801,1386604,1025308,702795,450975,329959,187996,4083637,7909799,14871146,14871146
Angola,1998,AO,AGO,AFR,1455763,2134762,3590525,1414706,990098,717038,415732,265312,160330,3963216,1442804,2142212,3585016,1441411,1054102,733454,462323,337927,198894,4228111,8191327,15366864,15366864
Angola,1999,AO,AGO,AFR,1495412,2203042,3698454,1472635,1014725,742537,433476,269709,167807,4100889,1482204,2210903,3693107,1499232,1084036,764284,475560,344857,210340,4378309,8479198,15870753,15870753
Angola,2000,AO,AGO,AFR,1538580,2270996,3809576,1533410,1042158,767062,452701,274379,175469,4245179,1525027,2279174,3804201,1560180,1115436,795252,490807,351094,222338,4535107,8780286,16394062,16394062
Angola,2001,AO,AGO,AFR,1586042,2339396,3925438,1597036,1073187,790811,473254,279524,183260,4397072,1571911,2347814,3919725,1624093,1148882,826497,508173,356834,234883,4699362,9096434,16941587,16941587
Angola,2002,AO,AGO,AFR,1638495,2408930,4047425,1663066,1108109,813869,495136,285193,191154,4556527,1623533,2417504,4041037,1690576,1184793,857969,527826,362094,247902,4871160,9427687,17516139,17516139
Angola,2003,AO,AGO,AFR,1696741,2480206,4176947,1732369,1148344,837123,519229,291373,199322,4727760,1680715,2488722,4169437,1759011,1223285,889491,550374,366773,261268,5050202,9777962,18124342,18124342
Angola,2004,AO,AGO,AFR,1761166,2554900,4316066,1804162,1193777,860709,545756,298099,207536,4910039,1743802,2563160,4306962,1829394,1265303,921113,576539,370843,274863,5238055,10148094,18771125,18771125
Angola,2005,AO,AGO,AFR,1830291,2634390,4464681,1876738,1243423,884371,572568,306927,215481,5099508,1811358,2642251,4453609,1900930,1311275,952242,604110,376386,288210,5433153,10532661,19450959,19450959
Angola,2006,AO,AGO,AFR,1902591,2720032,4622623,1949538,1297252,908040,598983,318288,223244,5295345,1882088,2727302,4609390,1973043,1361726,982444,632149,384376,301247,5634985,10930330,20162340,20162340
Angola,2007,AO,AGO,AFR,1977140,2813530,4790670,2022444,1355570,932714,625787,331422,230900,5498837,1955197,2819941,4775138,2045659,1416980,1012728,661633,393954,314087,5845041,11343878,20909684,20909684
Angola,2008,AO,AGO,AFR,2053808,2915479,4969287,2094758,1417256,959575,652511,346438,238696,5709234,2030575,2920616,4951191,2117970,1475840,1044053,691906,405349,326689,6061807,11771041,21691522,21691522
Angola,2009,AO,AGO,AFR,2131889,3025907,5157796,2166634,1482145,989302,678922,363118,246790,5926911,2107536,3029360,5136896,2190114,1538263,1077060,722788,418643,339205,6286073,12212984,22507674,22507674
Angola,2010,AO,AGO,AFR,2210397,3145517,5355914,2239267,1551202,1022676,705074,381251,255269,6154739,2184981,3147009,5331990,2263303,1605390,1112542,754424,433983,351898,6521540,12676279,23364185,23364185
Angola,2011,AO,AGO,AFR,2288385,3273899,5562284,2313449,1624042,1060064,730959,400659,264206,6393379,2261966,3273168,5535134,2338212,1676768,1150690,786695,451307,364641,6768313,13161692,24259111,24259111
Angola,2012,AO,AGO,AFR,2366278,3410511,5776789,2388869,1699279,1101291,756429,421294,273605,6640767,2338937,3407279,5746216,2414431,1751031,1191440,819403,470746,377471,7024522,13665289,25188292,25188292
Angola,2013,AO,AGO,AFR,2444057,3555087,5999144,2465222,1775744,1146144,781394,443389,283026,6894919,2415659,3549118,5964777,2491425,1827048,1234809,852278,492712,389887,7288159,14183078,26147002,26147002
Angola,2014,AO,AGO,AFR,2520439,3706361,6226800,2543264,1852308,1194416,805896,467032,292251,7155167,2490833,3697426,6188259,2569813,1903544,1280874,884942,517578,401363,7558114,14713281,27128337,27128337
Angola,2015,AO,AGO,AFR,2594750,3862433,6457183,2624379,1927897,1245845,830144,490838,302633,7421736,2563716,3850215,6413931,2651012,1979438,1330040,916970,543676,413728,7834864,15256600,28127721,28127721
Angola,2016,AO,AGO,AFR,2667428,4021429,6688857,2711983,2004001,1301547,854625,514478,314682,7701316,2634536,4005741,6640277,2738520,2056080,1383666,948236,570238,427554,8124294,15825610,29154746,29154746
Angola,2017,AO,AGO,AFR,2738616,4182282,6920898,2807331,2079659,1361115,879930,538453,327904,7994392,2703276,4163374,6866650,2833470,2132481,1441359,979323,597925,442129,8426687,16421079,30208628,30208628
Angola,2018,AO,AGO,AFR,2808086,4343895,7151981,2908414,2151718,1422388,906534,562116,342338,8293508,2769820,4322024,7091844,2933657,2205688,1501363,1011039,626333,458120,8736200,17029708,31273533,31273533
Angola,2019,AO,AGO,AFR,2876698,4504735,7381433,3016437,2221076,1485545,935207,585319,358024,8601608,2835481,4479892,7315373,3040322,2276496,1563818,1043960,655173,475403,9055172,17656780,32353588,32353588
Angola,2020,AO,AGO,AFR,2945572,4663127,7608699,3129507,2284929,1549011,965367,606922,373056,8908792,2901462,4635146,7536608,3151415,2341821,1627245,1077578,683591,492734,9374384,18283176,33428486,33428486
Angola,2021,AO,AGO,AFR,3015224,4818314,7833538,3249675,2346050,1612754,996994,626306,386168,9217947,2968182,4786773,7754955,3269217,2404354,1691624,1111956,711154,509020,9697325,18915272,34503774,34503774
Angola,2022,AO,AGO,AFR,3082589,4970319,8052908,3378371,2406969,1677114,1031085,644725,399594,9537858,3032701,4934820,7967521,3395311,2466482,1757012,1147714,738439,525740,10030698,19568556,35588987,35588987
Angola,2023,AO,AGO,AFR,3145568,5119050,8264618,3513728,2466352,1741465,1068714,664013,416655,9870927,3093648,5079425,8173073,3527760,2526704,1822633,1185779,766581,546125,10375582,20246509,36684202,36684202
Angola,2024,AO,AGO,AFR,3205694,5264631,8470325,3657010,2528030,1806395,1110259,684211,436925,10222830,3152583,5220879,8373462,3668060,2588855,1888992,1226879,795372,569862,10738020,20960850,37804634,37804634
Angola,2025,AO,AGO,AFR,3263214,5407808,8671022,3806312,2593817,1870984,1154924,704319,457996,10588352,3209334,5359919,8569253,3814237,2654869,1955289,1271095,823637,595037,11114164,21702516,38942791,38942791
Angola,2026,AO,AGO,AFR,3319185,5548784,8867969,3959345,2665379,1934785,1202832,724395,479910,10966646,3264904,5496758,8761662,3964122,2726400,2021022,1318946,851042,621722,11503254,22469900,40099526,40099526
Angola,2027,AO,AGO,AFR,3375926,5685293,9061219,4114949,2744446,1997089,1253659,744941,502540,11357624,3321300,5629067,8950367,4116959,2805138,2085434,1370129,878121,649804,11905585,23263209,41274799,41274799
Angola,2028,AO,AGO,AFR,3434398,5816570,9250968,4272291,2831837,2057598,1306783,766960,525671,11761140,3379278,5756451,9135729,4271911,2891810,2148190,1423990,905893,679090,12320884,24082024,42468711,42468711
Angola,2029,AO,AGO,AFR,3493708,5944207,9437915,4429508,2927962,2116555,1362137,791021,549095,12176278,3438014,5880735,9318749,4426817,2986857,2209434,1480469,934901,709510,12747988,24924266,43680934,43680934
Angola,2030,AO,AGO,AFR,3553735,6069309,9623044,4584739,3033578,2174224,1419601,817331,572705,12602178,3497517,6002970,9500487,4579669,3091197,2269292,1539485,965296,741010,13185949,25788127,44911664,44911664
Angola,1950,AO,AGO,AFR,360889,532515,893404,425084,320127,234511,156998,92075,57453,1286248,361097,536604,897701,447472,352319,249609,170319,107307,73801,1400827,2687075,4478184,4478184
Angola,1951,AO,AGO,AFR,369722,541099,910821,433011,326036,239468,161024,95544,58623,1313706,370811,545805,916616,452519,359265,256768,174041,110987,75020,1428600,2742306,4569738,4569738
Angola,1952,AO,AGO,AFR,379475,549897,929372,441096,331947,244280,165230,99131,59690,1341374,381229,555484,936713,457527,366132,264032,177892,114783,76136,1456502,2797876,4663958,4663958
Angola,1953,AO,AGO,AFR,392078,557641,949719,449068,338113,248788,169190,102632,60908,1368699,393611,563867,957478,462541,372836,270612,181265,118371,77209,1482834,2851533,4758724,4758724
Angola,1954,AO,AGO,AFR,408468,564056,972524,456257,344960,252853,172263,105821,62611,1394765,408778,569052,977830,467604,379406,275519,183371,121178,78267,1505345,2900110,4850458,4850458
Angola,1955,AO,AGO,AFR,425272,572775,998047,462288,352730,256532,174236,108594,64900,1419280,423670,573924,997594,472501,386026,278532,183939,122942,79257,1523197,2942477,4938118,4938118
Angola,1956,AO,AGO,AFR,441034,584937,1025971,467230,361541,259960,175230,110869,67705,1442535,437029,579968,1016997,476915,393014,279854,183039,123631,80158,1536611,2979146,5022109,5022109
Angola,1957,AO,AGO,AFR,456877,599330,1056207,470999,371318,263349,175521,112541,70934,1464662,450586,586186,1036772,480591,400611,279988,181088,123308,81100,1546686,3011348,5104328,5104328
Angola,1958,AO,AGO,AFR,472318,616266,1088584,473807,381873,266827,175259,113703,74354,1485823,464006,593221,1057227,483372,408898,279365,178280,122145,82136,1554196,3040019,5185839,5185839
Angola,1959,AO,AGO,AFR,487155,635726,1122881,475993,392868,270680,174887,114575,77800,1506803,477445,602144,1079589,485004,417861,278994,175264,120465,83085,1560673,3067476,5269947,5269947
Angola,1960,AO,AGO,AFR,501468,657305,1158773,478036,404078,274997,174559,115236,81283,1528189,490844,613087,1103931,485676,427281,279151,172142,118329,83722,1566301,3094490,5357195,5357195
Angola,1961,AO,AGO,AFR,513651,679889,1193540,478309,412389,278466,174762,115598,83872,1543396,503512,627948,1131460,483877,435756,281187,171204,116420,84496,1572940,3116336,5441333,5441333
Angola,1962,AO,AGO,AFR,523820,702770,1226590,477272,417228,280852,175475,115782,85508,1552117,515123,646666,1161789,479916,442644,285155,172725,114936,85524,1580900,3133017,5521400,5521400
Angola,1963,AO,AGO,AFR,534069,726546,1260615,476800,420920,283107,175889,115915,87110,1559741,525917,666817,1192734,475757,448256,289076,173990,113318,86339,1586736,3146477,5599827,5599827
Angola,1964,AO,AGO,AFR,544355,751363,1295718,476856,422620,285087,175743,115898,88683,1564887,535773,688330,1224103,471139,452051,292426,174489,111588,86793,1588486,3153373,5673199,5673199
Angola,1965,AO,AGO,AFR,554538,773767,1328305,480368,422029,286430,174610,115667,90229,1569333,544442,707103,1251545,469090,453722,294555,173675,109629,86712,1587383,3156716,5736582,5736582
Angola,1966,AO,AGO,AFR,564202,792877,1357079,487710,419484,286968,172184,115181,91701,1573228,551772,721323,1273095,470586,453303,295201,171202,107337,86024,1583653,3156881,5787044,5787044
Angola,1967,AO,AGO,AFR,573054,810736,1383790,497107,415519,287022,168659,114437,93045,1575789,558147,733048,1291195,473731,451324,294839,167263,104808,84764,1576729,3152518,5827503,5827503
Angola,1968,AO,AGO,AFR,581240,828175,1409415,508662,411138,287415,164858,113457,94258,1579788,564535,743971,1308506,478549,448654,294783,162879,102384,83242,1570491,3150279,5868203,5868203
Angola,1969,AO,AGO,AFR,589043,847279,1436322,522545,407606,289706,162371,112364,95354,1589946,572341,758176,1330517,485027,446390,297427,160038,100710,82016,1571608,3161554,5928386,5928386
Angola,2031,AO,AGO,AFR,3614543,6193003,9807546,4737164,3148466,2231384,1478642,846045,596392,13038093,3557801,6124409,9682210,4729398,3204696,2328520,1600500,997243,773549,13633906,26671999,46161755,46161755
Angola,2032,AO,AGO,AFR,3674711,6315166,9989877,4887059,3272311,2288706,1538708,877273,620078,13484135,3617355,6244844,9862199,4876274,3327074,2387773,1662942,1030925,807046,14092034,27576169,47428242,47428242
Angola,2033,AO,AGO,AFR,3733649,6435771,10169420,5034304,3404968,2346739,1599397,911127,643791,13940326,3675653,6364230,10039883,5020335,3458294,2447451,1726396,1066607,841368,14560451,28500777,48710079,48710079
Angola,2034,AO,AGO,AFR,3791856,6554821,10346677,5178566,3545350,2406938,1660327,947698,667614,14406493,3733269,6482475,10215744,5161336,3597251,2509002,1790407,1104673,876351,15039020,29445513,50007927,50007927
Angola,2035,AO,AGO,AFR,3849410,6672000,10521410,5320499,3691624,2471139,1720994,986974,691698,14882928,3790254,6599313,10389567,5299988,3742031,2574363,1854407,1145594,911667,15528050,30410978,51321963,51321963
Angola,2036,AO,AGO,AFR,3906201,6788414,10694615,5460307,3841581,2540925,1780988,1029042,716129,15368972,3846483,6715771,10562254,5436507,3890516,2645151,1917922,1189823,947069,16026988,31395960,52652827,52652827
Angola,2037,AO,AGO,AFR,3962577,6904994,10867571,5595754,3994093,2617954,1839648,1073645,741245,15862339,3902398,6832391,10734789,5568587,4041965,2723006,1980233,1237096,982929,16533816,32396155,53998512,53998512
Angola,2038,AO,AGO,AFR,4017385,7022123,11039508,5726076,4148357,2703008,1896727,1120291,767689,16362148,3956791,6949357,10906148,5695820,4195551,2808628,2041023,1286849,1019971,17047842,33409990,55355639,55355639
Angola,2039,AO,AGO,AFR,4069869,7139389,11209258,5852849,4302575,2796491,1952463,1168948,795779,16869105,4008845,7066425,11075270,5820013,4349155,2902454,2100441,1339059,1058540,17569662,34438767,56723291,56723291
Angola,2040,AO,AGO,AFR,4121440,7256712,11378152,5977129,4454905,2899114,2007095,1219500,825553,17383296,4059979,7183637,11243616,5942201,4500798,3005388,2158620,1393635,1098725,18099367,35482663,58104437,58104437
Angola,2041,AO,AGO,AFR,4171523,7374025,11545548,6100033,4604555,3010672,2061345,1271472,857067,17905144,4109569,7300863,11410432,6063624,4649430,3117305,2216271,1450084,1140641,18637355,36542499,59498476,59498476
Angola,2042,AO,AGO,AFR,4217373,7490357,11707730,6221436,4751806,3130856,2115838,1324369,890356,18434661,4154960,7417120,11572080,6184080,4795315,3237928,2274019,1507874,1184357,19183573,37618234,60898051,60898051
Angola,2043,AO,AGO,AFR,4262271,7604006,11866277,6341329,4896538,3259541,2171070,1377836,925482,18971796,4199522,7530699,11730221,6303514,4938490,3367231,2332247,1566635,1230032,19738149,38709945,62306440,62306440
Angola,2044,AO,AGO,AFR,4307337,7714650,12021987,6459711,5038423,3395669,2228414,1431539,962592,19516348,4244295,7641325,11885620,6421841,5078710,3504128,2392351,1625952,1277883,20300865,39817213,63724815,63724815
Angola,2045,AO,AGO,AFR,4347599,7823739,12171338,6576278,5178103,3537515,2289583,1485058,1001799,20068336,4284395,7750409,12034804,6538807,5216676,3646783,2456190,1685306,1328010,20871772,40940108,65146245,65146245
Angola,2046,AO,AGO,AFR,4384564,7930598,12315162,6692109,5315757,3682953,2356060,1538048,1043237,20628164,4321425,7857203,12178628,6655419,5352594,3793119,2525304,1744262,1380560,21451258,42079422,66573219,66573219
Angola,2047,AO,AGO,AFR,4421926,8032948,12454874,6808123,5449207,3830926,2429391,1589942,1086964,21194553,4358939,7959596,12318535,6772212,5484183,3942436,2601269,1802178,1435679,22037957,43232510,68005916,68005916
Angola,2048,AO,AGO,AFR,4457155,8132879,12590034,6924685,5577705,3980673,2510291,1640542,1133071,21766967,4394204,8059704,12453908,6889356,5611034,4093912,2684752,1858781,1493575,22631410,44398377,69442324,69442324
Angola,2049,AO,AGO,AFR,4490358,8230687,12721045,7041377,5702770,4130446,2599145,1690108,1181767,22345613,4427397,8157717,12585114,7006593,5734907,4245477,2776177,1914247,1554513,23231914,45577527,70883694,70883694
Angola,2050,AO,AGO,AFR,4523962,8322860,12846822,7158108,5825423,4278486,2696610,1738862,1232962,22930451,4461024,8250173,12711197,7123982,5856828,4395199,2876410,1968712,1618471,23839602,46770053,72328068,72328068
Anguilla,1970,AI,AIA,AMR,481,927,1408,521,239,185,181,245,138,1509,485,915,1400,537,299,274,263,294,299,1966,3475,6283,6283
Anguilla,1971,AI,AIA,AMR,468,943,1411,531,236,187,175,254,153,1536,476,934,1410,547,286,281,255,300,302,1971,3507,6329,6329
Anguilla,1972,AI,AIA,AMR,457,949,1406,550,225,191,174,254,171,1565,468,951,1419,559,280,282,249,301,309,1980,3545,6366,6366
Anguilla,1973,AI,AIA,AMR,441,955,1396,578,217,192,168,249,196,1600,458,964,1422,573,271,279,244,297,314,1978,3578,6399,6399
Anguilla,1974,AI,AIA,AMR,430,950,1380,612,218,188,163,241,212,1634,449,964,1413,592,271,277,243,291,322,1996,3630,6429,6429
Anguilla,1975,AI,AIA,AMR,422,930,1352,649,235,187,164,231,229,1695,435,944,1379,618,288,270,243,290,333,2042,3737,6463,6463
Anguilla,1976,AI,AIA,AMR,420,906,1326,678,255,191,167,218,238,1747,422,919,1341,642,310,259,242,282,343,2078,3825,6497,6497
Anguilla,1977,AI,AIA,AMR,418,877,1295,706,281,190,170,206,250,1803,413,888,1301,673,329,250,242,275,358,2127,3930,6519,6519
Anguilla,1978,AI,AIA,AMR,411,848,1259,727,313,186,170,196,259,1851,406,856,1262,691,348,243,244,268,366,2160,4011,6535,6535
Anguilla,1979,AI,AIA,AMR,402,833,1235,736,349,185,171,188,262,1891,400,829,1229,699,375,229,247,260,381,2191,4082,6548,6548
Anguilla,1980,AI,AIA,AMR,384,821,1205,741,379,188,174,179,275,1936,396,807,1203,703,398,224,249,252,393,2219,4155,6560,6560
Anguilla,1981,AI,AIA,AMR,374,811,1185,741,406,195,175,168,293,1978,395,786,1181,700,414,229,246,247,400,2236,4214,6571,6571
Anguilla,1982,AI,AIA,AMR,364,799,1163,730,438,199,178,157,299,2001,403,773,1176,689,430,238,238,242,406,2243,4244,6585,6585
Anguilla,1983,AI,AIA,AMR,356,794,1150,712,475,204,180,148,306,2025,412,759,1171,682,445,244,231,238,408,2248,4273,6601,6601
Anguilla,1984,AI,AIA,AMR,360,787,1147,708,513,222,182,144,315,2084,417,754,1171,691,467,249,229,234,414,2284,4368,6691,6691
Anguilla,1985,AI,AIA,AMR,377,785,1162,735,552,256,187,156,311,2197,424,759,1183,716,506,267,230,232,422,2373,4570,6907,6907
Anguilla,1986,AI,AIA,AMR,396,780,1176,768,591,288,203,163,311,2324,425,771,1196,739,546,293,235,237,421,2471,4795,7167,7167
Anguilla,1987,AI,AIA,AMR,414,781,1195,792,636,331,212,171,309,2451,431,785,1216,755,594,319,245,241,424,2578,5029,7436,7436
Anguilla,1988,AI,AIA,AMR,431,783,1214,810,681,379,219,181,313,2583,441,798,1239,764,649,349,245,251,420,2678,5261,7718,7718
Anguilla,1989,AI,AIA,AMR,452,792,1244,825,726,428,235,190,320,2724,455,817,1272,765,702,390,243,265,420,2785,5509,8017,8017
Anguilla,1990,AI,AIA,AMR,472,809,1281,824,771,473,247,198,323,2836,471,833,1304,764,748,436,245,271,429,2893,5729,8316,8316
Anguilla,1991,AI,AIA,AMR,478,839,1317,816,814,524,268,208,329,2959,481,859,1340,764,787,482,253,276,432,2994,5953,8617,8617
Anguilla,1992,AI,AIA,AMR,471,874,1345,806,850,570,279,222,339,3066,481,889,1370,765,825,530,265,281,436,3102,6168,8887,8887
Anguilla,1993,AI,AIA,AMR,459,907,1366,805,877,616,299,228,334,3159,465,927,1392,772,854,581,274,284,444,3209,6368,9121,9121
Anguilla,1994,AI,AIA,AMR,447,938,1385,801,902,660,324,234,327,3248,451,960,1411,785,876,628,285,286,444,3304,6552,9356,9356
Anguilla,1995,AI,AIA,AMR,445,968,1413,804,927,694,354,250,316,3345,444,991,1435,793,902,677,306,288,444,3410,6755,9601,9601
Anguilla,1996,AI,AIA,AMR,449,986,1435,808,946,728,390,262,308,3442,449,1008,1457,801,924,725,338,286,447,3521,6963,9863,9863
Anguilla,1997,AI,AIA,AMR,462,1000,1462,820,956,768,428,261,319,3552,457,1023,1480,818,941,775,371,292,442,3639,7191,10132,10132
Anguilla,1998,AI,AIA,AMR,474,1009,1483,826,964,811,473,261,322,3657,474,1031,1505,832,954,827,411,292,451,3767,7424,10416,10416
Anguilla,1999,AI,AIA,AMR,489,1023,1512,841,969,850,524,259,331,3774,495,1046,1541,847,962,880,464,289,450,3892,7666,10722,10722
Anguilla,2000,AI,AIA,AMR,515,1036,1551,861,958,890,570,260,350,3889,521,1057,1578,870,966,928,522,286,453,4025,7914,11047,11047
Anguilla,2001,AI,AIA,AMR,538,1041,1579,893,944,928,608,272,362,4007,538,1055,1593,904,965,968,572,288,460,4157,8164,11344,11344
Anguilla,2002,AI,AIA,AMR,539,1029,1568,931,936,960,640,289,368,4124,537,1037,1574,948,961,1002,613,297,471,4292,8416,11560,11560
Anguilla,2003,AI,AIA,AMR,530,1010,1540,973,928,984,677,312,365,4239,526,1020,1546,992,956,1034,652,306,480,4420,8659,11744,11744
Anguilla,2004,AI,AIA,AMR,520,1004,1524,1004,923,1012,714,337,367,4357,511,1008,1519,1027,958,1053,697,320,483,4538,8895,11934,11934
Anguilla,2005,AI,AIA,AMR,505,1008,1513,1017,927,1037,739,367,370,4457,497,1011,1508,1045,957,1068,745,338,494,4647,9104,12128,12128
Anguilla,2006,AI,AIA,AMR,494,1020,1514,1015,939,1058,760,397,383,4552,488,1019,1507,1044,972,1081,791,366,501,4755,9307,12325,12325
Anguilla,2007,AI,AIA,AMR,492,1019,1511,1004,957,1068,796,427,388,4640,489,1024,1513,1028,998,1092,835,392,510,4855,9495,12524,12524
Anguilla,2008,AI,AIA,AMR,502,1022,1524,987,976,1075,836,461,396,4731,492,1032,1524,1004,1022,1109,874,422,515,4946,9677,12730,12730
Anguilla,2009,AI,AIA,AMR,511,1025,1536,963,996,1084,872,499,407,4821,498,1042,1540,973,1045,1118,918,461,526,5041,9862,12946,12946
Anguilla,2010,AI,AIA,AMR,527,1031,1558,944,1018,1093,905,534,422,4916,502,1053,1555,939,1077,1131,960,506,529,5142,10058,13172,13172
Anguilla,2011,AI,AIA,AMR,526,1033,1559,928,1028,1094,939,566,441,4996,499,1059,1558,917,1093,1133,997,551,539,5230,10226,13341,13341
Anguilla,2012,AI,AIA,AMR,508,1037,1545,925,1031,1084,969,594,452,5055,481,1061,1542,912,1098,1120,1029,596,549,5304,10359,13455,13455
Anguilla,2013,AI,AIA,AMR,494,1034,1528,926,1069,1098,1000,632,473,5198,471,1049,1520,913,1149,1126,1056,645,560,5449,10647,13700,13700
Anguilla,2014,AI,AIA,AMR,483,1021,1504,925,1157,1143,1036,675,509,5445,468,1026,1494,912,1250,1168,1079,700,569,5678,11123,14120,14120
Anguilla,2015,AI,AIA,AMR,464,1017,1481,919,1239,1189,1072,702,544,5665,458,1013,1471,909,1343,1215,1100,749,586,5902,11567,14525,14525
Anguilla,2016,AI,AIA,AMR,448,1018,1466,909,1272,1223,1100,730,592,5826,445,1016,1461,897,1384,1258,1118,790,614,6061,11887,14813,14813
Anguilla,2017,AI,AIA,AMR,435,1017,1452,902,1267,1260,1119,760,627,5935,429,1017,1446,878,1393,1306,1133,827,647,6184,12119,15015,15015
Anguilla,2018,AI,AIA,AMR,417,1023,1440,886,1251,1297,1135,792,664,6025,409,1023,1432,861,1379,1346,1154,864,686,6290,12315,15181,15181
Anguilla,2019,AI,AIA,AMR,407,1018,1425,876,1235,1340,1152,818,709,6130,398,1017,1415,851,1362,1399,1167,902,734,6415,12545,15380,15380
Anguilla,2020,AI,AIA,AMR,406,1005,1411,864,1219,1388,1170,846,746,6233,399,1002,1401,842,1342,1460,1177,941,777,6539,12772,15585,15585
Anguilla,2021,AI,AIA,AMR,401,989,1390,854,1196,1428,1185,878,784,6325,396,992,1388,832,1314,1518,1187,973,823,6647,12972,15753,15753
Anguilla,2022,AI,AIA,AMR,396,976,1372,853,1152,1458,1196,910,816,6385,388,977,1365,836,1257,1564,1196,1001,879,6733,13118,15857,15857
Anguilla,2023,AI,AIA,AMR,387,959,1346,867,1097,1470,1211,934,842,6421,377,961,1338,847,1185,1596,1210,1026,930,6794,13215,15899,15899
Anguilla,2024,AI,AIA,AMR,378,933,1311,886,1048,1473,1221,959,873,6460,367,937,1304,865,1121,1609,1235,1046,984,6860,13320,15936,15936
Anguilla,2025,AI,AIA,AMR,371,899,1270,912,1005,1468,1234,989,895,6503,358,907,1265,891,1062,1609,1260,1063,1047,6932,13435,15966,15966
Anguilla,2026,AI,AIA,AMR,364,870,1234,936,966,1445,1253,1012,932,6544,351,876,1227,918,1006,1595,1292,1080,1108,6999,13543,15993,15993
Anguilla,2027,AI,AIA,AMR,356,848,1204,952,931,1409,1280,1031,971,6574,344,847,1191,941,954,1566,1334,1093,1159,7047,13621,16018,16018
Anguilla,2028,AI,AIA,AMR,350,821,1171,971,899,1363,1305,1045,1016,6599,338,815,1153,965,909,1525,1370,1112,1224,7105,13704,16032,16032
Anguilla,2029,AI,AIA,AMR,345,799,1144,982,875,1308,1337,1064,1059,6625,332,788,1120,980,874,1466,1412,1129,1292,7153,13778,16044,16044
Anguilla,2030,AI,AIA,AMR,339,785,1124,983,857,1253,1366,1081,1101,6641,328,769,1097,985,847,1398,1461,1142,1359,7192,13833,16055,16055
Anguilla,1950,AI,AIA,AMR,420,630,1050,502,349,262,168,83,63,1427,408,584,992,479,356,281,197,119,117,1549,2976,5017,5017
Anguilla,1951,AI,AIA,AMR,473,640,1113,511,366,273,175,88,63,1476,460,599,1059,489,371,288,205,124,116,1593,3069,5244,5244
Anguilla,1952,AI,AIA,AMR,532,639,1171,514,382,279,179,91,62,1507,518,605,1123,487,389,291,210,123,110,1610,3117,5403,5403
Anguilla,1953,AI,AIA,AMR,588,630,1218,506,397,284,177,95,61,1520,574,602,1176,475,395,288,211,124,114,1607,3127,5529,5529
Anguilla,1954,AI,AIA,AMR,622,646,1268,489,409,293,186,106,66,1549,611,616,1227,454,400,292,218,132,116,1612,3161,5659,5659
Anguilla,1955,AI,AIA,AMR,620,687,1307,465,398,289,194,115,72,1533,612,657,1269,437,393,304,232,151,128,1645,3178,5752,5752
Anguilla,1956,AI,AIA,AMR,596,729,1325,432,360,275,200,118,84,1469,598,702,1300,432,371,311,249,164,154,1681,3150,5787,5787
Anguilla,1957,AI,AIA,AMR,565,772,1337,408,317,255,206,121,100,1407,581,739,1320,430,349,312,271,178,189,1729,3136,5793,5793
Anguilla,1958,AI,AIA,AMR,537,807,1344,382,272,229,213,118,122,1336,560,765,1325,436,326,306,292,198,224,1782,3118,5783,5783
Anguilla,1959,AI,AIA,AMR,514,825,1339,365,224,202,216,113,143,1263,541,780,1321,451,302,299,309,209,262,1832,3095,5756,5756
Anguilla,1960,AI,AIA,AMR,506,825,1331,374,198,185,211,111,152,1231,528,790,1318,465,287,280,330,215,289,1866,3097,5752,5752
Anguilla,1961,AI,AIA,AMR,512,820,1332,396,197,182,211,118,146,1250,522,808,1330,478,288,267,335,221,292,1881,3131,5795,5795
Anguilla,1962,AI,AIA,AMR,516,818,1334,424,201,184,210,126,139,1284,517,824,1341,483,293,261,333,227,294,1891,3175,5855,5855
Anguilla,1963,AI,AIA,AMR,519,820,1339,449,207,184,206,138,138,1322,516,840,1356,486,303,258,330,235,286,1898,3220,5913,5913
Anguilla,1964,AI,AIA,AMR,521,826,1347,474,213,180,204,154,132,1357,515,851,1366,486,308,257,323,242,281,1897,3254,5968,5968
Anguilla,1965,AI,AIA,AMR,519,833,1352,488,217,180,205,169,126,1385,514,861,1375,491,311,255,317,247,281,1902,3287,6018,6018
Anguilla,1966,AI,AIA,AMR,512,847,1359,496,227,182,200,186,124,1415,511,867,1378,498,315,255,308,261,281,1918,3333,6071,6071
Anguilla,1967,AI,AIA,AMR,506,868,1374,502,231,182,194,205,125,1439,505,879,1384,506,314,258,293,277,283,1931,3370,6127,6127
Anguilla,1968,AI,AIA,AMR,498,887,1385,509,237,184,191,220,126,1467,499,888,1387,514,312,263,281,288,285,1943,3410,6178,6178
Anguilla,1969,AI,AIA,AMR,489,908,1397,515,235,185,186,235,127,1483,491,901,1392,528,305,268,273,289,291,1954,3437,6229,6229
Anguilla,2031,AI,AIA,AMR,335,769,1104,980,846,1193,1394,1098,1145,6656,324,751,1075,985,831,1327,1504,1153,1421,7221,13877,16058,16058
Anguilla,2032,AI,AIA,AMR,330,752,1082,972,846,1136,1416,1110,1188,6668,320,732,1052,976,833,1251,1545,1163,1483,7251,13919,16052,16052
Anguilla,2033,AI,AIA,AMR,326,736,1062,956,860,1083,1426,1120,1224,6669,316,715,1031,960,845,1180,1576,1176,1548,7285,13954,16043,16043
Anguilla,2034,AI,AIA,AMR,323,721,1044,930,880,1035,1429,1135,1264,6673,311,699,1010,935,863,1115,1590,1199,1601,7303,13976,16031,16031
Anguilla,2035,AI,AIA,AMR,320,709,1029,894,908,992,1423,1148,1301,6666,308,685,993,905,889,1056,1592,1221,1664,7327,13993,16015,16015
Anguilla,2036,AI,AIA,AMR,316,698,1014,865,931,954,1401,1167,1342,6660,306,673,979,874,915,1001,1578,1251,1718,7337,13997,15991,15991
Anguilla,2037,AI,AIA,AMR,314,686,1000,844,946,922,1369,1191,1388,6660,304,662,966,845,939,951,1548,1294,1774,7351,14011,15969,15969
Anguilla,2038,AI,AIA,AMR,312,676,988,817,966,891,1327,1223,1429,6653,302,652,954,813,964,905,1504,1335,1830,7351,14004,15946,15946
Anguilla,2039,AI,AIA,AMR,311,667,978,795,976,869,1275,1252,1468,6635,301,643,944,787,979,870,1447,1377,1891,7351,13986,15914,15914
Anguilla,2040,AI,AIA,AMR,310,658,968,783,975,850,1221,1285,1515,6629,300,636,936,768,984,843,1379,1424,1940,7338,13967,15875,15875
Anguilla,2041,AI,AIA,AMR,310,650,960,767,972,839,1163,1306,1556,6603,300,628,928,750,984,829,1310,1470,1999,7342,13945,15833,15833
Anguilla,2042,AI,AIA,AMR,310,644,954,749,961,839,1106,1331,1592,6578,300,622,922,731,975,831,1237,1508,2045,7327,13905,15786,15786
Anguilla,2043,AI,AIA,AMR,309,638,947,732,944,851,1054,1339,1635,6555,299,616,915,714,959,844,1166,1535,2097,7315,13870,15739,15739
Anguilla,2044,AI,AIA,AMR,308,634,942,718,918,872,1010,1346,1671,6535,298,612,910,698,935,862,1102,1551,2157,7305,13840,15693,15693
Anguilla,2045,AI,AIA,AMR,306,630,936,706,886,898,969,1343,1707,6509,296,608,904,685,903,886,1046,1555,2209,7284,13793,15637,15637
Anguilla,2046,AI,AIA,AMR,304,626,930,696,858,920,932,1322,1756,6484,293,606,899,673,872,912,991,1538,2272,7258,13742,15575,15575
Anguilla,2047,AI,AIA,AMR,302,624,926,684,837,934,900,1291,1803,6449,292,603,895,662,843,936,942,1506,2342,7231,13680,15511,15511
Anguilla,2048,AI,AIA,AMR,300,621,921,674,810,953,870,1253,1862,6422,290,600,890,652,811,962,897,1470,2414,7206,13628,15444,15444
Anguilla,2049,AI,AIA,AMR,297,619,916,665,790,965,846,1206,1921,6393,287,598,885,643,785,977,864,1417,2491,7177,13570,15371,15371
Anguilla,2050,AI,AIA,AMR,295,616,911,658,775,966,830,1155,1982,6366,285,595,880,636,766,980,837,1350,2571,7140,13506,15294,15294
Albania,1970,AL,ALB,EUR,178612,333901,512513,227052,165425,119147,77371,53465,45976,688436,165012,301515,466527,201002,144660,105238,79221,61597,65545,657263,1345699,2324731,2324731
Albania,1971,AL,ALB,EUR,181105,341566,522671,239598,167943,123678,79830,55101,46874,713024,167160,307782,474942,212050,147201,108536,81736,62843,66810,679176,1392200,2389812,2389812
Albania,1972,AL,ALB,EUR,183706,348038,531744,252926,170404,128173,82708,56647,47957,738815,169374,312966,482340,223942,149614,112069,84359,63915,68365,702264,1441079,2455171,2455171
Albania,1973,AL,ALB,EUR,185999,353443,539442,266793,173153,132676,85900,58156,49237,765915,171333,317232,488565,236468,152177,115787,86983,64947,70154,726516,1492431,2520436,2520436
Albania,1974,AL,ALB,EUR,187959,357771,545730,280723,176672,137113,89359,59654,50684,794205,173069,320553,493622,249430,155126,119664,89515,66083,72078,751896,1546101,2585452,2585452
Albania,1975,AL,ALB,EUR,189926,360972,550898,294278,181190,141335,93068,61121,52245,823237,174915,322918,497833,262145,158998,123597,91925,67426,74062,778153,1601390,2650122,2650122
Albania,1976,AL,ALB,EUR,191755,363110,554865,307394,186560,145262,96977,62570,53851,852614,176709,324505,501214,274284,163981,127404,94248,68957,75993,804867,1657481,2713560,2713560
Albania,1977,AL,ALB,EUR,192986,364670,557656,319710,192784,148769,101077,64044,55468,881852,177967,325696,503663,285857,169801,130939,96568,70653,77810,831628,1713480,2774795,2774795
Albania,1978,AL,ALB,EUR,193586,365836,559422,330582,200114,151767,105344,65597,57054,910458,178646,326675,505321,296375,176702,134107,98931,72523,79479,858117,1768575,2833314,2833314
Albania,1979,AL,ALB,EUR,193653,366667,560320,339573,208653,154212,109733,67296,58608,938075,178795,327568,506363,305401,184835,136816,101420,74568,80971,884011,1822086,2888763,2888763
Albania,1980,AL,ALB,EUR,193400,367455,560855,346325,218318,156105,114195,69224,60240,964407,178478,328682,507160,312500,194180,139094,104106,76817,82540,909237,1873644,2941651,2941651
Albania,1981,AL,ALB,EUR,193320,367958,561278,350819,228781,157614,118663,71431,61990,989298,178202,329911,508113,317572,204559,141044,107017,79216,84285,933693,1922991,2992389,2992389
Albania,1982,AL,ALB,EUR,194020,367585,561605,353399,239569,158993,123111,73873,63835,1012780,178703,330712,509415,321008,215528,142814,110205,81656,86162,957373,1970153,3041179,3041179
Albania,1983,AL,ALB,EUR,195548,366168,561716,354175,250358,160547,127532,76473,65828,1034913,180053,330973,511026,322957,226706,144660,113622,84015,88297,980257,2015170,3087911,3087911
Albania,1984,AL,ALB,EUR,197518,363860,561378,353236,260521,162687,131794,79231,68005,1055474,182048,330778,512826,323361,237793,146758,117226,86170,90742,1002050,2057524,3131726,3131726
Albania,1985,AL,ALB,EUR,199478,361174,560652,350628,269522,165596,135715,82172,70297,1073930,184342,330397,514739,322433,247973,149594,120872,88080,93455,1022407,2096337,3171725,3171725
Albania,1986,AL,ALB,EUR,200993,358496,559489,346518,277342,169058,139165,85268,72638,1089989,186311,330222,516533,320526,256893,153276,124311,89818,96291,1041115,2131104,3207128,3207128
Albania,1987,AL,ALB,EUR,201870,356055,557925,341313,283717,172961,141963,88540,75028,1103522,187634,330529,518163,317988,264667,157405,127375,91476,99157,1058068,2161590,3237676,3237676
Albania,1988,AL,ALB,EUR,202132,354016,556148,335172,288098,177521,143988,91954,77382,1114115,188329,331410,519739,314989,270883,162151,129903,93103,101989,1073018,2187133,3263019,3263019
Albania,1989,AL,ALB,EUR,201617,352320,553937,328187,290124,182804,145252,95458,79647,1121472,188271,332772,521043,311716,275121,167747,131742,94753,104661,1085740,2207212,3282182,3282182
Albania,1990,AL,ALB,EUR,200291,350911,551202,320714,289617,188699,145788,99008,81881,1125707,187407,334384,521791,308557,277040,174156,132951,96480,107190,1096374,2222081,3295066,3295066
Albania,1991,AL,ALB,EUR,198088,349855,547943,312857,286756,194943,145869,102540,84257,1127222,185704,335964,521668,305579,276778,181142,133732,98373,109643,1105247,2232469,3302081,3302081
Albania,1992,AL,ALB,EUR,194791,349368,544159,304458,282007,201122,145863,106037,86906,1126393,183110,337570,520680,302393,274869,188320,134284,100525,112116,1112507,2238900,3303739,3303739
Albania,1993,AL,ALB,EUR,190521,349267,539788,295740,275725,206925,146057,109441,89830,1123718,179743,339063,518806,298996,271630,195371,134906,102847,114632,1118382,2242100,3300711,3300711
Albania,1994,AL,ALB,EUR,185814,349090,534904,287205,268302,211883,146833,112607,93063,1119893,175976,340060,516036,295656,267254,202003,135799,105303,117150,1123165,2243058,3293999,3293999
Albania,1995,AL,ALB,EUR,180966,348487,529453,279489,260031,215650,148343,115369,96569,1115451,172068,340261,512329,292573,262168,207604,137392,107738,119663,1127138,2242589,3284364,3284364
Albania,1996,AL,ALB,EUR,175843,346952,522795,273023,251245,218460,150347,117635,100252,1110962,167702,339170,506872,289897,256838,212146,139728,109919,122170,1130698,2241660,3271331,3271331
Albania,1997,AL,ALB,EUR,169992,344212,514204,267972,242263,220329,152650,119320,104049,1106583,162213,336699,498912,287763,251432,215985,142415,111786,124630,1134011,2240594,3253719,3253719
Albania,1998,AL,ALB,EUR,163310,340299,503609,264501,233359,221151,155505,120530,107962,1103008,155590,332931,488521,286041,245901,219060,145594,113369,127073,1137038,2240046,3232175,3232175
Albania,1999,AL,ALB,EUR,156045,335363,491408,262707,224724,220870,158999,121486,112027,1100813,148224,327970,476194,284539,240248,221181,149489,114700,129683,1139840,2240653,3208260,3208260
Albania,2000,AL,ALB,EUR,148242,329616,477858,262329,216513,219299,163051,122254,116282,1099728,140234,321997,462231,283031,234618,221954,154116,115864,132613,1142196,2241924,3182021,3182021
Albania,2001,AL,ALB,EUR,140250,322772,463022,263119,208858,216504,167601,123030,120820,1099932,131947,314788,446735,281100,228902,221462,159400,117006,136057,1143927,2243859,3153612,3153612
Albania,2002,AL,ALB,EUR,132496,314486,446982,265047,201625,212770,172336,124054,125669,1101501,123792,306167,429959,278784,222734,220117,165118,118268,140086,1145107,2246608,3123551,3123551
Albania,2003,AL,ALB,EUR,125361,305049,430410,267601,194934,208361,177015,125499,130749,1104159,116233,296259,412492,276224,216325,218085,170895,119879,144525,1145933,2250092,3092991,3092991
Albania,2004,AL,ALB,EUR,118699,294761,413460,270353,189204,203464,181250,127649,135897,1107817,109199,285385,394584,273667,210019,215418,176532,121946,149186,1146768,2254585,3062622,3062622
Albania,2005,AL,ALB,EUR,112299,283767,396066,273119,184750,198265,184771,130529,140925,1112359,102575,273804,376379,271303,204000,212363,181551,124766,153845,1147828,2260187,3032634,3032634
Albania,2006,AL,ALB,EUR,106414,272356,378770,275243,181702,192983,187853,133799,145680,1117260,96680,261599,358279,268897,198499,209179,185949,128279,158276,1149079,2266339,3003387,3003387
Albania,2007,AL,ALB,EUR,101067,260843,361910,276528,180158,187716,190632,137308,150398,1122740,91508,248950,340458,266690,193725,205723,190143,132109,162591,1150981,2273721,2976084,2976084
Albania,2008,AL,ALB,EUR,96297,249536,345833,276913,180084,182577,192950,141266,155032,1128822,87134,236438,323572,264579,189722,201898,194085,136411,166755,1153450,2282272,2951689,2951689
Albania,2009,AL,ALB,EUR,92416,238355,330771,276374,181509,177740,194469,145731,159454,1135277,83834,224216,308050,262485,186657,197782,197384,141447,170685,1156440,2291717,2930541,2930541
Albania,2010,AL,ALB,EUR,89613,227423,317036,275106,184053,173492,194955,150652,163811,1142069,81684,212467,294151,260680,184507,193820,199411,147159,174569,1160146,2302215,2913399,2913399
Albania,2011,AL,ALB,EUR,87924,217036,304960,272585,187606,169944,194616,155849,168337,1148937,80681,201648,282329,258790,183212,190012,200434,153309,178669,1164426,2313363,2900654,2900654
Albania,2012,AL,ALB,EUR,87167,207473,294640,268710,192276,166722,193770,161056,173198,1155732,80585,192110,272695,256461,183011,185821,201030,159653,183148,1169124,2324856,2892193,2892193
Albania,2013,AL,ALB,EUR,86960,199017,285977,263765,197506,163783,192476,166218,178386,1162134,80911,184159,265070,253317,184023,181413,201120,165876,188085,1173834,2335968,2887014,2887014
Albania,2014,AL,ALB,EUR,86878,191414,278292,257861,203146,161561,190578,171138,184160,1168444,81253,177241,258494,249387,186464,177014,200403,172001,193609,1178878,2347322,2884102,2884102
Albania,2015,AL,ALB,EUR,86401,184717,271118,251000,209128,160320,188262,175553,190401,1174664,81218,171315,252533,244576,190213,173000,199076,177605,199693,1184163,2358827,2882481,2882481
Albania,2016,AL,ALB,EUR,85224,179636,264860,243166,214367,160151,185786,179767,196568,1179805,80418,167373,247791,238107,194565,169782,197465,182736,205957,1188612,2368417,2881063,2881063
Albania,2017,AL,ALB,EUR,83273,175585,258858,235223,218665,161024,182869,184001,202535,1184317,78734,164664,243398,230775,199450,167368,195171,187899,212128,1192791,2377108,2879355,2879355
Albania,2018,AL,ALB,EUR,80494,172131,252625,227231,222192,163027,179659,187803,208676,1188588,76182,162676,238858,223141,204538,165740,192145,192810,218571,1196945,2385533,2877013,2877013
Albania,2019,AL,ALB,EUR,77317,169398,246715,218603,224746,166274,176682,190340,215322,1191967,73150,161560,234710,214790,209346,165194,188798,196529,225833,1200490,2392457,2873883,2873883
Albania,2020,AL,ALB,EUR,74644,166686,241330,210007,226347,169845,174109,191195,220936,1192439,70502,160382,230884,206356,213836,165218,185957,198168,232661,1202196,2394635,2866849,2866849
Albania,2021,AL,ALB,EUR,72777,164193,236970,201412,226114,173666,171802,190984,225008,1188986,68616,159209,227825,197705,217290,165445,183225,198835,238427,1200927,2389913,2854710,2854710
Albania,2022,AL,ALB,EUR,71956,161863,233819,193941,225288,177669,168726,190030,228335,1183989,67580,157540,225120,189726,219775,166204,179502,199128,245061,1199396,2383385,2842321,2842321
Albania,2023,AL,ALB,EUR,72050,159256,231306,188081,224442,181592,165092,188496,231880,1179583,67307,154917,222224,183231,221134,167918,175208,198963,252876,1199330,2378913,2832439,2832439
Albania,2024,AL,ALB,EUR,72161,156736,228897,182378,222481,186342,161994,186509,237537,1177241,67299,152115,219414,176850,221165,171191,170677,198266,262319,1200468,2377709,2826020,2826020
Albania,2025,AL,ALB,EUR,72157,154277,226434,177142,219309,191832,159770,183946,244299,1176298,67385,149313,216698,170889,219493,175913,166590,196810,272503,1202198,2378496,2821626,2821626
Albania,2026,AL,ALB,EUR,72007,152001,224008,173152,214752,196904,158581,180783,250956,1175128,67353,146588,213941,166522,215305,181237,163430,194768,282353,1203615,2378743,2816695,2816695
Albania,2027,AL,ALB,EUR,71523,149821,221344,169600,210011,201550,158354,176847,257608,1173970,67017,143853,210870,162837,210040,186963,161127,191724,292240,1204931,2378901,2811110,2811110
Albania,2028,AL,ALB,EUR,70822,147529,218351,166291,204833,205829,159283,172538,264071,1172845,66457,141012,207469,159838,203921,192639,159768,187899,302037,1206102,2378947,2804771,2804771
Albania,2029,AL,ALB,EUR,69998,145298,215296,163379,198837,209434,161461,168277,270068,1171456,65766,138150,203916,157475,196958,197853,159444,183680,311522,1206932,2378388,2797599,2797599
Albania,2030,AL,ALB,EUR,69032,143485,212517,160369,192718,212560,164074,164615,275150,1169486,64925,135678,200603,154946,189922,202857,159614,180076,319580,1206995,2376481,2789599,2789599
Albania,1950,AL,ALB,EUR,98131,159948,258079,124055,81642,66420,46631,32143,33485,384376,89608,141293,230901,105874,79126,64695,48718,38586,42224,379223,763599,1252582,1252582
Albania,1951,AL,ALB,EUR,101979,162519,264498,128876,84390,68496,47557,32410,34530,396259,93634,144295,237929,109856,81492,66114,49454,39257,44308,390481,786740,1289168,1289168
Albania,1952,AL,ALB,EUR,106247,164902,271149,133395,87833,70330,48497,32923,35531,408509,98079,147242,245321,113976,84002,67277,50297,40132,46279,401963,810472,1326948,1326948
Albania,1953,AL,ALB,EUR,111116,167450,278566,137732,91855,71891,49538,33666,36422,421104,103122,150329,253451,118169,86625,68288,51336,41182,48034,413634,834738,1366744,1366744
Albania,1954,AL,ALB,EUR,116440,170664,287104,141980,96315,73141,50773,34564,37150,433923,108786,153767,262553,122409,89329,69269,52629,42283,49512,425431,859354,1409005,1409005
Albania,1955,AL,ALB,EUR,122035,174873,296908,146168,101101,74081,52295,35532,37657,446834,114550,158144,272694,126626,92081,70350,54234,43313,50690,437294,884128,1453730,1453730
Albania,1956,AL,ALB,EUR,127923,180045,307968,150327,106033,74818,54094,36499,37934,459705,120172,163652,283824,130724,94895,71583,56115,44202,51610,449129,908834,1500624,1500624
Albania,1957,AL,ALB,EUR,133985,186219,320204,154365,111016,75555,56100,37450,38045,472531,125854,170038,295892,134641,97802,73015,58157,44970,52359,460944,933475,1549571,1549571
Albania,1958,AL,ALB,EUR,140087,193662,333749,158198,115971,76490,58218,38378,38151,485406,131504,177432,308936,138381,100829,74673,60210,45682,53114,472889,958295,1600983,1600983
Albania,1959,AL,ALB,EUR,146172,202459,348631,161810,120829,77836,60317,39259,38374,498425,137066,185884,322950,141903,104069,76572,62111,46355,54000,485010,983435,1655020,1655020
Albania,1960,AL,ALB,EUR,152053,212540,364593,165119,125544,79720,62326,40065,38809,511583,142378,195277,337655,145185,107553,78734,63763,47000,55117,497352,1008935,1711189,1711189
Albania,1961,AL,ALB,EUR,157549,223777,381326,168188,130091,82208,64205,40801,39486,524979,147276,205489,352765,148310,111279,81113,65124,47669,56513,510008,1034987,1769079,1769079
Albania,1962,AL,ALB,EUR,162484,235915,398399,171228,134536,85261,65926,41548,40360,538859,151628,216406,368034,151345,115223,83636,66281,48443,58012,522940,1061799,1828232,1828232
Albania,1963,AL,ALB,EUR,166568,248798,415366,174573,138970,88745,67496,42393,41321,553498,155167,227925,383092,154539,119297,86246,67366,49416,59475,536339,1089837,1888302,1888302
Albania,1964,AL,ALB,EUR,169583,262089,431672,178713,143373,92575,68909,43452,42263,569285,157695,239945,397640,158124,123455,88863,68503,50664,60810,550419,1119704,1949013,1949013
Albania,1965,AL,ALB,EUR,171476,275435,446911,183893,147676,96693,70144,44789,43070,586265,159206,251834,411040,162605,127587,91444,69791,52255,61885,565567,1151832,2009789,2009789
Albania,1966,AL,ALB,EUR,172529,288758,461287,190068,151848,101005,71273,46368,43680,604242,159989,263291,423280,168196,131582,94013,71260,54144,62694,581889,1186131,2070689,2070689
Albania,1967,AL,ALB,EUR,173413,301759,475172,197246,155781,105458,72431,48120,44179,623215,160658,274395,435053,174658,135342,96616,72913,56175,63303,599007,1222222,2132443,2132443
Albania,1968,AL,ALB,EUR,174651,313841,488492,205728,159389,109996,73746,49939,44670,643468,161669,284660,446329,182228,138789,99301,74787,58189,63878,617172,1260640,2195466,2195466
Albania,1969,AL,ALB,EUR,176422,324647,501069,215682,162616,114571,75359,51738,45244,665210,163145,293790,456935,191024,141885,102158,76894,60037,64590,636588,1301798,2259799,2259799
Albania,2031,AL,ALB,EUR,67917,142270,210187,157739,185987,214453,167194,161775,279573,1166721,63925,133847,197772,152737,182258,207087,160057,177042,326879,1206060,2372781,2780747,2780747
Albania,2032,AL,ALB,EUR,66666,141389,208055,155351,179405,214928,171002,158891,283804,1163381,62786,132538,195324,150582,174817,210070,160995,173465,334270,1204199,2367580,2770957,2770957
Albania,2033,AL,ALB,EUR,65333,140793,206126,152767,173609,214173,175085,155871,287971,1159476,61558,131709,193267,147981,168365,211460,162790,169467,341312,1201375,2360851,2760238,2760238
Albania,2034,AL,ALB,EUR,63946,140088,204034,150258,167947,212271,179881,153198,291788,1155343,60271,131014,191285,145191,162012,211509,166084,165166,347976,1197938,2353281,2748602,2748602
Albania,2035,AL,ALB,EUR,62522,139122,201644,147809,162743,209136,185354,151263,294855,1151160,58946,130262,189208,142398,156070,209853,170793,161251,353699,1194064,2345224,2736080,2736080
Albania,2036,AL,ALB,EUR,61064,137860,198924,145545,158781,204626,190417,150310,297259,1146938,57582,129234,186816,139675,151718,205691,176109,158246,358532,1189971,2336909,2722651,2722651
Albania,2037,AL,ALB,EUR,59620,136131,195751,143373,155254,199930,195052,150271,298926,1142806,56230,127764,183994,136942,148048,200455,181813,156069,362446,1185773,2328579,2708322,2708322
Albania,2038,AL,ALB,EUR,58196,134099,192295,141090,151969,194800,199325,151339,300070,1138593,54895,125977,180872,134106,145061,194365,187470,154815,365542,1181359,2319952,2693123,2693123
Albania,2039,AL,ALB,EUR,56803,131899,188702,138871,149076,188854,202935,153614,300823,1134173,53590,124005,177595,131249,142706,187440,192670,154573,367975,1176613,2310786,2677082,2677082
Albania,2040,AL,ALB,EUR,55457,129515,184972,137064,146084,182783,206069,156291,301273,1129564,52328,121838,174166,128785,140189,180440,197660,154813,369666,1171553,2301117,2660261,2660261
Albania,2041,AL,ALB,EUR,54188,126942,181130,135859,143476,176107,207984,159468,301875,1124769,51137,119480,170617,126955,137989,172810,201876,155320,371215,1166165,2290934,2642682,2642682
Albania,2042,AL,ALB,EUR,52993,124255,177248,134984,141104,169573,208491,163307,302240,1119699,50013,116994,167007,125649,135840,165405,204848,156310,372341,1160393,2280092,2624352,2624352
Albania,2043,AL,ALB,EUR,51878,121503,173381,134392,138531,163816,207780,167391,302426,1114336,48962,114432,163394,124824,133248,158985,206234,158139,372783,1154213,2268549,2605325,2605325
Albania,2044,AL,ALB,EUR,50861,118730,169591,133693,136040,158198,205930,172170,302626,1108657,48000,111847,159847,124134,130467,152657,206295,161439,372601,1147593,2256250,2585680,2585680
Albania,2045,AL,ALB,EUR,49911,115963,165874,132731,133607,153032,202864,177600,302815,1102649,47102,109257,156359,123385,127677,146744,204666,166124,371945,1140541,2243190,2565420,2565420
Albania,2046,AL,ALB,EUR,49009,113239,162248,131474,131355,149100,198431,182623,303334,1096317,46250,106707,152957,122356,124961,142418,200538,171404,371381,1133058,2229375,2544581,2544581
Albania,2047,AL,ALB,EUR,48165,110604,158769,129752,129195,145598,193811,187220,304067,1089643,45452,104234,149686,120889,122243,138763,195353,177074,370819,1125141,2214784,2523233,2523233
Albania,2048,AL,ALB,EUR,47376,108072,155448,127727,126926,142343,188769,191469,305401,1082635,44705,101853,146558,119105,119416,135792,189325,182691,370454,1116783,2199418,2501416,2501416
Albania,2049,AL,ALB,EUR,46608,105661,152269,125531,124718,139474,182917,195088,307561,1075289,43977,99589,143566,117132,116564,133454,182460,187862,370551,1108023,2183312,2479150,2479150
Albania,2050,AL,ALB,EUR,45858,103369,149227,123152,122923,136505,176939,198227,309887,1067633,43271,97431,140702,114973,114104,130951,175526,192815,370533,1098902,2166535,2456472,2456472
Andorra,1970,AD,AND,EUR,1016,2172,3188,1976,1365,1479,1140,832,483,7275,956,1850,2806,1596,1464,1312,987,689,547,6595,13870,19860,19860
Andorra,1971,AD,AND,EUR,1091,2281,3372,2239,1503,1545,1197,880,537,7901,1028,1949,2977,1797,1545,1373,1064,723,581,7083,14984,21322,21322
Andorra,1972,AD,AND,EUR,1177,2362,3539,2508,1665,1607,1261,931,581,8553,1107,2032,3139,2006,1635,1430,1146,758,616,7591,16144,22832,22832
Andorra,1973,AD,AND,EUR,1272,2417,3689,2778,1867,1662,1336,984,644,9271,1187,2110,3297,2214,1740,1500,1227,803,661,8145,17416,24393,24393
Andorra,1974,AD,AND,EUR,1362,2463,3825,3037,2108,1713,1414,1038,700,10010,1268,2180,3448,2416,1863,1566,1311,852,708,8716,18726,26003,26003
Andorra,1975,AD,AND,EUR,1443,2500,3943,3279,2375,1763,1496,1089,779,10781,1346,2253,3599,2600,2017,1630,1398,903,764,9312,20093,27640,27640
Andorra,1976,AD,AND,EUR,1505,2557,4062,3482,2673,1827,1589,1142,859,11572,1405,2335,3740,2757,2197,1692,1494,959,823,9922,21494,29294,29294
Andorra,1977,AD,AND,EUR,1532,2633,4165,3635,2987,1907,1688,1203,935,12355,1445,2437,3882,2887,2392,1769,1581,1024,886,10539,22894,30949,30949
Andorra,1978,AD,AND,EUR,1512,2745,4257,3736,3307,2017,1794,1264,1031,13149,1450,2554,4004,2981,2614,1849,1659,1104,961,11168,24317,32574,32574
Andorra,1979,AD,AND,EUR,1440,2875,4315,3786,3633,2163,1896,1331,1127,13936,1403,2692,4095,3035,2843,1954,1726,1187,1049,11794,25730,34142,34142
Andorra,1980,AD,AND,EUR,1316,3020,4336,3781,3951,2354,1996,1398,1231,14711,1289,2830,4119,3060,3079,2091,1787,1275,1145,12437,27148,35611,35611
Andorra,1981,AD,AND,EUR,1149,3153,4302,3748,4256,2593,2096,1467,1343,15503,1119,2958,4077,3081,3323,2234,1845,1372,1252,13107,28610,36987,36987
Andorra,1982,AD,AND,EUR,1117,3256,4373,3745,4508,2839,2179,1550,1449,16270,1067,3056,4123,3166,3544,2395,1908,1480,1341,13834,30104,38598,38598
Andorra,1983,AD,AND,EUR,1212,3328,4540,3773,4716,3090,2244,1641,1551,17015,1140,3117,4257,3307,3747,2565,1970,1590,1434,14613,31628,40432,40432
Andorra,1984,AD,AND,EUR,1257,3384,4641,3786,4943,3351,2312,1744,1662,17798,1177,3156,4333,3424,3958,2758,2038,1695,1534,15407,33205,42181,42181
Andorra,1985,AD,AND,EUR,1212,3446,4658,3787,5173,3610,2396,1842,1781,18589,1155,3188,4343,3516,4177,2977,2103,1800,1653,16226,34815,43809,43809
Andorra,1986,AD,AND,EUR,1207,3492,4699,3878,5373,3855,2489,1959,1908,19462,1157,3227,4384,3624,4374,3190,2174,1907,1792,17061,36523,45605,45605
Andorra,1987,AD,AND,EUR,1297,3498,4795,4068,5555,4081,2596,2090,2054,20444,1233,3251,4484,3764,4562,3385,2262,2002,1937,17912,38356,47635,47635
Andorra,1988,AD,AND,EUR,1377,3488,4865,4241,5757,4293,2723,2214,2212,21440,1301,3253,4554,3880,4768,3581,2366,2081,2112,18788,40228,49654,49654
Andorra,1989,AD,AND,EUR,1426,3476,4902,4377,5989,4505,2880,2321,2391,22463,1335,3262,4597,3968,4991,3770,2498,2147,2304,19678,42141,51639,51639
Andorra,1990,AD,AND,EUR,1434,3482,4916,4462,6234,4720,3067,2416,2575,23474,1317,3294,4611,4016,5222,3955,2662,2207,2502,20564,44038,53569,53569
Andorra,1991,AD,AND,EUR,1469,3468,4937,4551,6415,4952,3266,2495,2729,24408,1333,3289,4622,4130,5434,4139,2821,2257,2686,21467,45875,55434,55434
Andorra,1992,AD,AND,EUR,1556,3423,4979,4655,6529,5216,3468,2563,2859,25290,1409,3234,4643,4305,5629,4318,2977,2295,2845,22369,47659,57283,57283
Andorra,1993,AD,AND,EUR,1639,3392,5031,4705,6656,5477,3700,2628,3012,26178,1484,3195,4679,4409,5855,4508,3148,2345,2999,23264,49442,59156,59156
Andorra,1994,AD,AND,EUR,1701,3382,5083,4691,6810,5733,3954,2702,3184,27074,1546,3181,4727,4425,6122,4709,3324,2400,3166,24146,51220,61037,61037
Andorra,1995,AD,AND,EUR,1740,3411,5151,4615,6978,5998,4224,2780,3372,27967,1591,3197,4788,4366,6418,4927,3514,2459,3334,25018,52985,62928,62928
Andorra,1996,AD,AND,EUR,1770,3421,5191,4465,6952,6218,4469,2838,3557,28499,1623,3194,4817,4236,6541,5150,3683,2511,3517,25638,54137,64147,64147
Andorra,1997,AD,AND,EUR,1797,3409,5206,4263,6726,6402,4672,2875,3727,28665,1650,3167,4817,4071,6456,5372,3832,2568,3702,26001,54666,64682,64682
Andorra,1998,AD,AND,EUR,1810,3415,5225,4071,6479,6571,4852,2940,3886,28799,1662,3171,4833,3906,6330,5593,3986,2637,3879,26331,55130,65186,65186
Andorra,1999,AD,AND,EUR,1806,3432,5238,3893,6228,6702,5017,3043,4038,28921,1664,3184,4848,3748,6183,5791,4130,2737,4055,26644,55565,65655,65655
Andorra,2000,AD,AND,EUR,1774,3463,5237,3734,5975,6787,5168,3199,4188,29051,1659,3202,4861,3603,6019,5964,4273,2874,4223,26956,56007,66097,66097
Andorra,2001,AD,AND,EUR,1815,3550,5365,3827,5998,6943,5336,3388,4289,29781,1718,3256,4974,3681,6027,6181,4426,3013,4365,27693,57474,67820,67820
Andorra,2002,AD,AND,EUR,1933,3701,5634,4119,6333,7189,5551,3589,4359,31140,1827,3355,5182,3943,6246,6456,4611,3153,4481,28890,60030,70849,70849
Andorra,2003,AD,AND,EUR,2024,3863,5887,4320,6729,7443,5793,3811,4454,32550,1904,3481,5385,4133,6521,6724,4817,3304,4591,30090,62640,73907,73907
Andorra,2004,AD,AND,EUR,2072,4047,6119,4428,7164,7717,6063,4038,4548,33958,1918,3640,5558,4232,6849,6992,5059,3457,4705,31294,65252,76933,76933
Andorra,2005,AD,AND,EUR,2049,4253,6302,4470,7603,8021,6366,4265,4651,35376,1852,3827,5679,4259,7208,7266,5325,3614,4798,32470,67846,79826,79826
Andorra,2006,AD,AND,EUR,2030,4347,6377,4378,7611,8043,6464,4335,4618,35449,1813,3918,5731,4162,7246,7359,5458,3659,4776,32660,68109,80221,80221
Andorra,2007,AD,AND,EUR,2049,4303,6352,4212,7181,7790,6341,4236,4430,34190,1847,3887,5734,4002,6949,7254,5475,3582,4643,31905,66095,78168,78168
Andorra,2008,AD,AND,EUR,2068,4229,6297,4071,6772,7543,6218,4102,4186,32892,1874,3835,5709,3881,6661,7119,5515,3497,4486,31159,64051,76055,76055
Andorra,2009,AD,AND,EUR,2051,4153,6204,3959,6387,7303,6078,3937,3923,31587,1880,3800,5680,3763,6387,6991,5539,3396,4311,30387,61974,73852,73852
Andorra,2010,AD,AND,EUR,1945,4104,6049,3877,6032,7034,5942,3735,3645,30265,1843,3780,5623,3644,6114,6866,5537,3324,4102,29587,59852,71519,71519
Andorra,2011,AD,AND,EUR,1878,4108,5986,3836,5735,6876,5947,3724,3565,29683,1842,3771,5613,3553,5860,6801,5631,3380,4058,29283,58966,70567,70567
Andorra,2012,AD,AND,EUR,1899,4105,6004,3859,5456,6862,6093,3896,3718,29884,1886,3766,5652,3525,5562,6831,5806,3527,4219,29470,59354,71013,71013
Andorra,2013,AD,AND,EUR,1871,4087,5958,3910,5186,6827,6234,4026,3904,30087,1869,3768,5637,3526,5287,6805,5988,3688,4394,29688,59775,71367,71367
Andorra,2014,AD,AND,EUR,1798,4070,5868,3938,4942,6791,6331,4194,4087,30283,1792,3757,5549,3547,5062,6744,6145,3840,4579,29917,60200,71621,71621
Andorra,2015,AD,AND,EUR,1683,4016,5699,3962,4765,6702,6406,4382,4272,30489,1670,3756,5426,3567,4847,6712,6220,4029,4760,30135,60624,71746,71746
Andorra,2016,AD,AND,EUR,1602,4026,5628,4076,4698,6637,6531,4591,4466,30999,1591,3786,5377,3628,4688,6725,6314,4262,4918,30535,61534,72540,72540
Andorra,2017,AD,AND,EUR,1490,4068,5558,4226,4749,6622,6720,4850,4649,31816,1473,3820,5293,3744,4598,6748,6471,4521,5079,31161,62977,73837,73837
Andorra,2018,AD,AND,EUR,1356,4067,5423,4322,4834,6583,6913,5124,4868,32644,1321,3830,5151,3835,4590,6690,6607,4799,5262,31783,64427,75013,75013
Andorra,2019,AD,AND,EUR,1324,4035,5359,4401,4950,6533,7087,5411,5098,33480,1260,3818,5078,3921,4635,6587,6755,5053,5473,32424,65904,76343,76343
Andorra,2020,AD,AND,EUR,1317,3992,5309,4469,5124,6463,7236,5688,5324,34304,1232,3820,5052,3992,4697,6457,6898,5284,5707,33035,67339,77700,77700
Andorra,2021,AD,AND,EUR,1320,3962,5282,4530,5308,6412,7339,5943,5543,35075,1218,3834,5052,4039,4753,6353,7016,5520,5944,33625,68700,79034,79034
Andorra,2022,AD,AND,EUR,1307,3905,5212,4511,5402,6320,7402,6168,5773,35576,1194,3809,5003,4057,4754,6190,7113,5748,6176,34038,69614,79824,79824
Andorra,2023,AD,AND,EUR,1270,3802,5072,4475,5375,6173,7398,6385,6020,35826,1167,3707,4874,4077,4689,6015,7121,5983,6431,34316,70142,80088,80088
Andorra,2024,AD,AND,EUR,1268,3666,4934,4462,5314,6052,7380,6555,6311,36074,1168,3551,4719,4097,4633,5891,7109,6179,6702,34611,70685,80341,80341
Andorra,2025,AD,AND,EUR,1323,3483,4806,4433,5248,5988,7317,6691,6624,36301,1214,3352,4566,4124,4581,5755,7137,6298,7011,34906,71207,80578,80578
Andorra,2026,AD,AND,EUR,1411,3260,4671,4431,5187,5913,7229,6807,6962,36529,1313,3115,4428,4154,4508,5606,7160,6410,7329,35167,71696,80796,80796
Andorra,2027,AD,AND,EUR,1459,3100,4559,4426,5106,5825,7129,6932,7309,36727,1375,2936,4311,4145,4464,5436,7116,6557,7684,35402,72129,80998,80998
Andorra,2028,AD,AND,EUR,1449,3032,4481,4382,5013,5754,7000,7045,7674,36868,1364,2853,4217,4119,4428,5323,6987,6680,8084,35621,72489,81187,81187
Andorra,2029,AD,AND,EUR,1441,2983,4424,4312,4952,5682,6858,7132,8053,36989,1357,2784,4141,4087,4410,5247,6816,6790,8463,35813,72802,81366,81366
Andorra,2030,AD,AND,EUR,1436,2930,4366,4231,4909,5651,6681,7195,8442,37109,1352,2718,4070,4058,4410,5153,6617,6894,8855,35987,73096,81528,81528
Andorra,1950,AD,AND,EUR,257,448,705,497,412,413,381,248,237,2188,248,436,684,493,420,435,402,324,360,2434,4622,6005,6005
Andorra,1951,AD,AND,EUR,246,436,682,461,409,397,373,243,233,2116,238,424,662,455,415,413,398,320,358,2359,4475,5827,5827
Andorra,1952,AD,AND,EUR,229,412,641,400,389,362,361,235,223,1970,218,413,631,388,389,382,387,311,351,2208,4178,5454,5454
Andorra,1953,AD,AND,EUR,221,402,623,378,382,342,362,236,218,1918,206,407,613,360,380,358,383,311,358,2150,4068,5308,5308
Andorra,1954,AD,AND,EUR,236,423,659,412,411,355,375,242,224,2019,219,433,652,395,406,359,395,313,362,2230,4249,5566,5566
Andorra,1955,AD,AND,EUR,275,471,746,479,472,400,405,251,226,2233,251,484,735,468,453,386,415,315,369,2406,4639,6116,6116
Andorra,1956,AD,AND,EUR,314,530,844,535,538,451,435,265,229,2453,287,530,817,540,503,419,437,319,374,2592,5045,6705,6705
Andorra,1957,AD,AND,EUR,359,593,952,582,606,511,466,285,229,2679,329,574,903,617,555,462,460,326,377,2797,5476,7330,7330
Andorra,1958,AD,AND,EUR,412,661,1073,625,677,574,506,309,228,2919,379,618,997,684,609,507,482,338,382,3002,5921,7994,7994
Andorra,1959,AD,AND,EUR,472,733,1205,660,752,641,542,337,239,3171,431,663,1094,757,672,562,504,353,391,3239,6410,8700,8700
Andorra,1960,AD,AND,EUR,527,817,1344,695,829,710,579,370,245,3428,481,715,1196,821,741,621,525,370,396,3474,6902,9443,9443
Andorra,1961,AD,AND,EUR,585,904,1489,730,901,782,620,408,255,3696,530,778,1308,881,809,685,548,400,405,3728,7424,10216,10216
Andorra,1962,AD,AND,EUR,639,1003,1642,766,968,856,671,450,264,3975,576,857,1433,923,884,753,572,436,399,3967,7942,11014,11014
Andorra,1963,AD,AND,EUR,690,1104,1794,808,1024,931,727,496,274,4260,622,948,1570,953,961,823,604,476,398,4215,8475,11839,11839
Andorra,1964,AD,AND,EUR,736,1211,1947,864,1061,1015,792,550,288,4570,662,1046,1708,971,1045,889,648,514,402,4469,9039,12690,12690
Andorra,1965,AD,AND,EUR,778,1315,2093,932,1087,1100,861,607,300,4887,699,1146,1845,987,1123,959,693,552,410,4724,9611,13563,13563
Andorra,1966,AD,AND,EUR,817,1453,2270,1045,1108,1183,927,666,325,5254,737,1270,2007,1030,1192,1038,748,587,424,5019,10273,14546,14546
Andorra,1967,AD,AND,EUR,860,1646,2506,1230,1142,1262,981,712,350,5677,784,1433,2217,1117,1259,1109,799,612,446,5342,11019,15745,15745
Andorra,1968,AD,AND,EUR,906,1852,2758,1463,1190,1337,1030,752,388,6160,833,1598,2431,1252,1318,1185,858,633,476,5722,11882,17079,17079
Andorra,1969,AD,AND,EUR,957,2031,2988,1715,1264,1410,1085,791,437,6702,892,1737,2629,1414,1383,1253,924,658,510,6142,12844,18449,18449
Andorra,2031,AD,AND,EUR,1434,2867,4301,4145,4894,5622,6514,7213,8836,37224,1348,2659,4007,4027,4409,5045,6442,6965,9252,36140,73364,81674,81674
Andorra,2032,AD,AND,EUR,1431,2812,4243,4057,4848,5608,6362,7230,9213,37318,1349,2614,3963,3973,4414,4961,6241,7039,9647,36275,73593,81799,81799
Andorra,2033,AD,AND,EUR,1431,2764,4195,3952,4811,5583,6219,7232,9600,37397,1349,2577,3926,3873,4429,4895,6069,7050,10077,36393,73790,81914,81914
Andorra,2034,AD,AND,EUR,1430,2754,4184,3817,4798,5523,6101,7216,9975,37430,1350,2570,3920,3716,4452,4842,5946,7039,10482,36477,73907,82015,82015
Andorra,2035,AD,AND,EUR,1431,2805,4236,3634,4765,5456,6039,7157,10331,37382,1350,2613,3963,3518,4480,4788,5810,7069,10841,36506,73888,82096,82096
Andorra,2036,AD,AND,EUR,1433,2889,4322,3412,4769,5396,5965,7071,10686,37299,1352,2708,4060,3282,4509,4715,5662,7093,11213,36474,73773,82154,82154
Andorra,2037,AD,AND,EUR,1436,2937,4373,3250,4763,5314,5879,6979,11051,37236,1353,2770,4123,3102,4499,4672,5497,7049,11638,36457,73693,82189,82189
Andorra,2038,AD,AND,EUR,1440,2926,4366,3181,4721,5222,5808,6857,11430,37219,1357,2758,4115,3019,4475,4639,5384,6926,12078,36521,73740,82218,82218
Andorra,2039,AD,AND,EUR,1442,2919,4361,3136,4648,5165,5739,6720,11787,37195,1360,2751,4111,2950,4442,4619,5306,6756,12482,36555,73750,82227,82227
Andorra,2040,AD,AND,EUR,1449,2915,4364,3085,4563,5119,5710,6549,12121,37147,1365,2747,4112,2882,4413,4618,5216,6560,12887,36576,73723,82210,82210
Andorra,2041,AD,AND,EUR,1452,2911,4363,3019,4482,5105,5679,6390,12409,37084,1368,2748,4116,2825,4382,4620,5110,6386,13276,36599,73683,82169,82169
Andorra,2042,AD,AND,EUR,1453,2912,4365,2964,4396,5058,5666,6244,12685,37013,1370,2748,4118,2780,4329,4622,5028,6192,13650,36601,73614,82103,82103
Andorra,2043,AD,AND,EUR,1448,2919,4367,2918,4293,5022,5643,6105,12949,36930,1366,2750,4116,2745,4230,4638,4962,6025,13990,36590,73520,82010,82010
Andorra,2044,AD,AND,EUR,1442,2925,4367,2906,4153,5008,5584,5998,13184,36833,1361,2754,4115,2740,4074,4662,4908,5906,14286,36576,73409,81888,81888
Andorra,2045,AD,AND,EUR,1434,2928,4362,2955,3975,4981,5519,5937,13358,36725,1352,2762,4114,2780,3877,4689,4858,5775,14563,36542,73267,81739,81739
Andorra,2046,AD,AND,EUR,1420,2930,4350,3041,3752,4980,5459,5867,13505,36604,1338,2768,4106,2874,3642,4720,4782,5630,14849,36497,73101,81558,81558
Andorra,2047,AD,AND,EUR,1407,2933,4340,3092,3591,4978,5379,5786,13659,36485,1326,2769,4095,2937,3461,4711,4742,5467,15124,36442,72927,81347,81347
Andorra,2048,AD,AND,EUR,1387,2936,4323,3079,3521,4932,5289,5719,13790,36330,1308,2768,4076,2927,3378,4685,4707,5355,15318,36370,72700,81099,81099
Andorra,2049,AD,AND,EUR,1367,2936,4303,3070,3475,4860,5228,5652,13879,36164,1288,2768,4056,2920,3310,4649,4687,5281,15439,36286,72450,80817,80817
Andorra,2050,AD,AND,EUR,1343,2929,4272,3064,3425,4779,5186,5627,13925,36006,1268,2763,4031,2915,3244,4625,4690,5191,15535,36200,72206,80504,80504
Netherlands Antilles,1970,AN,ANT,AMR,10913,22818,33731,15612,10274,8064,5986,4722,3447,48105,10427,21860,32287,15672,11268,8665,6300,5039,5259,52203,100308,166326,166326
Netherlands Antilles,1971,AN,ANT,AMR,10678,23161,33839,16128,10511,8214,6011,4613,3609,49086,10214,22161,32375,16047,11633,8884,6358,5060,5349,53331,102417,168633,168633
Netherlands Antilles,1972,AN,ANT,AMR,10382,23288,33670,16717,10780,8325,6037,4502,3771,50132,9957,22282,32239,16541,11993,9073,6427,5060,5482,54576,104708,170617,170617
Netherlands Antilles,1973,AN,ANT,AMR,10084,23107,33191,17318,11073,8418,6095,4435,3945,51284,9686,22129,31815,17106,12347,9240,6524,5040,5630,55887,107171,172175,172175
Netherlands Antilles,1974,AN,ANT,AMR,9821,22726,32547,17876,11361,8516,6189,4418,4118,52478,9447,21793,31240,17662,12695,9413,6639,5032,5777,57218,109696,173481,173481
Netherlands Antilles,1975,AN,ANT,AMR,9628,22240,31868,18408,11676,8625,6279,4412,4264,53664,9268,21352,30620,18218,13049,9578,6753,5042,5920,58560,112224,174703,174703
Netherlands Antilles,1976,AN,ANT,AMR,9511,21671,31182,18874,12011,8734,6380,4431,4392,54822,9160,20840,30000,18718,13407,9765,6882,5068,6054,59894,114716,175895,175895
Netherlands Antilles,1977,AN,ANT,AMR,9438,21080,30518,19260,12373,8874,6497,4470,4488,55962,9093,20311,29404,19139,13759,9996,7035,5112,6166,61207,117169,177088,177088
Netherlands Antilles,1978,AN,ANT,AMR,9399,20516,29915,19540,12764,9025,6617,4520,4577,57043,9048,19800,28848,19440,14130,10243,7219,5175,6266,62473,119516,178289,178289
Netherlands Antilles,1979,AN,ANT,AMR,9386,19974,29360,19704,13169,9204,6759,4587,4649,58072,9028,19328,28356,19604,14522,10523,7438,5261,6339,63687,121759,179477,179477
Netherlands Antilles,1980,AN,ANT,AMR,9394,19487,28881,19734,13583,9411,6899,4670,4711,59008,9019,18899,27918,19629,14937,10830,7651,5366,6406,64819,123827,180637,180637
Netherlands Antilles,1981,AN,ANT,AMR,9413,19042,28455,19695,14022,9650,7031,4753,4767,59918,9018,18517,27535,19592,15379,11175,7853,5477,6466,65942,125860,181852,181852
Netherlands Antilles,1982,AN,ANT,AMR,9444,18627,28071,19671,14452,9959,7172,4849,4806,60909,9050,18152,27202,19570,15844,11553,8037,5576,6515,67095,128004,183257,183257
Netherlands Antilles,1983,AN,ANT,AMR,9496,18228,27724,19583,14861,10322,7326,4954,4848,61894,9126,17775,26901,19501,16316,11973,8213,5660,6578,68241,130135,184765,184765
Netherlands Antilles,1984,AN,ANT,AMR,9570,17891,27461,19352,15308,10697,7476,5065,4897,62795,9222,17442,26664,19321,16817,12401,8394,5749,6660,69342,132137,186250,186250
Netherlands Antilles,1985,AN,ANT,AMR,9660,17642,27302,18975,15766,11098,7629,5179,4951,63598,9336,17179,26515,19024,17321,12847,8564,5853,6742,70351,133949,187766,187766
Netherlands Antilles,1986,AN,ANT,AMR,9759,17492,27251,18471,16215,11514,7794,5301,5008,64303,9456,17006,26462,18618,17802,13295,8763,5974,6846,71298,135601,189317,189317
Netherlands Antilles,1987,AN,ANT,AMR,9858,17398,27256,17881,16647,11947,7987,5440,5075,64977,9579,16917,26496,18125,18250,13749,9009,6119,6935,72187,137164,190915,190915
Netherlands Antilles,1988,AN,ANT,AMR,9964,17355,27319,17237,17038,12387,8200,5597,5142,65601,9697,16891,26588,17557,18652,14211,9294,6293,7035,73042,138643,192547,192547
Netherlands Antilles,1989,AN,ANT,AMR,10071,17364,27435,16550,17376,12843,8432,5762,5221,66184,9802,16938,26740,16912,18990,14700,9633,6474,7133,73842,140026,194206,194206
Netherlands Antilles,1990,AN,ANT,AMR,10173,17431,27604,15851,17627,13310,8718,5936,5307,66749,9894,17050,26944,16231,19253,15192,10016,6659,7236,74587,141336,195895,195895
Netherlands Antilles,1991,AN,ANT,AMR,10259,17544,27803,15155,17763,13797,9030,6113,5400,67258,9961,17224,27185,15535,19432,15727,10429,6848,7356,75327,142585,197567,197567
Netherlands Antilles,1992,AN,ANT,AMR,10263,17638,27901,14496,17628,14267,9373,6264,5483,67511,9937,17377,27314,14868,19378,16241,10851,7024,7471,75833,143344,198563,198563
Netherlands Antilles,1993,AN,ANT,AMR,10090,17654,27744,13923,17165,14590,9671,6389,5561,67299,9757,17431,27188,14283,19028,16651,11218,7173,7581,75934,143233,198160,198160
Netherlands Antilles,1994,AN,ANT,AMR,9776,17609,27385,13423,16532,14807,9922,6492,5657,66833,9450,17421,26871,13778,18500,16987,11529,7315,7700,75809,142642,196894,196894
Netherlands Antilles,1995,AN,ANT,AMR,9399,17567,26966,12980,15802,15002,10167,6590,5766,66307,9096,17390,26486,13343,17873,17312,11834,7443,7834,75639,141946,195394,195394
Netherlands Antilles,1996,AN,ANT,AMR,8985,17504,26489,12594,15007,15162,10406,6678,5864,65711,8712,17333,26045,12963,17196,17571,12133,7591,7981,75435,141146,193696,193696
Netherlands Antilles,1997,AN,ANT,AMR,8588,17378,25966,12240,14201,15273,10624,6770,5991,65099,8338,17221,25559,12617,16494,17773,12399,7768,8155,75206,140305,191835,191835
Netherlands Antilles,1998,AN,ANT,AMR,8238,17159,25397,11900,13427,15318,10824,6873,6121,64463,8009,17023,25032,12294,15779,17935,12653,7961,8342,74964,139427,189853,189853
Netherlands Antilles,1999,AN,ANT,AMR,7939,16849,24788,11590,12666,15276,11020,6982,6280,63814,7739,16746,24485,12026,15037,18027,12900,8176,8540,74706,138520,187769,187769
Netherlands Antilles,2000,AN,ANT,AMR,7691,16502,24193,11394,11930,15170,11196,7108,6429,63227,7522,16416,23938,11861,14289,18046,13143,8417,8746,74502,137729,185873,185873
Netherlands Antilles,2001,AN,ANT,AMR,7515,16247,23762,11526,11310,15103,11421,7276,6588,63224,7354,16163,23517,11980,13607,18043,13467,8716,8956,74769,137993,185273,185273
Netherlands Antilles,2002,AN,ANT,AMR,7393,16134,23527,12032,10884,15125,11794,7542,6754,64131,7227,16022,23249,12430,13070,18063,13943,9092,9200,75798,139929,186710,186710
Netherlands Antilles,2003,AN,ANT,AMR,7336,16065,23401,12630,10596,15155,12291,7915,6951,65538,7147,15916,23063,12999,12711,18084,14579,9537,9466,77376,142914,189376,189376
Netherlands Antilles,2004,AN,ANT,AMR,7320,15964,23284,13179,10424,15093,12831,8333,7164,67024,7104,15804,22908,13543,12479,18042,15293,10004,9747,79108,146132,192317,192317
Netherlands Antilles,2005,AN,ANT,AMR,7360,15822,23182,13540,10433,14966,13384,8839,7402,68564,7129,15641,22770,13937,12477,17942,15999,10542,10068,80965,149529,195481,195481
Netherlands Antilles,2006,AN,ANT,AMR,7475,15706,23181,13645,10627,14801,13922,9415,7679,70089,7246,15469,22715,14110,12679,17843,16654,11145,10461,82892,152981,198882,198882
Netherlands Antilles,2007,AN,ANT,AMR,7618,15666,23284,13637,10841,14635,14425,10001,8007,71546,7400,15362,22762,14149,12923,17735,17283,11752,10914,84756,156302,202352,202352
Netherlands Antilles,2008,AN,ANT,AMR,7736,15684,23420,13598,11002,14512,14887,10583,8382,72964,7530,15316,22846,14119,13159,17611,17905,12382,11424,86600,159564,205843,205843
Netherlands Antilles,2009,AN,ANT,AMR,7778,15753,23531,13595,11104,14418,15306,11176,8788,74387,7580,15349,22929,14068,13371,17501,18464,13048,11984,88436,162823,209285,209285
Netherlands Antilles,1950,AN,ANT,AMR,8182,11516,19698,9459,8149,6988,4440,2472,2408,33916,7890,11329,19219,9327,7683,5972,4641,3491,4560,35674,69590,108514,108514
Netherlands Antilles,1951,AN,ANT,AMR,8527,12044,20571,9733,8304,7118,4794,2588,2395,34932,8222,11803,20025,9591,7854,6158,4817,3569,4521,36510,71442,112040,112040
Netherlands Antilles,1952,AN,ANT,AMR,8871,12547,21418,9813,8382,7135,5062,2645,2368,35405,8557,12276,20833,9752,8002,6289,4952,3638,4492,37125,72530,114803,114803
Netherlands Antilles,1953,AN,ANT,AMR,9190,13137,22327,9898,8462,7162,5353,2714,2343,35932,8874,12816,21690,9905,8145,6433,5092,3719,4478,37772,73704,117715,117715
Netherlands Antilles,1954,AN,ANT,AMR,9514,13775,23289,9966,8562,7210,5632,2812,2349,36531,9201,13408,22609,10053,8296,6599,5224,3807,4485,38464,74995,120889,120889
Netherlands Antilles,1955,AN,ANT,AMR,9860,14440,24300,10054,8649,7283,5871,2929,2361,37147,9536,14030,23566,10203,8450,6778,5338,3896,4487,39152,76299,124159,124159
Netherlands Antilles,1956,AN,ANT,AMR,10186,15170,25356,10188,8707,7352,6044,3043,2367,37701,9853,14707,24560,10369,8602,6958,5421,3978,4485,39813,77514,127438,127438
Netherlands Antilles,1957,AN,ANT,AMR,10530,15943,26473,10367,8771,7455,6190,3169,2378,38330,10172,15425,25597,10559,8765,7147,5501,4058,4492,40522,78852,130926,130926
Netherlands Antilles,1958,AN,ANT,AMR,10926,16722,27648,10616,8832,7550,6293,3318,2403,39012,10529,16163,26692,10793,8932,7336,5581,4140,4507,41289,80301,134644,134644
Netherlands Antilles,1959,AN,ANT,AMR,11364,17491,28855,10948,8884,7644,6384,3483,2425,39768,10904,16910,27814,11085,9098,7523,5668,4230,4527,42131,81899,138576,138576
Netherlands Antilles,1960,AN,ANT,AMR,11618,18156,29774,11247,8912,7684,6374,3643,2457,40317,11122,17570,28692,11359,9244,7636,5720,4304,4561,42824,83141,141598,141598
Netherlands Antilles,1961,AN,ANT,AMR,11615,18659,30274,11579,8942,7664,6311,3830,2500,40826,11119,18082,29201,11689,9374,7676,5769,4374,4606,43488,84314,143798,143798
Netherlands Antilles,1962,AN,ANT,AMR,11547,19117,30664,12047,9011,7642,6274,4069,2560,41603,11053,18547,29600,12152,9504,7700,5867,4465,4657,44345,85948,146203,146203
Netherlands Antilles,1963,AN,ANT,AMR,11437,19604,31041,12523,9095,7636,6209,4292,2625,42380,10959,19015,29974,12647,9647,7737,5955,4559,4723,45268,87648,148666,148666
Netherlands Antilles,1964,AN,ANT,AMR,11301,20149,31450,13000,9201,7631,6154,4496,2708,43190,10838,19501,30339,13149,9803,7781,6028,4653,4795,46209,89399,151170,151170
Netherlands Antilles,1965,AN,ANT,AMR,11242,20642,31884,13440,9318,7643,6093,4655,2790,43939,10773,19940,30713,13652,9962,7854,6084,4732,4868,47152,91091,153692,153692
Netherlands Antilles,1966,AN,ANT,AMR,11252,21077,32329,13876,9463,7674,6048,4770,2897,44728,10760,20325,31085,14119,10145,7952,6137,4804,4931,48088,92816,156242,156242
Netherlands Antilles,1967,AN,ANT,AMR,11237,21529,32766,14303,9635,7734,6011,4833,3013,45529,10730,20723,31453,14549,10370,8082,6180,4875,5018,49074,94603,158817,158817
Netherlands Antilles,1968,AN,ANT,AMR,11179,21979,33158,14727,9826,7816,5987,4844,3147,46347,10669,21126,31795,14949,10628,8249,6215,4944,5099,50084,96431,161382,161382
Netherlands Antilles,1969,AN,ANT,AMR,11075,22416,33491,15159,10043,7926,5981,4806,3291,47206,10573,21506,32079,15321,10926,8451,6256,4997,5173,51124,98330,163890,163890
United Arab Emirates,1970,AE,ARE,EMR,20482,31491,51973,56403,48576,25734,10884,4558,2417,148572,19182,24731,43913,18167,15050,9332,5598,3247,2234,53628,202200,298084,298084
United Arab Emirates,1971,AE,ARE,EMR,23078,33924,57002,68385,58675,30643,12666,5477,2837,178683,21641,27086,48727,20579,16689,10220,6276,3704,2631,60099,238782,344513,344513
United Arab Emirates,1972,AE,ARE,EMR,25738,36128,61866,78133,70543,36485,14834,6382,3302,209679,24271,29473,53744,22952,18589,11278,7041,4165,3049,67074,276753,392368,392368
United Arab Emirates,1973,AE,ARE,EMR,28336,38575,66911,84992,84315,43337,17431,7257,3857,241189,26894,31995,58889,25251,20796,12535,7883,4610,3479,74554,315743,441546,441546
United Arab Emirates,1974,AE,ARE,EMR,30803,41598,72401,88631,99971,51201,20488,8110,4527,272928,29327,34851,64178,27365,23333,13981,8750,5056,3957,82442,355370,491955,491955
United Arab Emirates,1975,AE,ARE,EMR,33171,45268,78439,89059,117310,60009,23995,8990,5381,304744,31446,38230,69676,29133,26190,15579,9590,5512,4529,90533,395277,543394,543394
United Arab Emirates,1976,AE,ARE,EMR,37086,49859,86945,98023,137824,69101,27006,9600,6055,347609,34925,42721,77646,33831,30055,17136,10157,5833,4961,101973,449582,614177,614177
United Arab Emirates,1977,AE,ARE,EMR,43436,55003,98439,114864,162490,78947,29607,9966,6407,402281,40774,48131,88905,41407,35272,18759,10590,6018,5184,117230,519511,706861,706861
United Arab Emirates,1978,AE,ARE,EMR,51171,60723,111894,126507,190599,90871,32951,10400,6669,457997,47957,53996,101953,48209,41561,20788,11269,6192,5372,133391,591388,805231,805231
United Arab Emirates,1979,AE,ARE,EMR,59575,68069,127644,131985,221784,105277,37247,10910,6800,514003,55745,60780,116525,53845,49004,23368,12226,6352,5486,150281,664284,908452,908452
United Arab Emirates,1980,AE,ARE,EMR,67648,77388,145036,131609,254587,122163,42560,11534,6839,569292,63114,68866,131980,58195,57547,26541,13371,6518,5566,167738,737030,1014048,1014048
United Arab Emirates,1981,AE,ARE,EMR,74872,86582,161454,129924,274359,135825,47155,12358,7057,606678,69963,77026,146989,63051,65428,29599,14294,6873,5816,185061,791739,1100180,1100180
United Arab Emirates,1982,AE,ARE,EMR,81647,94693,176340,129876,280519,145712,50786,13332,7460,627685,76610,84733,161343,68829,72448,32508,15045,7421,6238,202489,830174,1167856,1167856
United Arab Emirates,1983,AE,ARE,EMR,87951,103340,191291,129430,286416,156927,54935,14303,7833,649844,82637,93038,175675,73919,80102,36027,16071,7980,6662,220761,870605,1237572,1237572
United Arab Emirates,1984,AE,ARE,EMR,93140,113210,206350,127295,292743,169528,59596,15184,8155,672501,87545,102268,189813,77925,88423,40333,17407,8504,7081,239673,912174,1308331,1308331
United Arab Emirates,1985,AE,ARE,EMR,96548,124694,221242,123809,299744,183350,64656,15940,8441,695940,90807,112585,203392,80760,97296,45455,18972,8965,7510,258958,954898,1379536,1379536
United Arab Emirates,1986,AE,ARE,EMR,99689,139756,239445,133827,306649,197996,69779,17069,8745,734065,93988,124435,218423,84806,104153,50303,20218,9389,7891,276760,1010825,1468697,1468697
United Arab Emirates,1987,AE,ARE,EMR,103503,155014,258517,159370,313558,213456,74867,18699,9108,789058,97786,136442,234228,91539,108843,54582,21096,9837,8209,294106,1083164,1575909,1575909
United Arab Emirates,1988,AE,ARE,EMR,106970,166079,273049,186801,321896,230005,80276,20469,9508,848955,101058,146963,248021,99875,113737,59089,22082,10327,8543,313653,1162608,1683681,1683681
United Arab Emirates,1989,AE,ARE,EMR,109964,174409,284373,213157,332733,247695,86402,22368,9952,912307,103776,156217,259993,109262,118943,63913,23302,10861,8881,335162,1247469,1791840,1791840
United Arab Emirates,1990,AE,ARE,EMR,112426,181177,293603,235642,347026,266717,93635,24395,10449,977864,105930,164429,270359,119059,124576,69190,24866,11418,9221,358330,1336194,1900151,1900151
United Arab Emirates,1991,AE,ARE,EMR,113974,187661,301635,251748,365597,287364,102356,26525,10998,1044588,107179,172189,279368,128531,130769,75099,26847,11983,9569,382798,1427386,2008383,2008383
United Arab Emirates,1992,AE,ARE,EMR,114614,194492,309106,259894,388891,309837,112789,28692,11608,1111711,107591,179643,287234,136979,137761,81747,29242,12521,9928,408178,1519889,2116231,2116231
United Arab Emirates,1993,AE,ARE,EMR,114666,201586,316252,259889,416605,334198,124983,30814,12253,1178742,107511,186527,294038,143962,145786,89174,31994,13018,10324,434258,1613000,2223284,2223284
United Arab Emirates,1994,AE,ARE,EMR,113975,208862,322837,252846,447560,360481,138968,32855,12874,1245584,106810,192843,299653,149401,154900,97382,35048,13469,10745,460945,1706529,2329024,2329024
United Arab Emirates,1995,AE,ARE,EMR,112439,216115,328554,242363,479371,388359,154703,34891,13403,1313090,105405,198521,303926,153843,164839,106321,38341,13901,11179,488424,1801514,2433988,2433988
United Arab Emirates,1996,AE,ARE,EMR,113935,228302,342237,266734,503254,407126,168854,37629,13903,1397500,106896,206036,312932,165819,172706,114033,41521,14434,11544,520057,1917557,2572735,2572735
United Arab Emirates,1997,AE,ARE,EMR,119293,240327,359620,327451,523526,416343,180510,41070,14479,1503379,111936,213646,325582,186751,179188,120051,44617,15119,11818,557544,2060923,2746119,2746119
United Arab Emirates,1998,AE,ARE,EMR,125156,244099,369255,387057,552365,426694,192079,44549,15124,1617868,117418,217674,335092,209239,187775,125896,48030,15899,12089,598928,2216796,2921130,2921130
United Arab Emirates,1999,AE,ARE,EMR,131044,243335,374379,439355,590844,439740,203693,48092,15878,1737602,123042,219337,342379,231609,198786,131806,51862,16778,12367,643208,2380810,3097563,3097563
United Arab Emirates,2000,AE,ARE,EMR,136622,241167,377789,479196,639517,457107,215519,51712,16744,1859795,128491,220015,348506,252064,212517,138103,56152,17754,12648,689238,2549033,3275333,3275333
United Arab Emirates,2001,AE,ARE,EMR,140740,240980,381720,502692,698382,480331,227645,55366,17673,1982089,132567,222033,354600,268775,229217,145168,60879,18825,12918,735782,2717871,3454198,3454198
United Arab Emirates,2002,AE,ARE,EMR,143381,244157,387538,507926,766689,510592,240090,58937,18541,2102775,135224,226199,361423,280386,249061,153423,65922,19962,13162,781916,2884691,3633655,3633655
United Arab Emirates,2003,AE,ARE,EMR,145528,250071,395599,495463,842358,548948,253033,62364,19221,2221387,137404,231724,369128,286351,271988,163299,71155,21174,13360,827327,3048714,3813443,3813443
United Arab Emirates,2004,AE,ARE,EMR,147103,258264,405367,468143,921415,596597,266919,65743,19586,2338403,139022,238382,377404,286835,297577,175206,76515,22510,13527,872170,3210573,3993339,3993339
United Arab Emirates,2005,AE,ARE,EMR,150416,272820,423236,497621,1028240,645557,273654,67515,19595,2532182,141783,248546,390329,300587,329855,186736,80826,23739,13506,935249,3467431,4280993,4280993
United Arab Emirates,2006,AE,ARE,EMR,157588,299111,456699,686618,1255439,696427,254862,59881,18163,2971390,146831,265700,412531,357686,387253,196056,80975,23633,12733,1058336,4029726,4898954,4898954
United Arab Emirates,2007,AE,ARE,EMR,169341,332950,502291,1013694,1639721,763771,208371,38801,14440,3678798,155111,287995,443106,455415,478481,205779,76155,21582,11022,1248434,4927232,5872624,5872624
United Arab Emirates,2008,AE,ARE,EMR,186562,364339,550901,1356813,2101121,856582,153458,16010,9835,4493819,168766,309705,478471,560699,588204,219747,69330,18601,8912,1465493,5959312,6988685,6988685
United Arab Emirates,2009,AE,ARE,EMR,208363,384679,593042,1588546,2529963,979366,116473,4179,6643,5225170,188212,325395,513607,637328,694613,241411,64256,16126,7088,1660822,6885992,7992644,7992644
United Arab Emirates,2010,AE,ARE,EMR,229430,398813,628243,1579793,2709891,1112926,132145,5177,6820,5546752,210002,327558,537560,644382,756564,273630,68730,17808,8108,1769222,7315974,8481771,8481771
United Arab Emirates,2011,AE,ARE,EMR,246980,408370,655350,1434764,2671985,1237471,188596,13064,9371,5555251,229813,321772,551585,605736,777858,312400,81733,23419,11872,1813018,7368269,8575205,8575205
United Arab Emirates,2012,AE,ARE,EMR,260768,409020,669788,1324762,2608810,1351519,253602,23343,12552,5574588,245058,320724,565782,568121,792211,351992,96510,29838,16134,1854806,7429394,8664969,8664969
United Arab Emirates,2013,AE,ARE,EMR,268382,405191,673573,1243763,2528615,1451976,325506,36799,16498,5603157,253903,326810,580713,530649,800855,391687,113196,37033,20988,1894408,7497565,8751847,8751847
United Arab Emirates,2014,AE,ARE,EMR,269998,400408,670406,1182825,2440262,1536700,401834,54389,21360,5637370,256548,339623,596171,493075,804951,430720,131794,44955,26514,1932009,7569379,8835951,8835951
United Arab Emirates,2015,AE,ARE,EMR,267655,397692,665347,1131012,2352341,1604758,480095,76592,27312,5672110,254529,356836,611365,455717,805478,468347,152175,53577,32786,1968080,7640190,8916899,8916899
United Arab Emirates,2016,AE,ARE,EMR,263887,399541,663428,1077551,2272464,1656354,557713,103570,34583,5702235,249934,375398,625332,419290,803173,503908,174081,62936,39880,2003268,7705503,8994263,8994263
United Arab Emirates,2017,AE,ARE,EMR,259868,407956,667824,1014688,2206424,1692737,631759,135544,43513,5724665,244034,393657,637691,384728,798292,536896,197202,73116,47879,2038113,7762778,9068296,9068296
United Arab Emirates,2018,AE,ARE,EMR,255971,423279,679250,938777,2157735,1716209,699096,172661,54602,5739080,237690,411067,648757,353171,790405,567145,221213,84268,56879,2073081,7812161,9140169,9140169
United Arab Emirates,2019,AE,ARE,EMR,252954,443143,696097,850349,2127149,1730333,756605,214756,68526,5747718,232559,426579,659138,326254,778134,594981,245835,96521,66980,2108705,7856423,9211657,9211657
United Arab Emirates,2020,AE,ARE,EMR,251366,464814,716180,738842,2080691,1787322,818482,254053,79796,5759186,230868,440565,671433,307421,752682,627853,271096,107623,73814,2140489,7899675,9287289,9287289
United Arab Emirates,2021,AE,ARE,EMR,250355,483558,733913,621196,1999920,1886964,892133,290273,87636,5778122,231795,452461,684256,298968,711192,666130,298098,117428,77039,2168855,7946977,9365145,9365145
United Arab Emirates,2022,AE,ARE,EMR,248549,495966,744515,557003,1952028,1935094,947330,318917,92863,5803235,232591,460981,693572,307124,671507,694744,321003,125630,79813,2199821,8003056,9441129,9441129
United Arab Emirates,2023,AE,ARE,EMR,245647,503251,748898,536722,1950151,1930049,983736,338751,95280,5834689,232369,466857,699226,328807,638966,712704,339217,132096,82263,2234053,8068742,9516871,9516871
United Arab Emirates,2024,AE,ARE,EMR,241561,507033,748594,522465,1952114,1914325,1022716,360192,98746,5870558,230441,470974,701415,353948,607093,726994,358853,139144,85264,2271296,8141854,9591853,9591853
United Arab Emirates,2025,AE,ARE,EMR,236763,508139,744902,518709,1951670,1888624,1063863,383054,103097,5909017,226650,473524,700174,381338,577832,736935,379744,146743,88634,2311226,8220243,9665319,9665319
United Arab Emirates,2026,AE,ARE,EMR,232025,506847,738872,528198,1944148,1854622,1106019,407296,108619,5948902,222166,473622,695788,409817,552502,741988,401766,154961,92445,2353479,8302381,9737048,9737048
United Arab Emirates,2027,AE,ARE,EMR,227663,503449,731112,550346,1928131,1815279,1146995,432812,115874,5989437,218029,470857,688886,438477,531655,741634,424742,163963,96792,2397263,8386700,9806692,9806692
United Arab Emirates,2028,AE,ARE,EMR,223552,498569,722121,580022,1906405,1774288,1184573,459550,125263,6030101,214128,466308,680436,465197,517019,735295,448380,174018,101706,2441615,8471716,9874281,9874281
United Arab Emirates,2029,AE,ARE,EMR,219409,493098,712507,609155,1884334,1735451,1216940,487586,136973,6070439,210187,461391,671578,486359,511952,722283,472286,185461,107223,2485564,8556003,9940085,9940085
United Arab Emirates,2030,AE,ARE,EMR,215322,487486,702808,633653,1863252,1702593,1242352,517005,151138,6109993,206295,457041,663336,501986,516162,702099,495985,198547,113393,2528172,8638165,10004319,10004319
United Arab Emirates,1950,AE,ARE,EMR,6734,10083,16817,7419,5281,3753,2728,1836,1212,22229,6216,8857,15073,6586,4767,3450,2568,1820,1285,20476,42705,74591,74591
United Arab Emirates,1951,AE,ARE,EMR,7230,11612,18842,8438,5742,3876,2766,1861,1250,23933,6495,9358,15853,6910,4948,3519,2587,1839,1333,21136,45069,79763,79763
United Arab Emirates,1952,AE,ARE,EMR,7637,13091,20728,9596,6279,4045,2801,1883,1286,25890,6759,9853,16612,7268,5145,3601,2611,1854,1377,21856,47746,85091,85091
United Arab Emirates,1953,AE,ARE,EMR,7992,14449,22441,10892,6909,4264,2840,1912,1323,28140,7022,10312,17334,7656,5358,3698,2640,1867,1420,22639,50779,90559,90559
United Arab Emirates,1954,AE,ARE,EMR,8334,15617,23951,12333,7632,4539,2882,1939,1351,30676,7276,10743,18019,8075,5599,3811,2671,1873,1460,23489,54165,96136,96136
United Arab Emirates,1955,AE,ARE,EMR,8629,16606,25235,13891,8459,4871,2936,1969,1380,33506,7478,11172,18650,8518,5866,3944,2708,1880,1491,24407,57913,101803,101803
United Arab Emirates,1956,AE,ARE,EMR,8869,17423,26292,15550,9395,5272,3002,2008,1409,36636,7653,11583,19236,8987,6161,4090,2753,1889,1519,25399,62035,107563,107563
United Arab Emirates,1957,AE,ARE,EMR,9109,18019,27128,17278,10465,5744,3093,2045,1434,40059,7845,11937,19782,9479,6489,4250,2807,1894,1547,26466,66525,113430,113430
United Arab Emirates,1958,AE,ARE,EMR,9451,18385,27836,19029,11668,6299,3223,2076,1457,43752,8194,12217,20411,9990,6844,4426,2877,1902,1566,27605,71357,119606,119606
United Arab Emirates,1959,AE,ARE,EMR,9981,18537,28518,20764,13024,6940,3397,2105,1478,47708,8817,12418,21235,10511,7237,4624,2957,1912,1574,28815,76523,126278,126278
United Arab Emirates,1960,AE,ARE,EMR,10690,18507,29197,22420,14533,7673,3627,2132,1493,51878,9691,12559,22250,11031,7662,4841,3056,1927,1581,30098,81976,133426,133426
United Arab Emirates,1961,AE,ARE,EMR,11549,18358,29907,23932,16201,8500,3918,2158,1509,56218,10768,12663,23431,11528,8121,5083,3170,1945,1579,31426,87644,140984,140984
United Arab Emirates,1962,AE,ARE,EMR,12511,18157,30668,25222,18024,9436,4268,2185,1528,60663,11978,12776,24754,11985,8619,5349,3297,1971,1565,32786,93449,148877,148877
United Arab Emirates,1963,AE,ARE,EMR,13413,18106,31519,26218,19994,10474,4690,2217,1550,65143,13071,13094,26165,12375,9152,5646,3435,2007,1562,34177,99320,157006,157006
United Arab Emirates,1964,AE,ARE,EMR,14128,18360,32488,26863,22098,11628,5185,2261,1574,69609,13863,13781,27644,12693,9708,5976,3591,2045,1543,35556,105165,165305,165305
United Arab Emirates,1965,AE,ARE,EMR,14697,18899,33596,27151,24299,12913,5762,2323,1610,74058,14416,14783,29199,12936,10293,6344,3760,2094,1516,36943,111001,173797,173797
United Arab Emirates,1966,AE,ARE,EMR,15171,19681,34852,27087,26549,14343,6422,2429,1638,78468,14816,16056,30872,13080,10892,6751,3943,2157,1493,38316,116784,182509,182509
United Arab Emirates,1967,AE,ARE,EMR,15562,20681,36243,26681,28790,15930,7179,2577,1667,82824,15128,17554,32682,13108,11504,7197,4151,2230,1463,39653,122477,191404,191404
United Arab Emirates,1968,AE,ARE,EMR,16402,23667,40069,31472,32934,18248,8152,2966,1791,95563,15743,19664,35407,13889,12374,7786,4489,2438,1567,42543,138106,213582,213582
United Arab Emirates,1969,AE,ARE,EMR,18142,28123,46265,43255,39952,21615,9396,3688,2063,119969,17121,22264,39385,15831,13616,8534,5000,2807,1858,47646,167615,253261,253261
United Arab Emirates,2031,AE,ARE,EMR,211620,481808,693428,652461,1841753,1679542,1258967,548117,167739,6148579,202763,453541,656304,513938,527272,675448,518751,213381,120296,2569086,8717665,10067403,10067403
United Arab Emirates,2032,AE,ARE,EMR,208837,475696,684533,664903,1819945,1668372,1265213,581437,186505,6186375,200112,450236,650348,522487,544290,644603,539567,229850,127964,2608761,8795136,10130008,10130008
United Arab Emirates,2033,AE,ARE,EMR,207162,468707,675869,672194,1799825,1666745,1260521,617265,207234,6223784,198516,446134,644650,528363,565959,612193,557466,247809,136430,2648220,8872004,10192521,10192521
United Arab Emirates,2034,AE,ARE,EMR,206714,460507,667221,675993,1785705,1668930,1245228,655536,229914,6261306,198094,440282,638376,532482,591077,580447,571701,267127,145699,2688533,8949839,10255434,10255434
United Arab Emirates,2035,AE,ARE,EMR,207699,451644,659343,677122,1782051,1668700,1220079,695929,254576,6298457,199042,432609,631651,535039,618442,551309,581617,287682,155803,2729892,9028349,10319346,10319346
United Arab Emirates,2036,AE,ARE,EMR,210079,443232,653311,675863,1791599,1661393,1186733,737314,281431,6334333,201335,424610,625945,535142,646895,526095,586670,309346,166835,2770983,9105316,10384576,10384576
United Arab Emirates,2037,AE,ARE,EMR,213701,436102,649803,672496,1813767,1645603,1148126,777558,310874,6368424,204812,417832,622644,532387,675531,505356,586367,331944,179030,2810615,9179039,10451479,10451479
United Arab Emirates,2038,AE,ARE,EMR,218434,430337,648771,667649,1843435,1624112,1107902,814499,343232,6400829,209349,412349,621698,527848,702228,490805,580121,355202,192691,2848895,9249724,10520193,10520193
United Arab Emirates,2039,AE,ARE,EMR,224103,425764,649867,662212,1872570,1602272,1069819,846369,378714,6431956,214781,407998,622779,522941,723374,485805,567256,378733,208121,2886230,9318186,10590827,10590827
United Arab Emirates,2040,AE,ARE,EMR,230547,422674,653221,656629,1897080,1581419,1037673,871461,417513,6461775,220955,405062,626017,518603,738993,490050,547276,402079,225632,2922633,9384408,10663646,10663646
United Arab Emirates,2041,AE,ARE,EMR,237706,421369,659075,650983,1915919,1560161,1015249,887987,459864,6490163,227818,403833,631651,515112,750941,501171,520872,424521,245357,2957974,9448137,10738862,10738862
United Arab Emirates,2042,AE,ARE,EMR,245168,422217,667385,644898,1928405,1538604,1004592,894415,505982,6516896,234971,404661,639632,511814,759489,518184,490315,445059,267229,2992090,9508986,10815996,10815996
United Arab Emirates,2043,AE,ARE,EMR,252671,425285,677956,637939,1935755,1518741,1003362,890202,555931,6541930,242172,407605,649777,507721,765368,539828,458207,462733,291120,3024977,9566907,10894640,10894640
United Arab Emirates,2044,AE,ARE,EMR,260054,430515,690569,629767,1939621,1504857,1005862,875684,609592,6565383,249257,412619,661876,501876,769494,564910,426767,476807,316897,3056751,9622134,10974581,10974581
United Arab Emirates,2045,AE,ARE,EMR,266786,437944,704730,620938,1940820,1501393,1005899,851611,666660,6587321,255721,419747,675468,494214,772056,592232,397927,486639,344466,3087534,9674855,11055055,11055055
United Arab Emirates,2046,AE,ARE,EMR,272456,447487,719943,612552,1939633,1511066,998841,819593,726224,6607909,261163,428900,690063,486225,772172,620639,372988,491697,373788,3117509,9725418,11135424,11135424
United Arab Emirates,2047,AE,ARE,EMR,277189,458571,735760,605450,1936341,1533298,983299,782487,786573,6627448,265699,439527,705226,479454,769434,649227,352492,491481,404922,3147010,9774458,11215445,11215445
United Arab Emirates,2048,AE,ARE,EMR,281000,470813,751813,599710,1931568,1562987,962059,743840,845927,6646091,269349,451265,720614,473981,764913,675883,338152,485430,437868,3176227,9822318,11294748,11294748
United Arab Emirates,2049,AE,ARE,EMR,283782,483864,767646,595158,1926203,1592138,940472,707321,902763,6664055,272013,463782,735795,469637,760020,696999,333298,472875,472553,3205382,9869437,11372877,11372877
United Arab Emirates,2050,AE,ARE,EMR,285760,497043,782803,592086,1920693,1616671,919896,676627,955605,6681578,273901,476420,750321,466709,755698,712599,337621,453332,508805,3234764,9916342,11449471,11449471
Argentina,1970,AR,ARG,AMR,1269209,2326523,3595732,2094920,1703905,1545850,1272212,940380,684758,8242025,1232007,2257687,3489694,2063893,1715919,1552755,1315714,990321,876741,8515343,16757368,23842803,23842803
Argentina,1971,AR,ARG,AMR,1295233,2348665,3643898,2128792,1738642,1552313,1293908,951842,705312,8370809,1259981,2279911,3539892,2093190,1751220,1557051,1341713,1014774,910833,8668781,17039590,24223379,24223379
Argentina,1972,AR,ARG,AMR,1326581,2370115,3696696,2159627,1775602,1556573,1317088,962334,725395,8496619,1294111,2302172,3596283,2121906,1789688,1559771,1369453,1037994,944381,8823193,17319812,24612794,24612794
Argentina,1973,AR,ARG,AMR,1364671,2393910,3758581,2187686,1815646,1560358,1340749,972833,745608,8622880,1333495,2327192,3660687,2148814,1830055,1562453,1397422,1060541,979155,8978440,17601320,25020588,25020588
Argentina,1974,AR,ARG,AMR,1408873,2423447,3832320,2213053,1856095,1565711,1362589,984520,765828,8747796,1377609,2358648,3736257,2174927,1869420,1567703,1422631,1082980,1015721,9133382,17881178,25449754,25449754
Argentina,1975,AR,ARG,AMR,1455934,2456398,3912332,2233841,1893943,1573347,1381562,997930,786222,8866845,1421192,2392942,3814134,2195679,1906135,1576740,1443656,1105787,1054250,9282247,18149092,25875558,25875558
Argentina,1976,AR,ARG,AMR,1503882,2492709,3996591,2249225,1929141,1583201,1397736,1012612,806594,8978509,1461761,2430423,3892184,2209126,1940638,1589761,1460585,1128474,1094387,9422971,18401480,26290257,26290257
Argentina,1977,AR,ARG,AMR,1551226,2533717,4084943,2264593,1963067,1596000,1411153,1028559,827461,9090833,1500654,2473085,3973739,2222506,1973137,1607238,1473695,1150799,1136887,9564262,18655095,26713780,26713780
Argentina,1978,AR,ARG,AMR,1594770,2580732,4175502,2281010,1995588,1612364,1422233,1046062,849357,9206614,1536001,2520735,4056736,2236843,2003326,1629031,1483551,1173353,1181164,9707268,18913882,27146121,27146121
Argentina,1979,AR,ARG,AMR,1631173,2636756,4267929,2297728,2026435,1632796,1431440,1064740,871286,9324425,1565364,2576258,4141622,2251514,2031090,1654844,1490984,1196879,1224849,9850160,19174585,27584134,27584134
Argentina,1980,AR,ARG,AMR,1658310,2701786,4360096,2315158,2055470,1657579,1439289,1083921,892548,9443965,1589075,2638288,4227363,2266950,2056488,1684551,1497077,1221258,1267063,9993387,19437352,28024803,28024803
Argentina,1981,AR,ARG,AMR,1675892,2774353,4450245,2334129,2083901,1687081,1445844,1103933,913035,9567923,1606575,2705426,4312001,2284068,2081085,1718308,1501869,1246990,1308790,10141110,19709033,28471285,28471285
Argentina,1982,AR,ARG,AMR,1684644,2852731,4537375,2354000,2112924,1721311,1451009,1125153,932479,9696876,1616811,2777205,4394016,2302709,2106403,1755895,1505315,1274457,1349719,10294498,19991374,28922762,28922762
Argentina,1983,AR,ARG,AMR,1686957,2934744,4621701,2376942,2140699,1758972,1455921,1146721,951690,9830945,1621441,2851215,4472656,2325064,2130856,1795692,1508814,1301868,1389532,10451826,20282771,29377137,29377137
Argentina,1984,AR,ARG,AMR,1686584,3016050,4702634,2405475,2166881,1797321,1462366,1166651,971133,9969827,1622484,2923982,4546466,2353721,2154622,1834486,1514795,1326429,1429218,10613271,20583098,29832197,29832197
Argentina,1985,AR,ARG,AMR,1686780,3091540,4778320,2439668,2192040,1835693,1471673,1184472,992443,10115989,1622267,2991773,4614040,2388474,2177619,1872158,1524632,1346814,1469075,10778772,20894761,30287112,30287112
Argentina,1986,AR,ARG,AMR,1689673,3158887,4848560,2479797,2215865,1874833,1484445,1201008,1017270,10273218,1623270,3051616,4674886,2429938,2198876,1909953,1538931,1363516,1510443,10951657,21224875,30748326,30748326
Argentina,1987,AR,ARG,AMR,1696421,3216788,4913209,2524197,2240578,1914011,1500801,1215988,1044940,10440515,1627072,3102488,4729560,2476079,2221044,1946932,1558075,1376905,1554131,11133166,21573681,31216453,31216453
Argentina,1988,AR,ARG,AMR,1706736,3264411,4971147,2574042,2266299,1952461,1520982,1229518,1075408,10618710,1634106,3144146,4778252,2526524,2244378,1982412,1581795,1387470,1600107,11322686,21941396,31690792,31690792
Argentina,1989,AR,ARG,AMR,1719282,3301972,5021254,2631550,2290729,1988892,1544959,1241769,1107896,10805795,1643847,3175989,4819836,2583355,2266586,2015311,1609423,1395973,1648238,11518886,22324681,32165766,32165766
Argentina,1990,AR,ARG,AMR,1734984,3330418,5065402,2695881,2312711,2022196,1572566,1253028,1141737,10998119,1657234,3200499,4857733,2644318,2286333,2044586,1640347,1403198,1697623,11716405,22714524,32637657,32637657
Argentina,1991,AR,ARG,AMR,1753157,3351378,5104535,2765413,2331882,2052497,1603649,1263159,1177036,11193636,1673392,3219385,4892777,2707871,2303272,2070737,1674284,1409079,1749579,11914822,23108458,33105763,33105763
Argentina,1992,AR,ARG,AMR,1771474,3366765,5138239,2839671,2348668,2080979,1637690,1271395,1212567,11390970,1689889,3233288,4923177,2775072,2318356,2095355,1710718,1413128,1803271,12115900,23506870,33568285,33568285
Argentina,1993,AR,ARG,AMR,1790003,3378865,5168868,2917578,2366511,2106284,1673395,1278342,1246774,11588884,1706860,3244513,4951373,2844758,2335233,2117496,1748172,1416510,1855950,12318119,23907003,34027240,34027240
Argentina,1994,AR,ARG,AMR,1808752,3390361,5199113,2994994,2388520,2128916,1709157,1286826,1282039,11790452,1724070,3254737,4978807,2913423,2356911,2137784,1783995,1421865,1906345,12520323,24310775,34488696,34488696
Argentina,1995,AR,ARG,AMR,1822793,3405703,5228496,3067047,2415634,2150101,1744550,1297720,1317061,11992113,1736752,3267490,5004242,2977571,2384121,2156745,1818492,1430660,1953668,12721257,24713370,34946110,34946110
Argentina,1996,AR,ARG,AMR,1828324,3426398,5254722,3131326,2448218,2169258,1779835,1310570,1349225,12188432,1741599,3284485,5026084,3034288,2417754,2173506,1852894,1443437,1998251,12920130,25108562,35389362,35389362
Argentina,1997,AR,ARG,AMR,1826890,3451118,5278008,3186548,2484920,2188628,1814412,1325508,1377843,12377859,1739986,3304648,5044634,3082521,2456012,2190739,1886197,1460426,2039566,13115461,25493320,35815971,35815971
Argentina,1998,AR,ARG,AMR,1820707,3479441,5300148,3231951,2527296,2208627,1847874,1343138,1404103,12562989,1733624,3328385,5062009,3122072,2498909,2208927,1917933,1481544,2078674,13308059,25871048,36233195,36233195
Argentina,1999,AR,ARG,AMR,1813154,3510244,5323398,3267905,2578489,2227979,1879817,1364346,1430576,12749112,1725977,3355116,5081093,3152407,2549417,2226577,1947519,1506434,2117079,13499433,26248545,36653031,36653031
Argentina,2000,AR,ARG,AMR,1806390,3539718,5346108,3295254,2638403,2246343,1909441,1388863,1456337,12934641,1719357,3381158,5100515,3175929,2606197,2243323,1974373,1534629,2155063,13689514,26624155,37070774,37070774
Argentina,2001,AR,ARG,AMR,1800893,3563516,5364409,3315549,2705651,2263809,1937096,1416544,1481064,13119713,1713982,3402466,5116448,3194323,2667958,2259295,1999222,1565914,2193205,13879917,26999630,37480493,37480493
Argentina,2002,AR,ARG,AMR,1797610,3580699,5378309,3330172,2778051,2280094,1964544,1447909,1504605,13305375,1710624,3417665,5128289,3207414,2733578,2274179,2023832,1600762,2233299,14073064,27378439,37885028,37885028
Argentina,2003,AR,ARG,AMR,1794907,3593245,5388152,3341351,2853551,2297608,1990119,1481752,1527172,13491553,1707815,3428312,5136127,3217346,2800745,2290340,2046483,1637063,2270362,14262339,27753892,38278164,38278164
Argentina,2004,AR,ARG,AMR,1790712,3604518,5395230,3352353,2928784,2319282,2013600,1515815,1551939,13681773,1703495,3437768,5141263,3226637,2867118,2311210,2067381,1671738,2306448,14450532,28132305,38668796,38668796
Argentina,2005,AR,ARG,AMR,1788970,3611829,5400799,3367545,2998928,2346010,2036212,1549853,1579799,13878347,1700796,3443615,5144411,3238860,2929287,2337697,2087336,1705904,2347853,14646937,28525284,39070501,39070501
Argentina,2006,AR,ARG,AMR,1792520,3611903,5404423,3388480,3061723,2378276,2057287,1584207,1609705,14079678,1701960,3442811,5144771,3255781,2984330,2370606,2105232,1740260,2391766,14847975,28927653,39476851,39476851
Argentina,2007,AR,ARG,AMR,1798667,3607424,5406091,3413721,3115900,2414657,2078494,1617713,1638803,14279288,1704800,3437735,5142535,3276317,3031266,2408130,2123568,1773440,2435475,15048196,29327484,39876111,39876111
Argentina,2008,AR,ARG,AMR,1805898,3599046,5404944,3443085,3161051,2456880,2100358,1650362,1669367,14481103,1708855,3428749,5137604,3301074,3070221,2450413,2142861,1805132,2480414,15250115,29731218,40273769,40273769
Argentina,2009,AR,ARG,AMR,1815190,3587933,5403123,3475666,3197891,2508301,2121978,1682499,1705896,14692231,1715503,3417050,5132553,3329573,3100980,2500570,2161693,1835040,2528570,15456426,30148657,40684338,40684338
Argentina,2010,AR,ARG,AMR,1825788,3580103,5405891,3507323,3227074,2568706,2142543,1712645,1744306,14902597,1724054,3408021,5132075,3357794,3125855,2557236,2179496,1862322,2576851,15659554,30562151,41100123,41100123
Argentina,2011,AR,ARG,AMR,1837116,3578853,5415969,3533618,3250133,2636751,2162130,1741137,1784128,15107897,1734099,3404160,5138259,3381543,3146538,2619224,2196521,1887892,2626895,15858613,30966510,41520740,41520740
Argentina,2012,AR,ARG,AMR,1850192,3582665,5432857,3553597,3269013,2710907,2180546,1769304,1826374,15309741,1746505,3404364,5150869,3399557,3163666,2686437,2212873,1913534,2682825,16058892,31368633,41952365,41952365
Argentina,2013,AR,ARG,AMR,1865363,3588313,5453676,3569057,3285638,2789058,2200072,1795392,1869202,15508419,1761147,3406622,5167769,3413228,3179133,2756597,2231010,1937657,2740777,16258402,31766821,42388269,42388269
Argentina,2014,AR,ARG,AMR,1879796,3594450,5474246,3583109,3302239,2867210,2223613,1819874,1912676,15708721,1775166,3409902,5185068,3425482,3194187,2826286,2253849,1960169,2796043,16456016,32164737,42824054,42824054
Argentina,2015,AR,ARG,AMR,1890271,3604282,5494553,3592871,3322845,2940499,2251889,1843669,1955993,15907766,1785919,3416660,5202579,3433716,3212059,2891941,2282130,1981379,2850940,16652165,32559931,43257065,43257065
Argentina,2016,AR,ARG,AMR,1893125,3620043,5513168,3594989,3348643,3006325,2285078,1865343,1996293,16096671,1790176,3428702,5218878,3434847,3234222,2950431,2316588,2000142,2903291,16839521,32936192,43668241,43668241
Argentina,2017,AR,ARG,AMR,1883874,3640058,5523932,3592245,3378294,3063618,2322468,1887518,2037473,16281616,1783728,3444680,5228408,3431313,3259492,3000776,2355599,2019364,2954115,17020659,33302275,44054616,44054616
Argentina,2018,AR,ARG,AMR,1857076,3663111,5520187,3585398,3411322,3111746,2365756,1910777,2081767,16466766,1760888,3463975,5224863,3423503,3288195,3042914,2399374,2039865,3007925,17201776,33668542,44413596,44413596
Argentina,2019,AR,ARG,AMR,1815629,3687330,5502959,3575571,3446446,3150890,2417590,1933122,2126790,16650409,1723802,3485113,5208915,3412665,3319611,3076338,2450750,2059917,3063954,17383235,34033644,44745520,44745520
Argentina,2020,AR,ARG,AMR,1763856,3708797,5472653,3568036,3479329,3181653,2477979,1952401,2164954,16824352,1676506,3504745,5181251,3403904,3349544,3102821,2507712,2077170,3116629,17557780,34382132,45036032,45036032
Argentina,2021,AR,ARG,AMR,1707932,3723234,5431166,3565858,3505463,3205367,2545691,1968986,2192313,16983678,1624810,3519200,5144010,3399703,3373761,3123857,2568855,2091483,3160267,17717926,34701604,45276780,45276780
Argentina,2022,AR,ARG,AMR,1659533,3727237,5386770,3568759,3524731,3224266,2619098,1985591,2221400,17143845,1579648,3525226,5104874,3399539,3391600,3140784,2634796,2105438,3202668,17874825,35018670,45510318,45510318
Argentina,2023,AR,ARG,AMR,1625528,3715817,5341345,3574490,3539786,3240795,2696001,2005853,2264878,17321803,1547768,3517169,5064937,3401739,3405066,3156189,2704003,2123538,3255265,18045800,35367603,45773884,45773884
Argentina,2024,AR,ARG,AMR,1603769,3689023,5292792,3581326,3553682,3257287,2772605,2031226,2317694,17513820,1527454,3494297,5021751,3405150,3417194,3171397,2773155,2147903,3314703,18229502,35743322,46057866,46057866
Argentina,2025,AR,ARG,AMR,1591287,3647972,5239259,3591840,3563328,3277715,2844386,2060882,2370416,17708567,1515874,3457953,4973827,3412027,3425278,3189316,2838251,2177396,3373608,18415876,36124443,46337520,46337520
Argentina,2026,AR,ARG,AMR,1586788,3595181,5181969,3608242,3565548,3303451,2909067,2095509,2423305,17905122,1511872,3410743,4922615,3424196,3426349,3211542,2896335,2212936,3432434,18603792,36508914,46613495,46613495
Argentina,2027,AR,ARG,AMR,1584358,3537768,5122126,3628811,3563022,3333056,2965415,2134159,2477929,18102392,1509801,3359323,4869124,3440295,3422798,3236884,2946421,2252874,3493037,18792309,36894701,46885957,46885957
Argentina,2028,AR,ARG,AMR,1582827,3477187,5060014,3652319,3556460,3365978,3012773,2178144,2534221,18299895,1508487,3304769,4813256,3459688,3414985,3265597,2988353,2297148,3555504,18981275,37281170,47154446,47154446
Argentina,2029,AR,ARG,AMR,1581950,3414217,4996167,3676895,3547028,3401012,3051482,2230016,2590512,18496945,1507752,3247546,4755298,3480896,3404140,3296985,3021661,2348461,3618048,19170191,37667136,47418599,47418599
Argentina,2030,AR,ARG,AMR,1581256,3350230,4931486,3698674,3540730,3434533,3082508,2289849,2646392,18692686,1507209,3188865,4696074,3500657,3395731,3327349,3048794,2405660,3680124,19358315,38051001,47678560,47678560
Argentina,1950,AR,ARG,AMR,1000153,1676921,2677074,1562554,1381084,1197134,928117,586243,336571,5991703,971806,1642725,2614531,1543231,1369370,1126521,814722,514365,366224,5734433,11726136,17017742,17017742
Argentina,1951,AR,ARG,AMR,1019432,1711090,2730522,1569388,1408842,1211413,951259,603662,345269,6089833,988628,1684251,2672879,1554425,1400497,1152887,840493,532879,380205,5861386,11951219,17354612,17354612
Argentina,1952,AR,ARG,AMR,1037064,1749471,2786535,1573490,1437703,1224613,974398,621054,356871,6188129,1003525,1727645,2731170,1562558,1433393,1177980,865878,551890,396326,5988025,12176154,17693853,17693853
Argentina,1953,AR,ARG,AMR,1053491,1790610,2844101,1576160,1466074,1237373,996811,638387,370046,6284851,1017418,1771375,2788793,1569217,1466183,1201993,891338,571714,414552,6114997,12399848,18032740,18032740
Argentina,1954,AR,ARG,AMR,1069714,1831736,2901450,1579793,1491365,1251228,1017920,656452,384357,6381115,1032281,1812391,2844672,1577065,1495508,1225495,917438,592594,433913,6242013,12623128,18369249,18369249
Argentina,1955,AR,ARG,AMR,1085152,1872357,2957509,1585935,1512215,1266742,1037347,675292,399204,6476735,1047189,1850994,2898183,1587750,1519718,1248995,944028,614298,453471,6368260,12844995,18700686,18700686
Argentina,1956,AR,ARG,AMR,1099400,1913037,3012437,1595269,1529035,1283743,1055394,694927,414798,6573166,1061064,1888667,2949731,1601999,1539161,1272287,971317,637090,474014,6495868,13069034,19031192,19031192
Argentina,1957,AR,ARG,AMR,1113828,1953103,3066931,1608469,1542041,1302221,1072270,715384,431129,6671514,1075420,1924798,3000218,1620402,1554130,1295029,999367,660984,495201,6625113,13296627,19363786,19363786
Argentina,1958,AR,ARG,AMR,1126088,1991935,3118023,1626071,1551520,1322244,1088114,736616,448607,6773172,1087933,1959145,3047078,1643055,1565297,1318028,1027639,685663,517403,6757085,13530257,19695352,19695352
Argentina,1959,AR,ARG,AMR,1135150,2028716,3163866,1648464,1558221,1343726,1103062,758164,467262,6878899,1097370,1991285,3088655,1669643,1573672,1342566,1055242,710585,541398,6893106,13772005,20024524,20024524
Argentina,1960,AR,ARG,AMR,1142958,2062894,3205852,1675562,1562786,1365845,1117011,778866,485567,6985637,1105467,2020767,3126234,1699769,1580267,1368503,1081675,735249,566568,7032031,14017668,20349744,20349744
Argentina,1961,AR,ARG,AMR,1149905,2096057,3245962,1709354,1567106,1389216,1130179,799300,504459,7099614,1112294,2048353,3160647,1733846,1584571,1395532,1107159,759854,593462,7174424,14274038,20680653,20680653
Argentina,1962,AR,ARG,AMR,1157290,2129105,3286395,1749706,1571251,1414322,1142191,819323,523471,7220264,1119175,2075236,3194411,1771633,1586538,1423977,1131474,784086,621580,7319288,14539552,21020359,21020359
Argentina,1963,AR,ARG,AMR,1167468,2158985,3326453,1793294,1574986,1439750,1153764,838483,542465,7342742,1128858,2100066,3228924,1811260,1588299,1452611,1154771,808253,650702,7465896,14808638,21364017,21364017
Argentina,1964,AR,ARG,AMR,1180080,2185784,3365864,1837514,1580727,1463151,1166382,856357,561798,7465929,1141130,2123607,3264737,1849754,1592613,1478305,1177625,832975,680683,7611955,15077884,21708487,21708487
Argentina,1965,AR,ARG,AMR,1193437,2210709,3404146,1881858,1590036,1483456,1180697,872862,581621,7590530,1154292,2146415,3300707,1887260,1601140,1499597,1200561,858308,711405,7758271,15348801,22053661,22053661
Argentina,1966,AR,ARG,AMR,1207503,2233453,3440956,1926824,1603398,1501018,1196660,888573,602678,7719151,1168295,2167404,3335699,1925061,1614441,1516766,1223321,884428,743290,7907307,15626458,22403116,22403116
Argentina,1967,AR,ARG,AMR,1220644,2256589,3477233,1971574,1621229,1515781,1214011,903386,624416,7850397,1181684,2189257,3370941,1962310,1632903,1530016,1245528,911430,776261,8058448,15908845,22757014,22757014
Argentina,1968,AR,ARG,AMR,1233124,2280541,3513665,2015239,1643912,1527757,1232464,916775,645362,7981509,1194653,2212451,3407104,1998455,1656334,1539820,1267784,938625,809672,8210690,16192199,23112971,23112971
Argentina,1969,AR,ARG,AMR,1248477,2303887,3552364,2056641,1671542,1537471,1251841,928681,664832,8111008,1210680,2235404,3446084,2032590,1684150,1547005,1291125,964908,842784,8362562,16473570,23472028,23472028
Argentina,2031,AR,ARG,AMR,1580078,3290101,4870179,3713450,3540789,3462286,3107365,2356377,2702273,18882540,1506154,3133382,4639536,3515339,3392285,3352596,3071379,2467551,3742117,19541267,38423807,47933520,47933520
Argentina,2032,AR,ARG,AMR,1578684,3239494,4818178,3717739,3545686,3483196,3127806,2427950,2758631,19061008,1504851,3086305,4591156,3521574,3392690,3371351,3089853,2533843,3804616,19713927,38774935,48184274,48184274
Argentina,2033,AR,ARG,AMR,1577689,3204111,4781800,3706499,3552341,3499190,3145782,2502656,2815699,19222167,1503926,3053198,4557124,3513580,3395038,3385201,3106193,2602481,3867982,19870475,39092642,48431562,48431562
Argentina,2034,AR,ARG,AMR,1576996,3181590,4758586,3679854,3559477,3513561,3163588,2576991,2874686,19368157,1503264,3032210,4535474,3490706,3398382,3397411,3121897,2670483,3933560,20012439,39380596,48674651,48674651
Argentina,2035,AR,ARG,AMR,1576197,3168512,4744709,3638977,3570252,3523748,3185264,2646814,2937471,19502526,1502485,3020129,4522614,3454373,3405180,3405611,3140300,2734569,4003072,20143105,39645631,48912958,48912958
Argentina,2036,AR,ARG,AMR,1575318,3162920,4738238,3586400,3586867,3526610,3212116,2710005,3004877,19626875,1501638,3015105,4516743,3407182,3417243,3406842,3162948,2791900,4077877,20263992,39890867,49145855,49145855
Argentina,2037,AR,ARG,AMR,1574161,3159176,4733337,3529223,3607608,3524780,3242705,2765440,3077496,19747252,1500510,3011766,4512276,3355799,3433220,3403485,3188657,2841539,4158163,20380863,40128115,49373724,49373724
Argentina,2038,AR,ARG,AMR,1571649,3156728,4728377,3468904,3631261,3518960,3276493,2812572,3156399,19864589,1498049,3009550,4507599,3301285,3452477,3395898,3217676,2883334,4243944,20494614,40359203,49595170,49595170
Argentina,2039,AR,ARG,AMR,1567220,3155230,4722450,3406227,3655977,3510308,3312320,2851799,3242370,19979001,1493751,3008182,4501933,3244122,3473538,3385305,3249316,2916866,4336024,20605171,40584172,49808558,49808558
Argentina,2040,AR,ARG,AMR,1561347,3153811,4715158,3342559,3677916,3504771,3346651,2884063,3335269,20091229,1488091,3006886,4494977,3185519,3493161,3377143,3279919,2944494,4432896,20713132,40804361,50014489,50014489
Argentina,2041,AR,ARG,AMR,1554418,3151828,4706246,3282751,3692898,3505517,3375303,2910788,3434231,20201488,1481434,3005009,4486443,3130117,3507727,3373905,3305446,2967789,4533775,20818759,41020247,50212929,50212929
Argentina,2042,AR,ARG,AMR,1545716,3149354,4695070,3232449,3697455,3511032,3397235,2933582,3538114,20309867,1473118,3002609,4475727,3083116,3513873,3374489,3324541,2987195,4638920,20922134,41232001,50402787,50402787
Argentina,2043,AR,ARG,AMR,1536347,3145918,4682265,3197317,3686570,3518276,3414354,2954231,3645359,20416107,1464187,2999254,4463441,3050072,3505840,3376999,3338786,3004594,4746733,21023024,41439131,50584827,50584827
Argentina,2044,AR,ARG,AMR,1527226,3140875,4668101,3175008,3660373,3526006,3429903,2974826,3753838,20519954,1455511,2994329,4449840,3029138,3482989,3380518,3351422,3021430,4855766,21121263,41641217,50759160,50759160
Argentina,2045,AR,ARG,AMR,1517637,3134284,4651921,3162115,3620054,3537374,3441407,2999129,3861443,20621522,1446393,2987930,4434323,3017105,3446751,3387497,3360130,3040920,4964613,21217016,41838538,50924787,50924787
Argentina,2046,AR,ARG,AMR,1507658,3126557,4634215,3156688,3568119,3554526,3445772,3028323,3966991,20720419,1436888,2980468,4417356,3012130,3399720,3399727,3361981,3064547,5071828,21309933,42030352,51081914,51081914
Argentina,2047,AR,ARG,AMR,1498177,3116786,4614963,3153101,3511631,3575770,3445565,3060987,4070008,20817062,1427860,2971067,4398927,3008838,3348528,3415860,3359311,3091115,5176669,21400321,42217383,51231274,51231274
Argentina,2048,AR,ARG,AMR,1488212,3104988,4593200,3150814,3452033,3599898,3441475,3096626,4170912,20911758,1418375,2959728,4378103,3006679,3294246,3435260,3352479,3120863,5279003,21488530,42400288,51371596,51371596
Argentina,2049,AR,ARG,AMR,1476921,3091525,4568446,3149472,3390098,3625077,3434650,3134152,4270701,21004150,1407616,2946803,4354419,3005371,3237342,3456468,3342703,3153129,5379286,21574299,42578449,51501321,51501321
Argentina,2050,AR,ARG,AMR,1465298,3076157,4541455,3148210,3327179,3647507,3430886,3170159,4369869,21093810,1396519,2932084,4328603,3004134,3179024,3476253,3335343,3184338,5478222,21657314,42751124,51621175,51621175
Armenia,1970,AM,ARM,EUR,147820,348231,496051,208738,166053,183473,65085,63786,53098,740233,141578,338915,480493,216820,177525,173954,81907,92581,74814,817601,1557834,2534377,2534377
Armenia,1971,AM,ARM,EUR,145641,350867,496508,226964,157444,189832,74818,62373,54701,766132,139788,341874,481662,236053,170403,179749,90074,91991,78354,846624,1612756,2590923,2590923
Armenia,1972,AM,ARM,EUR,144514,350187,494701,244534,149085,194811,88154,60063,56439,793086,139303,341989,481292,255764,163669,185347,101929,90231,82023,878963,1672049,2648048,2648048
Armenia,1973,AM,ARM,EUR,144663,346745,491408,261630,143040,198389,103512,57382,58256,822209,139950,339514,479464,275171,158738,190532,115664,87817,85851,913773,1735982,2706852,2706852
Armenia,1974,AM,ARM,EUR,146144,340809,486953,279300,140597,199868,118578,54909,60107,853359,141740,334773,476513,295345,157154,194023,128933,85452,89912,950819,1804178,2767646,2767646
Armenia,1975,AM,ARM,EUR,148948,333037,481985,297319,142553,198748,132299,53268,61943,886130,144619,328478,473097,315834,160035,195174,140668,83762,94111,989584,1875714,2830798,2830798
Armenia,1976,AM,ARM,EUR,153600,325162,478762,316570,150103,193957,143425,51474,63580,919109,149358,321321,470679,334740,167338,195113,150876,81426,98271,1027764,1946873,2896311,2896311
Armenia,1977,AM,ARM,EUR,159884,318834,478718,335679,163567,186058,151520,49630,64806,951260,156249,314994,471243,350801,179093,193647,159644,79026,102091,1064302,2015562,2965523,2965523
Armenia,1978,AM,ARM,EUR,166113,314914,481027,351346,182214,176527,157065,49795,65510,982457,163214,311514,474728,363625,195963,188766,166767,79571,105319,1100011,2082468,3038224,3038224
Armenia,1979,AM,ARM,EUR,171023,311465,482488,361183,202317,167244,160763,52769,65673,1009949,167415,308252,475667,369763,216292,181701,170257,82951,107992,1128956,2138905,3097058,3097058
Armenia,1980,AM,ARM,EUR,174988,307643,482631,363519,219467,158991,164014,58473,65174,1029638,169890,304617,474507,368815,235632,174164,171812,88303,109618,1148344,2177982,3135123,3135123
Armenia,1981,AM,ARM,EUR,179324,305361,484685,360861,233635,151479,166966,66675,63987,1043603,173015,303079,476094,364291,252130,166848,174562,95823,109837,1163491,2207094,3167876,3167876
Armenia,1982,AM,ARM,EUR,184376,305017,489393,355057,246450,145546,169218,76870,62451,1055592,176775,303399,480174,356762,267015,160654,177793,105066,109569,1176859,2232451,3202011,3202011
Armenia,1983,AM,ARM,EUR,190288,306089,496377,346197,259791,140786,170619,87989,61002,1066384,182003,304407,486410,346616,281711,155461,180565,115048,109711,1189112,2255496,3238291,3238291
Armenia,1984,AM,ARM,EUR,195059,308375,503434,333858,273994,137845,171078,99220,59730,1075725,186962,305882,492844,334737,295821,151987,182623,125012,109914,1200094,2275819,3272102,3272102
Armenia,1985,AM,ARM,EUR,197269,311364,508633,320058,287237,137931,170265,109870,58784,1084145,190039,308358,498397,322342,308079,151574,183733,134149,109839,1209716,2293861,3300896,3300896
Armenia,1986,AM,ARM,EUR,198176,314413,512589,307666,297561,141827,167612,119271,58323,1092260,192261,311203,503464,310786,317779,155420,182882,142085,109920,1218872,2311132,3327182,3327182
Armenia,1987,AM,ARM,EUR,199170,316760,515930,297667,304510,150038,162146,127138,58479,1099978,194014,313583,507597,301164,324503,164370,178342,149023,110461,1227863,2327841,3351364,3351364
Armenia,1988,AM,ARM,EUR,199499,318312,517811,289777,308001,161915,154014,132417,59297,1105421,194239,315781,510020,292775,328269,177638,170020,153685,111199,1233586,2339007,3366838,3366838
Armenia,1989,AM,ARM,EUR,200973,325762,526735,292117,318682,180889,147435,136045,62361,1137529,194981,323418,518399,293904,339823,197947,163024,156194,114627,1265519,2403048,3448186,3448186
Armenia,1990,AM,ARM,EUR,203958,337586,541544,297567,329685,201555,142253,139264,67294,1177618,196367,335065,531432,297398,351697,219954,157966,158246,120681,1305942,2483560,3556539,3556539
Armenia,1991,AM,ARM,EUR,205660,347596,553256,297404,330875,217469,136866,141826,72645,1197085,196330,344946,541276,294876,353259,237291,152853,160808,126930,1326017,2523102,3617631,3617631
Armenia,1992,AM,ARM,EUR,201223,347085,548308,286733,316858,223355,128909,141406,78739,1176000,192157,345786,537943,285436,341662,245072,145110,161301,133721,1312302,2488302,3574555,3574555
Armenia,1993,AM,ARM,EUR,190952,339403,530355,269050,292476,223351,119059,138667,84967,1127570,183179,340242,523421,272212,320519,247206,135585,159680,140810,1276012,2403582,3457349,3457349
Armenia,1994,AM,ARM,EUR,179677,335403,515080,256606,272738,227019,111961,136163,90915,1095402,172147,337553,509700,264429,301423,252596,129001,158360,147721,1253530,2348932,3373713,3373713
Armenia,1995,AM,ARM,EUR,167411,335231,502642,249612,257565,232975,108609,133696,96395,1078852,159219,338025,497244,261239,285162,260226,126280,157294,153845,1244046,2322898,3322782,3322782
Armenia,1996,AM,ARM,EUR,155197,337684,492881,248348,245279,239604,109793,130580,101187,1074791,145609,340329,485938,261411,272057,268680,128277,155687,159177,1245289,2320080,3298898,3298898
Armenia,1997,AM,ARM,EUR,143172,338903,482075,247994,233215,243781,114935,125090,105215,1070230,132126,340855,472981,261762,259847,274784,134863,151031,163846,1246133,2316363,3271418,3271418
Armenia,1998,AM,ARM,EUR,132578,336562,469140,248652,222475,245712,123621,117466,108355,1066281,120348,337019,457367,263522,248677,278715,145641,143413,167804,1247772,2314053,3240550,3240550
Armenia,1999,AM,ARM,EUR,124140,328844,452984,251942,212680,244974,134297,109064,110683,1063640,111058,327738,438796,267638,238142,280304,158744,134848,170934,1250610,2314250,3206030,3206030
Armenia,2000,AM,ARM,EUR,116890,317687,434577,256377,204810,241301,144953,100989,113284,1061714,103303,314629,417932,272998,229274,279014,171912,126719,174383,1254300,2316014,3168523,3168523
Armenia,2001,AM,ARM,EUR,110538,305737,416275,260542,199472,235388,154302,94252,116828,1060784,96723,300140,396863,278192,223010,275128,183557,119767,179557,1259211,2319995,3133133,3133133
Armenia,2002,AM,ARM,EUR,105595,293981,399576,265641,195560,227461,162367,89439,120802,1061270,91776,286380,378156,284065,218820,269163,193692,114253,186035,1266028,2327298,3105037,3105037
Armenia,2003,AM,ARM,EUR,102446,282006,384452,271353,192416,218289,170615,85900,124604,1063177,88738,272703,361441,290314,216783,261259,203872,109884,192918,1275030,2338207,3084102,3084102
Armenia,2004,AM,ARM,EUR,100763,269273,370036,276619,189716,209095,179403,83377,127690,1065900,87215,257936,345151,296090,216656,251477,214532,106930,198973,1284658,2350558,3065745,3065745
Armenia,2005,AM,ARM,EUR,100415,254784,355199,281597,187771,199812,187363,82726,129674,1068943,86994,241317,328311,301791,217712,240698,224644,106243,203708,1294796,2363739,3047246,3047246
Armenia,2006,AM,ARM,EUR,99914,239534,339448,285961,187799,189619,193471,84736,129880,1071466,86712,223937,310649,306756,219454,229971,233328,108803,206606,1304918,2376384,3026486,3026486
Armenia,2007,AM,ARM,EUR,99234,225091,324325,289405,188679,179747,197414,89830,127589,1072664,86306,207620,293926,310115,221430,220176,239962,115491,206303,1313477,2386141,3004393,3004393
Armenia,2008,AM,ARM,EUR,99319,213171,312490,289606,190508,171208,199396,97579,122821,1071118,86600,194311,280911,309248,224872,211410,244733,125903,202736,1318902,2390020,2983421,2983421
Armenia,2009,AM,ARM,EUR,100187,204755,304942,284759,194917,163597,199083,106763,116992,1066111,87609,184923,272532,303058,230752,203237,247502,138368,197796,1320713,2386824,2964296,2964296
Armenia,2010,AM,ARM,EUR,101265,198786,300051,276697,200404,157764,196224,115843,112082,1059014,88811,178324,267135,293072,237948,196599,247692,150866,193908,1320085,2379099,2946293,2946293
Armenia,2011,AM,ARM,EUR,103048,193460,296508,267775,205394,153958,191216,123645,109075,1051063,90607,172753,263360,281460,244901,192110,245315,161844,192414,1318044,2369107,2928976,2928976
Armenia,2012,AM,ARM,EUR,106151,188735,294886,257852,211319,151117,184257,130692,107757,1042994,93563,168114,261677,269224,251902,188973,240398,171616,192749,1314862,2357856,2914421,2914421
Armenia,2013,AM,ARM,EUR,109019,185953,294972,246478,217725,148625,175993,138229,107173,1034223,96348,165543,261891,255839,258591,187367,233016,181622,193874,1310309,2344532,2901385,2901385
Armenia,2014,AM,ARM,EUR,111149,185388,296537,234228,223440,146318,167601,146106,106912,1024605,98521,165183,263704,241279,264700,187465,223698,192030,195898,1305070,2329675,2889930,2889930
Armenia,2015,AM,ARM,EUR,112303,186403,298706,220301,229030,144895,159280,153349,107567,1014422,99870,166344,266214,224911,270827,188839,213495,202007,199169,1299248,2313670,2878595,2878595
Armenia,2016,AM,ARM,EUR,112617,187976,300593,205677,234159,145516,150204,159008,109208,1003772,100512,168044,268556,207810,276285,190982,203411,210673,203751,1292912,2296684,2865835,2865835
Armenia,2017,AM,ARM,EUR,111233,190681,301914,191901,238489,147077,141488,162723,111428,993106,99679,170773,270452,191800,280201,193432,194295,217422,209293,1286443,2279549,2851923,2851923
Armenia,2018,AM,ARM,EUR,108176,193932,302108,180684,239710,149691,134107,164682,114010,982884,97360,174035,271395,178823,279952,197428,186224,222413,215330,1280170,2263054,2836557,2836557
Armenia,2019,AM,ARM,EUR,104022,197240,301262,172996,236036,154967,127664,164636,117206,973505,94040,177404,271444,169792,274441,203926,178770,225509,221950,1274388,2247893,2820602,2820602
Armenia,2020,AM,ARM,EUR,99651,200240,299891,168694,230201,162035,123199,161554,119941,965624,90441,180419,270860,163989,265817,212230,173162,225858,228180,1269236,2234860,2805608,2805608
Armenia,2021,AM,ARM,EUR,95746,203493,299239,165767,224284,169071,120796,155692,121646,957256,87173,183575,270748,159537,256127,220626,169913,223452,234076,1263731,2220987,2790974,2790974
Armenia,2022,AM,ARM,EUR,92076,206682,298758,163772,217772,177334,119737,148532,124174,951321,84033,186586,270619,155921,245975,229253,168321,218892,241412,1259774,2211095,2780469,2780469
Armenia,2023,AM,ARM,EUR,88833,208277,297110,164121,210398,186608,119828,141601,129423,951979,81227,188119,269346,154339,234901,237868,168698,212591,251133,1259530,2211509,2777970,2777970
Armenia,2024,AM,ARM,EUR,85633,207912,293545,166484,202104,195210,120401,135585,136592,956376,78504,187963,266467,154906,222536,245891,170815,204790,262649,1261587,2217963,2777979,2777979
Armenia,2025,AM,ARM,EUR,82667,206080,288747,170219,192076,203681,121873,129840,143838,961527,76022,186541,262563,156954,208220,253910,174163,196230,274696,1264173,2225700,2777003,2777003
Armenia,2026,AM,ARM,EUR,80000,203625,283625,174318,181258,211690,125256,123528,150484,966534,73826,184577,258403,159527,193003,261265,178238,187873,286646,1266552,2233086,2775109,2775109
Armenia,2027,AM,ARM,EUR,77593,199524,277117,179364,171163,218915,129461,117594,155971,972468,71857,181163,253020,163153,178688,267089,182561,180523,297709,1269723,2242191,2772323,2772323
Armenia,2028,AM,ARM,EUR,75422,194017,269439,184785,163471,223098,134631,112920,160282,979187,70068,176511,246579,167331,167205,268773,188338,174237,307656,1273540,2252727,2768742,2768742
Armenia,2029,AM,ARM,EUR,73486,187376,260862,190112,159134,222491,142279,109100,163341,986457,68464,170856,239320,171648,159463,265224,196509,168600,316393,1277837,2264294,2764470,2764470
Armenia,2030,AM,ARM,EUR,71788,180517,252305,194538,157086,218849,150974,106849,165092,993388,67037,165003,232040,175357,154344,257931,205962,164486,323720,1281800,2275188,2759528,2759528
Armenia,1950,AM,ARM,EUR,86454,147470,233924,158116,57464,64977,52263,47223,49004,429047,84168,153968,238136,153674,72913,85798,61148,46255,64145,483933,912980,1385041,1385041
Armenia,1951,AM,ARM,EUR,97115,140807,237922,164172,67418,63470,54222,45431,49971,444684,93958,147202,241160,159765,81256,84745,65136,44168,65160,500230,944914,1424000,1424000
Armenia,1952,AM,ARM,EUR,105458,135567,241025,169200,80919,61313,56234,43546,51111,462323,101426,141473,242899,165776,92976,82798,68845,42042,66378,518815,981138,1465061,1465061
Armenia,1953,AM,ARM,EUR,111966,132666,244632,173107,96480,58830,58242,41834,52215,480708,107274,137408,244682,171459,106632,80276,72314,40340,67519,538540,1019248,1508559,1508559
Armenia,1954,AM,ARM,EUR,118089,133325,251414,175250,111645,56656,60129,40697,52948,497325,113008,136441,249449,175540,119849,77880,75565,39701,68195,556730,1054055,1554921,1554921
Armenia,1955,AM,ARM,EUR,124300,138227,262527,175130,125332,55425,61762,40267,53216,511132,118903,139524,258427,177377,131565,76218,78539,40317,68273,572289,1083421,1604376,1604376
Armenia,1956,AM,ARM,EUR,130848,146746,277594,173466,137656,54973,63177,40506,53048,522826,125138,146071,271209,177805,141792,75059,81277,42191,67764,585888,1108714,1657515,1657515
Armenia,1957,AM,ARM,EUR,138237,158224,296461,171021,148328,54987,64474,41413,52456,532679,132187,155479,287666,177455,150266,74219,83783,45385,66623,597731,1130410,1714534,1714534
Armenia,1958,AM,ARM,EUR,146128,172954,319082,166922,157390,56260,65462,42806,51612,540452,139716,168742,308458,174596,157369,74560,85779,49421,65100,606825,1147277,1774816,1774816
Armenia,1959,AM,ARM,EUR,154275,189620,343895,160946,165563,60233,65733,44426,50751,547652,147498,184509,332007,168970,164227,77412,86866,53563,63642,614680,1162332,1838234,1838234
Armenia,1960,AM,ARM,EUR,162642,207261,369903,153447,172810,67066,65073,46430,49902,554728,155544,201360,356904,161974,170652,82696,86959,57898,62432,622611,1177339,1904148,1904148
Armenia,1961,AM,ARM,EUR,170076,225295,395371,145544,178883,76953,63538,48822,49112,562852,162737,218745,381482,154864,176286,90615,86134,62462,61463,631824,1194676,1971530,1971530
Armenia,1962,AM,ARM,EUR,175120,242276,417396,139157,183951,90361,61302,51297,48501,574569,167631,234978,402609,149029,181916,101804,84307,66903,60810,644769,1219338,2039346,2039346
Armenia,1963,AM,ARM,EUR,177334,258314,435648,135245,187879,105829,58697,53789,48114,589553,169796,250432,420228,145105,187287,114831,81794,71214,60490,660721,1250274,2106142,2106142
Armenia,1964,AM,ARM,EUR,176382,274571,450953,135057,189982,120967,56333,56186,47975,606500,168910,266330,435240,144539,191109,127338,79286,75389,60682,678343,1284843,2171029,2171029
Armenia,1965,AM,ARM,EUR,172625,290959,463584,139308,189723,134715,54849,58349,48139,625083,165324,282427,447751,148292,192739,138303,77399,79372,61535,697640,1322723,2234051,2234051
Armenia,1966,AM,ARM,EUR,167067,306521,473588,147415,187798,147188,54119,60299,48618,645437,160018,297731,457749,155809,192996,147750,75940,83166,63068,718729,1364166,2295496,2295496
Armenia,1967,AM,ARM,EUR,160929,320760,481689,158757,184941,158078,53893,62098,49427,667194,154151,311747,465898,166476,192524,155425,74755,86734,65308,741222,1408416,2355997,2355997
Armenia,1968,AM,ARM,EUR,155405,332872,488277,173637,180334,167408,54939,63520,50455,690293,148865,323715,472580,181279,189644,161730,74705,89792,68171,765321,1455614,2416461,2416461
Armenia,1969,AM,ARM,EUR,150999,342158,493157,190766,173699,175846,58589,64139,51673,714712,144647,332919,477566,198804,184079,167789,77021,91836,71395,790924,1505636,2476359,2476359
Armenia,2031,AM,ARM,EUR,70297,174204,244501,198676,155411,214219,158994,106248,165693,999241,65766,159624,225390,178945,150053,248911,215010,162368,329503,1284790,2284031,2753925,2753925
Armenia,2032,AM,ARM,EUR,69061,168244,237305,202290,154049,208429,167641,106358,165480,1004247,64699,154538,219237,182180,146514,239125,223918,161444,333779,1286960,2291207,2747753,2747753
Armenia,2033,AM,ARM,EUR,68091,162836,230927,203878,154417,201203,176682,106850,165212,1008242,63858,149947,213805,183712,144937,228110,232461,161975,336936,1288131,2296373,2741125,2741125
Armenia,2034,AM,ARM,EUR,67325,157712,225037,203518,156789,193087,185045,107664,165513,1011616,63191,145626,208817,183558,145510,215813,240402,164118,339179,1288580,2300196,2734049,2734049
Armenia,2035,AM,ARM,EUR,66772,153056,219828,201697,160522,183276,193303,109347,166039,1014184,62707,141726,204433,182137,147556,201582,248344,167455,341053,1288127,2302311,2726573,2726573
Armenia,2036,AM,ARM,EUR,66444,148907,215351,199249,164616,172697,201123,112721,165517,1015923,62423,138261,200684,180175,150132,186463,255633,171506,342860,1286769,2302692,2718722,2718722
Armenia,2037,AM,ARM,EUR,66264,145273,211537,195162,169646,162837,208161,116801,164317,1016924,62273,135227,197500,176762,153752,172243,261401,175799,344585,1284542,2301466,2710501,2710501
Armenia,2038,AM,ARM,EUR,66165,142136,208301,189670,175055,155340,212253,121771,163198,1017287,62194,132602,194796,172115,157925,160835,263077,181515,346077,1281544,2298831,2701923,2701923
Armenia,2039,AM,ARM,EUR,66160,139442,205602,183052,180371,151134,211731,129026,161790,1017104,62195,130333,192528,166465,162238,153153,259579,189546,346805,1277786,2294890,2693021,2693021
Armenia,2040,AM,ARM,EUR,66208,137197,203405,176219,184794,149180,208290,137261,160671,1016415,62245,128428,190673,160619,165943,148075,252385,198827,347477,1273326,2289741,2683809,2683809
Armenia,2041,AM,ARM,EUR,66255,135380,201635,169929,188925,147582,203886,144869,160082,1015273,62291,126875,189166,155248,169524,143817,243484,207710,348404,1268187,2283460,2674265,2674265
Armenia,2042,AM,ARM,EUR,66269,133969,200238,163988,192530,146293,198368,153036,159521,1013736,62303,125660,187963,150168,172754,140309,233828,216433,348914,1262406,2276142,2664340,2664340
Armenia,2043,AM,ARM,EUR,66222,132907,199129,158600,194122,146712,191486,161567,159388,1011875,62255,124741,186996,145582,174285,138753,222955,224792,349657,1256024,2267899,2654030,2654030
Armenia,2044,AM,ARM,EUR,66111,132139,198250,153492,193776,149107,183749,169489,160168,1009781,62149,124076,186225,141268,174131,139335,210826,232571,351034,1249165,2258946,2643414,2643414
Armenia,2045,AM,ARM,EUR,65917,131640,197557,148853,191979,152845,174396,177360,162071,1007504,61967,123645,185612,137370,172716,141383,196797,240362,353217,1241845,2249349,2632515,2632515
Armenia,2046,AM,ARM,EUR,65635,131365,197000,144720,189559,156930,164321,184835,164705,1005070,61699,123408,185107,133910,170759,143957,181898,247522,356089,1234135,2239205,2621300,2621300
Armenia,2047,AM,ARM,EUR,65299,131199,196498,141100,185508,161943,154949,191544,167509,1002553,61378,123268,184646,130883,167355,147571,167888,253182,359229,1226108,2228661,2609802,2609802
Armenia,2048,AM,ARM,EUR,64894,131057,195951,137977,180064,167334,147855,195486,171317,1000033,60993,123143,184136,128261,162723,151734,156664,254850,363657,1217889,2217922,2598016,2598016
Armenia,2049,AM,ARM,EUR,64364,130944,195308,135293,173497,172642,143927,195149,177016,997524,60492,123041,183533,125993,157089,156043,149107,251477,369829,1209538,2207062,2585903,2585903
Armenia,2050,AM,ARM,EUR,63704,130799,194503,133058,166718,177063,142168,192114,183942,995063,59870,122909,182779,124089,151261,159744,144130,244508,377392,1201124,2196187,2573465,2573465
American Samoa,1970,AS,ASM,WPR,2430,4012,6442,2645,1710,1224,915,530,332,7356,2304,3955,6259,2649,1552,1202,819,460,343,7025,14381,27075,27075
American Samoa,1971,AS,ASM,WPR,2456,4071,6527,2651,1775,1281,929,559,337,7532,2296,3971,6267,2739,1610,1225,857,480,348,7259,14791,27593,27593
American Samoa,1972,AS,ASM,WPR,2477,4145,6622,2616,1853,1341,943,596,346,7695,2291,3960,6251,2819,1680,1244,899,505,357,7504,15199,28063,28063
American Samoa,1973,AS,ASM,WPR,2484,4234,6718,2564,1932,1404,965,626,361,7852,2290,3939,6229,2892,1753,1261,940,529,359,7734,15586,28529,28529
American Samoa,1974,AS,ASM,WPR,2480,4325,6805,2547,1987,1468,993,651,369,8015,2300,3932,6232,2956,1824,1282,979,552,368,7961,15976,29012,29012
American Samoa,1975,AS,ASM,WPR,2473,4397,6870,2640,2003,1517,1026,669,383,8238,2319,3965,6284,3025,1900,1293,1013,573,376,8180,16418,29573,29573
American Samoa,1976,AS,ASM,WPR,2472,4448,6920,2812,2006,1558,1055,678,391,8500,2345,4013,6358,3119,1977,1300,1041,588,389,8414,16914,30198,30198
American Samoa,1977,AS,ASM,WPR,2484,4472,6956,2978,2028,1600,1080,684,409,8779,2369,4040,6409,3228,2052,1318,1057,606,408,8669,17448,30816,30816
American Samoa,1978,AS,ASM,WPR,2504,4482,6986,3120,2074,1645,1107,688,430,9064,2392,4054,6446,3350,2129,1335,1069,621,428,8932,17996,31428,31428
American Samoa,1979,AS,ASM,WPR,2530,4484,7014,3243,2144,1687,1128,695,449,9346,2412,4067,6479,3478,2198,1363,1073,643,448,9203,18549,32045,32045
American Samoa,1980,AS,ASM,WPR,2582,4520,7102,3384,2235,1730,1161,722,465,9697,2449,4123,6572,3609,2282,1415,1075,679,460,9520,19217,32886,32886
American Samoa,1981,AS,ASM,WPR,2668,4598,7266,3571,2339,1791,1205,748,484,10138,2510,4243,6753,3734,2391,1490,1083,716,489,9903,20041,34059,34059
American Samoa,1982,AS,ASM,WPR,2778,4687,7465,3764,2461,1859,1258,774,512,10628,2604,4365,6969,3852,2519,1570,1095,754,514,10304,20932,35367,35367
American Samoa,1983,AS,ASM,WPR,2897,4784,7681,3943,2595,1928,1314,800,545,11125,2717,4473,7190,3973,2660,1650,1122,791,546,10742,21867,36735,36735
American Samoa,1984,AS,ASM,WPR,3025,4892,7917,4109,2743,1999,1377,832,579,11639,2850,4566,7416,4094,2813,1737,1156,828,571,11199,22838,38168,38168
American Samoa,1985,AS,ASM,WPR,3160,5016,8176,4247,2915,2074,1439,867,605,12147,3004,4663,7667,4215,2974,1834,1192,864,599,11678,23825,39663,39663
American Samoa,1986,AS,ASM,WPR,3304,5162,8466,4371,3096,2154,1502,903,632,12658,3157,4766,7923,4333,3131,1948,1234,892,624,12162,24820,41221,41221
American Samoa,1987,AS,ASM,WPR,3457,5335,8792,4477,3280,2246,1580,940,668,13191,3314,4894,8208,4441,3305,2065,1291,907,655,12664,25855,42842,42842
American Samoa,1988,AS,ASM,WPR,3618,5524,9142,4571,3466,2343,1659,973,693,13705,3469,5044,8513,4543,3480,2189,1353,913,689,13167,26872,44532,44532
American Samoa,1989,AS,ASM,WPR,3790,5732,9522,4666,3648,2452,1738,1014,723,14241,3627,5219,8846,4624,3661,2317,1418,923,726,13669,27910,46288,46288
American Samoa,1990,AS,ASM,WPR,3945,5903,9848,4735,3799,2563,1794,1052,749,14692,3766,5402,9168,4644,3843,2435,1483,934,772,14111,28803,47818,47818
American Samoa,1991,AS,ASM,WPR,4064,6023,10087,4769,3914,2662,1842,1084,761,15032,3869,5561,9430,4606,4000,2540,1534,950,814,14444,29476,48992,48992
American Samoa,1992,AS,ASM,WPR,4169,6135,10304,4793,4017,2766,1876,1118,775,15345,3962,5712,9674,4560,4134,2645,1587,972,847,14745,30090,50078,50078
American Samoa,1993,AS,ASM,WPR,4270,6263,10533,4818,4112,2872,1913,1154,794,15663,4051,5867,9918,4526,4251,2756,1640,1002,883,15058,30721,51174,51174
American Samoa,1994,AS,ASM,WPR,4362,6407,10769,4847,4198,2970,1959,1193,806,15973,4135,6034,10169,4509,4335,2878,1701,1035,912,15370,31343,52288,52288
American Samoa,1995,AS,ASM,WPR,4437,6575,11012,4880,4268,3084,2007,1229,819,16287,4199,6222,10421,4505,4381,3012,1791,1068,934,15691,31978,53401,53401
American Samoa,1996,AS,ASM,WPR,4486,6774,11260,4912,4324,3196,2062,1266,821,16581,4239,6423,10662,4516,4394,3153,1884,1100,952,15999,32580,54500,54500
American Samoa,1997,AS,ASM,WPR,4497,6994,11491,4947,4369,3309,2126,1306,816,16873,4246,6647,10893,4536,4386,3297,1995,1137,965,16316,33189,55578,55578
American Samoa,1998,AS,ASM,WPR,4460,7238,11698,4985,4401,3429,2199,1345,817,17176,4215,6892,11107,4562,4366,3443,2113,1166,977,16627,33803,56603,56603
American Samoa,1999,AS,ASM,WPR,4393,7500,11893,5031,4416,3546,2279,1374,819,17465,4157,7150,11307,4593,4333,3583,2234,1194,990,16927,34392,57594,57594
American Samoa,2000,AS,ASM,WPR,4283,7693,11976,5046,4400,3636,2357,1400,844,17683,4060,7344,11404,4616,4279,3698,2336,1230,1008,17167,34850,58230,58230
American Samoa,2001,AS,ASM,WPR,4127,7771,11898,5003,4352,3693,2427,1426,877,17778,3915,7427,11342,4611,4208,3770,2411,1266,1041,17307,35085,58324,58324
American Samoa,2002,AS,ASM,WPR,3983,7769,11752,4946,4291,3737,2489,1448,909,17820,3770,7432,11202,4600,4134,3821,2479,1308,1069,17411,35231,58177,58177
American Samoa,2003,AS,ASM,WPR,3869,7708,11577,4892,4223,3767,2542,1478,941,17843,3639,7380,11019,4593,4059,3854,2546,1349,1101,17502,35345,57941,57941
American Samoa,2004,AS,ASM,WPR,3771,7600,11371,4849,4152,3784,2596,1510,973,17864,3517,7284,10801,4599,3986,3859,2615,1398,1130,17587,35451,57626,57626
American Samoa,2005,AS,ASM,WPR,3678,7454,11132,4839,4069,3784,2661,1543,1002,17898,3402,7142,10544,4636,3914,3839,2695,1461,1146,17691,35589,57254,57254
American Samoa,2006,AS,ASM,WPR,3595,7267,10862,4867,3969,3780,2722,1578,1014,17930,3305,6956,10261,4693,3842,3795,2770,1528,1154,17782,35712,56837,56837
American Samoa,2007,AS,ASM,WPR,3528,7047,10575,4919,3856,3759,2786,1615,1030,17965,3240,6729,9969,4776,3763,3729,2841,1595,1164,17868,35833,56383,56383
American Samoa,2008,AS,ASM,WPR,3465,6824,10289,4992,3719,3724,2853,1647,1040,17975,3204,6483,9687,4874,3666,3662,2909,1664,1168,17943,35918,55891,55891
American Samoa,2009,AS,ASM,WPR,3409,6623,10032,5060,3558,3672,2915,1682,1040,17927,3202,6242,9444,4964,3548,3590,2969,1733,1156,17960,35887,55366,55366
American Samoa,2010,AS,ASM,WPR,3331,6437,9768,5139,3411,3607,2968,1719,1046,17890,3169,6026,9195,5060,3429,3514,3024,1793,1169,17989,35879,54849,54849
American Samoa,2011,AS,ASM,WPR,3228,6261,9489,5202,3278,3536,3011,1770,1071,17868,3083,5818,8901,5147,3326,3450,3076,1857,1196,18052,35920,54310,54310
American Samoa,2012,AS,ASM,WPR,3120,6101,9221,5220,3157,3460,3042,1819,1096,17794,2986,5638,8624,5183,3227,3385,3115,1913,1230,18053,35847,53691,53691
American Samoa,2013,AS,ASM,WPR,3009,5944,8953,5186,3064,3370,3065,1864,1124,17673,2868,5479,8347,5164,3159,3313,3141,1975,1273,18025,35698,52995,52995
American Samoa,2014,AS,ASM,WPR,2893,5786,8679,5098,3006,3276,3071,1909,1154,17514,2730,5339,8069,5085,3136,3236,3144,2037,1316,17954,35468,52217,52217
American Samoa,2015,AS,ASM,WPR,2778,5613,8391,4958,3003,3172,3073,1963,1178,17347,2603,5186,7789,4947,3155,3148,3125,2102,1363,17840,35187,51368,51368
American Samoa,2016,AS,ASM,WPR,2661,5420,8081,4766,3046,3059,3064,2015,1210,17160,2494,5010,7504,4750,3221,3062,3082,2167,1418,17700,34860,50448,50448
American Samoa,2017,AS,ASM,WPR,2542,5207,7749,4547,3120,2938,3047,2070,1231,16953,2385,4829,7214,4512,3330,2974,3017,2230,1484,17547,34500,49463,49463
American Samoa,2018,AS,ASM,WPR,2423,4982,7405,4304,3214,2806,3013,2133,1259,16729,2272,4648,6920,4243,3463,2872,2955,2293,1544,17370,34099,48424,48424
American Samoa,2019,AS,ASM,WPR,2302,4752,7054,4061,3306,2675,2967,2187,1285,16481,2157,4459,6616,3975,3590,2761,2892,2346,1608,17172,33653,47321,47321
American Samoa,2020,AS,ASM,WPR,2185,4526,6711,3840,3385,2542,2902,2232,1309,16210,2050,4264,6314,3726,3694,2649,2818,2398,1670,16955,33165,46189,46189
American Samoa,2021,AS,ASM,WPR,2077,4297,6374,3642,3431,2407,2827,2266,1342,15915,1947,4063,6010,3500,3764,2535,2753,2442,1740,16734,32649,45035,45035
American Samoa,2022,AS,ASM,WPR,2001,4185,6186,3523,3425,2287,2759,2302,1390,15686,1879,3953,5832,3343,3767,2436,2705,2490,1826,16567,32253,44273,44273
American Samoa,2023,AS,ASM,WPR,1948,4176,6124,3499,3373,2193,2694,2351,1452,15562,1833,3926,5759,3270,3702,2372,2662,2539,1925,16470,32032,43914,43914
American Samoa,2024,AS,ASM,WPR,1894,4149,6043,3495,3281,2136,2623,2386,1523,15444,1788,3869,5657,3247,3588,2348,2615,2571,2034,16403,31847,43544,43544
American Samoa,2025,AS,ASM,WPR,1841,4111,5952,3505,3151,2133,2542,2410,1600,15341,1739,3817,5556,3243,3413,2376,2554,2583,2146,16315,31656,43161,43161
American Samoa,2026,AS,ASM,WPR,1781,4064,5845,3516,2989,2171,2454,2428,1681,15239,1684,3774,5458,3238,3199,2444,2500,2578,2273,16232,31471,42773,42773
American Samoa,2027,AS,ASM,WPR,1723,4005,5728,3528,2812,2243,2359,2439,1767,15148,1628,3727,5355,3249,2954,2554,2441,2551,2396,16145,31293,42384,42384
American Samoa,2028,AS,ASM,WPR,1667,3934,5601,3542,2634,2335,2255,2440,1855,15061,1574,3669,5243,3269,2702,2675,2369,2528,2524,16067,31128,41978,41978
American Samoa,2029,AS,ASM,WPR,1612,3851,5463,3563,2479,2423,2149,2427,1945,14986,1524,3596,5120,3295,2472,2791,2288,2502,2648,15996,30982,41562,41562
American Samoa,2030,AS,ASM,WPR,1558,3754,5312,3593,2364,2498,2038,2395,2030,14918,1472,3513,4985,3329,2275,2880,2204,2466,2768,15922,30840,41142,41142
American Samoa,1950,AS,ASM,WPR,1859,2802,4661,1930,1379,852,573,239,242,5215,1693,2466,4159,1894,1285,804,533,276,201,4993,10208,19032,19032
American Samoa,1951,AS,ASM,WPR,1892,2864,4756,1965,1377,885,583,252,245,5307,1750,2527,4277,1907,1319,825,543,290,211,5095,10402,19425,19425
American Samoa,1952,AS,ASM,WPR,1899,2908,4807,1961,1340,904,576,264,242,5287,1771,2576,4347,1895,1330,826,541,303,222,5117,10404,19561,19561
American Samoa,1953,AS,ASM,WPR,1901,2951,4852,1951,1307,915,571,280,245,5269,1777,2633,4410,1881,1341,828,536,315,239,5140,10409,19670,19670
American Samoa,1954,AS,ASM,WPR,1903,2986,4889,1944,1277,919,571,295,240,5246,1772,2685,4457,1874,1341,833,537,326,252,5163,10409,19758,19758
American Samoa,1955,AS,ASM,WPR,1902,3021,4923,1932,1246,913,575,308,241,5215,1767,2733,4500,1874,1335,835,535,340,271,5190,10405,19826,19826
American Samoa,1956,AS,ASM,WPR,1902,3069,4971,1915,1214,905,579,321,242,5176,1776,2776,4552,1877,1326,838,533,346,283,5203,10379,19902,19902
American Samoa,1957,AS,ASM,WPR,1905,3127,5032,1884,1180,913,586,331,245,5139,1780,2804,4584,1856,1322,844,524,354,285,5185,10324,19937,19937
American Samoa,1958,AS,ASM,WPR,1902,3183,5085,1861,1131,932,597,340,242,5103,1769,2830,4599,1814,1313,854,524,346,280,5131,10234,19918,19918
American Samoa,1959,AS,ASM,WPR,1907,3214,5121,1867,1060,954,609,348,239,5077,1764,2857,4621,1774,1284,862,535,334,280,5069,10146,19883,19883
American Samoa,1960,AS,ASM,WPR,1926,3232,5158,1941,1023,970,621,359,243,5157,1787,2889,4676,1780,1272,879,553,326,284,5094,10251,20085,20085
American Samoa,1961,AS,ASM,WPR,1965,3258,5223,2062,1041,989,647,376,246,5361,1845,2948,4793,1846,1293,919,577,333,282,5250,10611,20626,20626
American Samoa,1962,AS,ASM,WPR,2011,3303,5314,2173,1095,1006,680,394,245,5593,1913,3017,4930,1932,1313,963,600,345,282,5435,11028,21272,21272
American Samoa,1963,AS,ASM,WPR,2063,3367,5430,2257,1161,1021,718,410,249,5816,1980,3107,5087,2009,1335,1005,629,358,280,5616,11432,21949,21949
American Samoa,1964,AS,ASM,WPR,2123,3448,5571,2314,1241,1037,757,424,254,6027,2047,3205,5252,2091,1359,1038,663,369,287,5807,11834,22656,22656
American Samoa,1965,AS,ASM,WPR,2188,3533,5721,2353,1334,1056,797,435,262,6237,2112,3319,5431,2172,1386,1073,693,382,293,5999,12236,23391,23391
American Samoa,1966,AS,ASM,WPR,2249,3625,5874,2391,1431,1075,832,448,275,6452,2167,3443,5610,2258,1416,1106,719,391,298,6188,12640,24122,24122
American Samoa,1967,AS,ASM,WPR,2300,3718,6018,2437,1523,1097,859,461,295,6672,2216,3573,5789,2344,1446,1130,745,401,308,6374,13046,24848,24848
American Samoa,1968,AS,ASM,WPR,2353,3816,6169,2497,1604,1125,880,477,310,6893,2258,3714,5972,2439,1474,1154,767,420,321,6575,13468,25608,25608
American Samoa,1969,AS,ASM,WPR,2397,3926,6323,2578,1661,1167,900,500,323,7129,2293,3858,6151,2546,1511,1173,791,442,327,6790,13919,26396,26396
American Samoa,2031,AS,ASM,WPR,1507,3649,5156,3619,2293,2546,1924,2357,2114,14853,1423,3422,4845,3359,2130,2933,2116,2436,2883,15857,30710,40715,40715
American Samoa,2032,AS,ASM,WPR,1456,3543,4999,3638,2265,2556,1825,2312,2190,14786,1375,3331,4706,3367,2043,2938,2037,2412,2993,15790,30576,40280,40280
American Samoa,2033,AS,ASM,WPR,1407,3438,4845,3643,2275,2525,1747,2259,2261,14710,1329,3236,4565,3358,2006,2898,1988,2378,3097,15725,30435,39842,39842
American Samoa,2034,AS,ASM,WPR,1361,3336,4697,3633,2306,2459,1705,2200,2324,14627,1286,3143,4429,3319,2020,2804,1977,2334,3196,15650,30277,39404,39404
American Samoa,2035,AS,ASM,WPR,1317,3235,4552,3612,2349,2351,1710,2134,2391,14547,1246,3051,4297,3283,2053,2656,2015,2287,3280,15574,30121,38966,38966
American Samoa,2036,AS,ASM,WPR,1278,3130,4408,3581,2400,2216,1765,2063,2448,14473,1208,2953,4161,3263,2088,2464,2095,2242,3349,15501,29974,38539,38539
American Samoa,2037,AS,ASM,WPR,1245,3027,4272,3540,2450,2069,1846,1984,2504,14393,1177,2855,4032,3233,2137,2244,2207,2193,3411,15425,29818,38120,38120
American Samoa,2038,AS,ASM,WPR,1217,2927,4144,3487,2503,1918,1948,1897,2554,14307,1148,2762,3910,3191,2199,2019,2339,2129,3460,15337,29644,37700,37700
American Samoa,2039,AS,ASM,WPR,1193,2834,4027,3423,2560,1790,2048,1807,2590,14218,1125,2670,3795,3141,2267,1811,2462,2058,3516,15255,29473,37294,37294
American Samoa,2040,AS,ASM,WPR,1174,2740,3914,3342,2627,1701,2131,1718,2616,14135,1107,2586,3693,3077,2340,1642,2560,1986,3558,15163,29298,36899,36899
American Samoa,2041,AS,ASM,WPR,1158,2658,3816,3255,2690,1659,2186,1619,2620,14029,1093,2503,3596,3005,2404,1527,2623,1907,3601,15067,29096,36512,36512
American Samoa,2042,AS,ASM,WPR,1147,2576,3723,3166,2746,1659,2204,1535,2628,13938,1084,2430,3514,2931,2459,1462,2638,1838,3644,14972,28910,36139,36139
American Samoa,2043,AS,ASM,WPR,1138,2504,3642,3080,2790,1692,2183,1473,2620,13838,1075,2361,3436,2855,2488,1452,2606,1795,3669,14865,28703,35780,35780
American Samoa,2044,AS,ASM,WPR,1132,2440,3572,2992,2820,1749,2128,1442,2608,13739,1069,2300,3369,2781,2485,1492,2523,1792,3685,14758,28497,35434,35434
American Samoa,2045,AS,ASM,WPR,1128,2381,3509,2905,2831,1813,2037,1459,2589,13634,1066,2247,3313,2703,2487,1545,2389,1833,3685,14642,28276,35101,35101
American Samoa,2046,AS,ASM,WPR,1124,2333,3457,2817,2837,1886,1916,1518,2561,13535,1063,2200,3263,2622,2503,1604,2210,1916,3677,14532,28067,34784,34784
American Samoa,2047,AS,ASM,WPR,1121,2293,3414,2729,2828,1958,1782,1605,2526,13428,1059,2164,3223,2541,2507,1672,2006,2032,3654,14412,27840,34481,34481
American Samoa,2048,AS,ASM,WPR,1116,2257,3373,2642,2808,2032,1651,1706,2489,13328,1054,2131,3185,2461,2498,1756,1796,2166,3617,14294,27622,34178,34178
American Samoa,2049,AS,ASM,WPR,1111,2233,3344,2559,2770,2107,1538,1803,2431,13208,1050,2109,3159,2381,2473,1840,1602,2288,3581,14165,27373,33868,33868
American Samoa,2050,AS,ASM,WPR,1101,2214,3315,2475,2717,2187,1461,1883,2370,13093,1040,2087,3127,2301,2436,1927,1444,2383,3526,14017,27110,33557,33557
Antigua and Barbuda,1970,AG,ATG,AMR,4680,9454,14134,6003,2562,2271,2431,2064,1049,16380,4664,9451,14115,6409,3376,2987,2788,2237,2087,19884,36264,64517,64517
Antigua and Barbuda,1971,AG,ATG,AMR,4475,9455,13930,6186,2593,2213,2436,2134,1129,16691,4444,9489,13933,6582,3414,2967,2795,2275,2180,20213,36904,64769,64769
Antigua and Barbuda,1972,AG,ATG,AMR,4251,9385,13636,6324,2597,2141,2438,2197,1224,16921,4210,9461,13671,6718,3431,2937,2802,2309,2274,20471,37392,64695,64695
Antigua and Barbuda,1973,AG,ATG,AMR,4020,9267,13287,6454,2593,2057,2440,2249,1324,17117,3971,9385,13356,6851,3450,2894,2808,2334,2371,20708,37825,64463,64463
Antigua and Barbuda,1974,AG,ATG,AMR,3787,9122,12909,6605,2601,1963,2436,2295,1428,17328,3737,9265,13002,7006,3482,2842,2813,2360,2467,20970,38298,64218,64218
Antigua and Barbuda,1975,AG,ATG,AMR,3617,8901,12518,6793,2632,1867,2426,2341,1543,17602,3571,9062,12633,7199,3528,2789,2825,2383,2557,21281,38883,64035,64035
Antigua and Barbuda,1976,AG,ATG,AMR,3538,8616,12154,7010,2690,1772,2405,2377,1661,17915,3491,8777,12268,7420,3601,2736,2835,2408,2651,21651,39566,63990,63990
Antigua and Barbuda,1977,AG,ATG,AMR,3517,8330,11847,7231,2777,1682,2376,2413,1780,18259,3467,8486,11953,7652,3705,2689,2843,2436,2737,22062,40321,64117,64117
Antigua and Barbuda,1978,AG,ATG,AMR,3521,8045,11566,7438,2900,1613,2340,2439,1895,18625,3467,8185,11652,7869,3833,2650,2848,2459,2823,22482,41107,64329,64329
Antigua and Barbuda,1979,AG,ATG,AMR,3564,7763,11327,7616,3055,1561,2300,2456,2005,18993,3500,7885,11385,8056,3988,2627,2842,2482,2911,22906,41899,64609,64609
Antigua and Barbuda,1980,AG,ATG,AMR,3614,7481,11095,7739,3238,1543,2246,2461,2115,19342,3545,7581,11126,8194,4172,2630,2833,2503,3000,23332,42674,64889,64889
Antigua and Barbuda,1981,AG,ATG,AMR,3606,7222,10828,7808,3463,1553,2179,2460,2216,19679,3536,7303,10839,8280,4383,2647,2814,2516,3084,23724,43403,65076,65076
Antigua and Barbuda,1982,AG,ATG,AMR,3545,7016,10561,7818,3727,1593,2104,2451,2315,20008,3478,7075,10553,8316,4622,2692,2785,2527,3169,24111,44119,65231,65231
Antigua and Barbuda,1983,AG,ATG,AMR,3486,6835,10321,7786,4012,1654,2027,2436,2402,20317,3418,6874,10292,8297,4880,2759,2750,2544,3254,24484,44801,65408,65408
Antigua and Barbuda,1984,AG,ATG,AMR,3415,6655,10070,7672,4363,1802,1928,2373,2479,20617,3347,6666,10013,8158,5167,2850,2665,2520,3313,24673,45290,65362,65362
Antigua and Barbuda,1985,AG,ATG,AMR,3341,6514,9855,7435,4736,2034,1833,2256,2520,20814,3277,6493,9770,7853,5450,2968,2541,2459,3341,24612,45426,65048,65048
Antigua and Barbuda,1986,AG,ATG,AMR,3304,6404,9708,7142,5034,2291,1778,2134,2554,20933,3251,6363,9614,7484,5684,3110,2434,2389,3355,24456,45389,64712,64712
Antigua and Barbuda,1987,AG,ATG,AMR,3271,6306,9577,6856,5250,2562,1770,2012,2570,21020,3235,6264,9499,7113,5850,3281,2354,2308,3356,24262,45282,64353,64353
Antigua and Barbuda,1988,AG,ATG,AMR,3233,6247,9480,6580,5379,2839,1815,1892,2559,21064,3218,6204,9422,6756,5937,3463,2302,2212,3345,24015,45079,63982,63982
Antigua and Barbuda,1989,AG,ATG,AMR,3216,6224,9440,6311,5430,3111,1911,1786,2522,21071,3215,6179,9394,6412,5946,3654,2283,2115,3323,23733,44804,63636,63636
Antigua and Barbuda,1990,AG,ATG,AMR,3222,6205,9427,6062,5409,3360,2060,1701,2477,21069,3233,6175,9408,6103,5884,3839,2305,2008,3287,23426,44495,63328,63328
Antigua and Barbuda,1991,AG,ATG,AMR,3211,6216,9427,5965,5474,3577,2185,1661,2434,21296,3209,6205,9414,5964,5920,4017,2374,1951,3270,23496,44792,63634,63634
Antigua and Barbuda,1992,AG,ATG,AMR,3201,6237,9438,5983,5635,3765,2266,1664,2419,21732,3180,6272,9452,6006,6112,4209,2493,1943,3266,24029,45761,64659,64659
Antigua and Barbuda,1993,AG,ATG,AMR,3218,6267,9485,5962,5766,3971,2361,1672,2403,22135,3203,6356,9559,6084,6324,4425,2637,1932,3252,24654,46789,65834,65834
Antigua and Barbuda,1994,AG,ATG,AMR,3250,6328,9578,5931,5872,4185,2471,1675,2389,22523,3249,6452,9701,6143,6519,4667,2790,1920,3232,25271,47794,67072,67072
Antigua and Barbuda,1995,AG,ATG,AMR,3308,6387,9695,5909,5971,4381,2600,1691,2373,22925,3302,6563,9865,6189,6705,4930,2947,1927,3218,25916,48841,68398,68398
Antigua and Barbuda,1996,AG,ATG,AMR,3408,6438,9846,5876,6076,4536,2768,1714,2355,23325,3388,6670,10058,6209,6902,5176,3119,1963,3203,26572,49897,69798,69798
Antigua and Barbuda,1997,AG,ATG,AMR,3508,6507,10015,5852,6171,4685,2941,1747,2324,23720,3485,6750,10235,6260,7062,5423,3303,2017,3176,27241,50961,71218,71218
Antigua and Barbuda,1998,AG,ATG,AMR,3564,6583,10147,5878,6217,4876,3080,1784,2304,24139,3530,6835,10365,6358,7147,5700,3485,2077,3164,27931,52070,72572,72572
Antigua and Barbuda,1999,AG,ATG,AMR,3566,6656,10222,5931,6198,5100,3213,1823,2289,24554,3515,6934,10449,6452,7187,5984,3672,2139,3155,28589,53143,73821,73821
Antigua and Barbuda,2000,AG,ATG,AMR,3564,6770,10334,5986,6138,5328,3360,1882,2280,24974,3502,7025,10527,6520,7191,6268,3853,2218,3170,29220,54194,75055,75055
Antigua and Barbuda,2001,AG,ATG,AMR,3549,6895,10444,6023,6091,5527,3519,1955,2272,25387,3479,7100,10579,6560,7170,6538,4026,2319,3191,29804,55191,76215,76215
Antigua and Barbuda,2002,AG,ATG,AMR,3489,6993,10482,6076,6056,5682,3693,2036,2280,25823,3410,7143,10553,6601,7115,6767,4220,2429,3215,30347,56170,77195,77195
Antigua and Barbuda,2003,AG,ATG,AMR,3432,7046,10478,6160,6009,5803,3894,2119,2284,26269,3349,7147,10496,6653,7015,6943,4442,2552,3230,30835,57104,78075,78075
Antigua and Barbuda,2004,AG,ATG,AMR,3396,7049,10445,6257,5970,5899,4100,2219,2294,26739,3311,7117,10428,6715,6905,7084,4697,2678,3246,31325,58064,78941,78941
Antigua and Barbuda,2005,AG,ATG,AMR,3325,7068,10393,6364,5955,6012,4280,2349,2306,27266,3238,7091,10329,6812,6805,7216,4957,2818,3274,31882,59148,79869,79869
Antigua and Barbuda,2006,AG,ATG,AMR,3243,7118,10361,6474,5949,6136,4423,2514,2322,27818,3154,7083,10237,6926,6722,7349,5184,2979,3317,32477,60295,80895,80895
Antigua and Barbuda,2007,AG,ATG,AMR,3210,7126,10336,6594,5970,6243,4570,2682,2346,28405,3121,7064,10185,7009,6709,7436,5413,3153,3368,33088,61493,82016,82016
Antigua and Barbuda,2008,AG,ATG,AMR,3240,7103,10343,6713,6047,6300,4761,2823,2385,29029,3149,7008,10157,7091,6764,7447,5673,3324,3427,33726,62755,83251,83251
Antigua and Barbuda,2009,AG,ATG,AMR,3313,7046,10359,6821,6159,6296,4986,2958,2433,29653,3218,6926,10144,7181,6835,7427,5943,3504,3494,34384,64037,84534,84534
Antigua and Barbuda,2010,AG,ATG,AMR,3352,6957,10309,6947,6269,6257,5220,3102,2495,30290,3256,6813,10069,7260,6898,7389,6217,3678,3586,35028,65318,85695,85695
Antigua and Barbuda,2011,AG,ATG,AMR,3349,6845,10194,7085,6363,6240,5431,3254,2577,30950,3254,6687,9941,7315,6946,7352,6481,3842,3708,35644,66594,86729,86729
Antigua and Barbuda,2012,AG,ATG,AMR,3319,6743,10062,7190,6472,6240,5607,3421,2664,31594,3220,6577,9797,7338,7004,7305,6714,4030,3833,36224,67818,87674,87674
Antigua and Barbuda,2013,AG,ATG,AMR,3211,6714,9925,7248,6591,6225,5747,3611,2755,32177,3117,6540,9657,7329,7073,7227,6904,4248,3962,36743,68920,88497,88497
Antigua and Barbuda,2014,AG,ATG,AMR,3051,6748,9799,7246,6711,6210,5860,3807,2851,32685,2963,6567,9530,7285,7138,7132,7058,4502,4103,37218,69903,89236,89236
Antigua and Barbuda,2015,AG,ATG,AMR,2941,6710,9651,7245,6814,6209,5978,3979,2982,33207,2854,6528,9382,7238,7221,7033,7194,4752,4274,37712,70919,89941,89941
Antigua and Barbuda,2016,AG,ATG,AMR,2859,6619,9478,7262,6889,6192,6099,4111,3146,33699,2776,6438,9214,7200,7289,6936,7320,4968,4465,38178,71877,90564,90564
Antigua and Barbuda,2017,AG,ATG,AMR,2785,6547,9332,7235,6957,6183,6197,4249,3308,34129,2703,6368,9071,7148,7307,6887,7398,5183,4668,38591,72720,91119,91119
Antigua and Barbuda,2018,AG,ATG,AMR,2729,6462,9191,7174,7008,6218,6242,4429,3455,34526,2646,6284,8930,7067,7321,6903,7398,5429,4868,38986,73512,91626,91626
Antigua and Barbuda,2019,AG,ATG,AMR,2689,6372,9061,7089,7054,6291,6226,4639,3603,34902,2609,6192,8801,6958,7342,6931,7363,5681,5079,39354,74256,92117,92117
Antigua and Barbuda,2020,AG,ATG,AMR,2678,6295,8973,6972,7120,6365,6177,4857,3770,35261,2596,6115,8711,6826,7365,6948,7318,5945,5316,39718,74979,92664,92664
Antigua and Barbuda,2021,AG,ATG,AMR,2696,6206,8902,6844,7197,6422,6145,5056,3944,35608,2614,6029,8643,6688,7377,6971,7272,6201,5558,40067,75675,93219,93219
Antigua and Barbuda,2022,AG,ATG,AMR,2729,6094,8823,6734,7248,6489,6128,5222,4137,35958,2645,5921,8566,6573,7371,7007,7217,6426,5818,40412,76370,93763,93763
Antigua and Barbuda,2023,AG,ATG,AMR,2772,5927,8699,6694,7262,6575,6100,5354,4365,36350,2689,5758,8447,6530,7342,7059,7135,6615,6117,40798,77148,94298,94298
Antigua and Barbuda,2024,AG,ATG,AMR,2817,5729,8546,6722,7227,6669,6078,5461,4608,36765,2732,5563,8295,6554,7281,7111,7037,6766,6457,41206,77971,94816,94816
Antigua and Barbuda,2025,AG,ATG,AMR,2822,5606,8428,6685,7206,6748,6069,5575,4850,37133,2738,5442,8180,6514,7218,7183,6938,6906,6806,41565,78698,95319,95319
Antigua and Barbuda,2026,AG,ATG,AMR,2806,5544,8350,6597,7213,6818,6054,5693,5088,37463,2723,5381,8104,6423,7177,7246,6842,7034,7162,41884,79347,95803,95803
Antigua and Barbuda,2027,AG,ATG,AMR,2788,5502,8290,6526,7181,6882,6043,5786,5331,37749,2705,5341,8046,6353,7125,7264,6798,7113,7525,42178,79927,96266,96266
Antigua and Barbuda,2028,AG,ATG,AMR,2771,5491,8262,6441,7121,6935,6080,5834,5587,37998,2687,5330,8017,6269,7043,7280,6814,7113,7902,42421,80419,96701,96701
Antigua and Barbuda,2029,AG,ATG,AMR,2753,5497,8250,6349,7040,6982,6158,5820,5880,38229,2669,5334,8003,6179,6934,7306,6841,7078,8297,42635,80864,97118,97118
Antigua and Barbuda,2030,AG,ATG,AMR,2732,5492,8224,6273,6924,7046,6231,5783,6192,38449,2650,5328,7978,6103,6806,7329,6864,7035,8721,42858,81307,97510,97510
Antigua and Barbuda,1950,AG,ATG,AMR,3529,6048,9577,3546,2734,2204,1904,718,523,11629,3519,6016,9535,4043,3014,2599,2288,1386,1352,14682,26311,45435,45435
Antigua and Barbuda,1951,AG,ATG,AMR,3599,6193,9792,3734,2701,2233,1978,771,522,11939,3570,6150,9720,4214,3018,2614,2333,1422,1344,14945,26884,46398,46398
Antigua and Barbuda,1952,AG,ATG,AMR,3674,6300,9974,3943,2645,2282,2036,838,520,12264,3625,6270,9895,4396,3012,2634,2363,1460,1359,15224,27488,47359,47359
Antigua and Barbuda,1953,AG,ATG,AMR,3758,6382,10140,4160,2585,2344,2073,920,521,12603,3690,6369,10059,4586,3004,2658,2377,1507,1385,15517,28120,48317,48317
Antigua and Barbuda,1954,AG,ATG,AMR,3857,6443,10300,4379,2545,2398,2097,1012,525,12956,3776,6445,10221,4765,3007,2683,2390,1565,1396,15806,28762,49280,49280
Antigua and Barbuda,1955,AG,ATG,AMR,3945,6513,10458,4592,2532,2434,2109,1109,533,13309,3857,6524,10381,4936,3036,2705,2400,1624,1414,16115,29424,50264,50264
Antigua and Barbuda,1956,AG,ATG,AMR,4010,6616,10626,4805,2542,2457,2101,1215,540,13660,3919,6620,10539,5094,3088,2729,2407,1698,1416,16432,30092,51250,51250
Antigua and Barbuda,1957,AG,ATG,AMR,4079,6713,10792,5006,2582,2467,2076,1328,547,14006,3986,6709,10695,5239,3164,2751,2411,1782,1406,16753,30759,52245,52245
Antigua and Barbuda,1958,AG,ATG,AMR,4149,6815,10964,5195,2643,2468,2049,1443,558,14356,4062,6802,10864,5372,3259,2772,2413,1862,1403,17081,31437,53263,53263
Antigua and Barbuda,1959,AG,ATG,AMR,4226,6923,11149,5363,2732,2451,2031,1546,581,14704,4137,6898,11035,5495,3369,2783,2421,1933,1417,17418,32122,54299,54299
Antigua and Barbuda,1960,AG,ATG,AMR,4302,7034,11336,5501,2841,2418,2038,1631,610,15039,4213,7000,11213,5611,3485,2785,2433,1992,1447,17753,32792,55342,55342
Antigua and Barbuda,1961,AG,ATG,AMR,4370,7140,11510,5579,2943,2364,2075,1700,659,15320,4281,7102,11383,5689,3593,2776,2446,2035,1494,18033,33353,56245,56245
Antigua and Barbuda,1962,AG,ATG,AMR,4431,7251,11682,5585,3039,2288,2137,1761,720,15530,4345,7199,11544,5725,3687,2756,2464,2061,1562,18255,33785,57008,57008
Antigua and Barbuda,1963,AG,ATG,AMR,4493,7376,11869,5566,3140,2206,2209,1815,780,15716,4407,7312,11719,5754,3782,2727,2487,2077,1641,18468,34184,57778,57778
Antigua and Barbuda,1964,AG,ATG,AMR,4594,7587,12181,5487,3209,2173,2277,1826,845,15817,4512,7517,12029,5729,3841,2737,2526,2084,1716,18633,34450,58664,58664
Antigua and Barbuda,1965,AG,ATG,AMR,4693,7881,12574,5403,3214,2198,2330,1801,901,15847,4627,7818,12445,5697,3841,2796,2571,2086,1785,18776,34623,59644,59644
Antigua and Barbuda,1966,AG,ATG,AMR,4739,8205,12944,5398,3145,2236,2371,1796,948,15894,4693,8149,12842,5728,3782,2864,2613,2099,1848,18934,34828,60615,60615
Antigua and Barbuda,1967,AG,ATG,AMR,4751,8562,13313,5453,3017,2279,2398,1824,982,15953,4727,8512,13239,5815,3679,2928,2665,2120,1904,19111,35064,61617,61617
Antigua and Barbuda,1968,AG,ATG,AMR,4757,8928,13685,5577,2845,2306,2412,1884,1002,16026,4748,8886,13634,5962,3555,2977,2712,2151,1954,19311,35337,62658,62658
Antigua and Barbuda,1969,AG,ATG,AMR,4769,9268,14037,5778,2644,2306,2424,1974,1013,16139,4763,9243,14006,6179,3420,2997,2759,2194,2015,19564,35703,63742,63742
Antigua and Barbuda,2031,AG,ATG,AMR,2712,5496,8208,6186,6800,7126,6289,5758,6498,38657,2630,5330,7960,6015,6671,7341,6884,6993,9138,43042,81699,97871,97871
Antigua and Barbuda,2032,AG,ATG,AMR,2690,5510,8200,6076,6691,7178,6355,5746,6785,38831,2607,5343,7950,5909,6556,7334,6920,6947,9551,43217,82048,98200,98200
Antigua and Barbuda,2033,AG,ATG,AMR,2665,5536,8201,5912,6652,7188,6443,5729,7062,38986,2582,5367,7949,5748,6513,7306,6975,6871,9957,43370,82356,98507,98507
Antigua and Barbuda,2034,AG,ATG,AMR,2638,5561,8199,5717,6682,7160,6537,5716,7324,39136,2554,5393,7947,5555,6537,7242,7026,6783,10356,43499,82635,98788,98788
Antigua and Barbuda,2035,AG,ATG,AMR,2607,5547,8154,5593,6646,7137,6619,5715,7596,39306,2526,5381,7907,5436,6498,7182,7102,6691,10747,43656,82962,99034,99034
Antigua and Barbuda,2036,AG,ATG,AMR,2573,5513,8086,5532,6557,7149,6688,5709,7867,39502,2495,5345,7840,5376,6410,7144,7165,6604,11122,43821,83323,99245,99245
Antigua and Barbuda,2037,AG,ATG,AMR,2541,5471,8012,5491,6488,7116,6752,5709,8118,39674,2464,5304,7768,5334,6339,7090,7184,6567,11459,43973,83647,99421,99421
Antigua and Barbuda,2038,AG,ATG,AMR,2509,5427,7936,5479,6401,7061,6810,5752,8337,39840,2432,5261,7693,5324,6255,7009,7197,6585,11730,44100,83940,99570,99570
Antigua and Barbuda,2039,AG,ATG,AMR,2475,5383,7858,5484,6309,6979,6852,5831,8528,39983,2400,5217,7617,5330,6165,6904,7224,6616,11990,44229,84212,99689,99689
Antigua and Barbuda,2040,AG,ATG,AMR,2444,5334,7778,5482,6237,6864,6924,5906,8715,40128,2370,5171,7541,5324,6089,6775,7250,6641,12254,44333,84461,99776,99776
Antigua and Barbuda,2041,AG,ATG,AMR,2415,5280,7695,5485,6155,6741,7001,5969,8908,40259,2342,5120,7462,5325,6004,6638,7264,6668,12519,44418,84677,99834,99834
Antigua and Barbuda,2042,AG,ATG,AMR,2387,5224,7611,5497,6047,6635,7055,6041,9097,40372,2316,5066,7382,5336,5896,6524,7258,6706,12762,44482,84854,99850,99850
Antigua and Barbuda,2043,AG,ATG,AMR,2360,5165,7525,5522,5883,6598,7071,6131,9272,40477,2287,5010,7297,5361,5734,6484,7229,6763,12968,44539,85016,99838,99838
Antigua and Barbuda,2044,AG,ATG,AMR,2332,5106,7438,5547,5687,6630,7041,6223,9440,40568,2260,4952,7212,5387,5543,6512,7169,6816,13154,44581,85149,99806,99806
Antigua and Barbuda,2045,AG,ATG,AMR,2307,5046,7353,5536,5564,6595,7025,6309,9621,40650,2236,4893,7129,5376,5424,6473,7110,6892,13333,44608,85258,99743,99743
Antigua and Barbuda,2046,AG,ATG,AMR,2285,4986,7271,5502,5503,6508,7038,6381,9798,40730,2214,4835,7049,5342,5363,6383,7072,6954,13502,44616,85346,99658,99658
Antigua and Barbuda,2047,AG,ATG,AMR,2264,4926,7190,5461,5464,6438,7009,6446,9957,40775,2194,4776,6970,5302,5321,6313,7022,6975,13670,44603,85378,99543,99543
Antigua and Barbuda,2048,AG,ATG,AMR,2245,4865,7110,5418,5456,6357,6954,6505,10130,40820,2175,4716,6891,5260,5311,6229,6941,6997,13845,44583,85403,99397,99397
Antigua and Barbuda,2049,AG,ATG,AMR,2226,4805,7031,5373,5461,6270,6875,6554,10317,40850,2157,4657,6814,5215,5315,6139,6837,7023,14006,44535,85385,99228,99228
Antigua and Barbuda,2050,AG,ATG,AMR,2207,4749,6956,5323,5456,6195,6765,6630,10488,40857,2139,4602,6741,5167,5310,6065,6708,7049,14170,44469,85326,99030,99030
Australia,1970,AU,AUS,WPR,611688,1245299,1856987,1117480,865410,792070,717236,540674,443173,4476043,583748,1184029,1767777,1071616,812110,739586,701541,552368,617014,4494235,8970278,12595034,12595034
Australia,1971,AU,AUS,WPR,634493,1271230,1905723,1149814,919948,800585,741364,553999,458466,4624176,606682,1208972,1815654,1106605,861341,749097,722990,572966,635279,4648278,9272454,12993834,12993834
Australia,1972,AU,AUS,WPR,652040,1285391,1937431,1168939,970736,805180,761720,564709,472135,4743419,624537,1221986,1846523,1127389,909155,754539,739503,588420,653926,4772932,9516351,13300308,13300308
Australia,1973,AU,AUS,WPR,659427,1290880,1950307,1184030,1011031,805403,778737,571739,484062,4835002,631806,1225749,1857555,1143092,949886,756126,751538,598230,671586,4870458,9705460,13513318,13513318
Australia,1974,AU,AUS,WPR,659130,1297014,1956144,1202456,1046265,808325,793739,578934,496500,4926219,630932,1230116,1861048,1162867,987753,760564,761602,608092,689095,4969973,9896192,13713388,13713388
Australia,1975,AU,AUS,WPR,649964,1302661,1952625,1219370,1076861,813637,801889,589552,510105,5011414,621939,1234801,1856740,1181030,1023629,766963,766284,619938,708222,5066066,10077480,13886854,13886854
Australia,1976,AU,AUS,WPR,631696,1308101,1939797,1237915,1103802,821307,802763,602449,525152,5093388,604473,1241668,1846141,1198685,1057227,775669,765112,633005,729051,5158749,10252137,14038072,14038072
Australia,1977,AU,AUS,WPR,611822,1313577,1925399,1259369,1132035,833253,798298,615019,540671,5178645,584518,1251013,1835531,1217626,1091493,789078,759542,646047,750009,5253795,10432440,14193365,14193365
Australia,1978,AU,AUS,WPR,596525,1316120,1912645,1280024,1160372,849910,791599,626615,557476,5265996,568862,1257144,1826006,1235975,1124811,807435,752693,657902,772348,5351164,10617160,14355814,14355814
Australia,1979,AU,AUS,WPR,586022,1316102,1902124,1297423,1185689,872481,784287,637359,575727,5352966,558620,1258728,1817348,1252288,1153534,831647,746028,668513,796083,5448093,10801059,14520527,14520527
Australia,1980,AU,AUS,WPR,581693,1317075,1898768,1310146,1212722,900658,777592,648847,594261,5444226,554486,1260256,1814742,1265860,1181521,860774,740539,679668,820230,5548592,10992818,14706322,14706322
Australia,1981,AU,AUS,WPR,584446,1319776,1904222,1321101,1238945,938679,774536,662735,612126,5548122,557105,1262770,1819875,1277412,1208010,897969,738224,691731,844488,5657834,11205956,14930052,14930052
Australia,1982,AU,AUS,WPR,591711,1321079,1912790,1331316,1255591,988481,775731,679601,628533,5659253,563406,1263054,1826460,1285910,1227360,945087,738985,704341,868253,5769936,11429189,15168445,15168445
Australia,1983,AU,AUS,WPR,599791,1316347,1916138,1338303,1266828,1037260,779459,698697,643604,5764151,570201,1257217,1827418,1290450,1243080,991404,742277,717616,890544,5875371,11639522,15383076,15383076
Australia,1984,AU,AUS,WPR,607105,1305404,1912509,1344564,1279639,1079508,785976,716239,660072,5865998,577386,1245241,1822627,1294384,1259802,1033247,748439,729392,913082,5978346,11844344,15579476,15579476
Australia,1985,AU,AUS,WPR,613613,1291732,1905345,1354256,1296387,1120669,796444,728530,680903,5977189,584331,1230240,1814571,1301832,1278773,1075763,757529,736283,938400,6088580,12065769,15785682,15785682
Australia,1986,AU,AUS,WPR,619088,1277819,1896907,1367375,1318668,1160680,811774,734614,706143,6099254,589706,1214912,1804618,1314459,1301858,1118688,771116,737594,967797,6211512,12310766,16012299,16012299
Australia,1987,AU,AUS,WPR,624136,1268805,1892941,1380043,1344881,1198746,832003,736096,732191,6223960,594620,1204618,1799238,1328739,1328802,1161202,790376,735785,998191,6343095,12567055,16259249,16259249
Australia,1988,AU,AUS,WPR,629929,1268366,1898295,1389865,1372069,1235349,857432,736127,757216,6348058,600340,1203149,1803489,1339995,1356633,1202911,815155,733573,1027798,6476065,12824123,16525903,16525903
Australia,1989,AU,AUS,WPR,637114,1273679,1910793,1397707,1396218,1268025,888901,735728,781505,6468084,606612,1208037,1814649,1347770,1381331,1240956,845725,731640,1055637,6603059,13071143,16796588,16796588
Australia,1990,AU,AUS,WPR,644921,1281552,1926473,1402936,1411127,1295581,924132,734856,806396,6575028,612983,1215362,1828345,1352284,1398550,1274045,880135,729979,1083166,6718159,13293187,17048003,17048003
Australia,1991,AU,AUS,WPR,652082,1290103,1942185,1403353,1416183,1316032,962999,734764,832759,6666090,619334,1223153,1842487,1352163,1407682,1300126,918432,729558,1112362,6820323,13486413,17271086,17271086
Australia,1992,AU,AUS,WPR,657909,1297318,1955227,1398475,1416076,1328178,1006203,736643,858239,6743814,624903,1230602,1855505,1346788,1410505,1318256,961344,731151,1139913,6907957,13651771,17462504,17462504
Australia,1993,AU,AUS,WPR,662003,1303383,1965386,1389646,1413939,1338268,1048883,740870,882215,6813821,628683,1237577,1866260,1337352,1409522,1334110,1004701,734814,1165542,6986041,13799862,17631511,17631511
Australia,1994,AU,AUS,WPR,664258,1311182,1975440,1379162,1413419,1352847,1088653,747857,905041,6886979,630645,1246099,1876744,1326330,1409631,1353142,1046648,741046,1189542,7066339,13953318,17805504,17805504
Australia,1995,AU,AUS,WPR,664392,1321919,1986311,1367983,1416773,1373221,1127650,757879,927547,6971053,630593,1257284,1887877,1315176,1414189,1376524,1089060,749923,1212882,7157754,14128807,18002999,18002999
Australia,1996,AU,AUS,WPR,663317,1332486,1995803,1353455,1422420,1396158,1165964,772329,950260,7060586,629256,1268184,1897440,1301680,1422936,1402379,1131975,762797,1236252,7258019,14318605,18211845,18211845
Australia,1997,AU,AUS,WPR,662008,1340584,2002592,1336085,1425755,1416669,1203243,792682,972044,7146478,627633,1276581,1904214,1285672,1430612,1426690,1175339,780895,1257759,7356967,14503445,18410250,18410250
Australia,1998,AU,AUS,WPR,659637,1348405,2008042,1322841,1424375,1433597,1238461,818571,993009,7230854,625368,1284182,1909550,1273307,1433214,1446985,1217772,803953,1277988,7453219,14684073,18601667,18601667
Australia,1999,AU,AUS,WPR,656352,1357907,2014259,1318467,1421414,1447841,1268426,850039,1013060,7319247,622803,1292559,1915362,1269865,1433426,1463311,1255626,832622,1297176,7552026,14871273,18800892,18800892
Australia,2000,AU,AUS,WPR,653782,1367993,2021775,1324338,1418714,1458635,1294131,885177,1034888,7415883,620966,1301053,1922019,1276699,1433559,1475941,1289768,864961,1317361,7658289,15074172,19017963,19017963
Australia,2001,AU,AUS,WPR,652209,1376476,2028685,1339382,1417469,1466336,1314512,924030,1060019,7521748,619814,1308081,1927895,1291413,1433224,1485351,1317455,902349,1340014,7769806,15291554,19248143,19248143
Australia,2002,AU,AUS,WPR,650914,1382118,2033032,1359154,1419502,1471932,1327721,967795,1085244,7631348,618758,1312383,1931141,1309746,1432813,1491863,1335862,947103,1362940,7880327,15511675,19475844,19475844
Australia,2003,AU,AUS,WPR,650534,1385488,2036022,1380242,1422139,1475758,1341378,1010453,1110441,7740411,618274,1314557,1932831,1329018,1431677,1496387,1353793,992375,1386491,7989741,15730152,19698999,19698999
Australia,2004,AU,AUS,WPR,652130,1387385,2039515,1402260,1423405,1480274,1359370,1048568,1136991,7850868,619064,1315996,1935060,1348253,1428930,1501178,1375511,1034631,1411116,8099619,15950487,19925056,19925056
Australia,2005,AU,AUS,WPR,656739,1388301,2045040,1426052,1425544,1488900,1379592,1084733,1165506,7970327,622677,1317212,1939889,1368587,1426511,1509072,1398945,1076234,1437124,8216473,16186800,20171731,20171731
Australia,2006,AU,AUS,WPR,667568,1389014,2056582,1453869,1433070,1502305,1403007,1119942,1197275,8109468,632751,1318423,1951174,1391372,1428851,1522337,1424890,1116593,1465766,8349809,16459277,20467030,20467030
Australia,2007,AU,AUS,WPR,686611,1390553,2077164,1488176,1453458,1517588,1429165,1155141,1233115,8276643,650664,1320362,1971026,1417756,1443349,1538705,1452761,1155684,1497753,8506008,16782651,20830828,20830828
Australia,2008,AU,AUS,WPR,709511,1394525,2104036,1526550,1490768,1531962,1454981,1189076,1272848,8466185,672247,1324268,1996515,1447587,1473518,1554160,1479720,1192917,1533221,8681123,17147308,21247873,21247873
Australia,2009,AU,AUS,WPR,729977,1400818,2130795,1557619,1535658,1544719,1477102,1218803,1317538,8651439,691848,1330100,2021948,1474179,1512026,1567588,1502726,1226148,1574042,8856709,17508148,21660892,21660892
Australia,2010,AU,AUS,WPR,743140,1409821,2152961,1570456,1575443,1556219,1492763,1246091,1367350,8808322,704535,1338554,2043089,1489308,1549279,1579462,1519582,1257348,1619815,9014794,17823116,22019168,22019168
Australia,2011,AU,AUS,WPR,752569,1423791,2176360,1573562,1613689,1568701,1503448,1269027,1422720,8951147,713507,1351517,2065024,1497530,1587125,1591710,1531929,1285340,1670867,9164501,18115648,22357034,22357034
Australia,2012,AU,AUS,WPR,766462,1442401,2208863,1580888,1657883,1582338,1512774,1284978,1483103,9101964,726522,1368579,2095101,1507952,1631389,1604405,1543512,1308574,1727506,9323338,18425302,22729269,22729269
Australia,2013,AU,AUS,WPR,781052,1464166,2245218,1591747,1701180,1592720,1521527,1300736,1543261,9251171,740214,1388614,2128828,1519549,1678679,1613770,1556305,1333217,1785044,9486564,18737735,23111782,23111782
Australia,2014,AU,AUS,WPR,790586,1487980,2278566,1601376,1737263,1598659,1529265,1319579,1600868,9387010,749394,1410468,2159862,1529146,1724044,1618872,1570134,1361060,1840891,9644147,19031157,23469579,23469579
Australia,2015,AU,AUS,WPR,798314,1513169,2311483,1610048,1769474,1603626,1537403,1339753,1657970,9518274,756775,1433901,2190676,1538094,1767189,1622080,1585476,1389799,1897168,9799806,19318080,23820236,23820236
Australia,2016,AU,AUS,WPR,805987,1540668,2346655,1621924,1800999,1611752,1548000,1362457,1715857,9660989,763731,1460005,2223736,1549208,1808586,1627487,1603236,1419763,1956046,9964326,19625315,24195701,24195701
Australia,2017,AU,AUS,WPR,809486,1571000,2380486,1638021,1832050,1627666,1559209,1387205,1774121,9818272,766423,1488485,2254908,1562148,1846448,1641948,1619268,1449513,2017334,10136659,19954931,24590334,24590334
Australia,2018,AU,AUS,WPR,808180,1601350,2409530,1655852,1862160,1651237,1567658,1410902,1832804,9980613,764413,1517196,2281609,1574420,1878723,1667254,1629663,1476272,2081147,10307479,20288092,24979230,24979230
Australia,2019,AU,AUS,WPR,806440,1625986,2432426,1660304,1899318,1684165,1577815,1431969,1892919,10146490,762270,1541630,2303900,1577338,1909690,1703089,1638751,1498517,2146967,10474352,20620842,25357170,25357170
Australia,2020,AU,AUS,WPR,800286,1643631,2443917,1645220,1933100,1722486,1591007,1448370,1954111,10294294,756380,1559372,2315752,1565185,1930666,1743938,1648322,1514912,2213060,10616083,20910377,25670051,25670051
Australia,2021,AU,AUS,WPR,790274,1654931,2445205,1631499,1950821,1760568,1603872,1460093,2015690,10422543,747199,1570162,2317361,1552890,1935691,1784834,1656634,1526713,2279218,10735980,21158523,25921089,25921089
Australia,2022,AU,AUS,WPR,784864,1658438,2443302,1630068,1961625,1800592,1615862,1469483,2077415,10555045,742643,1573120,2315763,1552350,1935103,1827964,1663898,1536875,2347108,10863298,21418343,26177413,26177413
Australia,2023,AU,AUS,WPR,783426,1657036,2440462,1634360,1969045,1841693,1626105,1478751,2139506,10689460,741898,1571301,2313199,1558405,1931026,1872310,1669162,1547934,2417160,10995997,21685457,26439111,26439111
Australia,2024,AU,AUS,WPR,782277,1654926,2437203,1640182,1972147,1882903,1636029,1489531,2202651,10823443,741263,1568919,2310182,1566683,1922545,1916146,1673695,1560888,2488697,11128654,21952097,26699482,26699482
Australia,2025,AU,AUS,WPR,783522,1649924,2433446,1650636,1967632,1922287,1646481,1502418,2267373,10956827,742730,1563830,2306560,1578744,1908699,1957029,1678516,1575868,2562363,11261219,22218046,26958054,26958054
Australia,2026,AU,AUS,WPR,787223,1642234,2429457,1667791,1954951,1956886,1658123,1517519,2333710,11088980,746497,1556271,2302768,1596108,1889889,1991407,1684418,1593274,2637732,11392828,22481808,27214034,27214034
Australia,2027,AU,AUS,WPR,790154,1634762,2424916,1689523,1937260,1986489,1675006,1531759,2400013,11220050,749480,1549193,2298673,1617088,1869312,2017947,1697013,1609136,2713040,11523536,22743586,27467171,27467171
Australia,2028,AU,AUS,WPR,792391,1627554,2419945,1711773,1916581,2014198,1699549,1543139,2464510,11349750,751753,1542417,2294170,1638594,1848578,2038769,1720115,1620081,2787001,11653138,23002888,27717005,27717005
Australia,2029,AU,AUS,WPR,793552,1621675,2415227,1731288,1893766,2043032,1729831,1553848,2525012,11476777,752996,1536812,2289808,1658216,1827463,2057026,1751760,1628471,2857502,11780438,23257215,27962250,27962250
Australia,2030,AU,AUS,WPR,793682,1615772,2409454,1748045,1873276,2070495,1764527,1565531,2580278,11602152,753245,1531372,2284617,1675091,1809483,2071987,1789597,1636922,2923112,11906192,23508344,28202414,28202414
Australia,1950,AU,AUS,WPR,454782,655017,1109799,609113,653224,601947,468907,372611,304745,3010547,433976,631454,1065430,581594,634119,567837,453176,391677,362984,2991387,6001934,8177167,8177167
Australia,1951,AU,AUS,WPR,472601,693022,1165623,612386,681353,622648,483160,375332,312210,3087089,451148,666681,1117829,579641,649630,586970,459632,397973,375439,3049285,6136374,8419830,8419830
Australia,1952,AU,AUS,WPR,481114,736259,1217373,614553,704053,636795,497283,377329,319842,3149855,459740,706564,1166304,577363,661613,601699,467165,403192,388224,3099256,6249111,8632792,8632792
Australia,1953,AU,AUS,WPR,488470,777581,1266051,614241,720252,644271,510807,378826,328494,3196891,467572,744690,1212262,576221,671184,612032,475792,406862,401870,3143961,6340852,8819165,8819165
Australia,1954,AU,AUS,WPR,497880,816693,1314573,615692,732440,649854,524234,380431,337688,3240339,477254,781002,1258256,578364,679556,621312,484967,410037,415964,3190200,6430539,9003370,9003370
Australia,1955,AU,AUS,WPR,507207,858032,1365239,624149,743237,660081,537957,383540,346726,3295690,486052,819820,1305872,584758,685138,633558,495202,414018,430364,3243038,6538728,9209844,9209844
Australia,1956,AU,AUS,WPR,516724,898530,1415254,639172,749760,674613,552716,388068,355150,3359479,494241,858222,1352463,597242,685991,648584,507939,417939,444916,3302611,6662090,9429810,9429810
Australia,1957,AU,AUS,WPR,526161,936415,1462576,656924,748296,688603,568770,393144,362975,3418712,502280,894712,1396992,616113,682680,663123,523499,420915,459586,3365916,6784628,9644191,9644191
Australia,1958,AU,AUS,WPR,536102,971763,1507865,676740,741816,700143,585447,399300,370027,3473473,511146,928856,1440002,639755,677754,675062,541556,423513,474163,3431803,6905276,9853146,9853146
Australia,1959,AU,AUS,WPR,547589,1002076,1549665,704211,735622,710721,601895,407259,375651,3535359,521660,957493,1479153,668526,672632,684681,561207,426467,487993,3501506,7036865,10065683,10065683
Australia,1960,AU,AUS,WPR,560318,1029261,1589579,739200,731156,722982,616229,417017,380710,3607294,533443,982777,1516220,699470,667885,694518,579645,430500,501538,3573556,7180850,10286647,10286647
Australia,1961,AU,AUS,WPR,572813,1051027,1623840,777764,726878,736808,626912,428042,386171,3682575,545642,1003093,1548735,733804,665272,705243,595105,436036,515334,3650794,7333369,10505938,10505938
Australia,1962,AU,AUS,WPR,583138,1064711,1647849,818393,722253,750912,633898,439800,391837,3757093,555916,1016127,1572043,774224,665377,715642,607313,443395,529011,3734962,7492055,10711941,10711941
Australia,1963,AU,AUS,WPR,590700,1080070,1670770,858358,720347,766289,638316,452101,397336,3832747,562628,1031135,1593763,814051,668218,726345,616707,452502,542273,3820096,7652843,10917375,10917375
Australia,1964,AU,AUS,WPR,595191,1101224,1696415,898143,723118,780596,643173,464904,402443,3912377,566051,1051362,1617413,851705,674404,736238,625912,462451,554704,3905414,7817791,11131609,11131609
Australia,1965,AU,AUS,WPR,596027,1126414,1722441,939676,730406,790010,652582,478224,408194,3999092,566504,1074811,1641315,891529,683664,742684,638472,473457,566788,3996594,7995686,11359442,11359442
Australia,1966,AU,AUS,WPR,593708,1154293,1748001,978978,743828,793514,666165,491682,414447,4088614,564046,1101110,1665156,931131,697514,744293,653556,486525,577883,4090902,8179516,11592675,11592675
Australia,1967,AU,AUS,WPR,589927,1178856,1768783,1014743,763307,792384,679095,504504,420313,4174346,560044,1124460,1684504,968270,716309,741559,666813,501286,587237,4181474,8355820,11809110,11809110
Australia,1968,AU,AUS,WPR,589214,1199949,1789163,1050213,788661,790503,689863,516887,425905,4262032,559793,1143572,1703365,1004290,740250,738073,677194,517481,595412,4272700,8534732,12027262,12027262
Australia,1969,AU,AUS,WPR,595549,1220685,1816234,1083348,821434,789181,700177,528543,432244,4354927,567135,1161541,1728676,1036802,771476,736009,686341,533962,603920,4368510,8723437,12268349,12268349
Australia,2031,AU,AUS,WPR,793145,1610022,2403167,1759964,1862883,2090481,1802521,1577718,2631874,11725441,752845,1526495,2279340,1686573,1801048,2080000,1831215,1645332,2985496,12029664,23755105,28437615,28437615
Australia,2032,AU,AUS,WPR,791810,1607855,2399665,1763793,1863116,2102549,1842382,1589492,2681799,11843131,751692,1525218,2276910,1689859,1802402,2081017,1874625,1652771,3047038,12147712,23990843,28667426,28667426
Australia,2033,AU,AUS,WPR,790095,1608677,2398772,1762451,1867547,2110117,1883207,1600136,2732208,11955666,750172,1526763,2276935,1688074,1808505,2077062,1918770,1658417,3109957,12260785,24216451,28892146,28892146
Australia,2034,AU,AUS,WPR,789111,1608709,2397820,1760398,1873501,2113402,1924147,1610544,2784317,12066309,749315,1527390,2276705,1685723,1816832,2068728,1962417,1663412,3174953,12372065,24438374,29112898,29112898
Australia,2035,AU,AUS,WPR,788881,1610106,2398987,1755456,1884053,2109131,1963311,1621570,2839279,12172800,749163,1529120,2278283,1680667,1828933,2055053,2003150,1668767,3242788,12479358,24652158,29329425,29329425
Australia,2036,AU,AUS,WPR,789209,1613290,2402499,1747831,1901264,2096747,1997776,1633879,2897299,12274796,749519,1532501,2282020,1673149,1846319,2036431,2037451,1675277,3313584,12582211,24857007,29541523,29541523
Australia,2037,AU,AUS,WPR,790813,1614906,2405719,1740428,1923018,2079390,2027340,1651310,2954039,12375525,751062,1534349,2285411,1666107,1867308,2016045,2063998,1688382,3381766,12683606,25059131,29750263,29750263
Australia,2038,AU,AUS,WPR,793338,1615444,2408782,1733291,1945287,2059070,2055057,1676117,3006005,12474827,753498,1535118,2288616,1659373,1888828,1995506,2084894,1711760,3442942,12783303,25258130,29955530,29955530
Australia,2039,AU,AUS,WPR,796041,1615641,2411682,1727479,1964829,2036653,2083891,1706423,3053414,12572689,756126,1535518,2291644,1653806,1908469,1974604,2103260,1743488,3497560,12881187,25453876,30157199,30157199
Australia,2040,AU,AUS,WPR,799261,1615557,2414818,1721647,1981628,2016555,2111372,1740944,3096859,12669005,759226,1535629,2294855,1648405,1925360,1956831,2118364,1781248,3546902,12977110,25646115,30355784,30355784
Australia,2041,AU,AUS,WPR,803001,1615366,2418367,1715967,1993616,2006474,2131459,1778606,3137519,12763641,762814,1535603,2298417,1643567,1936873,1948569,2126569,1822678,3592616,13070872,25834513,30551298,30551298
Australia,2042,AU,AUS,WPR,806901,1615652,2422553,1713860,1997550,2006940,2143713,1818038,3176734,12856835,766564,1536009,2302573,1642324,1940212,1950052,2127831,1865838,3636313,13162570,26019405,30744528,30744528
Australia,2043,AU,AUS,WPR,811143,1616480,2427623,1714732,1996335,2011570,2151530,1858384,3215871,12948422,770630,1536934,2307564,1643895,1938483,1956268,2124161,1909716,3679655,13252178,26200600,30935796,30935796
Australia,2044,AU,AUS,WPR,815632,1618214,2433846,1714819,1994411,2017711,2155130,1898850,3256938,13037859,774922,1538719,2313641,1644547,1936192,1964697,2116160,1953119,3724580,13339295,26377154,31124643,31124643
Australia,2045,AU,AUS,WPR,819810,1621217,2441027,1716263,1989613,2028406,2151280,1937633,3302030,13125225,778928,1541681,2320609,1646307,1931200,1976881,2102867,1993679,3772982,13423916,26549141,31310778,31310778
Australia,2046,AU,AUS,WPR,823494,1625297,2448791,1719482,1982139,2045696,2139418,1971907,3352085,13210727,782478,1545640,2328118,1649711,1923749,1994326,2084658,2027937,3825903,13506284,26717011,31493926,31493926
Australia,2047,AU,AUS,WPR,826387,1630815,2457202,1721136,1974888,2067491,2122645,2001460,3406639,13294259,785249,1550949,2336198,1651582,1916771,2015352,2064694,2054590,3883347,13586336,26880595,31673994,31673994
Australia,2048,AU,AUS,WPR,828131,1637592,2465723,1721717,1967903,2089785,2102972,2029260,3464494,13376131,786908,1557457,2344365,1652377,1910104,2036895,2044581,2075711,3944696,13664364,27040495,31850587,31850587
Australia,2049,AU,AUS,WPR,828861,1644800,2473661,1721953,1962237,2109376,2081268,2058182,3523914,13456930,787594,1564384,2351978,1652802,1904600,2056566,2024121,2094362,4008517,13740968,27197898,32023534,32023534
Australia,2050,AU,AUS,WPR,828803,1652206,2481009,1721916,1956548,2126238,2061881,2085782,3584252,13536617,787543,1571508,2359051,1652939,1899263,2073502,2006786,2109816,4073937,13816243,27352860,32192919,32192919
Austria,1970,AT,AUT,EUR,311212,619191,930403,514204,513745,444889,336653,380436,396773,2586700,297087,591787,888874,496191,491730,445189,461229,512527,652463,3059329,5646029,7465301,7465301
Austria,1971,AT,AUT,EUR,302794,630524,933318,529561,517394,441873,351596,361194,401534,2603152,288434,602154,890588,511146,495669,432384,476415,493235,662627,3071476,5674628,7498541,7498541
Austria,1972,AT,AUT,EUR,292977,639583,932560,539011,533816,439246,371194,339912,405903,2629082,278794,611374,890168,520968,509971,423394,493259,468612,674054,3090258,5719340,7542077,7542077
Austria,1973,AT,AUT,EUR,280515,646529,927044,545450,554256,437169,392936,319498,410050,2659359,267180,618749,885929,527988,526913,418116,508784,444062,685828,3111691,5771050,7584023,7584023
Austria,1974,AT,AUT,EUR,267024,649015,916039,550904,555603,442781,409816,303973,413905,2676982,254594,622015,876609,535205,528684,423918,515904,426143,697543,3127397,5804379,7597030,7597030
Austria,1975,AT,AUT,EUR,254871,644027,898898,555979,538265,455797,417885,295934,416855,2680715,243414,618417,861831,542628,515752,439168,510281,419443,708204,3135476,5816191,7576926,7576926
Austria,1976,AT,AUT,EUR,244209,633935,878144,567927,522253,469720,421234,293433,418951,2693518,233429,609516,842945,555178,503652,454603,497791,420791,716887,3148902,5842420,7563511,7563511
Austria,1977,AT,AUT,EUR,234933,621246,856179,585024,515200,480507,422680,292541,421758,2717710,224239,597725,821964,572161,499307,466015,483310,423799,725914,3170506,5888216,7566358,7566358
Austria,1978,AT,AUT,EUR,227576,604694,832270,600650,512304,487817,422851,291714,423719,2739055,217109,581410,798519,588789,498775,474355,467654,426473,734358,3190404,5929459,7560249,7560249
Austria,1979,AT,AUT,EUR,222296,585638,807934,615108,508728,496207,421143,292158,423673,2757017,211840,562299,774139,604482,497803,484341,451437,429462,740870,3208395,5965412,7547481,7547481
Austria,1980,AT,AUT,EUR,220348,567325,787673,629159,513576,500468,417731,297891,419627,2778452,209733,544005,753738,618333,504746,489982,436138,437103,741400,3227702,6006154,7547561,7547561
Austria,1981,AT,AUT,EUR,222678,550173,772851,642066,525769,504161,413938,310932,409289,2806155,212048,526728,738776,628388,518531,494236,423568,451708,732098,3248529,6054684,7566316,7566316
Austria,1982,AT,AUT,EUR,226488,530396,756884,650093,530757,515069,409277,327178,395725,2828099,216145,507317,723462,633448,525341,505609,413971,466928,717542,3262839,6090938,7571289,7571289
Austria,1983,AT,AUT,EUR,229631,508037,737668,654263,531600,526505,404760,344589,382139,2843856,219535,486294,705829,635844,527591,518265,407572,480500,701976,3271748,6115604,7559110,7559110
Austria,1984,AT,AUT,EUR,232084,488571,720655,656510,537889,525945,410643,358884,373748,2863619,222127,467552,689679,636892,534312,518674,413280,487099,694353,3284610,6148229,7558563,7558563
Austria,1985,AT,AUT,EUR,232368,475076,707444,653723,548791,513771,426750,366780,372517,2882332,222535,453862,676397,633594,544777,507265,429535,482402,698369,3295942,6178274,7562114,7562114
Austria,1986,AT,AUT,EUR,230324,466854,697178,645783,564110,501559,442686,370283,375380,2899801,220362,445326,665688,625357,558573,495834,445509,471172,708139,3304584,6204385,7567248,7567248
Austria,1987,AT,AUT,EUR,227533,461694,689227,632703,581160,495843,453640,371593,380153,2915092,217080,440147,657227,611925,573777,490823,456632,457944,719738,3310839,6225931,7572380,7572380
Austria,1988,AT,AUT,EUR,226100,459331,685431,616257,599283,495276,461722,371988,385089,2929615,214834,437743,652577,595223,589471,491036,464885,443924,731593,3316132,6245747,7583761,7583761
Austria,1989,AT,AUT,EUR,226906,459321,686227,601402,621741,496914,471627,370959,389770,2952413,215023,437130,652153,580623,607801,492811,475084,429449,742829,3328597,6281010,7619391,7619391
Austria,1990,AT,AUT,EUR,229290,461145,690435,589111,646825,508677,477108,368452,394958,2985131,217227,437894,655121,568632,626996,503287,480989,415679,752457,3348040,6333171,7678729,7678729
Austria,1991,AT,AUT,EUR,233704,465840,699544,576385,670756,527087,481613,365558,400453,3021852,221475,441797,663272,556836,644694,520302,485754,404279,759103,3370968,6392820,7755638,7755638
Austria,1992,AT,AUT,EUR,239072,472988,712060,562279,691093,540229,494641,362765,406643,3057650,226285,448829,675114,544521,660874,532363,499079,396425,762735,3395997,6453647,7840816,7840816
Austria,1993,AT,AUT,EUR,242348,479158,721506,544901,706143,550296,508727,360688,414478,3085233,229726,454958,684684,529284,673659,540390,513645,391789,765087,3413854,6499087,7905278,7905278
Austria,1994,AT,AUT,EUR,242870,482608,725478,525348,711942,561178,510255,368192,423237,3100152,230704,458837,689541,510789,679714,549473,514935,398068,767220,3420199,6520351,7935365,7935365
Austria,1995,AT,AUT,EUR,241564,483669,725233,509265,707459,573563,500768,385259,432122,3108436,229692,460977,690669,495365,678263,561059,504573,414416,769279,3422955,6531391,7947296,7947296
Austria,1996,AT,AUT,EUR,238365,483827,722192,498120,696864,589805,491042,401637,440466,3117934,226948,461738,688686,485093,672340,576458,494426,430182,770726,3429225,6547159,7958041,7958041
Austria,1997,AT,AUT,EUR,233136,483917,717053,490395,682209,608026,487288,412976,447860,3128754,222315,461146,683461,477556,663322,593668,490848,440969,771466,3437829,6566583,7967093,7967093
Austria,1998,AT,AUT,EUR,226799,484340,711139,486446,663514,626323,488391,421701,454304,3140679,216467,460881,677348,472699,649694,611106,492317,449204,771682,3446702,6587381,7975862,7975862
Austria,1999,AT,AUT,EUR,220468,485205,705673,485388,643122,645225,490639,431832,459932,3156138,210239,461487,671726,470193,633833,629012,494637,459404,770765,3457844,6613982,7991377,7991377
Austria,2000,AT,AUT,EUR,214824,484810,699634,485727,622985,662487,500628,437362,465452,3174641,204666,461185,665851,469047,617488,644961,504453,465164,769201,3470314,6644955,8010428,8010428
Austria,2001,AT,AUT,EUR,209021,484029,693050,488494,604075,677151,515868,442258,472143,3199989,198711,460731,659442,470479,600544,657805,519850,469715,768750,3487143,6687132,8039626,8039626
Austria,2002,AT,AUT,EUR,204843,483342,688185,494670,586823,689260,525281,454299,478702,3229035,194402,459958,654360,475942,584071,668460,529149,481662,768128,3507412,6736447,8078992,8078992
Austria,2003,AT,AUT,EUR,203331,480704,684035,502460,570145,699515,531477,466900,486063,3256560,192869,457668,650537,483707,568600,678326,535175,494917,768243,3528968,6785528,8120104,8120104
Austria,2004,AT,AUT,EUR,203488,476452,679940,510180,556802,707246,541727,468839,503621,3288415,192820,453682,646502,492081,555457,686729,545315,496791,779986,3556359,6844774,8171217,8171217
Austria,2005,AT,AUT,EUR,204323,471326,675649,516013,549950,709504,556747,461249,530108,3323571,193705,448464,642169,498245,547230,690650,559499,488216,801802,3585642,6909213,8227034,8227034
Austria,2006,AT,AUT,EUR,204389,463983,668372,517935,545964,705295,575459,453746,554995,3353394,194444,441138,635582,500140,542754,689020,576649,479704,822154,3610421,6963815,8267763,8267763
Austria,2007,AT,AUT,EUR,203525,455388,658913,518175,543217,695333,595188,451106,573923,3376942,194187,433156,627343,500364,540434,682596,594767,476803,836553,3631517,7008459,8294722,8294722
Austria,2008,AT,AUT,EUR,202778,447220,649998,519271,542956,680518,614855,452815,589071,3399486,193414,425774,619188,501351,540159,671633,613441,478828,847047,3652459,7051945,8321131,8321131
Austria,2009,AT,AUT,EUR,202038,439872,641910,520076,543032,662461,634702,455640,603592,3419503,192603,418652,611255,501613,539877,657544,632350,481705,857183,3670272,7089775,8342935,8342935
Austria,2010,AT,AUT,EUR,201293,433798,635091,519289,543582,643730,652642,465232,612773,3437248,191802,412897,604699,500465,540088,642548,648835,491789,862064,3685789,7123037,8362829,8362829
Austria,2011,AT,AUT,EUR,201820,428126,629946,518926,546976,625410,667133,479180,620753,3458378,191636,407701,599337,499145,542871,627032,661769,507021,865698,3703536,7161914,8391200,8391200
Austria,2012,AT,AUT,EUR,203253,423268,626521,519988,553621,607612,679068,488521,635410,3484220,192050,403191,595241,498568,548504,611481,672529,516605,875962,3723649,7207869,8429637,8429637
Austria,2013,AT,AUT,EUR,204989,420551,625540,519336,563576,591752,690551,496323,652304,3513842,193220,400365,593585,497439,556632,596795,683099,523328,889282,3746575,7260417,8479539,8479539
Austria,2014,AT,AUT,EUR,207488,420003,627491,517669,576375,580750,699774,507895,667824,3550287,195285,399684,594969,494513,566842,584333,692019,533540,902075,3773322,7323609,8546066,8546066
Austria,2015,AT,AUT,EUR,212098,423225,635323,522441,592211,577512,704002,523537,681379,3601082,198987,402157,601144,492336,577629,577807,696804,547613,912682,3804871,7405953,8642421,8642421
Austria,2016,AT,AUT,EUR,217242,428310,645552,524917,605026,578448,702590,542760,693176,3646917,203670,406116,609786,488333,585650,576557,696915,565002,921774,3834231,7481148,8736487,8736487
Austria,2017,AT,AUT,EUR,221155,431216,652371,517111,610820,579924,696145,564046,705065,3673111,207700,408346,616046,481300,589134,577429,693072,584032,930994,3855961,7529072,8797496,8797496
Austria,2018,AT,AUT,EUR,223406,432819,656225,506081,614114,583482,685282,585603,717018,3691580,210194,409480,619674,473716,590680,579595,684862,603556,940625,3873034,7564614,8840513,8840513
Austria,2019,AT,AUT,EUR,224102,434558,658660,495969,616350,588235,672082,607298,729360,3709294,211416,410860,622276,466729,591635,582468,673935,623324,951619,3889710,7599004,8879940,8879940
Austria,2020,AT,AUT,EUR,223252,436434,659686,486752,616172,593001,657973,627049,742219,3723166,211194,412127,623321,459272,590754,585263,661781,640964,963563,3901597,7624763,8907777,8907777
Austria,2021,AT,AUT,EUR,221240,438799,660039,476544,614197,598516,642293,642920,756607,3731077,209611,413840,623451,450182,588301,588929,647500,654666,977950,3907528,7638605,8922082,8922082
Austria,2022,AT,AUT,EUR,218927,442177,661104,467127,610822,605235,625867,656070,774981,3740102,207751,416491,624242,441941,584250,594167,632139,665980,995690,3914167,7654269,8939617,8939617
Austria,2023,AT,AUT,EUR,217251,444627,661878,460024,604302,612824,609739,668078,795784,3750751,206358,418888,625246,435694,577376,599940,616619,676635,1014822,3921086,7671837,8958960,8958960
Austria,2024,AT,AUT,EUR,216807,445663,662470,454833,595245,620035,595814,676905,818047,3760879,205801,420246,626047,431562,567631,605975,602091,685029,1035461,3927749,7688628,8977139,8977139
Austria,2025,AT,AUT,EUR,216867,445938,662805,451278,584324,625120,587560,679878,842397,3770557,205754,420537,626291,429114,556188,610372,592156,688653,1057988,3934471,7705028,8994123,8994123
Austria,2026,AT,AUT,EUR,216327,446086,662413,449992,570787,628746,584553,677511,868646,3780235,205173,421078,626251,428274,542965,612316,587538,687424,1082401,3940918,7721153,9009822,9009822
Austria,2027,AT,AUT,EUR,215085,446459,661544,449760,556175,631729,584298,670887,896646,3789495,203945,422038,625983,427928,529298,612611,585936,682626,1108413,3946812,7736307,9023827,9023827
Austria,2028,AT,AUT,EUR,213494,446690,660184,449681,542387,634042,586622,660002,925578,3798312,202399,422668,625067,427743,516441,612741,586223,673575,1135766,3952489,7750801,9036044,9036044
Austria,2029,AT,AUT,EUR,211656,446201,657857,450074,529910,635387,590172,646761,954790,3807094,200626,422583,623209,428049,504647,612492,587481,661757,1163738,3958164,7765258,9046322,9046322
Austria,2030,AT,AUT,EUR,209535,444680,654215,451190,519258,634640,594350,633117,983592,3816147,198589,421596,620185,428700,494754,610841,589423,649334,1190967,3964019,7780166,9054576,9054576
Austria,1950,AT,AUT,EUR,263900,540131,804031,475119,373927,465698,475125,322676,303377,2415922,252230,522810,775040,474818,496077,572722,550243,428475,419107,2941442,5357364,6936440,6936440
Austria,1951,AT,AUT,EUR,266151,542382,808533,466081,384248,441468,481143,326752,307035,2406727,254520,524012,778532,457850,508121,551045,554680,435191,429750,2936637,5343364,6930431,6930431
Austria,1952,AT,AUT,EUR,261752,551858,813610,457124,401839,414612,484388,332171,310535,2400669,250811,531282,782093,443680,522810,523136,558618,441763,440636,2930643,5331312,6927015,6927015
Austria,1953,AT,AUT,EUR,254015,563857,817872,450004,423226,388324,485287,338944,314281,2400066,243587,541742,785329,434639,537080,494340,561724,448852,451893,2928528,5328594,6931794,6931794
Austria,1954,AT,AUT,EUR,249838,560354,810192,455400,440349,367653,484238,347609,317544,2412793,239543,538158,777701,438910,543000,473203,564051,456742,463046,2938952,5351745,6939642,6939642
Austria,1955,AT,AUT,EUR,249723,542242,791965,472306,448304,355862,481073,358190,319609,2435344,239445,520755,760200,454363,535171,464214,565913,466497,472595,2958753,5394097,6946260,6946260
Austria,1956,AT,AUT,EUR,254379,523348,777727,488173,449607,350057,474803,368983,321648,2453271,244167,502472,746639,468836,518875,462917,565294,476349,481847,2974118,5427389,6951739,6951739
Austria,1957,AT,AUT,EUR,262460,511431,773891,499590,448472,346011,467027,379787,323989,2464876,251955,490887,742842,479220,500614,463358,563348,485186,491988,2983714,5448590,6965319,6965319
Austria,1958,AT,AUT,EUR,271294,504735,776029,509332,446623,342640,459252,390036,326508,2474391,260413,484297,744710,488179,481805,464154,561520,493156,502844,2991658,5466049,6986787,6986787
Austria,1959,AT,AUT,EUR,281270,499058,780328,521174,443507,341435,449436,399100,329801,2484453,269695,478482,748177,499386,462931,465431,558162,499768,514960,3000638,5485091,7013596,7013596
Austria,1960,AT,AUT,EUR,291656,501850,793506,528048,439488,347370,433862,407026,332938,2488732,279263,480764,760027,505993,445545,472240,547976,505067,527463,3004284,5493016,7046553,7046553
Austria,1961,AT,AUT,EUR,301039,510814,811853,531441,435103,362127,411646,412645,337548,2490510,287588,490044,777632,509309,431267,486973,526826,509790,541262,3005427,5495937,7085435,7085435
Austria,1962,AT,AUT,EUR,309372,515739,825111,541220,431053,382059,387129,415734,343073,2500268,294987,495805,790792,518844,421265,503383,499981,514487,554832,3012792,5513060,7128967,7128967
Austria,1963,AT,AUT,EUR,317107,519363,836470,551838,428483,404718,363449,416828,348375,2513691,302721,499645,802366,529503,415434,518650,473177,518233,567346,3022343,5536034,7174868,7174868
Austria,1964,AT,AUT,EUR,323480,527300,850780,547877,437100,423592,345003,416485,355532,2525589,309518,507146,816664,526193,421954,525731,453697,521329,580964,3029868,5555457,7222900,7222900
Austria,1965,AT,AUT,EUR,327110,539327,866437,531472,457338,435013,335451,414632,362963,2536869,313513,518202,831715,510571,439562,520252,446357,523974,594141,3034857,5571726,7269888,7269888
Austria,1966,AT,AUT,EUR,327725,555034,882759,516788,477854,441835,332490,410802,370874,2550643,314493,532197,846690,496625,457353,507877,447178,524712,607079,3040824,5591467,7320913,7320913
Austria,1967,AT,AUT,EUR,326283,572860,899143,510006,492785,446468,331297,406153,379464,2566173,313349,548025,861374,489246,470078,493405,451057,524606,620548,3048940,5615113,7375630,7375630
Austria,1968,AT,AUT,EUR,323515,589556,913071,507217,501396,448367,330024,400805,386267,2574076,309961,563740,873701,487557,478376,477406,453128,524112,632377,3052956,5627032,7413808,7413808
Austria,1969,AT,AUT,EUR,318467,605337,923804,505372,509842,447499,330144,393336,391733,2577926,304421,578962,883383,487860,487367,460752,453826,521553,642852,3054210,5632136,7439324,7439324
Austria,2031,AT,AUT,EUR,207156,442136,649292,453577,509124,632745,600005,618601,1011431,3825483,196316,419439,615755,430411,485659,608393,593150,635553,1217165,3970331,7795814,9060869,9060869
Austria,2032,AT,AUT,EUR,204752,438596,643348,456972,499800,629473,606833,603408,1038446,3834932,194020,416365,610385,433070,477434,604369,598426,620784,1242568,3976651,7811583,9065311,9065311
Austria,2033,AT,AUT,EUR,202351,435340,637691,459435,492778,623074,614475,588532,1064869,3843163,191727,413430,605157,435472,471214,597548,604229,605887,1267579,3981929,7825092,9067937,9067937
Austria,2034,AT,AUT,EUR,200051,433067,633118,460487,487653,614147,621741,575782,1089591,3849401,189536,411104,600640,436837,467101,587864,610296,591981,1291639,3985718,7835119,9068871,9068871
Austria,2035,AT,AUT,EUR,197961,431012,628973,460776,484153,603357,626914,568464,1110770,3854434,187544,409030,596574,437137,464673,576489,614739,582573,1312755,3988366,7842800,9068346,9068346
Austria,2036,AT,AUT,EUR,196048,428101,624149,460940,482912,589966,630663,566165,1128766,3859412,185722,406176,591898,437682,463851,563337,616759,578371,1331000,3991000,7850412,9066453,9066453
Austria,2037,AT,AUT,EUR,194284,424463,618747,461326,482718,575505,633773,566474,1144455,3864251,184038,402660,586698,438649,463518,549741,617149,577108,1347370,3993535,7857786,9063229,9063229
Austria,2038,AT,AUT,EUR,192753,420480,613233,461567,482672,561857,636206,569186,1157069,3868557,182576,398827,581403,439284,463346,536959,617370,577671,1361013,3995643,7864200,9058835,9058835
Austria,2039,AT,AUT,EUR,191506,416348,607854,461090,483097,549513,637671,573027,1167784,3872182,181384,394868,576252,439203,463670,525235,617204,579157,1372708,3997177,7869359,9053460,9053460
Austria,2040,AT,AUT,EUR,190495,412143,602638,459587,484242,538979,637052,577452,1177759,3875071,180418,390843,571261,438224,464334,515403,615645,581294,1383167,3998067,7873138,9047040,9047040
Austria,2041,AT,AUT,EUR,189768,407859,597627,457058,486656,528960,635291,583250,1185952,3877167,179728,386755,566483,436078,466055,506367,613284,585154,1391408,3998346,7875513,9039623,9039623
Austria,2042,AT,AUT,EUR,189351,403698,593049,453537,490069,519740,632165,590127,1192633,3878271,179342,382778,562120,433010,468719,498198,609356,590508,1398004,3997795,7876066,9031238,9031238
Austria,2043,AT,AUT,EUR,189192,399771,588963,450300,492553,512803,625936,597780,1198901,3878273,179206,379027,558233,430089,471134,492023,602645,596376,1404035,3996302,7874575,9021774,9021774
Austria,2044,AT,AUT,EUR,189266,396230,585496,448039,493625,507755,617209,605067,1205417,3877112,179287,375648,554935,427771,472507,487952,593094,602501,1409988,3993813,7870925,9011355,9011355
Austria,2045,AT,AUT,EUR,189586,393135,582721,445997,493941,504320,606636,610368,1213501,3874763,179592,372697,552289,425700,472819,485560,581861,607047,1417209,3990196,7864959,8999968,8999968
Austria,2046,AT,AUT,EUR,190058,390499,580557,443100,494127,503126,593493,614335,1223021,3871202,180041,370191,550232,422858,473373,484763,568862,609239,1426335,3985430,7856632,8987428,8987428
Austria,2047,AT,AUT,EUR,190620,388322,578942,439476,494539,502975,579295,617684,1232459,3866428,180568,368121,548689,419346,474350,484457,555426,609843,1436101,3979523,7845951,8973593,8973593
Austria,2048,AT,AUT,EUR,191247,386636,577883,435508,494806,502969,565906,620347,1240935,3860471,181146,366520,547666,415523,474999,484308,542797,610259,1444479,3972365,7832836,8958386,8958386
Austria,2049,AT,AUT,EUR,191848,385468,577316,431392,494354,503432,553802,622037,1248382,3853399,181701,365418,547119,411568,474925,484653,531218,610285,1451403,3964052,7817451,8941895,8941895
Austria,2050,AT,AUT,EUR,192378,384774,577152,427199,492875,504610,543486,621689,1255471,3845330,182202,364760,546962,407556,473964,485337,521520,608921,1457443,3954741,7800071,8924190,8924190
Azerbaijan,1970,AZ,AZE,EUR,418437,825714,1244151,448458,314083,310131,134329,91305,74816,1373122,398039,794609,1192648,440591,341669,340434,190055,148318,154337,1615404,2988526,5425317,5425317
Azerbaijan,1971,AZ,AZE,EUR,406656,844287,1250943,491785,291136,324305,145713,90622,75528,1419089,386706,812166,1198872,483067,315983,355521,200075,147758,157905,1660309,3079398,5529211,5529211
Azerbaijan,1972,AZ,AZE,EUR,396687,855651,1252338,532564,274543,336874,158925,89629,76487,1469022,377110,822779,1199889,522706,295967,370074,211636,147229,161479,1709091,3178113,5630344,5630344
Azerbaijan,1973,AZ,AZE,EUR,388749,859726,1248475,570475,266868,345856,173709,88484,77726,1523118,369472,826361,1195833,558925,283888,382623,224394,146904,164902,1761636,3284754,5729065,5729065
Azerbaijan,1974,AZ,AZE,EUR,382775,857639,1240414,607318,267316,350259,189558,87436,79086,1580973,363714,824031,1187745,593859,279349,391554,237897,146976,168213,1817848,3398821,5826984,5826984
Azerbaijan,1975,AZ,AZE,EUR,378947,850066,1229013,643313,274824,350871,205855,86971,80433,1642267,360006,816430,1176436,628175,282700,395580,251865,147620,171355,1877295,3519562,5925012,5925012
Azerbaijan,1976,AZ,AZE,EUR,373726,829836,1203562,676039,287655,350104,224822,88374,85903,1712897,358231,801951,1160182,662153,294818,391256,267060,151097,178426,1944810,3657707,6021448,6021448
Azerbaijan,1977,AZ,AZE,EUR,367190,798504,1165694,706024,303941,346770,246535,91013,95907,1790190,358587,782762,1141349,695837,314102,379547,282046,156990,189997,2018519,3808709,6115755,6115755
Azerbaijan,1978,AZ,AZE,EUR,363952,765684,1129636,735662,323283,336770,268632,93532,106689,1864568,360253,763423,1123676,728642,339490,362999,293636,163217,202775,2090759,3955327,6208636,6208636
Azerbaijan,1979,AZ,AZE,EUR,367663,741966,1109629,761678,348583,317823,286123,97452,111728,1923387,363320,747166,1110486,756503,371117,343558,302547,169235,210746,2153706,4077093,6297208,6297208
Azerbaijan,1980,AZ,AZE,EUR,377069,728856,1105925,780802,378950,294221,298141,104468,110240,1966822,368437,734582,1103019,776512,407005,323560,312502,175465,212252,2207296,4174118,6383060,6383060
Azerbaijan,1981,AZ,AZE,EUR,388550,717424,1105974,793774,409890,272737,309133,114746,107975,2008255,375120,723987,1099107,789979,443907,304244,325190,183877,211990,2259187,4267442,6472524,6472524
Azerbaijan,1982,AZ,AZE,EUR,402825,709726,1112551,798616,440315,255457,318512,127873,105303,2046076,384431,717344,1101775,795230,479591,288068,338249,194856,211121,2307115,4353191,6567522,6567522
Azerbaijan,1983,AZ,AZE,EUR,418763,705157,1123920,796060,472908,242602,324531,143615,102846,2082562,397464,711189,1108653,795306,514710,275958,348683,207796,211418,2353871,4436433,6669007,6669007
Azerbaijan,1984,AZ,AZE,EUR,435087,705338,1140425,785565,510035,234416,326265,160703,100767,2117751,412806,707552,1120358,790900,550213,268732,355382,221251,212212,2398690,4516441,6777225,6777225
Azerbaijan,1985,AZ,AZE,EUR,451943,710363,1162306,769052,549472,232082,324370,176976,99017,2150969,428707,708736,1137443,781483,586406,267939,358536,233595,212460,2440419,4591388,6891140,6891140
Azerbaijan,1986,AZ,AZE,EUR,467978,720014,1187992,751740,586316,236598,318985,191284,97758,2182681,443856,714411,1158267,768960,621872,274686,358043,244290,212327,2480178,4662859,7009127,7009127
Azerbaijan,1987,AZ,AZE,EUR,483458,734808,1218266,734775,619720,248299,308083,204346,97252,2212475,458547,724838,1183385,754637,655454,289738,351660,254021,213046,2518556,4731031,7132685,7132685
Azerbaijan,1988,AZ,AZE,EUR,497614,753361,1250975,719171,651781,267343,290933,216817,98095,2244140,472008,738233,1210241,739757,686517,312833,338048,262637,216003,2555795,4799935,7261151,7261151
Azerbaijan,1989,AZ,AZE,EUR,506105,775503,1281608,699617,673500,290050,268755,227399,100297,2259618,479982,755056,1235038,718496,705867,339879,318715,269688,219961,2572606,4832224,7348874,7348874
Azerbaijan,1990,AZ,AZE,EUR,508574,800230,1308804,683031,687653,316798,245922,236431,104137,2273972,482148,774681,1256829,699549,717656,371278,297792,277919,224036,2588230,4862202,7427836,7427836
Azerbaijan,1991,AZ,AZE,EUR,507616,827088,1334704,674035,702030,347370,226597,245069,109726,2304827,480955,796086,1277041,689444,729089,406449,278801,289140,228778,2621701,4926528,7538267,7538267
Azerbaijan,1992,AZ,AZE,EUR,501683,855970,1357653,668614,708589,377650,211391,252157,116572,2334973,474726,819453,1294179,683821,732838,440574,263058,300858,235378,2656527,4991500,7643338,7643338
Azerbaijan,1993,AZ,AZE,EUR,490182,885144,1375326,666026,707915,410075,200443,256308,124898,2365665,462780,845279,1308059,678961,731778,474195,251350,310294,244479,2691057,5056722,7740107,7740107
Azerbaijan,1994,AZ,AZE,EUR,476255,904037,1380292,665305,698195,447558,195783,257206,134284,2398331,450126,867605,1317731,680093,730480,506333,243301,313917,251402,2725526,5123857,7821880,7821880
Azerbaijan,1995,AZ,AZE,EUR,461530,912386,1373916,665874,681814,486485,198668,255385,143411,2431637,438194,883833,1322027,688740,729046,537809,240429,311701,254020,2761745,5193382,7889330,7889330
Azerbaijan,1996,AZ,AZE,EUR,445150,917365,1362515,668639,665822,520967,208139,250892,151621,2466080,423752,896383,1320135,699163,726534,569849,244591,305925,254297,2800359,5266439,7949101,7949101
Azerbaijan,1997,AZ,AZE,EUR,427253,918954,1346207,675116,649700,550429,223996,242615,159458,2501314,406224,905828,1312052,712115,722852,601286,255823,295215,253197,2840488,5341802,8000061,8000061
Azerbaijan,1998,AZ,AZE,EUR,407629,917306,1324935,684472,633502,575348,245681,230292,167447,2536742,385088,912126,1297214,726552,718956,632141,273672,279041,251849,2882211,5418953,8041096,8041096
Azerbaijan,1999,AZ,AZE,EUR,389164,916134,1305298,703125,621469,597724,271084,215358,175632,2584392,362460,913913,1276373,743677,712399,662136,299040,262035,256093,2935380,5519772,8101449,8101449
Azerbaijan,2000,AZ,AZE,EUR,375056,912738,1287794,730789,616652,618052,299080,200179,184572,2649324,342431,908267,1250698,763716,705237,689142,330488,246496,267444,3002523,5651847,8190337,8190337
Azerbaijan,2001,AZ,AZE,EUR,364426,901912,1266338,760081,616380,633628,328884,187269,194414,2720656,326428,894252,1220680,785757,701194,710278,363883,231963,281268,3074343,5794999,8282023,8282023
Azerbaijan,2002,AZ,AZE,EUR,356771,885980,1242751,788894,619308,643698,358964,178253,204461,2793578,314877,873403,1188280,808367,699570,725042,397676,220598,296261,3147514,5941092,8372127,8372127
Azerbaijan,2003,AZ,AZE,EUR,352779,866442,1219221,816605,624016,648958,389910,173502,213634,2866625,308529,847123,1155652,830734,699030,734637,432417,213325,310680,3220823,6087448,8462322,8462322
Azerbaijan,2004,AZ,AZE,EUR,352597,844378,1196975,844961,631065,649945,422172,173029,221061,2942233,307752,817980,1125732,856705,698021,736993,468075,210157,321272,3291223,6233456,8556164,8556164
Azerbaijan,2005,AZ,AZE,EUR,356967,820657,1177624,872121,642459,647329,454883,177239,226237,3020268,312136,787364,1099500,885557,698860,732098,503596,212083,326642,3358836,6379104,8656237,8656237
Azerbaijan,2006,AZ,AZE,EUR,367885,795749,1163634,893682,659372,642620,486586,186230,228274,3096764,321597,755897,1077494,910859,705336,723777,537764,220202,327523,3425461,6522225,8763353,8763353
Azerbaijan,2007,AZ,AZE,EUR,384860,771136,1155996,909457,681833,636999,516268,199939,226670,3171166,335478,726352,1061830,930213,718211,713366,569472,234595,323569,3489426,6660592,8878411,8878411
Azerbaijan,2008,AZ,AZE,EUR,405044,748607,1153651,920097,708669,631475,543270,218073,222153,3243737,351441,700881,1052322,942278,737676,701891,598151,254688,315302,3549986,6793723,8999696,8999696
Azerbaijan,2009,AZ,AZE,EUR,424742,731145,1155887,923967,735356,626057,566977,239348,216398,3308103,367001,679480,1046481,943069,761476,692156,625215,279260,307978,3609154,6917257,9119628,9119628
Azerbaijan,2010,AZ,AZE,EUR,442009,721474,1163483,920241,760727,621584,586630,262712,211043,3362937,381274,663466,1044740,932716,787471,685067,649976,306879,303939,3666048,7028985,9237202,9237202
Azerbaijan,2011,AZ,AZE,EUR,457410,720703,1178113,909524,787053,619637,601564,287885,207364,3413027,394657,655596,1050253,914879,815168,679556,669681,336438,301893,3717615,7130642,9359014,9359014
Azerbaijan,2012,AZ,AZE,EUR,471368,728732,1200100,891979,813128,620467,611775,314488,206158,3457995,407070,656325,1063395,890003,843183,676172,684161,367413,303157,3764089,7222084,9485576,9485576
Azerbaijan,2013,AZ,AZE,EUR,482760,744250,1227010,869712,837555,624285,617580,342461,207542,3499135,417578,664373,1081951,860044,869915,675432,693672,399635,307687,3806385,7305520,9614478,9614478
Azerbaijan,2014,AZ,AZE,EUR,490712,764991,1255703,845024,858973,631289,619454,371631,211369,3537740,425397,677556,1102953,827411,893729,677967,698643,432934,314804,3845488,7383228,9741880,9741880
Azerbaijan,2015,AZ,AZE,EUR,493937,789677,1283614,818971,876654,641803,618000,401195,217257,3573880,429320,694847,1124167,793509,913446,684465,699559,466795,324049,3881823,7455703,9863480,9863480
Azerbaijan,2016,AZ,AZE,EUR,489639,818654,1308293,792237,890833,656122,613938,430135,224692,3607957,426828,716554,1143382,759680,928237,695448,697032,500538,335677,3916612,7524569,9976248,9976248
Azerbaijan,2017,AZ,AZE,EUR,473615,850847,1324462,766122,901687,674065,608205,457622,233609,3641310,414047,741511,1155558,727922,937433,710924,691739,533219,348998,3950235,7591545,10071567,10071567
Azerbaijan,2018,AZ,AZE,EUR,449000,882746,1331746,743112,909022,695188,602023,482889,244424,3676658,393623,766757,1160380,700063,940859,730540,684688,563844,363748,3983742,7660400,10152522,10152522
Azerbaijan,2019,AZ,AZE,EUR,424526,910653,1335179,725890,911713,718735,596583,505267,257724,3715912,373219,789790,1163009,677443,937870,753680,677208,591540,380903,4018644,7734556,10232753,10232753
Azerbaijan,2020,AZ,AZE,EUR,399577,931444,1331021,716031,907232,742826,590979,520021,269561,3746650,352261,808152,1160413,661526,927431,779168,669622,613083,396031,4046861,7793511,10284951,10284951
Azerbaijan,2021,AZ,AZE,EUR,374377,942857,1317234,715191,895779,767410,586400,527075,280139,3771994,330949,819193,1150142,653767,909505,806191,663126,628491,412537,4073617,7845611,10312992,10312992
Azerbaijan,2022,AZ,AZE,EUR,356256,941074,1297330,723534,878524,792754,586654,534125,297923,3813514,315788,818986,1134774,654555,884712,833864,659649,641381,438290,4112451,7925965,10358074,10358074
Azerbaijan,2023,AZ,AZE,EUR,343845,928069,1271914,739108,856451,816759,591339,541003,322717,3867377,305668,809183,1114851,662557,854828,860358,659309,651214,470243,4158509,8025886,10412651,10412651
Azerbaijan,2024,AZ,AZE,EUR,330211,911730,1241941,759852,832079,837860,599049,544453,350039,3923332,294511,796696,1091207,675681,822336,884004,662177,656824,505393,4206415,8129747,10462904,10462904
Azerbaijan,2025,AZ,AZE,EUR,318406,890214,1208620,784490,806530,855461,610139,545004,378923,3980547,284972,779785,1064757,692907,788656,903639,668945,658631,542829,4255607,8236154,10509535,10509535
Azerbaijan,2026,AZ,AZE,EUR,311232,860922,1172154,813349,780262,869556,624763,543178,408121,4039229,279544,756083,1035627,714522,755003,918320,680051,657074,581349,4306319,8345548,10553323,10553323
Azerbaijan,2027,AZ,AZE,EUR,306152,826968,1133120,845364,754585,880314,642714,539697,436577,4099251,276029,728250,1004279,739372,723400,927421,695512,652824,619916,4358445,8457696,10595099,10595099
Azerbaijan,2028,AZ,AZE,EUR,302925,790142,1093067,877060,731896,887459,663517,535582,463683,4159197,274193,697816,972009,764515,695665,930801,715019,646895,657894,4410789,8569986,10635058,10635058
Azerbaijan,2029,AZ,AZE,EUR,301509,752184,1053693,904776,714946,889992,686503,531989,489343,4217549,273956,666330,940286,787454,673170,927850,737986,640554,695002,4462016,8679565,10673545,10673545
Azerbaijan,2030,AZ,AZE,EUR,301829,715582,1017411,925432,705834,886604,710969,529892,513486,4272217,275278,635921,911199,805770,657413,917743,763613,634902,730870,4510311,8782528,10711138,10711138
Azerbaijan,1950,AZ,AZE,EUR,190867,350713,541580,354512,162993,131152,106738,83049,87636,926080,182602,361704,544306,362692,208172,177770,162233,106010,130119,1146996,2073076,3158966,3158966
Azerbaijan,1951,AZ,AZE,EUR,219736,327129,546865,371270,176816,130396,107108,83549,85386,954525,210479,336639,547118,379310,219211,176937,164956,108360,128011,1176785,2131310,3225280,3225280
Azerbaijan,1952,AZ,AZE,EUR,243898,310343,554241,386266,192885,129146,107889,84023,83308,983517,233680,317461,551141,395419,231953,176125,167028,111374,126050,1207949,2191466,3296850,3296850
Azerbaijan,1953,AZ,AZE,EUR,263544,303045,566589,397256,210855,127571,109088,84333,81382,1010485,252118,306432,558550,409496,246025,175543,168357,114922,124208,1238551,2249036,3374174,3374174
Azerbaijan,1954,AZ,AZE,EUR,281233,304358,585591,403188,230167,126053,110668,84377,79689,1034142,268510,303109,571619,419850,260951,175427,169118,118752,122739,1266837,2300979,3458184,3458184
Azerbaijan,1955,AZ,AZE,EUR,297988,313058,611046,404948,250081,125273,112371,84241,78284,1055198,284243,307813,592056,425179,276447,175986,169578,122786,121732,1291708,2346906,3550017,3550017
Azerbaijan,1956,AZ,AZE,EUR,315471,329176,644647,401402,269792,125928,113928,84020,77140,1072210,300842,321107,621949,423457,292406,177583,169691,127020,120910,1311067,2383277,3649871,3649871
Azerbaijan,1957,AZ,AZE,EUR,334549,352586,687135,392258,288569,128566,115192,83800,76221,1084606,318950,342045,660995,415068,308539,180686,169328,131416,120248,1325285,2409891,3758021,3758021
Azerbaijan,1958,AZ,AZE,EUR,354772,382240,737012,379362,305707,133638,116043,83642,75457,1093849,338149,370070,708219,401375,324207,185617,168719,135646,120026,1335590,2429439,3874677,3874677
Azerbaijan,1959,AZ,AZE,EUR,375616,420612,796228,361003,320554,141455,116428,83549,74840,1097829,357946,407102,765048,381216,338756,192528,168163,139246,120378,1340287,2438116,3999395,3999395
Azerbaijan,1960,AZ,AZE,EUR,396380,465093,861473,337866,335420,151975,116257,83615,74398,1099531,377667,450221,827888,356009,354003,201419,167577,142250,121332,1342590,2442121,4131484,4131484
Azerbaijan,1961,AZ,AZE,EUR,416183,509951,926134,315156,351356,164915,115528,83994,74154,1105103,396446,493774,890220,331384,370336,212180,166878,144735,122923,1348436,2453539,4269886,4269886
Azerbaijan,1962,AZ,AZE,EUR,433715,551998,985713,299123,365636,179944,114382,84710,74010,1117805,413055,534346,947401,312584,386199,224598,166202,146672,125149,1361404,2479209,4412316,4412316
Azerbaijan,1963,AZ,AZE,EUR,447851,590874,1038725,292396,376142,196755,112983,85776,73925,1137977,426451,571342,997793,301882,400099,238324,165772,148024,128049,1382150,2520127,4556648,4556648
Azerbaijan,1964,AZ,AZE,EUR,457550,628504,1086054,293990,381765,214767,111660,87137,73857,1163176,435630,606911,1042541,298703,410259,252837,165780,148914,131486,1407979,2571155,4699755,4699755
Azerbaijan,1965,AZ,AZE,EUR,461734,665144,1126878,302544,383159,233203,110973,88554,73824,1192257,439572,641731,1081303,303178,415206,267773,166386,149541,135284,1437368,2629625,4837811,4837811
Azerbaijan,1966,AZ,AZE,EUR,460507,701549,1162056,318045,379152,251267,111523,89802,73832,1223621,438367,676465,1114832,315837,412859,282979,167907,149816,139168,1468566,2692187,4969078,4969078
Azerbaijan,1967,AZ,AZE,EUR,454048,737326,1191374,340414,369496,268295,113782,90752,73900,1256639,432175,710562,1142737,335821,403623,298186,170778,149615,143058,1501081,2757720,5091822,5091822
Azerbaijan,1968,AZ,AZE,EUR,443462,770983,1214445,368796,356092,283696,118197,91338,74062,1292181,422034,742613,1164647,362755,388970,312843,175355,149187,147035,1536145,2828326,5207417,5207417
Azerbaijan,1969,AZ,AZE,EUR,431023,801011,1232034,405636,337392,296912,125061,91538,74339,1330878,410113,771171,1181284,398638,367850,326338,181784,148782,150781,1574173,2905051,5318380,5318380
Azerbaijan,2031,AZ,AZE,EUR,303412,683350,986762,936740,705425,876365,736218,529892,535981,4320621,277743,609240,886983,816789,649705,900224,790842,630662,765122,4553344,8873965,10747709,10747709
Azerbaijan,2032,AZ,AZE,EUR,305870,660242,966112,934924,713615,859515,761179,532281,556949,4358463,280997,590608,871605,816567,650483,875748,818304,628355,797696,4587153,8945616,10783334,10783334
Azerbaijan,2033,AZ,AZE,EUR,308989,644690,953679,921990,729111,838045,784482,537256,576594,4387478,284824,578700,863524,806800,658504,846231,844451,628516,828654,4613156,9000634,10817832,10817832
Azerbaijan,2034,AZ,AZE,EUR,312312,629721,942033,905758,749701,814338,805010,545066,595024,4414897,288803,567353,856156,794360,671610,814136,867801,631794,857964,4637665,9052562,10850748,10850748
Azerbaijan,2035,AZ,AZE,EUR,315223,618303,933526,884390,774135,789485,822180,556016,611870,4438076,292349,559170,851519,777512,688790,780865,887209,638832,885133,4658341,9096417,10881465,10881465
Azerbaijan,2036,AZ,AZE,EUR,317470,612761,930231,855305,802731,763929,835982,570161,626589,4454697,295194,556234,851428,753895,710332,747625,901747,650009,909472,4673080,9127777,10909439,10909439
Azerbaijan,2037,AZ,AZE,EUR,318792,610182,928974,821610,834443,738966,846576,587264,639004,4467863,297095,555991,853086,726164,735087,716414,910793,665323,930703,4684484,9152347,10934405,10934405
Azerbaijan,2038,AZ,AZE,EUR,318864,610107,928971,785072,865840,716945,853680,606902,649540,4477979,297751,557996,855747,695840,760137,689039,914210,684475,949212,4692913,9170892,10955609,10955609
Azerbaijan,2039,AZ,AZE,EUR,317491,612040,929531,747434,893312,700572,856350,628502,659224,4485394,296974,561753,858727,664478,782993,666857,911417,706925,965989,4698659,9184053,10972311,10972311
Azerbaijan,2040,AZ,AZE,EUR,314832,615294,930126,711158,913817,691895,853330,651469,668975,4490644,294910,566634,861544,634187,801255,651353,901593,731915,981810,4702113,9192757,10984426,10984426
Azerbaijan,2041,AZ,AZE,EUR,311085,619141,930226,679219,925092,691757,843713,675172,679289,4494242,291753,571956,863709,607618,812248,643824,884488,758432,997116,4703726,9197968,10991899,10991899
Azerbaijan,2042,AZ,AZE,EUR,306185,622942,929127,656331,923390,700041,827722,698632,690581,4496697,287441,577118,864559,589070,812066,644699,860539,785157,1012455,4703986,9200683,10994371,10994371
Azerbaijan,2043,AZ,AZE,EUR,300526,626153,926679,640940,910706,715483,807289,720578,703293,4498289,282351,581610,863961,577219,802381,652749,831641,810599,1028492,4703081,9201370,10992015,10992015
Azerbaijan,2044,AZ,AZE,EUR,294625,628128,922753,626137,894780,735924,784709,739991,717765,4499306,276975,584825,861800,565933,790044,665837,800221,833349,1045925,4701309,9200615,10985175,10985175
Azerbaijan,2045,AZ,AZE,EUR,288635,628409,917044,614864,873780,760126,761049,756336,734038,4500193,271462,586324,857786,557803,773327,682957,767656,852307,1065067,4699117,9199310,10974136,10974136
Azerbaijan,2046,AZ,AZE,EUR,282757,626939,909696,609424,845151,788408,736724,769572,751750,4501029,266025,586029,852054,554900,749874,704395,735117,866565,1085758,4696609,9197638,10959389,10959389
Azerbaijan,2047,AZ,AZE,EUR,277256,623400,900656,606928,811973,819740,712988,779828,770500,4501957,260923,583636,844559,554687,722332,729017,704582,875512,1107826,4693956,9195913,10941124,10941124
Azerbaijan,2048,AZ,AZE,EUR,272114,617855,889969,606918,775989,850756,692130,786862,790351,4503006,256143,579227,835370,556712,692217,753929,677829,879032,1131466,4691185,9194191,10919530,10919530
Azerbaijan,2049,AZ,AZE,EUR,267257,610630,877887,608907,738917,877922,676781,789812,811709,4504048,251622,573095,824717,560485,661067,776666,656204,876577,1157185,4688184,9192232,10894838,10894838
Azerbaijan,2050,AZ,AZE,EUR,262720,602026,864746,612199,703187,898245,668910,787515,834777,4504833,247392,565545,812937,565371,630983,794840,641159,867367,1185060,4684780,9189613,10867296,10867296
Burundi,1970,BI,BDI,AFR,318356,463758,782114,337205,215211,145514,105683,71399,48197,923209,317183,463463,780646,343498,230278,160597,123287,88006,66203,1011869,1935078,3497834,3497834
Burundi,1971,BI,BDI,AFR,326132,474387,800519,348542,220890,148620,107059,72713,49431,947255,324992,473954,798946,353616,236087,163554,124676,89533,67888,1035354,1982609,3582070,3582070
Burundi,1972,BI,BDI,AFR,329947,479982,809929,347780,214360,145479,105210,72291,49222,934342,329177,480621,809798,352553,230605,161104,123114,89489,68250,1025115,1959457,3579195,3579195
Burundi,1973,BI,BDI,AFR,331280,485426,816706,347627,207664,142175,103111,71646,48940,921163,330873,487437,818310,352612,225044,158635,121261,89209,68500,1015261,1936424,3571450,3571450
Burundi,1974,BI,BDI,AFR,335533,497376,832909,362375,213490,145954,104430,72720,50267,949236,335019,499565,834584,366903,230875,162463,122439,90477,70150,1043307,1992543,3660032,3660032
Burundi,1975,BI,BDI,AFR,341568,510326,851894,373807,221009,149498,105723,73794,51602,975433,340835,512338,853173,377716,237774,166041,123632,91758,71809,1068730,2044163,3749232,3749232
Burundi,1976,BI,BDI,AFR,348331,523303,871634,380409,230227,152260,106719,74660,52800,997075,347456,525088,872544,383911,245974,168950,124588,92867,73345,1089635,2086710,3830889,3830889
Burundi,1977,BI,BDI,AFR,355941,536754,892695,389462,241208,156002,108221,75641,54150,1024684,355007,538347,893354,392771,255924,172853,126027,94087,75029,1116691,2141375,3927428,3927428
Burundi,1978,BI,BDI,AFR,366748,549058,915806,400570,253981,160796,110239,76742,55597,1057925,365699,550511,916210,403854,267673,177787,127958,95397,76807,1149476,2207401,4039410,4039410
Burundi,1979,BI,BDI,AFR,380366,560241,940607,408534,263656,164250,111721,77544,56757,1082462,379120,561589,940709,411562,276292,181508,129474,96424,78391,1173651,2256113,4137437,4137437
Burundi,1980,BI,BDI,AFR,396949,574325,971274,427509,284704,173452,115805,79438,58915,1139823,395456,575650,971106,431157,296458,190636,133297,98292,80794,1230634,2370457,4312834,4312834
Burundi,1981,BI,BDI,AFR,416852,589099,1005951,444865,304968,182408,120004,81285,60883,1194413,415030,590344,1005374,449017,315939,199558,137286,100087,83124,1285011,2479424,4490743,4490743
Burundi,1982,BI,BDI,AFR,437377,603088,1040465,450739,313680,185645,122052,82081,61805,1216002,435202,604114,1039316,454426,323822,203076,139471,100988,84711,1306494,2522496,4602271,4602271
Burundi,1983,BI,BDI,AFR,457420,619064,1076484,458733,323594,189653,124643,83026,62907,1242556,454896,619819,1074715,462022,332976,207199,142177,101972,86405,1332751,2575307,4726506,4726506
Burundi,1984,BI,BDI,AFR,475927,637109,1113036,465622,331959,192162,126948,83797,63835,1264323,473046,637536,1110582,468415,340667,209770,144700,102816,87955,1354323,2618646,4842268,4842268
Burundi,1985,BI,BDI,AFR,492570,656922,1149492,471521,335751,196053,128843,84363,64565,1281096,489357,657006,1146363,473757,344041,213479,146955,103524,89317,1371073,2652169,4948024,4948024
Burundi,1986,BI,BDI,AFR,505087,680267,1185354,476588,334006,201812,130215,84699,64996,1292316,501582,680011,1181593,478176,342110,218828,148839,104077,90411,1382441,2674757,5041706,5041706
Burundi,1987,BI,BDI,AFR,514911,707006,1221917,486072,335825,208911,132241,85331,65494,1313874,511149,706495,1217644,487384,343789,225381,151376,104907,91501,1404338,2718212,5157769,5157769
Burundi,1988,BI,BDI,AFR,523766,734803,1258569,494684,337697,215599,134110,85794,65546,1333430,519869,734275,1254144,496371,345954,231704,153896,105651,92111,1425687,2759117,5271840,5271840
Burundi,1989,BI,BDI,AFR,531612,763596,1295208,501513,337475,221088,135555,86026,65146,1346803,527638,763009,1290647,503550,346006,236896,156096,106239,92246,1441033,2787836,5373697,5373697
Burundi,1990,BI,BDI,AFR,539662,791954,1331616,511024,338776,226923,137274,86443,64735,1365175,535632,791070,1326702,513057,347191,242224,158510,107003,92308,1460293,2825468,5483793,5483793
Burundi,1991,BI,BDI,AFR,547292,819195,1366487,521915,340951,232656,138923,86977,64247,1385669,543321,817819,1361140,524001,349253,247431,160805,107884,92157,1481531,2867200,5594828,5594828
Burundi,1992,BI,BDI,AFR,555710,846344,1402054,539365,349760,241216,141653,88264,64241,1424499,551944,844158,1396102,541859,357942,255227,163887,109359,92148,1520422,2944921,5743085,5743085
Burundi,1993,BI,BDI,AFR,554044,861735,1415779,508916,306630,223039,132770,84505,60080,1315940,550712,859123,1409835,508666,314567,238221,156751,106762,88693,1413660,2729600,5555220,5555220
Burundi,1994,BI,BDI,AFR,546728,881666,1428394,519998,300939,222460,130991,84264,59495,1318147,543830,879097,1422927,519931,308840,237699,155493,107030,87949,1416942,2735089,5586408,5586408
Burundi,1995,BI,BDI,AFR,547962,909485,1457447,579307,345580,244104,141998,88884,62564,1462437,545235,906607,1451842,582434,353625,257857,165376,111364,90389,1561045,3023482,5932783,5932783
Burundi,1996,BI,BDI,AFR,549430,923645,1473075,584186,334038,234985,143338,88078,60460,1445085,546757,920282,1467039,586264,341964,249357,167137,111487,89100,1545309,2990394,5930507,5930507
Burundi,1997,BI,BDI,AFR,546500,935186,1481686,593419,323064,225589,144286,87310,59010,1432678,543979,931443,1475422,594431,330753,240516,168416,111676,88283,1534075,2966753,5923862,5923862
Burundi,1998,BI,BDI,AFR,542412,950633,1493045,623697,330628,225364,149059,88488,59600,1476836,539954,946766,1486720,624998,338180,240136,172873,113452,89111,1578750,3055586,6035340,6035340
Burundi,1999,BI,BDI,AFR,550982,956221,1507203,659106,343120,227151,154649,90236,60694,1534956,548369,952453,1500822,660848,350631,241553,177969,115719,90481,1637201,3172157,6180180,6180180
Burundi,2000,BI,BDI,AFR,563964,959407,1523371,688873,353402,227391,159202,91668,61573,1582109,561104,955729,1516833,690841,361181,241639,182170,117756,91760,1685347,3267456,6307659,6307659
Burundi,2001,BI,BDI,AFR,571786,972165,1543951,720312,368776,229967,164359,93413,62905,1639732,568588,968680,1537268,722950,377301,244094,186925,120023,93488,1744781,3384513,6465729,6465729
Burundi,2002,BI,BDI,AFR,588037,982007,1570044,752199,388117,234407,169986,95312,64633,1704654,584432,978912,1563344,755161,397423,248289,192066,122309,95640,1810888,3515542,6648938,6648938
Burundi,2003,BI,BDI,AFR,613253,988900,1602153,784664,412135,241225,176030,97550,66767,1778371,609301,986161,1595462,787606,422121,254690,197528,124749,98169,1884863,3663234,6860846,6860846
Burundi,2004,BI,BDI,AFR,643762,998140,1641902,819349,444188,252041,183601,99955,69468,1868602,639586,995589,1635175,822345,454863,264931,204400,127084,101202,1974825,3843427,7120496,7120496
Burundi,2005,BI,BDI,AFR,677827,1010805,1688632,849659,477424,263799,189256,104043,72117,1956298,673456,1008339,1681795,852439,488805,276209,209432,130968,104296,2062149,4018447,7388874,7388874
Burundi,2006,BI,BDI,AFR,715161,1026679,1741840,872921,512011,276091,192241,110148,74627,2038039,710515,1024149,1734664,875305,524146,288153,211864,136816,107360,2143644,4181683,7658190,7658190
Burundi,2007,BI,BDI,AFR,754292,1047550,1801842,892676,549659,290267,195710,116197,77264,2121773,749223,1044832,1794055,894601,562515,301997,214741,142513,110572,2226939,4348712,7944609,7944609
Burundi,2008,BI,BDI,AFR,795038,1073842,1868880,916631,593936,307522,200664,122683,80465,2221901,789382,1070981,1860363,918667,607616,318871,218959,148521,114332,2326966,4548867,8278109,8278109
Burundi,2009,BI,BDI,AFR,839225,1117586,1956811,941158,652320,332513,208635,130400,84890,2349916,832779,1114622,1947401,944502,667019,343281,225814,155499,119118,2455233,4805149,8709366,8709366
Burundi,2010,BI,BDI,AFR,884158,1169204,2053362,956897,704747,357982,216470,137706,88871,2462673,876688,1165845,2042533,961048,720221,368476,232644,162083,123557,2568029,5030702,9126605,9126605
Burundi,2011,BI,BDI,AFR,924832,1217039,2141871,964655,739708,378190,221957,143569,91514,2539593,916362,1212893,2129255,968408,755550,389046,237587,167479,126951,2645021,5184614,9455733,9455733
Burundi,2012,BI,BDI,AFR,960599,1274849,2235448,970257,773202,400884,228542,149542,94325,2616752,951222,1269722,2220944,973835,789163,412267,243637,172984,130449,2722335,5339087,9795479,9795479
Burundi,2013,BI,BDI,AFR,991882,1342106,2333988,974334,805575,426545,236612,155572,97447,2696085,981580,1335962,2317542,977812,821559,438614,251202,178564,134206,2801957,5498042,10149577,10149577
Burundi,2014,BI,BDI,AFR,1017389,1414335,2431724,978163,832434,453745,245529,161701,100199,2771771,1006142,1407151,2413293,981271,848356,466769,259794,184376,137553,2878119,5649890,10494913,10494913
Burundi,2015,BI,BDI,AFR,1032017,1488409,2520426,969174,837121,473812,251720,164664,102852,2799343,1019899,1480225,2500124,970701,852879,488642,266389,187441,141209,2907261,5706604,10727148,10727148
Burundi,2016,BI,BDI,AFR,1036362,1563269,2599631,958953,827795,492525,257346,164982,106632,2808233,1023421,1554135,2577556,958301,843099,509573,272779,187969,146183,2917904,5726137,10903327,10903327
Burundi,2017,BI,BDI,AFR,1036507,1637064,2673571,969490,826668,519316,267020,166773,111548,2860815,1022775,1626942,2649717,967657,841145,538120,282891,189707,151964,2971484,5832299,11155593,11155593
Burundi,2018,BI,BDI,AFR,1035437,1708571,2744008,999693,838427,553740,279944,170149,117655,2959608,1021020,1697466,2718486,997900,852190,573871,295962,192781,158668,3071372,6030980,11493472,11493472
Burundi,2019,BI,BDI,AFR,1034415,1776027,2810442,1051372,846720,592002,295248,174239,124254,3083835,1019461,1763899,2783360,1050355,859911,613247,311431,196445,165815,3197204,6281039,11874838,11874838
Burundi,2020,BI,BDI,AFR,1033085,1835931,2869016,1105468,847627,625725,311260,177993,129503,3197576,1017656,1822651,2840307,1104908,860211,648107,328103,200056,171934,3313319,6510895,12220227,12220227
Burundi,2021,BI,BDI,AFR,1034883,1885585,2920468,1156052,854867,656275,328512,181919,133694,3311319,1018942,1870983,2889925,1155588,866909,679572,346329,204001,177101,3429500,6740819,12551213,12551213
Burundi,2022,BI,BDI,AFR,1041574,1924555,2966129,1216440,861038,685025,347773,186695,137835,3434806,1025087,1908530,2933617,1215996,872627,708845,366695,208784,182082,3555029,6989835,12889576,12889576
Burundi,2023,BI,BDI,AFR,1050587,1955345,3005932,1286072,866771,712004,369413,192745,142382,3569387,1033613,1937952,2971565,1285787,877970,736110,389577,214870,187360,3691674,7261061,13238559,13238559
Burundi,2024,BI,BDI,AFR,1059547,1979249,3038796,1359750,875385,735976,393590,200248,147632,3712581,1042370,1960698,3003068,1359765,886336,760248,415162,222472,193232,3837215,7549796,13591657,13591657
Burundi,2025,BI,BDI,AFR,1067528,1996203,3063731,1437159,888936,756927,419802,209040,153182,3865046,1050467,1976634,3027101,1437463,899858,781217,442932,231475,199328,3992273,7857319,13948140,13948140
Burundi,2026,BI,BDI,AFR,1076183,2008227,3084410,1515748,907330,773364,449098,219078,158593,4023211,1059395,1987606,3047001,1516251,918354,797501,473978,241854,205256,4153194,8176405,14307816,14307816
Burundi,2027,BI,BDI,AFR,1087213,2018722,3105935,1590553,931567,786021,480543,230404,164084,4183172,1070720,1997127,3067847,1591108,942955,809794,507292,253659,211252,4316060,8499232,14673012,14673012
Burundi,2028,BI,BDI,AFR,1100590,2027726,3128316,1660839,961091,798160,513029,242060,169673,4344852,1084292,2005391,3089683,1661224,973054,821573,541697,265896,217349,4480793,8825645,15043647,15043647
Burundi,2029,BI,BDI,AFR,1115760,2035575,3151335,1726258,1005399,800785,546045,254530,175218,4508235,1099497,2012851,3112348,1726249,1018315,823690,576616,279129,223381,4647380,9155615,15419302,15419302
Burundi,2030,BI,BDI,AFR,1132909,2042985,3175894,1785328,1057948,801934,577522,268877,181104,4672713,1116531,2020183,3136714,1784703,1072111,824302,609783,294508,229806,4815213,9487926,15800530,15800530
Burundi,1950,BI,BDI,AFR,186389,268896,455285,206052,153964,112130,76070,44713,31556,624485,191399,282410,473809,220081,170228,126070,88558,54476,41119,700532,1325017,2254113,2254113
Burundi,1951,BI,BDI,AFR,197494,274590,472084,208396,155049,113674,77656,45612,32068,632455,201080,288024,489104,222145,171304,127831,90560,55646,42111,709597,1342052,2303248,2303248
Burundi,1952,BI,BDI,AFR,207761,280352,488113,211087,156092,115140,79099,46671,32610,640699,210098,293689,503787,224554,172255,129549,92425,57053,43110,718946,1359645,2351535,2351535
Burundi,1953,BI,BDI,AFR,217398,286435,503833,213993,156997,116466,80437,47862,33145,648900,218624,299557,518181,227175,172995,131154,94158,58635,44068,728185,1377085,2399099,2399099
Burundi,1954,BI,BDI,AFR,227444,292042,519486,217095,157844,117693,81781,49155,33659,657227,227658,304863,532521,230018,173661,132664,95854,60340,44984,737521,1394748,2446758,2446758
Burundi,1955,BI,BDI,AFR,234191,300962,535153,220435,158754,118864,83179,50509,34144,665885,233882,313023,546905,233165,174394,134112,97569,62128,45877,747245,1413130,2495193,2495193
Burundi,1956,BI,BDI,AFR,236911,313920,550831,223998,159745,119955,84616,51920,34624,674858,236535,324762,561297,236590,175204,135487,99274,63984,46733,757272,1432130,2544258,2544258
Burundi,1957,BI,BDI,AFR,239766,326663,566429,227810,160865,120953,86080,53394,35083,684185,239327,336275,575602,240317,176119,136768,100954,65911,47550,767619,1451804,2593840,2593840
Burundi,1958,BI,BDI,AFR,242717,339153,581870,231830,161968,121791,87516,54875,35564,693544,242215,347543,589758,244282,177012,137871,102580,67852,48384,777981,1471525,2643153,2643153
Burundi,1959,BI,BDI,AFR,245856,351427,597283,236337,163259,122587,88906,56294,36138,703521,245255,358614,603869,248763,178087,138870,104178,69731,49339,788968,1492489,2693642,2693642
Burundi,1960,BI,BDI,AFR,249327,363518,612845,241491,164950,123443,90275,57639,36839,714637,248620,369508,618128,253897,179546,139840,105773,71522,50444,801022,1515659,2746628,2746628
Burundi,1961,BI,BDI,AFR,253582,375844,629426,249101,169322,125457,92103,59120,37847,732950,252753,380664,633417,261653,183715,141808,107773,73393,51835,820177,1553127,2815972,2815972
Burundi,1962,BI,BDI,AFR,258729,388154,646883,256504,174111,127519,93897,60521,38958,751510,257766,391786,649552,269153,188307,143729,109762,75151,53347,839449,1590959,2887398,2887398
Burundi,1963,BI,BDI,AFR,264355,399974,664329,262068,177206,128621,95213,61686,39986,764780,263284,402460,665744,274534,191200,144693,111342,76678,54834,853281,1618061,2948133,2948133
Burundi,1964,BI,BDI,AFR,270989,413143,684132,270408,184095,131523,97244,63215,41365,787850,269810,414586,684396,282872,197992,147345,113546,78477,56619,876851,1664701,3033221,3033221
Burundi,1965,BI,BDI,AFR,278309,423503,701812,281020,190856,134349,99124,64685,42601,812635,277054,424288,701342,293213,204938,150043,115658,80223,58266,902341,1714976,3118134,3118134
Burundi,1966,BI,BDI,AFR,286058,430120,716178,293307,195922,136436,100573,66013,43668,835919,284757,430633,715390,304603,210257,152056,117385,81815,59771,925887,1761806,3193378,3193378
Burundi,1967,BI,BDI,AFR,294116,437732,731848,305829,201705,139020,102158,67501,44885,861098,292810,438004,730814,315991,216190,154456,119191,83484,61426,950738,1811836,3274493,3274493
Burundi,1968,BI,BDI,AFR,302164,446011,748175,317227,206855,141413,103533,68921,46038,883987,300895,446049,746944,326157,221528,156699,120793,85084,63039,973300,1857287,3352397,3352397
Burundi,1969,BI,BDI,AFR,310445,454404,764849,327258,210977,143380,104620,70186,47109,903530,309225,454250,763475,334869,225863,158568,122090,86563,64617,992570,1896100,3424429,3424429
Burundi,2031,BI,BDI,AFR,1151441,2054231,3205672,1834703,1109182,811230,607138,284930,187450,4834633,1134897,2031527,3166424,1833372,1124501,833354,640823,311836,236774,4980660,9815293,16187388,16187388
Burundi,2032,BI,BDI,AFR,1170279,2072169,3242448,1873371,1168791,818645,634662,302577,194242,4992288,1153571,2049645,3203216,1871325,1185314,840686,669484,331023,244249,5142081,10134369,16580035,16580035
Burundi,2033,BI,BDI,AFR,1190093,2094448,3284541,1903878,1236074,824485,659953,321990,201650,5148030,1173210,2072117,3245327,1901097,1253934,846446,695709,352241,252434,5301861,10449891,16979760,16979760
Burundi,2034,BI,BDI,AFR,1211024,2118659,3329683,1927794,1307404,833159,682436,343471,209766,5304030,1193930,2096564,3290494,1924281,1326647,855110,718922,375798,261475,5462233,10766263,17386443,17386443
Burundi,2035,BI,BDI,AFR,1232616,2143972,3376588,1945011,1382414,846576,702115,366657,218624,5461397,1215345,2122185,3337530,1940717,1402998,868732,739104,401271,271397,5624219,11085616,17799740,17799740
Burundi,2036,BI,BDI,AFR,1253654,2171294,3424948,1957451,1458605,864618,717671,392600,228335,5619280,1236253,2149929,3386182,1952285,1480466,887166,754913,429781,282313,5786924,11406204,18217324,18217324
Burundi,2037,BI,BDI,AFR,1273989,2201199,3475188,1968411,1531196,888253,729778,420458,239074,5777170,1256474,2180309,3436783,1962425,1554139,911520,766989,460381,294435,5949889,11727059,18639033,18639033
Burundi,2038,BI,BDI,AFR,1293604,2234341,3527945,1977930,1599484,916965,741454,449140,250082,5935055,1275993,2213832,3489825,1971326,1623231,941219,778606,491915,306933,6113230,12048285,19066058,19066058
Burundi,2039,BI,BDI,AFR,1311412,2270334,3581746,1986337,1663141,959714,744202,478209,261622,6093225,1293724,2250028,3543752,1979440,1687399,985532,781015,523849,320151,6277386,12370611,19496105,19496105
Burundi,2040,BI,BDI,AFR,1327071,2308911,3635982,1994332,1720731,1010334,745600,505906,274861,6251764,1309314,2288706,3598020,1987426,1745196,1038108,782014,554180,335451,6442375,12694139,19928151,19928151
Burundi,2041,BI,BDI,AFR,1341445,2348317,3689762,2006057,1769019,1059814,754716,531940,289757,6411303,1323630,2328211,3651841,1999347,1793467,1089445,791118,582569,352756,6608702,13020005,20361593,20361593
Burundi,2042,BI,BDI,AFR,1353850,2387338,3741188,2024285,1807018,1117288,762065,556103,306145,6572904,1336033,2367354,3703387,2017910,1831285,1148935,798571,608766,371935,6777402,13350306,20794876,20794876
Burundi,2043,BI,BDI,AFR,1363378,2426598,3789976,2046736,1837185,1182092,767951,578310,324280,6736554,1345572,2406756,3752328,2040753,1861132,1215992,804539,632756,393269,6948441,13684995,21227305,21227305
Burundi,2044,BI,BDI,AFR,1371470,2465194,3836664,2071082,1861035,1250796,776538,598084,344471,6902006,1353656,2445469,3799125,2065538,1884570,1287065,813309,654048,417121,7121651,14023657,21659444,21659444
Burundi,2045,BI,BDI,AFR,1378349,2502329,3880678,2096517,1878481,1323079,789613,615426,366396,7069512,1360533,2482767,3843300,2091494,1901453,1361725,826842,672608,443103,7297225,14366737,22090717,22090717
Burundi,2046,BI,BDI,AFR,1384288,2537694,3921982,2123929,1891336,1396529,807063,629259,390957,7239073,1366502,2518342,3884844,2119545,1913600,1437527,845008,687289,472231,7475200,14714273,22521094,22521094
Burundi,2047,BI,BDI,AFR,1389635,2570462,3960097,2153869,1902763,1466563,829790,640173,417559,7410717,1371875,2551366,3923241,2150205,1924349,1509678,868858,698677,503815,7655582,15066299,22949637,22949637
Burundi,2048,BI,BDI,AFR,1393582,2599686,3993268,2186978,1912804,1532517,857347,650782,444639,7585067,1375865,2580879,3956744,2183969,1933893,1577434,897875,709716,536069,7838956,15424023,23374034,23374034
Burundi,2049,BI,BDI,AFR,1395614,2625755,4021369,2222882,1921775,1594067,897889,653366,472023,7762002,1377991,2607218,3985209,2220375,1942673,1640453,940746,712206,568792,8025245,15787247,23793823,23793823
Burundi,2050,BI,BDI,AFR,1395880,2648547,4044427,2261312,1930347,1649847,945790,654816,499210,7941322,1378425,2630269,4008694,2259235,1951321,1697323,991514,713447,601397,8214237,16155559,24208671,24208671
Belgium,1970,BE,BEL,EUR,367902,794449,1162351,734013,587562,642385,538826,516324,530710,3549820,350759,760507,1111266,704026,572480,641985,552997,574862,759586,3805936,7355756,9629376,9629376
Belgium,1971,BE,BEL,EUR,362449,797162,1159611,742923,598337,635526,556650,501294,535445,3570175,345527,762531,1108058,712829,580855,634279,571674,557879,771030,3828546,7398721,9666395,9666395
Belgium,1972,BE,BEL,EUR,358057,795911,1153968,747765,613866,630114,579816,480038,539994,3591593,341306,761108,1102414,717833,593865,628032,595476,534368,782747,3852321,7443914,9700298,9700298
Belgium,1973,BE,BEL,EUR,353045,790585,1143630,754406,627619,626157,605003,457049,544250,3614484,336450,755963,1092413,724035,605658,623633,620723,508865,794542,3877456,7491940,9727980,9727980
Belgium,1974,BE,BEL,EUR,346009,782617,1128626,762644,641017,622184,623037,442093,547987,3638962,329596,748223,1077819,731989,616549,619347,639187,491526,805056,3903654,7542616,9749065,9749065
Belgium,1975,BE,BEL,EUR,336217,774721,1110938,771425,657124,613425,628221,441723,551027,3662945,320155,740447,1060602,740601,630291,609886,644484,489538,814134,3928934,7591879,9763430,9763430
Belgium,1976,BE,BEL,EUR,325560,766607,1092167,780748,677708,598266,627754,448899,552497,3685872,309891,732393,1042284,749531,649165,593829,643232,495912,821556,3953225,7639097,9773537,9773537
Belgium,1977,BE,BEL,EUR,316661,756740,1073401,789335,699533,583528,627203,455070,555456,3710125,301374,722678,1024052,757870,669428,577947,641765,501222,830561,3978793,7688918,9786373,9786373
Belgium,1978,BE,BEL,EUR,310946,743752,1054698,796390,717124,576549,624313,460702,559931,3735009,296037,709913,1005950,764777,685807,569596,638118,505413,840831,4004542,7739551,9800206,9800206
Belgium,1979,BE,BEL,EUR,308897,726609,1035506,803372,730683,576488,618941,467280,563814,3760578,294013,693108,987121,771272,698570,568045,632038,510729,850268,4030922,7791500,9814137,9814137
Belgium,1980,BE,BEL,EUR,309836,708021,1017857,808118,743691,579293,612467,477491,563969,3785029,294738,675103,969841,775133,711038,569280,624968,520826,855015,4056260,7841289,9828986,9828986
Belgium,1981,BE,BEL,EUR,311756,691231,1002987,809170,751800,588831,605872,494031,556976,3806680,296498,658960,955458,775503,719186,576737,617414,538867,850756,4078463,7885143,9843592,9843592
Belgium,1982,BE,BEL,EUR,312820,677264,990084,806353,755894,603285,600685,514776,545304,3826297,297336,645723,943059,772570,723511,588864,611198,561319,840441,4097903,7924200,9857343,9857343
Belgium,1983,BE,BEL,EUR,312198,665899,978097,799710,761604,616177,596942,536639,531982,3843054,296543,635073,931616,766191,729020,599767,606738,584793,827249,4113758,7956812,9866532,9866532
Belgium,1984,BE,BEL,EUR,309730,656291,966021,790636,768782,629001,593085,552303,524888,3858695,294279,625762,920041,757470,736416,609871,602496,601943,820653,4128849,7987544,9873600,9873600
Belgium,1985,BE,BEL,EUR,306068,647174,953242,781615,776421,644679,584657,557416,529926,3874714,290857,616877,907734,748772,744575,623043,593254,607224,827980,4144848,8019562,9880534,9880534
Belgium,1986,BE,BEL,EUR,302752,638442,941194,772426,784586,664679,570225,558078,540517,3890511,287446,608494,895940,739947,753204,641413,577516,606600,841498,4160178,8050689,9887815,9887815
Belgium,1987,BE,BEL,EUR,300789,630776,931565,761561,792148,685945,556331,558802,551819,3906606,285358,601064,886422,729674,761480,661335,561979,605774,855387,4175629,8082235,9900221,9900221
Belgium,1988,BE,BEL,EUR,300716,624604,925320,747759,798465,703301,550131,557604,564430,3921690,285247,595231,880478,716650,768608,677656,554019,603005,870571,4190509,8112199,9917995,9917995
Belgium,1989,BE,BEL,EUR,302506,620305,922811,730049,805004,716852,550773,554366,576775,3933819,287051,591297,878348,699902,775677,690632,552914,597957,885108,4202190,8136009,9937170,9937170
Belgium,1990,BE,BEL,EUR,305912,617988,923900,711046,809652,730020,554089,550205,589004,3944016,290545,589127,879672,682177,780358,703718,554467,592039,899206,4211965,8155981,9959560,9959560
Belgium,1991,BE,BEL,EUR,310050,617204,927254,694115,810910,738329,563925,545924,601265,3954468,294899,588095,882994,666604,781691,712855,562132,585694,913372,4222348,8176816,9987070,9987070
Belgium,1992,BE,BEL,EUR,313549,617010,930559,680412,808648,742552,578639,542908,612701,3965860,298708,587419,886127,654320,779976,718289,574570,580559,926200,4233914,8199774,10016455,10016455
Belgium,1993,BE,BEL,EUR,315111,617148,932259,669584,803052,748460,591900,541326,623389,3977711,300571,587144,887715,644860,775301,724916,586027,577179,937782,4246065,8223776,10043738,10043738
Belgium,1994,BE,BEL,EUR,313913,617440,931353,660687,795553,755902,605090,539658,634428,3991318,299483,587520,887003,636851,768692,733548,596783,573974,949655,4259503,8250821,10069182,10069182
Belgium,1995,BE,BEL,EUR,310470,618249,928719,652608,788436,764031,620739,533702,647245,4006761,296156,588558,884714,629587,762366,743036,610433,565943,963638,4275003,8281764,10095198,10095198
Belgium,1996,BE,BEL,EUR,305744,620244,925988,645295,781427,773011,640551,522042,660842,4023168,291840,590617,882457,623067,756263,753067,629300,551694,978229,4291620,8314788,10123229,10123229
Belgium,1997,BE,BEL,EUR,301063,623061,924124,639265,773155,781724,661824,510715,674004,4040687,287586,593682,881268,617588,749108,762911,649820,537607,991759,4308793,8349480,10154872,10154872
Belgium,1998,BE,BEL,EUR,297403,625850,923253,634810,762480,789733,679397,506271,685710,4058401,284183,596820,881003,613932,739589,771742,666853,530819,1002943,4325878,8384279,10188538,10188538
Belgium,1999,BE,BEL,EUR,295448,627703,923151,632357,748401,798577,693262,507852,695824,4076273,282635,598801,881436,612544,726741,780784,680772,530611,1011896,4343348,8419621,10224220,10224220
Belgium,2000,BE,BEL,EUR,295396,628919,924315,632090,733315,806118,706858,511825,704844,4095050,282886,600140,883026,613321,713308,787758,694998,532822,1019748,4361955,8457005,10264343,10264343
Belgium,2001,BE,BEL,EUR,295850,629527,925377,633475,720613,810791,716072,521922,713525,4116398,283284,601320,884604,615549,702395,791654,705405,540916,1026951,4382870,8499268,10309255,10309255
Belgium,2002,BE,BEL,EUR,295451,629468,924919,635530,711418,812468,721580,536509,722613,4140118,282769,601940,884709,618246,695167,792851,712112,553666,1033785,4405827,8545945,10355568,10355568
Belgium,2003,BE,BEL,EUR,295189,628429,923618,637964,705254,811293,728905,549688,732257,4165361,282395,601354,883749,621325,690999,791480,720031,565404,1040584,4429823,8595184,10402550,10402550
Belgium,2004,BE,BEL,EUR,296412,626261,922673,640562,701115,808543,737953,562948,742422,4193543,283321,599554,882875,624847,688431,788430,730040,576514,1048810,4457072,8650615,10456163,10456163
Belgium,2005,BE,BEL,EUR,298639,623705,922344,643668,697755,806283,748063,578395,750493,4224657,285127,597279,882406,628671,686786,785700,740958,590244,1055210,4487569,8712226,10516978,10516978
Belgium,2006,BE,BEL,EUR,301869,620374,922243,647976,695030,804030,759288,597387,754549,4258260,288091,594202,882293,633159,685887,783251,752392,608850,1056639,4520178,8778438,10582975,10582975
Belgium,2007,BE,BEL,EUR,306830,616326,923156,653014,693454,800402,770391,617674,758485,4293420,292884,590290,883174,638304,685815,779785,763542,629110,1057390,4553946,8847366,10653697,10653697
Belgium,2008,BE,BEL,EUR,313267,613508,926775,657995,693208,794254,780720,634502,766704,4327383,298953,587382,886335,643251,687259,773826,773668,645997,1062211,4586212,8913595,10726716,10726716
Belgium,2009,BE,BEL,EUR,319378,613856,933234,662248,694611,784452,791778,648028,778463,4359580,304688,587605,892293,646799,690550,764291,784029,659799,1070776,4616244,8975824,10801356,10801356
Belgium,2010,BE,BEL,EUR,324357,617029,941386,666121,697899,773147,801756,661486,790958,4391367,309613,590453,900066,649415,695520,753796,792282,673716,1080397,4645126,9036493,10877947,10877947
Belgium,2011,BE,BEL,EUR,328000,621654,949654,669600,702559,763649,809013,670977,808233,4424031,313156,594588,907744,651721,701382,745397,797345,683817,1094653,4674315,9098346,10955743,10955743
Belgium,2012,BE,BEL,EUR,329887,627156,957043,672474,707627,757208,813134,677074,829196,4456713,314938,599617,914555,653320,707152,740271,799592,690379,1112118,4702832,9159545,11031139,11031139
Belgium,2013,BE,BEL,EUR,329909,634292,964201,674261,712873,753421,814278,684862,848614,4488309,315086,606115,921201,653502,712700,737758,799260,698093,1128229,4729542,9217851,11103257,11103257
Belgium,2014,BE,BEL,EUR,328616,642676,971292,674646,718148,751365,813705,694491,868639,4520994,313893,613715,927608,652252,718065,736481,797237,707866,1144931,4756832,9277826,11176723,11176723
Belgium,2015,BE,BEL,EUR,326232,651015,977247,674278,723711,749825,813288,705206,888194,4554502,311502,621461,932963,650238,723165,735872,795431,718518,1160365,4783589,9338091,11248303,11248303
Belgium,2016,BE,BEL,EUR,323182,659074,982256,672755,730247,748626,812592,717009,906312,4587541,308487,629076,937563,647086,728542,735690,793750,729669,1174741,4809478,9397019,11316836,11316836
Belgium,2017,BE,BEL,EUR,320182,667113,987295,670031,737478,748247,810256,728919,924911,4619842,305554,636770,942324,642808,734367,736026,790963,740768,1190100,4835032,9454874,11384489,11384489
Belgium,2018,BE,BEL,EUR,316905,674668,991573,668034,744536,748815,805265,740319,944463,4651432,302529,643945,946474,639363,739746,737554,785586,750877,1205986,4859112,9510544,11448595,11448595
Belgium,2019,BE,BEL,EUR,313234,680454,993688,668812,750467,750641,796539,752609,965122,4684190,299352,649286,948638,639048,743292,740609,776536,761316,1223240,4884041,9568231,11510568,11510568
Belgium,2020,BE,BEL,EUR,309403,683805,993208,672136,755373,754092,785960,763577,982917,4714055,295954,652455,948409,641486,745281,745136,766422,769903,1237813,4906041,9620096,11561717,11561717
Belgium,2021,BE,BEL,EUR,306346,684866,991212,676740,759269,758705,776877,771557,1000483,4743631,293138,653378,946516,645331,746447,750422,758278,775471,1254113,4930062,9673693,11611419,11611419
Belgium,2022,BE,BEL,EUR,303598,682221,985819,680186,759705,762430,770463,776863,1023830,4773477,290498,650827,941325,648280,744899,754806,753042,778498,1275777,4955302,9728779,11655930,11655930
Belgium,2023,BE,BEL,EUR,301213,675476,976689,683238,756313,765107,766138,779533,1050067,4800396,288045,644800,932845,650966,739910,758200,750087,779064,1297988,4976215,9776611,11686140,11686140
Belgium,2024,BE,BEL,EUR,300057,666776,966833,687634,751170,767658,763243,780280,1077663,4827648,286725,636978,923703,655140,733109,761330,748322,777830,1321854,4997585,9825233,11715774,11715774
Belgium,2025,BE,BEL,EUR,299899,656667,956566,692196,745037,770174,760697,780900,1105722,4854726,286411,627526,913937,659842,725301,764119,747109,776659,1346262,5019292,9874018,11744521,11744521
Belgium,2026,BE,BEL,EUR,299746,646583,946329,696561,737739,773364,758283,781068,1134075,4881090,286087,618013,904100,664564,716248,767209,746069,775533,1371033,5040656,9921746,11772171,11772171
Belgium,2027,BE,BEL,EUR,299083,637833,936916,700878,729394,777122,756383,779489,1162793,4906059,285286,609676,894962,669403,706204,770683,745258,773202,1396189,5060939,9966998,11798879,11798879
Belgium,2028,BE,BEL,EUR,298198,630230,928428,704660,722101,780427,755231,775174,1191945,4929538,284318,602382,886700,673731,697306,773480,745567,768186,1421789,5080059,10009597,11824728,11824728
Belgium,2029,BE,BEL,EUR,297187,623496,920683,706796,717947,782317,755248,767102,1222230,4951640,283240,596083,879323,676271,691907,774251,747312,759486,1448753,5097980,10049620,11849632,11849632
Belgium,2030,BE,BEL,EUR,296168,617584,913752,706641,716737,783039,756761,757191,1251881,4972250,282169,590537,872706,676634,689767,773258,750404,749661,1475035,5114759,10087009,11873460,11873460
Belgium,1950,BE,BEL,EUR,354033,563726,917759,645172,590166,637648,603070,425375,425765,3327196,339903,549767,889670,633255,570830,636370,629518,488229,524517,3482719,6809915,8617344,8617344
Belgium,1951,BE,BEL,EUR,356897,573448,930345,633872,607159,618379,609104,431671,430198,3330383,342478,557999,900477,624151,589383,617068,633493,496870,533232,3494197,6824580,8655405,8655405
Belgium,1952,BE,BEL,EUR,355216,588079,943295,624786,630308,591690,613259,439722,434575,3334340,340822,570820,911642,616797,613447,590763,636153,506853,542294,3506307,6840647,8695582,8695582
Belgium,1953,BE,BEL,EUR,355647,601080,956727,617860,655788,562419,617316,447810,438964,3340157,340544,582398,922942,611491,639281,562231,639212,516585,551783,3520583,6860740,8740410,8740410
Belgium,1954,BE,BEL,EUR,357166,614314,971480,611551,672998,541859,620009,456510,442851,3345778,341609,593376,934985,606468,658267,542052,640456,526610,561122,3534975,6880753,8787229,8787229
Belgium,1955,BE,BEL,EUR,359833,630457,990290,601122,675237,538225,620377,466706,445987,3347654,344266,607270,951536,596483,663045,538471,639435,537280,570331,3545045,6892699,8834526,8834526
Belgium,1956,BE,BEL,EUR,363715,651125,1014840,584843,670850,543943,616855,478735,448502,3343728,348033,626331,974364,580003,660738,544159,635889,548483,579300,3548572,6892300,8881501,8881501
Belgium,1957,BE,BEL,EUR,368396,672922,1041318,569632,666832,548398,612235,491051,451835,3339983,352488,646778,999266,563913,658509,548581,631545,559543,589315,3551406,6891389,8931969,8931969
Belgium,1958,BE,BEL,EUR,373435,690369,1063804,563191,660586,552128,609638,502091,455664,3343298,357199,663146,1020345,556018,654069,551860,628863,568526,600892,3560228,6903526,8987674,8987674
Belgium,1959,BE,BEL,EUR,379124,703975,1083099,564403,652071,557287,606343,512035,460974,3353113,362413,675817,1038230,555418,647245,556548,625536,576156,614045,3574948,6928061,9049391,9049391
Belgium,1960,BE,BEL,EUR,384248,717111,1101359,568592,643287,567150,597542,520323,465765,3362659,366923,688056,1054979,557773,639662,566514,616779,582893,626110,3589731,6952390,9108724,9108724
Belgium,1961,BE,BEL,EUR,389280,725139,1114419,579749,635145,585308,580061,525767,471592,3377622,371321,695795,1067116,566662,631784,585591,598682,587346,639246,3609311,6986933,9168469,9168469
Belgium,1962,BE,BEL,EUR,393330,729515,1122845,595837,629173,609569,555464,529600,479014,3398657,375053,700005,1075058,580235,625641,610110,573496,590534,653751,3633767,7032424,9230329,9230329
Belgium,1963,BE,BEL,EUR,395762,736090,1131852,610203,625348,636288,528329,532791,484368,3417327,377455,705716,1083171,592546,621526,636348,545966,593770,665724,3655880,7073207,9288221,9288221
Belgium,1964,BE,BEL,EUR,397943,744321,1142264,624501,621988,655295,509712,534817,490536,3436849,379561,713316,1092877,604072,617687,655840,526686,595426,678764,3678475,7115324,9350467,9350467
Belgium,1965,BE,BEL,EUR,399137,753236,1152373,641564,614259,660171,507219,535152,498043,3456408,380611,721798,1102409,618531,608847,661492,523616,594936,693475,3700897,7157305,9412087,9412087
Belgium,1966,BE,BEL,EUR,397354,763006,1160360,663275,600357,658951,513534,532296,506010,3474423,378845,730953,1109798,638359,593421,660135,529605,591853,708162,3721535,7195958,9466115,9466115
Belgium,1967,BE,BEL,EUR,392734,772305,1165039,686383,586951,658090,518718,528606,514573,3493321,374469,739831,1114300,659740,578185,658723,534435,588180,723306,3742569,7235890,9515229,9515229
Belgium,1968,BE,BEL,EUR,385576,780224,1165800,705204,581579,654923,523083,526521,520669,3511979,367666,747496,1115162,677108,570776,655135,538119,586008,736160,3763306,7275285,9556254,9556254
Belgium,1969,BE,BEL,EUR,376102,788287,1164389,719938,583270,649165,528690,523708,525380,3530151,358602,755114,1113716,690760,570297,649088,543028,583053,747616,3783842,7313993,9592100,9592100
Belgium,2031,BE,BEL,EUR,295383,612466,907849,704206,717159,782664,759378,748643,1279192,4991242,281346,585594,866940,674619,689484,771356,754239,741625,1499039,5130362,10121604,11896391,11896391
Belgium,2032,BE,BEL,EUR,294811,608127,902938,699826,718603,781006,762202,742809,1304187,5008633,280746,581277,862023,670568,690463,768323,757928,736580,1520931,5144793,10153426,11918379,11918379
Belgium,2033,BE,BEL,EUR,294440,604868,899308,693109,721706,777733,765056,739220,1327282,5024106,280347,577866,858213,664554,693169,763391,761396,733993,1541273,5157776,10181882,11939397,11939397
Belgium,2034,BE,BEL,EUR,294402,602709,897111,684445,726151,772721,767790,737009,1349456,5037572,280278,575478,855756,656748,697356,756660,764616,732586,1561125,5169091,10206663,11959522,11959522
Belgium,2035,BE,BEL,EUR,294724,601540,896264,674371,730751,766724,770496,735168,1371574,5049084,280560,574098,854658,647315,702071,748921,767499,731741,1581053,5178600,10227684,11978613,11978613
Belgium,2036,BE,BEL,EUR,295268,600615,895883,664323,735154,759573,773869,733469,1393177,5059565,281055,572957,854012,637821,706804,739952,770693,731078,1600857,5187205,10246770,11996665,11996665
Belgium,2037,BE,BEL,EUR,295940,599390,895330,655608,739507,751381,777789,732229,1413004,5069518,281675,571562,853237,629500,711651,729993,774261,730639,1619367,5195411,10264929,12013501,12013501
Belgium,2038,BE,BEL,EUR,296747,598141,894888,648036,743322,744229,781234,731635,1430249,5078705,282424,570206,852630,622220,715991,721175,777142,731251,1635154,5202933,10281638,12029156,12029156
Belgium,2039,BE,BEL,EUR,297583,597098,894681,641329,745494,740185,783256,732097,1444690,5087051,283197,569063,852260,615939,718550,715839,777999,733222,1648082,5209631,10296682,12043628,12043628
Belgium,2040,BE,BEL,EUR,298404,596413,894817,635445,745385,739062,784108,733922,1456467,5094389,283958,568280,852238,610408,718929,713746,777093,736468,1658651,5215295,10309684,12056739,12056739
Belgium,2041,BE,BEL,EUR,299138,596175,895313,630351,743000,739560,783870,736791,1467101,5100673,284636,567959,852595,605475,716935,713503,775289,740432,1668222,5219856,10320529,12068442,12068442
Belgium,2042,BE,BEL,EUR,299675,596283,895958,626034,738679,741074,782369,739879,1477941,5105976,285122,567984,853106,601174,712904,714526,772367,744271,1678246,5223488,10329464,12078530,12078530
Belgium,2043,BE,BEL,EUR,299880,596724,896604,622794,732028,744237,779282,743014,1489035,5110390,285293,568339,853632,597773,706920,717264,767568,747911,1688757,5226193,10336583,12086810,12086810
Belgium,2044,BE,BEL,EUR,299603,597523,897126,620654,723434,748725,774477,746061,1500601,5113952,285010,569049,854059,595394,699143,721480,760985,751321,1699656,5227979,10341931,12093128,12093128
Belgium,2045,BE,BEL,EUR,298940,598677,897617,619499,713437,753369,768711,749113,1512539,5116668,284362,570100,854462,594024,689743,726222,753416,754435,1711133,5228973,10345641,12097719,12097719
Belgium,2046,BE,BEL,EUR,297886,599956,897842,618585,703463,757812,761810,752822,1524215,5118707,283348,571275,854623,592893,680280,730976,744635,757857,1722606,5229247,10347954,12100428,12100428
Belgium,2047,BE,BEL,EUR,296387,601170,897557,617375,694817,762200,753887,757034,1534826,5120139,281919,572388,854307,591506,671993,735848,734876,761633,1733043,5228899,10349038,12100897,12100897
Belgium,2048,BE,BEL,EUR,294511,602186,896697,616138,687308,766052,746975,760740,1543861,5121074,280130,573310,853440,590158,664741,740202,726235,764710,1742030,5228076,10349150,12099277,12099277
Belgium,2049,BE,BEL,EUR,292488,602752,895240,615109,680661,768266,743130,763003,1551560,5121729,278202,573806,852008,589025,658486,742781,721047,765764,1749767,5226870,10348599,12095849,12095849
Belgium,2050,BE,BEL,EUR,290312,602913,893225,614432,674832,768210,742165,764080,1558342,5122061,276132,573920,850052,588250,652978,743187,719075,765070,1756758,5225318,10347379,12090657,12090657
Benin,1970,BJ,BEN,AFR,270307,379906,650213,253472,183761,128578,101461,80065,67058,814395,267162,377249,644411,265267,210070,147598,115704,90620,85159,914418,1728813,3023443,3023443
Benin,1971,BJ,BEN,AFR,276809,392475,669284,260366,188430,130551,101792,80064,67717,828920,273463,389579,663042,268956,215116,150261,116361,90909,85530,927133,1756053,3088381,3088381
Benin,1972,BJ,BEN,AFR,283723,405148,688871,268422,192559,132763,102229,80030,68427,844430,280135,402020,682155,273749,219693,153165,117051,91286,86015,940959,1785389,3156408,3156408
Benin,1973,BJ,BEN,AFR,290927,417902,708829,278097,195695,135277,102778,79990,69155,860992,287053,414553,701606,280153,223306,156351,117841,91736,86569,955956,1816948,3227380,3227380
Benin,1974,BJ,BEN,AFR,298330,430764,729094,290356,196803,138195,103429,79982,69876,878641,294147,427217,721364,289131,224917,159901,118810,92255,87161,972175,1850816,3301276,3301276
Benin,1975,BJ,BEN,AFR,306068,443722,749790,301820,199352,141524,104212,80037,70590,897535,301522,440018,741540,298939,226358,163839,120035,92839,87827,989837,1887372,3378703,3378703
Benin,1976,BJ,BEN,AFR,314133,456736,770869,311412,204758,145190,105169,80172,71331,918032,309167,452919,762086,308534,229005,168119,121549,93525,88615,1009347,1927379,3460329,3460329
Benin,1977,BJ,BEN,AFR,322547,469890,792437,321908,210213,149212,106328,80391,72087,940139,317110,466016,783126,319068,231727,172718,123394,94325,89521,1030753,1970892,3546454,3546454
Benin,1978,BJ,BEN,AFR,331321,483255,814576,333015,215783,153592,107683,80680,72822,963575,325380,479444,804824,330275,234619,177694,125552,95225,90579,1053944,2017519,3636927,3636927
Benin,1979,BJ,BEN,AFR,340940,496788,837728,344656,221594,158242,109222,81033,73506,988253,334432,493167,827599,342093,237777,183028,127953,96179,91776,1078806,2067059,3732394,3732394
Benin,1980,BJ,BEN,AFR,351955,510639,862594,356731,227848,163001,110989,81441,74130,1014140,344760,507288,852048,354400,241423,188516,130595,97167,93059,1105160,2119300,3833939,3833939
Benin,1981,BJ,BEN,AFR,364208,525010,889218,369133,234835,167650,112995,81928,74741,1041282,356254,521929,878183,367056,245829,193911,133501,98181,94406,1132884,2174166,3941569,3941569
Benin,1982,BJ,BEN,AFR,377160,540087,917247,381670,242965,171853,115235,82507,75325,1069555,368444,537213,905657,379893,251362,198939,136655,99229,95843,1161921,2231476,4054385,4054385
Benin,1983,BJ,BEN,AFR,390395,555803,946198,394281,252630,175172,117755,83172,75891,1098901,380956,553066,934022,392897,258482,203139,140110,100374,97400,1192402,2291303,4171526,4171526
Benin,1984,BJ,BEN,AFR,403645,572477,976122,406980,264690,176627,120633,83913,76422,1129265,393492,569821,963313,406108,268074,205517,143934,101704,99039,1224376,2353641,4293070,4293070
Benin,1985,BJ,BEN,AFR,416503,590769,1007272,419783,276026,179432,123892,84767,76996,1160896,405625,588015,993640,419482,278458,207742,148122,103243,100703,1257750,2418646,4419552,4419552
Benin,1986,BJ,BEN,AFR,428981,610664,1039645,432647,285649,184902,127470,85787,77654,1194109,417370,607572,1024942,432929,288622,211082,152615,105023,102419,1292690,2486799,4551382,4551382
Benin,1987,BJ,BEN,AFR,441557,631694,1073251,445636,296113,190428,131377,86983,78372,1228909,429218,628075,1057293,446534,299650,214461,157401,107073,104219,1329338,2558247,4688787,4688787
Benin,1988,BJ,BEN,AFR,454642,653550,1108192,458855,307155,196078,135631,88369,79180,1265268,441547,649160,1090707,460360,311245,217933,162495,109365,106065,1367463,2632731,4831624,4831624
Benin,1989,BJ,BEN,AFR,467828,676319,1144147,472389,318822,202024,140175,89941,80072,1303423,453888,670938,1124826,474484,323457,221644,167900,111849,107937,1407271,2710694,4979680,4979680
Benin,1990,BJ,BEN,AFR,481171,700018,1181189,486360,331013,208435,144860,91727,81023,1343418,466289,693514,1159803,489091,336210,225827,173463,114543,109878,1449012,2792430,5133419,5133419
Benin,1991,BJ,BEN,AFR,495079,724519,1219598,500847,343509,215518,149439,93719,82019,1385051,479137,716819,1195956,504193,349275,230705,178932,117465,111880,1492450,2877501,5293046,5293046
Benin,1992,BJ,BEN,AFR,509139,749839,1258978,516013,356123,223644,153612,95900,83060,1428352,492080,740859,1232939,519887,362474,236608,184038,120590,113909,1537506,2965858,5457778,5457778
Benin,1993,BJ,BEN,AFR,525819,778095,1303914,543133,381263,239359,159690,99532,85280,1508257,507679,767687,1275366,548247,388359,249719,190653,124891,116778,1618647,3126904,5706181,5706181
Benin,1994,BJ,BEN,AFR,544744,805557,1350301,563879,400335,254477,162853,102945,86980,1571469,525500,793370,1318870,569424,408169,262468,194443,129030,119227,1682761,3254230,5923394,5923394
Benin,1995,BJ,BEN,AFR,561597,830476,1392073,571011,403672,261296,163948,105229,87438,1592594,541408,816113,1357521,575445,412022,268728,195156,132268,120705,1704324,3296918,6046511,6046511
Benin,1996,BJ,BEN,AFR,576537,856709,1433246,585620,411936,268928,168543,108271,88627,1631925,555712,839888,1395600,589020,420691,276901,197740,136091,122648,1743091,3375016,6203860,6203860
Benin,1997,BJ,BEN,AFR,591455,883766,1475221,605101,423473,278921,173893,111898,90286,1683572,570119,864421,1434540,607494,432595,287307,200915,140391,124988,1793690,3477262,6387026,6387026
Benin,1998,BJ,BEN,AFR,606417,911634,1518051,626897,436386,290061,179613,115920,92145,1741022,584563,889999,1474562,628368,446038,298915,204471,145092,127651,1850535,3591557,6584183,6584183
Benin,1999,BJ,BEN,AFR,619037,942439,1561476,649910,449582,301775,185601,120157,94105,1801130,596740,918640,1515380,650499,459965,311220,208309,150102,130507,1910602,3711732,6788589,6788589
Benin,2000,BJ,BEN,AFR,630924,974141,1605065,673947,463020,313881,191962,124476,96179,1863465,608287,948252,1556539,673549,474212,323956,212554,155206,133483,1972960,3836425,6998023,6998023
Benin,2001,BJ,BEN,AFR,644923,1003965,1648888,698836,476848,326226,198922,128675,98371,1927878,622074,976052,1598126,697291,488819,336927,217418,160172,136530,2037157,3965035,7212041,7212041
Benin,2002,BJ,BEN,AFR,660276,1033356,1693632,724579,491284,338652,206828,132500,100707,1994550,637379,1003327,1640706,721630,503861,349921,223185,164719,139574,2102890,4097440,7431783,7431783
Benin,2003,BJ,BEN,AFR,677505,1062674,1740179,751185,506341,351121,216017,135597,103209,2063470,654584,1030588,1685172,746598,519350,362954,230283,168476,142731,2170392,4233862,7659208,7659208
Benin,2004,BJ,BEN,AFR,696468,1092375,1788843,777960,522413,363654,227216,137201,105960,2134404,673410,1058388,1731798,771508,535673,376072,239492,170632,146130,2239507,4373911,7894554,7894554
Benin,2005,BJ,BEN,AFR,717006,1122520,1839526,805680,541416,376872,238129,140070,109088,2211255,693699,1087006,1780705,798542,556127,390493,249889,172876,150006,2317933,4529188,8149419,8149419
Benin,2006,BJ,BEN,AFR,738672,1152251,1890923,832013,560609,389384,247362,144999,112320,2286687,715058,1115646,1830704,823563,576480,404272,259876,176008,154121,2394320,4681007,8402631,8402631
Benin,2007,BJ,BEN,AFR,760068,1182422,1942490,857020,579429,401154,257003,149843,115711,2360160,736137,1144869,1881006,845410,594699,416675,270047,178954,158322,2464107,4824267,8647761,8647761
Benin,2008,BJ,BEN,AFR,780020,1214408,1994428,883970,600382,413599,267396,154912,119501,2439760,755894,1176001,1931895,869563,614983,429795,280983,182127,162934,2540385,4980145,8906469,8906469
Benin,2009,BJ,BEN,AFR,798828,1245738,2044566,913912,622417,426164,278238,160190,123464,2524385,774772,1206516,1981288,896977,636351,443151,292436,185528,167826,2622269,5146654,9172514,9172514
Benin,2010,BJ,BEN,AFR,817684,1277502,2095186,944826,645438,438965,289452,165822,127580,2612083,793836,1237493,2031329,925407,658510,456750,304266,189314,172864,2707111,5319194,9445710,9445710
Benin,2011,BJ,BEN,AFR,836609,1312715,2149324,974004,669302,452160,300919,171990,131707,2700082,812875,1272030,2084905,952162,681291,470705,316333,193696,177880,2792067,5492149,9726380,9726380
Benin,2012,BJ,BEN,AFR,856589,1349517,2206106,1002674,693877,465886,312455,178970,135616,2789478,832740,1308231,2140971,978283,704357,484988,328417,198889,182585,2877519,5666997,10014078,10014078
Benin,2013,BJ,BEN,AFR,879025,1386431,2265456,1031070,719003,480060,323985,187003,139038,2880159,854825,1344711,2199536,1004097,727501,499486,340482,205250,186762,2963578,5843737,10308730,10308730
Benin,2014,BJ,BEN,AFR,903937,1423842,2327779,1060101,744507,495280,335618,196694,141409,2973609,879276,1381839,2261115,1030828,750700,514829,352680,213446,189856,3052339,6025948,10614844,10614844
Benin,2015,BJ,BEN,AFR,930632,1462374,2393006,1089529,770108,512172,347347,205955,144887,3069998,905376,1420186,2325562,1058401,773739,531660,365012,222283,193126,3144221,6214219,10932783,10932783
Benin,2016,BJ,BEN,AFR,958544,1502235,2460779,1118760,795783,530542,359035,214111,150255,3168486,932541,1459795,2392336,1086265,796648,549795,377332,231021,197421,3238482,6406968,11260085,11260085
Benin,2017,BJ,BEN,AFR,986936,1543417,2530353,1148761,821614,550035,370745,222907,155790,3269852,960132,1500549,2460681,1115251,819645,568867,389696,240448,201982,3335889,6605741,11596779,11596779
Benin,2018,BJ,BEN,AFR,1014297,1585553,2599850,1180263,848011,570357,382542,232143,161568,3374884,986722,1542176,2528898,1145820,843277,588547,402155,250347,206901,3437047,6811931,11940683,11940683
Benin,2019,BJ,BEN,AFR,1039480,1629025,2668505,1211142,877128,591558,394411,241766,167618,3483623,1011099,1585268,2596367,1175777,869686,608911,414704,260674,212203,3541955,7025578,12290444,12290444
Benin,2020,BJ,BEN,AFR,1062493,1674287,2736780,1242420,907128,613600,406319,251354,173175,3593996,1033227,1630210,2663437,1206151,896989,629923,427371,271129,217355,3648918,7242914,12643123,12643123
Benin,2021,BJ,BEN,AFR,1083464,1720825,2804289,1276944,935365,636305,418298,260651,177860,3705423,1053206,1676324,2729530,1239937,922630,651445,440205,281461,221976,3757654,7463077,12996895,12996895
Benin,2022,BJ,BEN,AFR,1102130,1768800,2870930,1312781,962965,659636,430651,269853,182480,3818366,1070973,1723852,2794825,1275410,947888,673489,453455,291776,226727,3868745,7687111,13352864,13352864
Benin,2023,BJ,BEN,AFR,1118737,1818160,2936897,1348619,990357,683737,443674,279357,188080,3933824,1086996,1772627,2859623,1311135,973182,696062,467215,302363,232526,3982483,7916307,13712828,13712828
Benin,2024,BJ,BEN,AFR,1134158,1867812,3001970,1384980,1018152,708145,457938,289520,195394,4054129,1101968,1821415,2923383,1347536,999171,718618,481920,313460,239886,4100591,8154720,14080072,14080072
Benin,2025,BJ,BEN,AFR,1149373,1917078,3066451,1422514,1046068,732447,473824,300038,203846,4178737,1116779,1869467,2986246,1385177,1025650,740760,498007,324833,248346,4222773,8401510,14454199,14454199
Benin,2026,BJ,BEN,AFR,1164620,1965298,3129918,1461446,1073833,756823,491090,310533,212839,4306564,1131718,1916323,3048041,1424162,1052439,762775,515323,336211,257493,4348403,8654967,14832937,14832937
Benin,2027,BJ,BEN,AFR,1180104,2011521,3191625,1501746,1102356,781321,509395,321050,222366,4438234,1146819,1961313,3108132,1464365,1080318,784848,533515,347640,267328,4478014,8916248,15216009,15216009
Benin,2028,BJ,BEN,AFR,1196297,2054993,3251290,1543040,1132388,806359,528457,331633,232289,4574166,1162459,2003782,3166241,1505512,1109808,807544,552277,359158,277724,4612023,9186189,15603721,15603721
Benin,2029,BJ,BEN,AFR,1213232,2095428,3308660,1585703,1161911,834006,548334,342274,242586,4714814,1178816,2043243,3222059,1548143,1138783,832908,571671,370748,288653,4750906,9465720,15996447,15996447
Benin,2030,BJ,BEN,AFR,1230297,2133473,3363770,1630161,1191888,862510,569043,353103,253227,4859932,1195408,2080297,3275705,1592637,1168291,859189,591716,382536,300057,4894426,9754358,16393827,16393827
Benin,1950,BJ,BEN,AFR,147011,226593,373604,170437,139178,121738,98524,73765,78205,681847,165232,258291,423523,193270,156035,131121,114609,90910,99527,785472,1467319,2264452,2264452
Benin,1951,BJ,BEN,AFR,151494,231803,383297,172628,139356,121433,99188,73639,76426,682670,165069,263757,428826,196115,156490,131094,114107,90952,97124,785882,1468552,2280678,2280678
Benin,1952,BJ,BEN,AFR,156318,236373,392691,175097,139661,121054,99941,73600,74610,683963,165658,268640,434298,199234,156964,131149,113532,91148,94851,786878,1470841,2297832,2297832
Benin,1953,BJ,BEN,AFR,162373,239773,402146,177914,140092,120644,100697,73635,72846,685828,167677,272377,440054,202667,157541,131290,112950,91429,92771,788648,1474476,2316684,2316684
Benin,1954,BJ,BEN,AFR,170858,240798,411656,181199,140655,120273,101335,73755,71253,688470,172221,273749,445970,206488,158331,131499,112433,91668,90854,791273,1479743,2337371,2337371
Benin,1955,BJ,BEN,AFR,177878,243456,421334,184941,141361,119976,101801,73971,69863,691913,177217,274847,452064,210701,159394,131760,112011,91799,89100,794765,1486678,2360081,2360081
Benin,1956,BJ,BEN,AFR,182058,249324,431382,189022,142250,119750,102110,74272,68700,696104,181253,277257,458510,215223,160767,132112,111710,91857,87609,799278,1495382,2385282,2385282
Benin,1957,BJ,BEN,AFR,186733,255120,441853,193458,143356,119612,102257,74626,67764,701073,185764,279619,465383,220013,162480,132551,111535,91814,86344,804737,1505810,2413053,2413053
Benin,1958,BJ,BEN,AFR,191816,260927,452743,198269,144684,119565,102268,75038,67008,706832,190696,282021,472717,225110,164502,133048,111462,91674,85321,811117,1517949,2443407,2443407
Benin,1959,BJ,BEN,AFR,197285,266935,464220,203350,146230,119608,102201,75542,66366,713297,196029,284580,480609,230506,166754,133579,111455,91496,84574,818364,1531661,2476498,2476498
Benin,1960,BJ,BEN,AFR,203130,273360,476490,208512,148029,119746,102086,76113,65835,720321,201747,287550,489297,235967,169231,134119,111507,91292,84053,826169,1546490,2512284,2512284
Benin,1961,BJ,BEN,AFR,209560,280522,490082,213464,150094,119983,101912,76743,65375,727571,208034,291257,499291,241216,171967,134669,111630,91047,83751,834280,1561851,2551216,2551216
Benin,1962,BJ,BEN,AFR,216454,288906,505360,217831,152410,120329,101683,77437,64998,734688,214779,296108,510887,245934,174944,135237,111825,90758,83666,842364,1577052,2593302,2593302
Benin,1963,BJ,BEN,AFR,223491,299000,522491,221107,155044,120793,101431,78130,64722,741227,221678,302653,524331,249602,178210,135901,112098,90470,83750,850031,1591258,2638082,2638082
Benin,1964,BJ,BEN,AFR,230674,311843,542517,222183,158115,121372,101211,78731,64622,746234,228704,311886,540590,251099,181848,136761,112433,90243,83894,856278,1602512,2685619,2685619
Benin,1965,BJ,BEN,AFR,237885,323795,561680,224758,161616,122086,101063,79210,64709,753442,235742,321925,557667,252348,185863,137875,112822,90096,84044,863048,1616490,2735843,2735843
Benin,1966,BJ,BEN,AFR,244804,333659,578463,230326,165446,122975,100983,79565,64953,764248,242488,331649,574137,254788,190186,139268,113289,90039,84224,871794,1636042,2788642,2788642
Benin,1967,BJ,BEN,AFR,251318,344415,595733,235869,169610,124062,100975,79799,65341,775656,248819,342266,591085,257199,194772,140980,113833,90086,84402,881272,1656928,2843739,2843739
Benin,1968,BJ,BEN,AFR,257675,355755,613430,241466,174129,125351,101055,79937,65839,787777,254971,353466,608437,259661,199668,142977,114440,90221,84611,891578,1679355,2901218,2901218
Benin,1969,BJ,BEN,AFR,263988,367619,631607,247269,178906,126845,101218,80018,66426,800682,261063,365173,626236,262271,204839,145184,115070,90399,84872,902635,1703317,2961166,2961166
Benin,2031,BJ,BEN,AFR,1247342,2169317,3416659,1675894,1225113,889409,590495,364256,264141,5009308,1212030,2115224,3327254,1638280,1201248,883967,612329,394647,311888,5042359,10051667,16795573,16795573
Benin,2032,BJ,BEN,AFR,1264694,2202940,3467634,1723138,1259890,915960,612682,375895,275251,5162816,1228942,2148019,3376961,1685247,1236020,908524,633501,407200,324077,5194569,10357385,17201982,17201982
Benin,2033,BJ,BEN,AFR,1282640,2235496,3518136,1771842,1294896,942509,635615,388025,286566,5319453,1246431,2179783,3426214,1733537,1271243,933294,655219,420158,336626,5350077,10669530,17613873,17613873
Benin,2034,BJ,BEN,AFR,1300567,2267851,3568418,1820844,1330432,969444,658718,400966,298095,5478499,1263946,2211428,3475374,1781933,1307171,958761,676885,433803,349555,5508108,10986607,18030401,18030401
Benin,2035,BJ,BEN,AFR,1317977,2300101,3618078,1869431,1367078,996468,681651,415191,309844,5639663,1280950,2243178,3524128,1829641,1344308,984705,698148,448634,362865,5668301,11307964,18450172,18450172
Benin,2036,BJ,BEN,AFR,1335542,2332378,3667920,1917012,1405090,1023368,704689,430655,321860,5802674,1298099,2275089,3573188,1876205,1382783,1010964,719319,464613,376596,5830480,11633154,18874268,18874268
Benin,2037,BJ,BEN,AFR,1353429,2365193,3718622,1962653,1444452,1051008,727855,447049,334164,5967181,1315629,2307464,3623093,1920967,1422476,1038299,740566,481396,390768,5994472,11961653,19303369,19303369
Benin,2038,BJ,BEN,AFR,1371074,2399267,3770341,2005619,1484795,1080103,751540,464103,346674,6132834,1332933,2340935,3673868,1963278,1463118,1067214,762420,498702,405288,6160020,12292854,19737070,19737070
Benin,2039,BJ,BEN,AFR,1389210,2434050,3823260,2045637,1526487,1108754,777700,481869,359379,6299826,1350682,2375146,3725828,2002662,1505248,1095679,786835,516579,420110,6327113,12626939,20176029,20176029
Benin,2040,BJ,BEN,AFR,1408708,2468484,3877192,2083338,1569933,1137871,804668,500365,372356,6468531,1369748,2409108,3778856,2039699,1549210,1124682,812136,535045,435300,6496072,12964603,20620647,20620647
Benin,2041,BJ,BEN,AFR,1428402,2503059,3931461,2118905,1614639,1170094,830135,519504,385674,6638951,1388995,2443249,3832244,2074665,1594328,1157026,836015,554025,450889,6666948,13305899,21069601,21069601
Benin,2042,BJ,BEN,AFR,1447883,2538254,3986137,2152329,1660828,1203817,855283,539293,399384,6810934,1408038,2478052,3886090,2107564,1640766,1191140,859695,573515,466937,6839617,13650551,21522780,21522780
Benin,2043,BJ,BEN,AFR,1467254,2573784,4041038,2184731,1708443,1237777,880438,559728,413505,6984622,1427008,2513199,3940207,2139463,1688521,1225707,883602,593501,483406,7014200,13998822,21980068,21980068
Benin,2044,BJ,BEN,AFR,1485950,2609788,4095738,2216951,1756371,1272264,905970,580317,428328,7160201,1445349,2548828,3994177,2171269,1736404,1260981,908180,613441,500585,7190860,14351061,22440979,22440979
Benin,2045,BJ,BEN,AFR,1503920,2646659,4150579,2249082,1803914,1307829,931598,600791,444249,7337463,1463012,2585292,4048304,2203191,1783642,1297455,933234,633055,518894,7369471,14706934,22905813,22905813
Benin,2046,BJ,BEN,AFR,1521238,2683883,4205121,2281248,1850499,1344715,957127,621404,461255,7516248,1480022,2622098,4102120,2235280,1829779,1335238,958606,652633,538342,7549878,15066126,23373375,23373375
Benin,2047,BJ,BEN,AFR,1537169,2721218,4258387,2313944,1895228,1382913,983368,642167,479108,7696728,1495660,2659070,4154730,2267824,1874175,1374224,985025,672317,558650,7732215,15428943,23842061,23842061
Benin,2048,BJ,BEN,AFR,1552448,2758218,4310666,2347872,1937392,1422079,1011016,663401,497541,7879301,1510667,2695762,4206429,2301458,1916197,1414168,1012977,692576,579469,7916845,15796146,24313238,24313238
Benin,2049,BJ,BEN,AFR,1567718,2795025,4362743,2382497,1976716,1462572,1038322,686892,516553,8063552,1525644,2732275,4257919,2335824,1955381,1455589,1040566,715234,600845,8103439,16166991,24787656,24787656
Benin,2050,BJ,BEN,AFR,1582177,2832451,4414628,2416789,2013822,1504770,1066102,711122,536219,8248824,1539829,2769415,4309244,2369954,1992297,1498816,1068709,738732,622836,8291344,16540168,25264035,25264035
Burkina Faso,1970,BF,BFA,AFR,496174,698863,1195037,506400,376551,262762,212940,147872,88889,1595414,487649,695591,1183240,507890,387088,282831,221828,151120,87215,1637972,3233386,5611666,5611666
Burkina Faso,1971,BF,BFA,AFR,505881,716668,1222549,509230,383219,263193,212985,149923,91121,1609671,497121,713268,1210389,514048,394852,285819,224566,154960,90932,1665177,3274848,5707793,5707793
Burkina Faso,1972,BF,BFA,AFR,515647,734830,1250477,513577,388396,264102,212719,151861,93374,1624029,506572,731292,1237864,521573,401552,289179,227167,158743,94701,1692915,3316944,5805283,5805283
Burkina Faso,1973,BF,BFA,AFR,525999,753437,1279436,523082,389638,265752,212264,153681,95641,1640058,516510,749718,1266228,532756,405599,293017,229662,162439,98539,1722012,3362070,5907742,5907742
Burkina Faso,1974,BF,BFA,AFR,537724,772251,1309975,537448,388137,268154,211712,155399,98022,1658872,527761,768357,1296118,547355,407848,297307,232085,166041,102540,1753176,3412048,6018141,6018141
Burkina Faso,1975,BF,BFA,AFR,551458,791314,1342772,553020,387768,271320,211192,157033,100588,1680921,540941,787167,1328108,562868,410936,302051,234486,169552,106745,1786638,3467559,6138444,6138444
Burkina Faso,1976,BF,BFA,AFR,567338,810921,1378259,569352,388934,275361,210833,158590,103362,1706432,556194,806365,1362559,578867,415234,307365,236936,172967,111147,1822516,3528948,6269765,6269765
Burkina Faso,1977,BF,BFA,AFR,585807,831368,1417175,587232,392111,280771,210898,160065,106276,1737353,573931,826262,1400193,595902,420819,313564,239560,176286,115720,1861851,3599204,6416569,6416569
Burkina Faso,1978,BF,BFA,AFR,607013,853087,1460100,605979,396702,287465,211331,161420,109241,1772138,594288,847333,1441621,613580,427325,320687,242365,179518,120433,1903908,3676046,6577779,6577779
Burkina Faso,1979,BF,BFA,AFR,630140,876394,1506534,625012,401923,295105,212128,162655,112262,1809085,616539,869882,1486421,631638,434323,328613,245369,182690,125271,1947904,3756989,6749939,6749939
Burkina Faso,1980,BF,BFA,AFR,654093,901644,1555737,644703,408260,303723,213466,163779,115279,1849210,639579,894198,1533777,650289,442074,337301,248653,185797,130136,1994250,3843460,6932967,6932967
Burkina Faso,1981,BF,BFA,AFR,678144,929067,1607211,664514,415731,312691,215379,164757,118266,1891338,662691,920448,1583139,669140,450698,346194,252281,188794,134935,2042042,3933380,7123730,7123730
Burkina Faso,1982,BF,BFA,AFR,701796,959094,1660890,684344,425039,320925,218018,165606,121212,1935144,685369,949135,1634504,688165,460862,354437,256394,191722,139706,2091286,4026430,7321817,7321817
Burkina Faso,1983,BF,BFA,AFR,724675,992286,1716961,704970,439802,326043,221566,166389,124135,1982905,707194,980833,1688027,707810,474816,360494,261082,194612,144479,2143293,4126198,7531184,7531184
Burkina Faso,1984,BF,BFA,AFR,747490,1028610,1776100,725817,459115,328695,225832,167109,127047,2033615,728857,1015482,1744339,727657,491972,364908,266202,197441,149246,2197426,4231041,7751476,7751476
Burkina Faso,1985,BF,BFA,AFR,771255,1067468,1838723,745986,478478,331864,230540,167732,129842,2084442,751394,1052526,1803920,747143,509405,369821,271618,200178,153935,2252100,4336542,7979185,7979185
Burkina Faso,1986,BF,BFA,AFR,795328,1108174,1903502,765009,496422,335356,235521,168238,132373,2132919,774332,1091263,1865595,765990,526125,375267,277278,202782,158371,2305813,4438732,8207827,8207827
Burkina Faso,1987,BF,BFA,AFR,818868,1150276,1969144,783298,512953,338809,240826,168674,134575,2179135,796880,1131169,1928049,784526,542217,380898,283285,205274,162473,2358673,4537808,8434996,8434996
Burkina Faso,1988,BF,BFA,AFR,841471,1193396,2034867,802319,528774,342490,246759,169123,136457,2225922,818610,1171912,1990522,803778,558006,386774,289837,207728,166272,2412395,4638317,8663720,8663720
Burkina Faso,1989,BF,BFA,AFR,862493,1237698,2100191,822795,544236,346412,253347,169730,138056,2274576,838816,1213727,2052543,824296,573730,392856,296985,210243,169807,2467917,4742493,8895234,8895234
Burkina Faso,1990,BF,BFA,AFR,881942,1283358,2165300,845112,559355,350640,260451,170600,139415,2325573,857423,1256985,2114408,846490,589495,399273,304659,212933,173230,2526080,4851653,9131361,9131361
Burkina Faso,1991,BF,BFA,AFR,900577,1329328,2229905,868016,572253,354647,267273,171726,140498,2374413,875230,1300749,2175979,869799,604308,405924,312294,215875,176567,2584767,4959180,9365064,9365064
Burkina Faso,1992,BF,BFA,AFR,919091,1374305,2293396,892753,583633,359465,272995,173278,141320,2423444,892969,1343648,2236617,895053,618467,413556,319124,219164,179728,2645092,5068536,9598555,9598555
Burkina Faso,1993,BF,BFA,AFR,938027,1417319,2355346,921685,595609,368634,275446,175375,141899,2478648,911168,1384661,2295829,923723,633026,424302,323680,222829,182685,2710245,5188893,9840075,9840075
Burkina Faso,1994,BF,BFA,AFR,958069,1458274,2416343,954754,608182,381624,275372,177906,142257,2540095,930588,1423768,2354356,955815,647944,437806,326576,226800,185523,2780464,5320559,10091256,10091256
Burkina Faso,1995,BF,BFA,AFR,979597,1498242,2477839,991129,621269,395069,275944,180853,142560,2606824,951501,1462036,2413537,990699,663151,451773,330016,231071,188356,2855066,5461890,10353263,10353263
Burkina Faso,1996,BF,BFA,AFR,1002749,1537750,2540499,1028990,634025,407873,277156,184156,142795,2674995,973789,1500088,2473877,1027140,678261,465482,334149,235656,191143,2931831,5606826,10621210,10621210
Burkina Faso,1997,BF,BFA,AFR,1027145,1576911,2604056,1068703,647704,420532,278907,187922,142992,2746760,997177,1537934,2535111,1065066,693969,479212,338729,240636,193816,3011428,5758188,10897353,10897353
Burkina Faso,1998,BF,BFA,AFR,1053158,1616133,2669291,1113498,667066,435045,282022,192707,143566,2833904,1022121,1575830,2597951,1106101,712954,493895,344060,246311,196601,3099922,5933826,11201063,11201063
Burkina Faso,1999,BF,BFA,AFR,1081233,1655327,2736560,1162667,692369,451509,286417,198513,144593,2936068,1048847,1613896,2662743,1150176,735640,509725,350140,252788,199707,3198176,6134244,11533554,11533554
Burkina Faso,2000,BF,BFA,AFR,1110928,1694447,2805375,1213274,721216,468677,291576,204931,145891,3045565,1076788,1652235,2729023,1195893,760996,526175,356803,259887,203183,3302937,6348502,11882888,11882888
Burkina Faso,2001,BF,BFA,AFR,1141387,1734803,2876190,1264621,754274,486700,297909,211644,147559,3162707,1105400,1691824,2797224,1242465,789415,543221,364342,267215,206986,3413644,6576351,12249764,12249764
Burkina Faso,2002,BF,BFA,AFR,1172398,1777099,2949497,1315185,791835,505698,306087,217860,149680,3286345,1134750,1733053,2867803,1288321,821161,560838,373296,273981,211033,3528630,6814975,12632269,12632269
Burkina Faso,2003,BF,BFA,AFR,1205736,1821677,3027413,1363134,833428,525492,318228,221345,152278,3413905,1166654,1776212,2942866,1331974,856210,578970,385143,278732,215366,3646395,7060300,13030591,13030591
Burkina Faso,2004,BF,BFA,AFR,1241696,1869435,3111131,1408226,878579,545902,333792,222743,155244,3544486,1201499,1822161,3023660,1373310,894342,597488,399547,282030,219982,3766699,7311185,13445977,13445977
Burkina Faso,2005,BF,BFA,AFR,1280024,1920532,3200556,1450780,925768,566662,349746,224747,158463,3676166,1238862,1871292,3110154,1413050,934675,616287,414429,285884,224928,3889253,7565419,13876127,13876127
Burkina Faso,2006,BF,BFA,AFR,1322327,1974306,3296633,1490109,972455,587278,365314,227449,161923,3804528,1280161,1922976,3203137,1451149,975650,635199,429228,290489,230233,4011948,7816476,14316242,14316242
Burkina Faso,2007,BF,BFA,AFR,1368081,2030512,3398593,1525196,1016152,607185,380201,230447,165580,3924761,1324734,1976925,3301659,1487032,1015714,654048,443887,295492,235888,4132061,8056822,14757074,14757074
Burkina Faso,2008,BF,BFA,AFR,1414727,2090713,3505440,1556723,1056188,626845,394328,233690,169617,4037391,1369859,2034864,3404723,1521093,1054439,673383,458401,300878,242170,4250364,8287755,15197915,15197915
Burkina Faso,2009,BF,BFA,AFR,1461164,2155482,3616646,1587708,1095082,647864,408362,237374,174325,4150715,1414545,2097131,3511676,1554854,1093170,694080,473087,306653,249139,4370983,8521698,15650022,15650022
Burkina Faso,2010,BF,BFA,AFR,1506732,2224371,3731103,1619738,1133968,671015,422549,241579,179548,4268397,1458351,2163157,3621508,1589233,1132535,716591,488039,312850,256593,4495841,8764238,16116845,16116845
Burkina Faso,2011,BF,BFA,AFR,1550015,2298305,3848320,1654849,1172892,696918,436985,246599,185042,4393285,1499884,2234147,3734031,1625810,1172318,741394,503303,319780,264412,4627017,9020302,16602651,16602651
Burkina Faso,2012,BF,BFA,AFR,1591053,2377213,3968266,1695097,1212337,726671,452128,253152,190454,4529839,1539170,2310030,3849200,1665892,1212131,769214,519067,328000,272132,4766436,9296275,17113732,17113732
Burkina Faso,2013,BF,BFA,AFR,1630050,2459633,4089683,1738297,1249183,759364,467586,262717,193864,4671011,1576523,2389293,3965816,1708306,1249791,799771,535139,338612,278284,4909903,9580914,17636408,17636408
Burkina Faso,2014,BF,BFA,AFR,1666340,2544349,4210689,1785369,1283928,794944,483328,274911,195762,4818242,1611344,2470972,4082316,1753890,1285552,833026,551443,351352,283336,5058599,9876841,18169842,18169842
Burkina Faso,2015,BF,BFA,AFR,1698938,2630646,4329584,1837512,1319051,833389,499758,287660,198465,4975835,1642666,2554475,4197141,1803548,1321205,868792,568170,364617,289123,5215455,10191290,18718019,18718019
Burkina Faso,2016,BF,BFA,AFR,1725966,2718623,4444589,1893637,1355249,873926,517195,300548,202070,5142625,1668662,2639692,4308354,1856535,1357522,906462,585535,378046,295827,5379927,10522552,19275498,19275498
Burkina Faso,2017,BF,BFA,AFR,1746503,2807855,4554358,1952676,1392252,915625,535794,313561,206392,5316300,1688449,2726046,4414495,1912264,1394435,945351,603737,391699,303220,5550706,10867006,19835858,19835858
Burkina Faso,2018,BF,BFA,AFR,1763201,2895951,4659152,2013737,1427821,956727,555533,326535,211483,5491836,1704606,2811195,4515801,1970914,1430718,984427,623037,405483,311360,5725939,11217775,20392723,20392723
Burkina Faso,2019,BF,BFA,AFR,1779056,2981028,4760084,2077632,1462470,997394,576841,339548,217289,5671174,1720076,2893290,4613366,2033002,1466663,1023910,643792,419472,320175,5907014,11578188,20951639,20951639
Burkina Faso,2020,BF,BFA,AFR,1795234,3061830,4857064,2147207,1499908,1039156,600350,352218,222691,5861530,1735898,2971158,4707056,2099791,1504245,1064630,666345,433368,328588,6096967,11958497,21522626,21522626
Burkina Faso,2021,BF,BFA,AFR,1813766,3135169,4948935,2222712,1540739,1080952,625967,364257,227142,6061769,1753965,3041508,4795473,2171741,1543982,1105583,690660,446742,335807,6294515,12356284,22100683,22100683
Burkina Faso,2022,BF,BFA,AFR,1835582,3199661,5035243,2300511,1581981,1120131,653560,376118,231613,6263914,1775296,3103109,4878405,2246868,1584621,1144925,716993,459991,342806,6496204,12760118,22673762,22673762
Burkina Faso,2023,BF,BFA,AFR,1858431,3258332,5116763,2380689,1624733,1156544,684012,388598,237404,6471980,1797840,3159328,4957168,2324948,1627032,1182259,746155,473940,351241,6705575,13177555,23251485,23251485
Burkina Faso,2024,BF,BFA,AFR,1880464,3313323,5193787,2463235,1670719,1190963,717522,402040,245183,6689662,1819769,3212379,5032148,2405605,1672382,1217915,778223,488763,361755,6924643,13614305,23840247,23840247
Burkina Faso,2025,BF,BFA,AFR,1901632,3364223,5265855,2547103,1719878,1224388,753354,416443,254785,6915951,1840882,3261759,5102641,2487860,1720732,1252790,812578,504363,374156,7152479,14068430,24436925,24436925
Burkina Faso,2026,BF,BFA,AFR,1922549,3411185,5333734,2632514,1771584,1257597,790648,431765,265514,7149622,1861744,3307545,5169289,2571626,1771568,1287640,848518,520640,387756,7387748,14537370,25040390,25040390
Burkina Faso,2027,BF,BFA,AFR,1944262,3454559,5398821,2719405,1825679,1290937,828698,447991,276762,7389472,1883315,3350139,5233454,2656577,1824815,1322730,885457,537606,401968,7629153,15018625,25650897,25650897
Burkina Faso,2028,BF,BFA,AFR,1966881,3494726,5461607,2805627,1883496,1324557,866968,465549,288491,7634688,1905654,3389943,5295597,2740605,1881863,1358044,922945,555699,416737,7875893,15510581,26267784,26267784
Burkina Faso,2029,BF,BFA,AFR,1990868,3533021,5523889,2889232,1945253,1358561,905451,484756,300745,7883998,1929229,3428195,5357424,2821863,1942849,1393618,961095,575229,432122,8126776,16010774,26892087,26892087
Burkina Faso,2030,BF,BFA,AFR,2015977,3570850,5586827,2968597,2010605,1393306,944213,505844,313516,8136081,1953899,3466144,5420043,2898891,2007342,1429755,1000060,596429,448135,8380612,16516693,27523563,27523563
Burkina Faso,1950,BF,BFA,AFR,342630,534467,877097,425678,333962,248457,170174,103165,50501,1331937,330521,502127,832648,395207,304689,218257,141056,78825,34032,1172066,2504003,4213757,4213757
Burkina Faso,1951,BF,BFA,AFR,338082,543793,881875,428164,335000,251546,173231,105164,52498,1345603,329259,511392,840651,399247,308117,223078,145565,81765,36079,1193851,2539454,4261979,4261979
Burkina Faso,1952,BF,BFA,AFR,335947,551825,887772,431350,335649,254435,176236,107177,54472,1359319,329952,519625,849577,403753,311352,227786,150091,84776,38146,1215904,2575223,4312573,4312573
Burkina Faso,1953,BF,BFA,AFR,339325,555131,894456,435024,335676,256972,179134,109212,56422,1372440,334580,524678,859258,408608,314258,232280,154603,87870,40256,1237875,2610315,4364030,4364030
Burkina Faso,1954,BF,BFA,AFR,347198,554769,901967,439226,335319,259190,181984,111305,58361,1385385,342385,527399,869784,413808,316937,236547,159137,91079,42447,1259955,2645340,4417092,4417092
Burkina Faso,1955,BF,BFA,AFR,355393,555052,910445,444140,334947,261188,184851,113494,60302,1398922,350450,530708,881158,419390,319532,240599,163682,94393,44701,1282297,2681219,4472824,4472824
Burkina Faso,1956,BF,BFA,AFR,363497,556261,919758,449731,334640,262908,187699,115755,62253,1412986,358365,534904,893269,425397,322066,244405,168203,97796,47004,1304871,2717857,4530885,4530885
Burkina Faso,1957,BF,BFA,AFR,371654,557966,929620,456033,334457,264291,190488,118056,64165,1427490,366328,539619,905947,432000,324619,247964,172695,101301,49384,1327963,2755453,4591019,4591019
Burkina Faso,1958,BF,BFA,AFR,379876,559972,939848,462846,334048,265160,193119,120358,66027,1441558,374378,544684,919062,439169,327070,251227,177123,104896,51852,1351337,2792895,4651801,4651801
Burkina Faso,1959,BF,BFA,AFR,388436,562221,950657,470537,334000,265756,195659,122662,67837,1456451,382765,550024,932789,447134,329695,254343,181505,108570,54350,1375597,2832048,4715489,4715489
Burkina Faso,1960,BF,BFA,AFR,397354,564861,962215,479185,334750,266259,198168,124967,69583,1472912,391457,555738,947195,455874,332706,257383,185834,112286,56860,1400943,2873855,4783259,4783259
Burkina Faso,1961,BF,BFA,AFR,406475,568329,974804,487735,335935,266416,200532,127252,71275,1489145,400322,562199,962521,464600,336007,260252,190077,116032,59387,1426355,2915500,4852833,4852833
Burkina Faso,1962,BF,BFA,AFR,415855,573694,989549,494951,337714,266238,202762,129531,72964,1504160,409411,570294,979705,472333,339742,262974,194242,119824,61970,1451085,2955245,4924497,4924497
Burkina Faso,1963,BF,BFA,AFR,425379,584333,1009712,497749,340197,265788,204842,131824,74704,1515104,418596,582137,1000733,477105,343930,265540,198288,123644,64616,1473123,2988227,4998671,4998671
Burkina Faso,1964,BF,BFA,AFR,435036,599586,1034622,497160,343335,265143,206720,134128,76492,1522978,427986,597268,1025254,479722,348518,267966,202171,127503,67379,1493259,3016237,5076111,5076111
Burkina Faso,1965,BF,BFA,AFR,444999,615461,1060460,497317,347202,264451,208405,136462,78351,1532188,437728,613001,1050729,483009,353549,270353,205901,131428,70316,1514556,3046744,5157929,5157929
Burkina Faso,1966,BF,BFA,AFR,455157,631449,1086606,498326,351639,263758,209835,138807,80303,1542668,447629,628829,1076458,487160,358992,272695,209436,135373,73409,1537065,3079733,5242797,5242797
Burkina Faso,1967,BF,BFA,AFR,465444,647756,1113200,499825,356731,263161,210986,141142,82358,1554203,457627,644970,1102597,491821,364991,275048,212758,139328,76665,1560611,3114814,5330613,5330613
Burkina Faso,1968,BF,BFA,AFR,475977,664345,1140322,501788,362727,262744,211893,143454,84494,1567100,467895,661392,1129287,496909,371729,277494,215914,143283,80073,1585402,3152502,5422119,5422119
Burkina Faso,1969,BF,BFA,AFR,486280,681356,1167636,503911,369372,262561,212534,145701,86674,1580753,477989,678234,1156223,502213,379128,280057,218927,147215,83591,1611131,3191884,5515747,5515747
Burkina Faso,2031,BF,BFA,AFR,2040965,3610578,5651543,3040464,2080505,1429845,982521,528966,326744,8389045,1978448,3506064,5484512,2968527,2076375,1467366,1039145,619495,464677,8635585,17024630,28160684,28160684
Burkina Faso,2032,BF,BFA,AFR,2065469,3653844,5719313,3103798,2154818,1468719,1019358,554339,340453,8641485,2002473,3549562,5552035,3029836,2149822,1506950,1077267,644742,481774,8890391,17531876,28803224,28803224
Burkina Faso,2033,BF,BFA,AFR,2089824,3698656,5788480,3161495,2232611,1510098,1054009,582170,354731,8895114,2026403,3594594,5620997,3085824,2226694,1548694,1113577,672454,499480,9146723,18041837,29451315,29451315
Burkina Faso,2034,BF,BFA,AFR,2113158,3743990,5857148,3215694,2312790,1554557,1086636,612252,369513,9151442,2049430,3640063,5689493,3138663,2306029,1593176,1148112,702483,517685,9406148,18557590,30104222,30104222
Burkina Faso,2035,BF,BFA,AFR,2134372,3790195,5924567,3266180,2394523,1602194,1118302,644008,384776,9409983,2070399,3686312,5756711,3188071,2387055,1640622,1181844,734336,536347,9668275,19078258,30759536,30759536
Burkina Faso,2036,BF,BFA,AFR,2153683,3836543,5990226,3313034,2477960,1652395,1149797,676859,400701,9670746,2089538,3732660,5822198,3234113,2469708,1690560,1215581,767520,555612,9933094,19603840,31416263,31416263
Burkina Faso,2037,BF,BFA,AFR,2171048,3883198,6054246,3356412,2562869,1704906,1181445,710319,417476,9933427,2106871,3779203,5886074,3277061,2553566,1742868,1249557,801580,575696,10200328,20133755,32074082,32074082
Burkina Faso,2038,BF,BFA,AFR,2186611,3930595,6117206,3396690,2647196,1761012,1213375,743934,435395,10197602,2122478,3826425,5948903,3317300,2636594,1798884,1283777,836120,596927,10469602,20667204,32733314,32733314
Burkina Faso,2039,BF,BFA,AFR,2199837,3978341,6178178,3435175,2729044,1820927,1245718,777746,454738,10463348,2135757,3873985,6009742,3356039,2716985,1858763,1318275,871274,619599,10740935,21204283,33392206,33392206
Burkina Faso,2040,BF,BFA,AFR,2211923,4025144,6237067,3473217,2806856,1884330,1278824,811840,475681,10730748,2147921,3920627,6068548,3394498,2793309,1922090,1353365,907210,643902,11014374,21745122,34050733,34050733
Burkina Faso,2041,BF,BFA,AFR,2224479,4069994,6294473,3513116,2877461,1952147,1313663,845557,498268,11000212,2160496,3965377,6125873,3434901,2862481,1989869,1389913,943273,669922,11290359,22290571,34710916,34710916
Burkina Faso,2042,BF,BFA,AFR,2235730,4112485,6348215,3556469,2939859,2024244,1350719,878022,522686,11271999,2171695,4007860,6179555,3478821,2923570,2061981,1428373,978487,697930,11569162,22841161,35368933,35368933
Burkina Faso,2043,BF,BFA,AFR,2244652,4153055,6397707,3601331,2996850,2099713,1390128,908629,549149,11545800,2180612,4048554,6229166,3524256,2979517,2137465,1468924,1012090,728207,11850459,23396259,36023133,36023133
Burkina Faso,2044,BF,BFA,AFR,2252976,4190344,6443320,3646725,3050500,2177512,1432428,937534,577439,11822138,2188964,4086072,6275036,3570126,3032430,2215383,1512116,1044112,760522,12134689,23956827,36675188,36675188
Burkina Faso,2045,BF,BFA,AFR,2260693,4224482,6485175,3692977,3100579,2256844,1477738,965667,607059,12100864,2196658,4120493,6317151,3616783,3082014,2294992,1558165,1075447,794395,12421796,24522660,37324984,37324984
Burkina Faso,2046,BF,BFA,AFR,2266380,4257219,6523599,3739370,3147162,2337838,1525473,993712,637676,12381231,2202376,4153518,6355894,3663536,3128334,2376219,1606627,1106823,829485,12711024,25092255,37971748,37971748
Burkina Faso,2047,BF,BFA,AFR,2272741,4286783,6559524,3786054,3190395,2420273,1575393,1021950,669057,12663122,2208845,4183446,6392291,3710487,3171654,2458659,1657383,1138455,865570,13002208,25665330,38617149,38617149
Burkina Faso,2048,BF,BFA,AFR,2281206,4312316,6593522,3833467,3230631,2502170,1628706,1050491,701047,12946512,2217303,4209425,6426728,3758103,3212330,2540330,1711721,1170342,902611,13295437,26241949,39262199,39262199
Burkina Faso,2049,BF,BFA,AFR,2289438,4334954,6624392,3881211,3269130,2581722,1685624,1079468,733861,13231016,2225453,4232552,6458005,3806048,3251544,2619480,1769793,1202556,940959,13590380,26821396,39903786,39903786
Burkina Faso,2050,BF,BFA,AFR,2297208,4355853,6653061,3928021,3307206,2657411,1745872,1109252,767723,13515485,2233238,4253912,6487150,3853091,3290492,2694723,1831224,1235424,980892,13885846,27401331,40541548,40541548
Bangladesh,1970,BD,BGD,SEA,6236229,9156848,15393077,6038933,4689362,3507608,2518337,1696871,1154168,19605279,6010287,8831762,14842049,5745426,4206809,3092159,2232474,1438191,986392,17701451,37306730,67541860,67541860
Bangladesh,1971,BD,BGD,SEA,6270544,9407303,15677847,6103561,4650903,3514452,2516908,1689225,1150539,19625588,6041724,9064792,15106516,5887893,4257504,3123466,2261296,1455770,980327,17966256,37591844,68376204,68376204
Bangladesh,1972,BD,BGD,SEA,6336568,9671193,16007761,6199286,4593356,3518595,2515894,1683164,1150227,19660522,6105522,9309152,15414674,6050061,4299674,3159240,2294782,1479793,980196,18263746,37924268,69346705,69346705
Bangladesh,1973,BD,BGD,SEA,6508425,9965015,16473440,6439739,4616225,3587992,2566304,1721208,1199101,20130569,6269340,9581725,15851065,6260426,4339477,3209711,2344845,1522844,1012444,18689747,38820316,71144818,71144818
Bangladesh,1974,BD,BGD,SEA,6677565,10241803,16919368,6722597,4623936,3652086,2618319,1758812,1247964,20623714,6428094,9840328,16268422,6507179,4365790,3258940,2393479,1565170,1045740,19136298,39760012,72947807,72947807
Bangladesh,1975,BD,BGD,SEA,6853976,10452007,17305983,6970686,4681406,3713064,2664293,1797561,1299397,21126407,6593266,10034090,16627356,6770616,4436664,3308736,2434506,1607215,1082852,19640589,40766996,74700345,74700345
Bangladesh,1976,BD,BGD,SEA,7037594,10606337,17643931,7138154,4805882,3773930,2701325,1837817,1355538,21612646,6765235,10169788,16935023,7020375,4570328,3359743,2465783,1648214,1124042,20188485,41801131,76380080,76380080
Bangladesh,1977,BD,BGD,SEA,7205611,10809662,18015273,7285657,4950848,3838180,2741672,1878034,1413190,22107581,6922156,10347826,17269982,7246035,4729419,3415740,2497526,1687872,1168354,20744946,42852527,78137788,78137788
Bangladesh,1978,BD,BGD,SEA,7361055,11067428,18428483,7428992,5109637,3909358,2787728,1917234,1469988,22622937,7067906,10577846,17645752,7446828,4910322,3479942,2532361,1726469,1214467,21310389,43933326,80007550,80007550
Bangladesh,1979,BD,BGD,SEA,7523649,11342331,18865980,7549464,5281817,3986059,2834460,1953990,1524993,23130783,7219040,10828816,18047856,7613284,5112684,3549245,2566600,1762848,1258871,21863532,44994315,81908151,81908151
Bangladesh,1980,BD,BGD,SEA,7693485,11649683,19343168,7678281,5461150,4072468,2886098,1989153,1578795,23665945,7375150,11120921,18496071,7757519,5333049,3627774,2604755,1798516,1302967,22424580,46090525,83929765,83929765
Bangladesh,1981,BD,BGD,SEA,7865271,11996738,19862009,7858641,5640961,4169156,2949548,2024025,1631962,24274293,7535242,11459789,18995031,7908066,5564164,3717722,2651950,1834499,1347102,23023503,47297796,86154836,86154836
Bangladesh,1982,BD,BGD,SEA,8035487,12362220,20397707,8102991,5820978,4272715,3027929,2058168,1684039,24966820,7700068,11819652,19519720,8084623,5799253,3816033,2709763,1870609,1390803,23671084,48637904,88555336,88555336
Bangladesh,1983,BD,BGD,SEA,8188499,12731663,20920162,8400042,6013891,4366799,3115896,2092981,1734685,25724294,7851927,12183747,20035674,8293172,6044133,3911974,2774769,1907301,1434002,24365351,50089645,91045478,91045478
Bangladesh,1984,BD,BGD,SEA,8312772,13097613,21410385,8719808,6221631,4450130,3205062,2130447,1783911,26510989,7978416,12540644,20519060,8526485,6297089,4005496,2841948,1945014,1477770,25093802,51604791,93534239,93534239
Bangladesh,1985,BD,BGD,SEA,8411517,13446636,21858153,9033312,6422160,4550210,3292900,2170219,1831137,27299938,8082413,12876333,20958746,8772631,6533749,4118972,2909775,1983426,1523715,25842268,53142206,95959099,95959099
Bangladesh,1986,BD,BGD,SEA,8480177,13770817,22250994,9330576,6608527,4676057,3380181,2212362,1876794,28084497,8152491,13185402,21337893,9028690,6743855,4258781,2977848,2021062,1568122,26598358,54682855,98271746,98271746
Bangladesh,1987,BD,BGD,SEA,8516353,14066753,22583106,9628597,6788137,4819268,3468033,2257814,1920709,28882558,8181994,13471471,21653465,9305542,6933149,4417108,3047389,2058229,1609716,27371133,56253691,100490256,100490256
Bangladesh,1988,BD,BGD,SEA,8529744,14352990,22882734,9942311,6960829,4974259,3558427,2306741,1960209,29702776,8186161,13750474,21936635,9605486,7101320,4593618,3121141,2096347,1648777,28166689,57869465,102688833,102688833
Bangladesh,1989,BD,BGD,SEA,8532944,14645394,23178338,10260397,7130390,5138049,3653582,2358992,1996164,30537574,8183399,14031220,22214619,9915970,7247841,4786440,3199033,2133797,1680057,28963138,59500712,104893674,104893674
Bangladesh,1990,BD,BGD,SEA,8522100,14947652,23469752,10589218,7306375,5308306,3755646,2416686,2035339,31411570,8169184,14319134,22488318,10241316,7381018,4993806,3282453,2172366,1707051,29778010,61189580,107147651,107147651
Bangladesh,1991,BD,BGD,SEA,8471961,15203242,23675203,10893901,7501817,5481904,3858557,2477839,2073934,32287952,8120000,14564336,22684336,10556537,7514971,5206580,3367674,2213013,1736569,30595344,62883296,109242834,109242834
Bangladesh,1992,BD,BGD,SEA,8398163,15422363,23820526,11186338,7729299,5655339,3948677,2541775,2111781,33173209,8056351,14777156,22833507,10880773,7674701,5414451,3444628,2256909,1773399,31444861,64618070,111272102,111272102
Bangladesh,1993,BD,BGD,SEA,8334490,15634707,23969197,11500352,7984990,5840070,4017537,2609217,2152252,34104418,8007947,14984413,22992360,11232167,7868057,5627351,3507828,2303890,1813489,32352782,66457200,113418757,113418757
Bangladesh,1994,BD,BGD,SEA,8289772,15811115,24100887,11830445,8255978,6040891,4079129,2677497,2193498,35077438,7977190,15160629,23137819,11584759,8085836,5852537,3570649,2352319,1852644,33298744,68376182,115614891,115614891
Bangladesh,1995,BD,BGD,SEA,8259759,15934527,24194286,12163004,8537344,6233225,4153748,2744076,2239306,36070703,7962259,15292905,23255164,11941090,8326633,6059284,3649998,2400808,1895375,34273188,70343891,117793338,117793338
Bangladesh,1996,BD,BGD,SEA,8250750,15987195,24237945,12479508,8830576,6409757,4245861,2807524,2288950,37062176,7972440,15356215,23328655,12293422,8593398,6233725,3747401,2445543,1934594,35248083,72310259,119876868,119876868
Bangladesh,1997,BD,BGD,SEA,8295384,15986924,24282308,12784662,9148437,6582004,4355257,2871556,2345139,38087055,8033172,15364413,23397585,12637552,8900836,6393730,3865646,2493535,1980988,36272287,74359342,122039226,122039226
Bangladesh,1998,BD,BGD,SEA,8384133,15965638,24349771,13073026,9483730,6753314,4481459,2941942,2419837,39153308,8130151,15354512,23484663,12970560,9242385,6540657,4006264,2551651,2051208,37362725,76516033,124350471,124350471
Bangladesh,1999,BD,BGD,SEA,8476464,15952523,24428987,13347547,9817307,6927998,4622686,3021910,2519743,40257191,8224536,15355842,23580378,13291789,9601262,6672176,4165168,2617543,2140336,38488274,78745465,126754824,126754824
Bangladesh,2000,BD,BGD,SEA,8576296,15941106,24517402,13609448,10143842,7111605,4772582,3104573,2623905,41365955,8320009,15362954,23682963,13598452,9974204,6794757,4337924,2686707,2234959,39627003,80992958,129193327,129193327
Bangladesh,2001,BD,BGD,SEA,8689618,15968068,24657686,13864742,10414927,7301042,4937267,3188132,2719342,42425452,8422442,15402936,23825378,13854381,10334258,6943248,4538858,2762903,2328317,40761965,83187417,131670484,131670484
Bangladesh,2002,BD,BGD,SEA,8778309,16053654,24831963,14105879,10619739,7497359,5115901,3271212,2812623,43422713,8500457,15496643,23997100,14054496,10661271,7132921,4766078,2847028,2426265,41888059,85310772,134139826,134139826
Bangladesh,2003,BD,BGD,SEA,8831873,16156954,24988827,14315491,10797987,7700646,5304101,3339372,2901917,44359514,8549164,15612933,24162097,14223388,10963286,7345094,5005398,2926610,2528989,42992765,87352279,136503206,136503206
Bangladesh,2004,BD,BGD,SEA,8860224,16259273,25119497,14505531,10973848,7905242,5501571,3398528,2988113,45272833,8576561,15728434,24304995,14374186,11252908,7575954,5252851,3004956,2631541,44092396,89365229,138789725,138789725
Bangladesh,2005,BD,BGD,SEA,8843060,16363632,25206692,14664626,11141859,8097950,5683156,3473506,3070086,46131183,8561838,15845340,24407178,14501751,11523930,7821049,5485171,3104650,2730978,45167529,91298712,140912590,140912590
Bangladesh,2006,BD,BGD,SEA,8770654,16482024,25252678,14733097,11247000,8254523,5830543,3566410,3145294,46776867,8494562,15976148,24470710,14563622,11747065,8071547,5689571,3230030,2826738,46128573,92905440,142628831,142628831
Bangladesh,2007,BD,BGD,SEA,8661673,16619067,25280740,14746658,11323298,8409078,5958901,3669479,3211383,47318797,8391666,16120355,24512021,14577038,11941548,8344381,5874089,3372130,2915193,47024379,94343176,144135934,144135934
Bangladesh,2008,BD,BGD,SEA,8519834,16758657,25278491,14725062,11363688,8550464,6068071,3779631,3271410,47758326,8256302,16263644,24519946,14568169,12102035,8627676,6036387,3529916,3000371,47864554,95622880,145421318,145421318
Bangladesh,2009,BD,BGD,SEA,8349667,16877458,25227125,14743195,11426837,8683390,6172886,3900264,3335262,48261834,8092620,16383373,24475993,14593165,12258155,8916642,6181546,3704704,3087645,48741857,97003691,146706810,146706810
Bangladesh,2010,BD,BGD,SEA,8172870,16970049,25142919,14863620,11606128,8850650,6300730,4037258,3412319,49070705,7922251,16470795,24393046,14682740,12460951,9230531,6325514,3898364,3186373,49784473,98855178,148391139,148391139
Bangladesh,2011,BD,BGD,SEA,7995783,17031520,25027303,15012241,11839102,9024895,6450342,4184455,3497341,50008376,7750728,16522501,24273229,14795388,12675578,9548507,6480414,4105780,3296425,50902092,100910468,150211005,150211005
Bangladesh,2012,BD,BGD,SEA,7824596,17038773,24863369,15191112,12101151,9198723,6625498,4339558,3579148,51035190,7581192,16521515,24102707,14941667,12888037,9856812,6662675,4324265,3415930,52089386,103124576,152090649,152090649
Bangladesh,2013,BD,BGD,SEA,7684007,16984114,24668121,15394728,12380413,9375477,6818495,4507879,3641889,52118881,7435177,16465577,23900754,15115141,13096314,10155916,6873607,4558757,3542652,53342387,105461268,154030139,154030139
Bangladesh,2014,BD,BGD,SEA,7584579,16875471,24460050,15587189,12663828,9562952,7016975,4686553,3696026,53213523,7323512,16359921,23683433,15281491,13299741,10449475,7104693,4801154,3667752,54604306,107817829,155961299,155961299
Bangladesh,2015,BD,BGD,SEA,7519860,16707255,24227115,15759567,12937366,9762971,7213789,4857594,3777399,54308686,7241895,16197608,23439503,15436147,13491392,10734479,7352984,5029667,3810025,55854694,110163380,157830000,157830000
Bangladesh,2016,BD,BGD,SEA,7495735,16487958,23983693,15956441,13211464,9985581,7416224,5016722,3889275,55475707,7198957,15985983,23184940,15611891,13666432,11015097,7625106,5239836,3981868,57140230,112615937,159784568,159784568
Bangladesh,2017,BD,BGD,SEA,7488952,16239649,23728601,16171533,13466739,10221521,7638014,5170947,4025077,56693831,7176506,15742727,22919233,15802336,13813599,11290144,7929203,5437657,4179362,58452301,115146132,161793964,161793964
Bangladesh,2018,BD,BGD,SEA,7478781,15987114,23465895,16351266,13677824,10448752,7863128,5319953,4187743,57848666,7155946,15489359,22645305,15971977,13935699,11546615,8250540,5619315,4399942,59724088,117572754,163683958,163683958
Bangladesh,2019,BD,BGD,SEA,7479378,15743405,23222783,16481576,13877010,10680405,8073089,5463701,4365612,58941393,7149412,15238820,22388232,16102407,14065367,11791255,8574872,5785038,4644873,60963812,119905205,165516222,165516222
Bangladesh,2020,BD,BGD,SEA,7490624,15521029,23011653,16598175,14096762,10946549,8276970,5603349,4530260,60052065,7156292,15005877,22162169,16206378,14214829,12041636,8902635,5929087,4900499,62195064,122247129,167420951,167420951
Bangladesh,2021,BD,BGD,SEA,7499688,15331862,22831550,16690883,14317170,11237248,8470138,5746858,4704242,61166539,7163649,14804583,21968232,16277703,14371216,12289050,9219341,6068285,5164339,63389934,124556473,169356251,169356251
Bangladesh,2022,BD,BGD,SEA,7506512,15159025,22665537,16698204,14512497,11519895,8648663,5913308,4901106,62193673,7171127,14618996,21790123,16278414,14530003,12516487,9523078,6242941,5446109,64537032,126730705,171186372,171186372
Bangladesh,2023,BD,BGD,SEA,7506008,15014073,22520081,16631976,14698045,11794408,8825569,6102395,5099769,63152162,7173973,14458623,21632596,16217257,14694754,12725733,9821047,6453218,5737478,65649487,128801649,172954319,172954319
Bangladesh,2024,BD,BGD,SEA,7487516,14922661,22410177,16513418,14869419,12069457,9012115,6297598,5302403,64064410,7161079,14347654,21508733,16107493,14850278,12928015,10113470,6683615,6035018,66717889,130782299,174701211,174701211
Bangladesh,2025,BD,BGD,SEA,7461914,14874099,22336013,16337476,15029622,12342690,9214555,6492773,5510428,64927544,7141398,14277850,21419248,15943272,14999654,13123036,10400651,6932818,6339266,67738697,132666241,176421509,176421509
Bangladesh,2026,BD,BGD,SEA,7431641,14858490,22290131,16109872,15195581,12596222,9429168,6689246,5724299,65744388,7115823,14242674,21358497,15728997,15160142,13290877,10679553,7203600,6649945,68713114,134457502,178106136,178106136
Bangladesh,2027,BD,BGD,SEA,7396892,14858018,22254910,15853637,15368068,12816035,9649439,6900350,5943624,66531153,7084358,14228104,21312462,15483137,15328782,13422878,10949728,7503480,6965430,69653435,136184588,179751964,179751964
Bangladesh,2028,BD,BGD,SEA,7356720,14851237,22207957,15597483,15533876,13018783,9873180,7118171,6167383,67308876,7046714,14214005,21260719,15230582,15492285,13543418,11207742,7821951,7282557,70578535,137887411,181356085,181356085
Bangladesh,2029,BD,BGD,SEA,7306748,14839927,22146675,15352803,15667062,13227353,10109062,7325280,6397182,68078742,6999211,14199897,21199108,14982718,15625640,13679925,11457537,8144190,7601049,71491059,139569801,182915579,182915579
Bangladesh,2030,BD,BGD,SEA,7246383,14829357,22075740,15128371,15757455,13426201,10362876,7521393,6636774,68833070,6941296,14189588,21130884,14750265,15715549,13819814,11705154,8468942,7924727,72384451,141217521,184424144,184424144
Bangladesh,1950,BD,BGD,SEA,3304526,5080714,8385240,3883601,2922744,2225264,1558187,941299,824920,12356015,3197683,4765597,7963280,3603418,2668679,1869009,1321401,838611,722880,11023998,23380013,39728535,39728535
Bangladesh,1951,BD,BGD,SEA,3348639,5186798,8535437,3984706,2989416,2273236,1604019,964106,800638,12616121,3250058,4880013,8130071,3682426,2738746,1924843,1352451,859763,708736,11266965,23883086,40548590,40548590
Bangladesh,1952,BD,BGD,SEA,3415678,5289415,8705093,4088985,3056718,2321130,1651705,990239,778992,12887769,3321786,4993304,8315090,3763710,2808956,1983053,1382740,883874,696593,11518926,24406695,41426885,41426885
Bangladesh,1953,BD,BGD,SEA,3517324,5372444,8889768,4190516,3121431,2367295,1699335,1018686,761373,13158636,3422261,5090944,8513205,3842781,2874825,2040919,1412380,909988,686767,11767660,24926296,42329279,42329279
Bangladesh,1954,BD,BGD,SEA,3656071,5440769,9096840,4288074,3187838,2413779,1745942,1049574,749216,13434423,3555659,5175640,8731299,3921408,2938343,2098357,1443800,937147,680420,12019475,25453898,43282032,43282032
Bangladesh,1955,BD,BGD,SEA,3804731,5527147,9331878,4383882,3260102,2462654,1791823,1082855,743144,13724460,3698399,5276299,8974698,4003399,3002872,2156512,1478601,964864,678265,12284513,26008973,44315548,44315548
Bangladesh,1956,BD,BGD,SEA,3949226,5638530,9587756,4477775,3336523,2513263,1836511,1117703,742836,14024611,3836909,5399268,9236177,4088494,3067009,2214576,1516069,992951,680022,12559121,26583732,45407666,45407666
Bangladesh,1957,BD,BGD,SEA,4097713,5766827,9864540,4570598,3416836,2566037,1879971,1153777,748474,14335693,3979272,5536828,9516100,4177624,3130492,2272376,1556207,1021550,685942,12844191,27179884,46560522,46560522
Bangladesh,1958,BD,BGD,SEA,4251096,5909363,10160459,4659086,3494820,2617818,1921404,1190717,759257,14643102,4126227,5686806,9813033,4266498,3187890,2327586,1597994,1050132,696101,13126201,27769303,47742791,47742791
Bangladesh,1959,BD,BGD,SEA,4410233,6068945,10479178,4753580,3577289,2671514,1963241,1228900,773573,14968097,4278283,5852398,10130681,4364479,3247724,2384258,1642457,1078387,709701,13427006,28395103,49004963,49004963
Bangladesh,1960,BD,BGD,SEA,4578295,6247381,10825676,4861788,3671365,2731285,2007649,1268577,790676,15331340,4438142,6035464,10473606,4478436,3318500,2446179,1690510,1106513,725666,13765804,29097144,50396429,50396429
Bangladesh,1961,BD,BGD,SEA,4757028,6443987,11201015,4973976,3772387,2794624,2053256,1309798,810829,15714870,4608234,6235026,10843260,4598037,3395361,2510610,1741215,1134343,744058,14123624,29838494,51882769,51882769
Bangladesh,1962,BD,BGD,SEA,4945344,6665285,11610629,5083336,3880044,2860824,2100048,1353456,835028,16112736,4787800,6456034,11243834,4716977,3478099,2577169,1794853,1162022,765336,14494456,30607192,53461661,53461661
Bangladesh,1963,BD,BGD,SEA,5130869,6924593,12055462,5175825,3990586,2929841,2147981,1398764,863911,16506908,4964472,6708067,11672539,4822697,3564213,2644221,1849902,1189740,788440,14859213,31366121,55094115,55094115
Bangladesh,1964,BD,BGD,SEA,5307857,7223848,12531705,5254721,4099803,3003123,2197424,1444142,897257,16896470,5133220,6994410,12127630,4916545,3652576,2711420,1905467,1219353,813296,15218657,32115127,56774465,56774465
Bangladesh,1965,BD,BGD,SEA,5470543,7537667,13008210,5349479,4208011,3081882,2248526,1488558,933816,17310272,5288276,7293605,12581881,5024202,3744672,2778967,1961086,1251383,839483,15599793,32910065,58500159,58500159
Bangladesh,1966,BD,BGD,SEA,5621773,7857463,13479236,5465960,4313031,3164497,2301141,1532270,973852,17750751,5431696,7597986,13029682,5151160,3838524,2845905,2016707,1285808,867484,16005588,33756339,60265259,60265259
Bangladesh,1967,BD,BGD,SEA,5775121,8189952,13965073,5597010,4415783,3251194,2355984,1575446,1017474,18212891,5576414,7915131,13491545,5291008,3935873,2913322,2073227,1323352,898193,16434975,34647866,62104488,62104488
Bangladesh,1968,BD,BGD,SEA,5933439,8525441,14458880,5740954,4517892,3341306,2412435,1617853,1063445,18693885,5725514,8235170,13960684,5442130,4036752,2980482,2129920,1362908,930012,16882204,35576089,63995652,63995652
Bangladesh,1969,BD,BGD,SEA,6097503,8856382,14953885,5889466,4610327,3428273,2467437,1659196,1110213,19164912,5880472,8549393,14429865,5595571,4130278,3042655,2185149,1403174,961413,17318240,36483152,65866908,65866908
Bangladesh,2031,BD,BGD,SEA,7178357,14808534,21986891,14938238,15810604,13603729,10627764,7706372,6891722,69578429,6875906,14171537,21047443,14549059,15765590,13954658,11943289,8788302,8264639,73265537,142843966,185878302,185878302
Bangladesh,2032,BD,BGD,SEA,7105802,14782129,21887931,14767671,15808222,13783646,10898346,7882980,7167568,70308433,6806199,14149314,20955513,14366099,15762362,14106088,12166994,9093771,8633831,74129145,144437578,187281026,187281026
Bangladesh,2033,BD,BGD,SEA,7028757,14744013,21772770,14625316,15744955,13970394,11170319,8057737,7459213,71027934,6732140,14116963,20849103,14208703,15704361,14272530,12376800,9386759,9030624,74979777,146007711,188629587,188629587
Bangladesh,2034,BD,BGD,SEA,6949420,14678097,21627517,14536185,15629779,14143323,11443128,8242039,7757414,71751868,6655769,14058861,20714630,14100365,15598020,14429869,12579872,9674812,9448459,75831397,147583265,189925419,189925419
Bangladesh,2035,BD,BGD,SEA,6870160,14594646,21464806,14489615,15457677,14305396,11714514,8441513,8058004,72466719,6579285,13983475,20562760,14032867,15437523,14581149,12775937,9958241,9886617,76672334,149139053,191166614,191166614
Bangladesh,2036,BD,BGD,SEA,6789596,14498845,21288441,14475751,15234341,14473170,11966974,8652792,8362936,73165964,6501554,13894661,20396215,13999707,15227240,14743348,12945353,10234187,10347198,77497033,150662997,192347658,192347658
Bangladesh,2037,BD,BGD,SEA,6707551,14393987,21101538,14476891,14982647,14647376,12187016,8870513,8683839,73848282,6422519,13795553,20218072,13986954,14985524,14913556,13079690,10502506,10835901,78304131,152152413,193472026,193472026
Bangladesh,2038,BD,BGD,SEA,6626842,14279162,20906004,14471726,14731104,14815020,12390665,9092066,9012593,74513174,6344785,13685839,20030624,13974609,14737121,15078669,13202815,10759404,11339729,79092347,153605521,194542147,194542147
Bangladesh,2039,BD,BGD,SEA,6547201,14152179,20699380,14462035,14490988,14950590,12600141,9324756,9335521,75164031,6268115,13563865,19831980,13962197,14493322,15213976,13341608,11008143,11844357,79863603,155027634,195558997,195558997
Bangladesh,2040,BD,BGD,SEA,6470877,14014813,20485690,14453059,14270933,15043979,12800445,9574235,9655996,75798647,6194764,13431284,19626048,13953507,14264761,15306288,13483763,11254721,12352710,80615750,156414397,196526123,196526123
Bangladesh,2041,BD,BGD,SEA,6401323,13868411,20269734,14433847,14084882,15100557,12980186,9834230,9979106,76412808,6127928,13289898,19417826,13937058,14067171,15359088,13620939,11492132,12867955,81344343,157757151,197444714,197444714
Bangladesh,2042,BD,BGD,SEA,6338670,13715895,20054565,14409039,13918232,15102475,13162750,10100100,10312691,77005287,6067436,13142782,19210218,13916391,13887640,15359190,13774482,11715655,13394158,82047516,159052803,198317585,198317585
Bangladesh,2043,BD,BGD,SEA,6285341,13560135,19845476,14372537,13779561,15044441,13352411,10367788,10658069,77574807,6015644,12992527,19008171,13885573,13733459,15305085,13942841,11925832,13931308,82724098,160298905,199152551,199152551
Bangladesh,2044,BD,BGD,SEA,6241443,13403058,19644501,14308325,13693676,14935157,13528929,10636843,11017149,78120079,5973069,12840934,18814003,13829064,13627972,15203074,14102302,12129731,14480517,83372660,161492739,199951236,199951236
Bangladesh,2045,BD,BGD,SEA,6203338,13249268,19452606,14226607,13649964,14769665,13695208,10905214,11391505,78638163,5936169,12692457,18628626,13755275,13562993,15047387,14255869,12327077,15041379,83989980,162628143,200709378,200709378
Bangladesh,2046,BD,BGD,SEA,6171439,13100859,19272298,14132541,13638646,14553591,13867100,11156103,11780237,79128218,5905172,12549152,18454324,13668035,13532063,14842338,14420161,12498689,15613522,84574808,163703026,201429647,201429647
Bangladesh,2047,BD,BGD,SEA,6144289,12957760,19102049,14029395,13642142,14309486,14045062,11376807,12188690,79591582,5878746,12410799,18289545,13570476,13521348,14606079,14592216,12636459,16201969,85128547,164720129,202111723,202111723
Bangladesh,2048,BD,BGD,SEA,6115966,12825220,18941186,13916265,13639339,14065498,14216386,11582140,12606930,80026558,5851142,12282361,18133503,13462279,13510977,14363126,14759136,12763336,16790982,85649836,165676394,202751082,202751082
Bangladesh,2049,BD,BGD,SEA,6085656,12703090,18788746,13790976,13632010,13832734,14356373,11793213,13029557,80434863,5821364,12164128,17985492,13341817,13500498,14124663,14896651,12905438,17370704,86139771,166574634,203348861,203348861
Bangladesh,2050,BD,BGD,SEA,6055217,12590002,18645219,13655292,13625330,13619640,14454984,11996057,13464955,80816258,5791267,12054835,17846102,13210732,13493647,13901168,14991675,13050905,17949207,86597334,167413592,203904900,203904900
Bulgaria,1970,BG,BGR,EUR,348510,672317,1020827,689949,580646,643226,506513,426615,373905,3220854,331956,647987,979943,689345,591858,647448,522477,450143,460054,3361325,6582179,8582950,8582950
Bulgaria,1971,BG,BGR,EUR,354907,669067,1023974,688402,586131,636162,531168,419275,387395,3248533,337725,644271,981996,684834,598421,641642,546884,444757,475214,3391752,6640285,8646260,8646260
Bulgaria,1972,BG,BGR,EUR,358724,667120,1025844,683606,596080,627455,556488,409086,399835,3272550,341172,641568,982740,677149,609320,634294,571939,436984,489344,3419030,6691580,8700153,8700153
Bulgaria,1973,BG,BGR,EUR,358689,670326,1029015,676569,609028,617430,579862,398785,413275,3294949,341234,643746,984980,667593,622828,625682,595017,429055,504376,3444551,6739500,8753489,8753489
Bulgaria,1974,BG,BGR,EUR,358284,677665,1035949,669051,623036,606214,597626,391807,427677,3315411,341094,649919,991013,657126,637600,616440,612367,424252,520514,3468299,6783710,8810675,8810675
Bulgaria,1975,BG,BGR,EUR,359563,683032,1042595,663732,634855,594357,607327,390503,441769,3332543,342636,654035,996671,649301,649601,607189,621681,425001,536386,3489159,6821702,8860971,8860971
Bulgaria,1976,BG,BGR,EUR,361472,684984,1046456,660514,643685,582631,610923,395331,454751,3347835,344871,654857,999728,644684,657426,598181,624778,431672,551716,3508457,6856292,8902474,8902474
Bulgaria,1977,BG,BGR,EUR,364246,685006,1049252,656531,650881,570986,612257,403980,465056,3359691,347922,653975,1001897,639476,663443,589285,625699,441949,564768,3524620,6884311,8935452,8935452
Bulgaria,1978,BG,BGR,EUR,364373,685201,1049574,651080,657576,559559,612199,413852,474443,3368709,348297,653661,1001958,632973,668647,580534,625654,453128,577087,3538023,6906732,8958267,8958267
Bulgaria,1979,BG,BGR,EUR,359306,687740,1047046,646277,661893,550244,609569,425364,483663,3377010,343420,656071,999491,627137,671261,573262,623741,465601,589881,3550883,6927893,8974427,8974427
Bulgaria,1980,BG,BGR,EUR,351091,691394,1042485,641188,661905,546022,604088,440215,488468,3381886,335497,659732,995229,620917,669434,570675,619828,480918,599239,3561011,6942897,8980606,8980606
Bulgaria,1981,BG,BGR,EUR,341239,694805,1036044,634592,657848,548275,596509,457422,489627,3384273,326088,663446,989534,613009,663202,574551,614144,498169,605490,3568565,6952838,8978412,8978412
Bulgaria,1982,BG,BGR,EUR,331206,697269,1028475,628473,650817,554896,587171,474886,488613,3384856,316482,666540,983022,605368,654088,582730,606566,515914,609466,3574132,6958988,8970485,8970485
Bulgaria,1983,BG,BGR,EUR,322575,694023,1016598,627061,641728,564479,576333,490394,486027,3386022,308280,664402,972682,602255,643388,593731,597515,532079,612169,3581137,6967159,8956433,8956433
Bulgaria,1984,BG,BGR,EUR,314704,685739,1000443,629801,632275,575443,564329,501308,486306,3389462,301019,657452,958471,603355,631667,606459,587826,543538,618269,3591114,6980576,8939490,8939490
Bulgaria,1985,BG,BGR,EUR,307897,676518,984415,630821,625221,584843,551794,506246,490948,3389873,294946,649754,944700,602853,622446,617041,578253,548732,628767,3598092,6987965,8917076,8917076
Bulgaria,1986,BG,BGR,EUR,303311,666848,970159,628984,620678,591638,539421,507105,499229,3387055,291243,641797,933040,599790,616908,623659,569126,549887,642472,3601842,6988897,8892100,8892100
Bulgaria,1987,BG,BGR,EUR,299460,658345,957805,625965,615671,597205,527220,507328,508240,3381629,288246,634880,923126,595945,611131,628560,560142,550744,656670,3603192,6984821,8865755,8865755
Bulgaria,1988,BG,BGR,EUR,295547,648908,944455,624084,609110,602958,515261,507552,516486,3375451,284795,626970,911765,593737,603938,633272,551029,552171,670005,3604152,6979603,8835815,8835815
Bulgaria,1989,BG,BGR,EUR,291310,635446,926756,625428,602937,607071,504954,506379,526130,3372899,280937,615079,896016,595191,597346,636084,542836,552984,684313,3608754,6981653,8804430,8804430
Bulgaria,1990,BG,BGR,EUR,285603,620437,906040,628652,596062,607612,499171,503362,535759,3370618,275638,601680,877318,598876,590086,635123,538847,552394,698476,3613802,6984420,8767778,8767778
Bulgaria,1991,BG,BGR,EUR,276587,606309,882896,632657,587117,604689,499724,498672,543485,3366344,266798,589207,856005,603848,580651,630041,541197,550075,710610,3616422,6982766,8721660,8721660
Bulgaria,1992,BG,BGR,EUR,264316,592739,857055,636745,578299,599098,504494,492328,550104,3361068,254725,577005,831730,609338,571170,622190,547899,545791,722293,3618681,6979749,8668540,8668540
Bulgaria,1993,BG,BGR,EUR,250219,580371,830590,635747,574305,591411,511989,484316,555860,3353628,241178,565472,806650,610227,566327,612791,557487,539976,733863,3620671,6974299,8611535,8611535
Bulgaria,1994,BG,BGR,EUR,234486,568292,802778,630149,574758,583124,520962,474736,560391,3344120,226293,554213,780506,606648,566080,602036,569161,533543,743587,3621055,6965175,8548466,8548466
Bulgaria,1995,BG,BGR,EUR,218104,555695,773799,624066,573732,577149,528934,464630,563642,3332153,210789,542464,753253,602578,564462,593425,579278,527144,751487,3618374,6950527,8477579,8477579
Bulgaria,1996,BG,BGR,EUR,203783,541995,745778,617866,570254,573909,534932,454990,565541,3317492,197148,529476,726624,598218,560447,588625,585566,520971,757652,3611479,6928971,8401376,8401376
Bulgaria,1997,BG,BGR,EUR,191424,525982,717406,612970,566215,570278,539966,445166,566593,3301188,185204,514249,699453,594583,555852,583613,590045,514494,762332,3600919,6902107,8318966,8318966
Bulgaria,1998,BG,BGR,EUR,180264,508372,688636,607108,563997,564980,545636,435221,567894,3284836,174317,497435,671752,589514,553202,576745,594730,507544,767980,3589715,6874551,8234927,8234927
Bulgaria,1999,BG,BGR,EUR,173577,489221,662798,597302,565647,559988,550807,427103,571216,3272063,167701,479155,646856,580224,554337,570051,598072,501242,776655,3580581,6852644,8162301,8162301
Bulgaria,2000,BG,BGR,EUR,171925,468465,640390,586183,569993,553924,553575,423260,574360,3261295,165782,459227,625009,569349,557750,561930,598169,498477,785320,3570995,6832290,8097691,8097691
Bulgaria,2001,BG,BGR,EUR,171776,446894,618670,576063,576090,545292,553460,425033,575686,3251624,165258,438084,603342,559186,562569,550804,594256,501911,792500,3561226,6812850,8034860,8034860
Bulgaria,2002,BG,BGR,EUR,172925,424481,597406,566413,583123,536606,551093,430903,575727,3243865,166018,415807,581825,549097,567905,539278,587405,509697,798333,3551715,6795580,7974810,7974810
Bulgaria,2003,BG,BGR,EUR,175842,401677,577519,557879,585211,533376,546868,439622,573842,3236798,168456,393205,561661,539624,568028,532793,578866,519995,802450,3541756,6778554,7917739,7917739
Bulgaria,2004,BG,BGR,EUR,177799,381867,559666,549469,582522,535355,541656,450046,571041,3230089,169856,373565,543421,530390,562975,531336,568367,532589,806477,3532134,6762223,7865316,7865316
Bulgaria,2005,BG,BGR,EUR,179034,366318,545352,540427,579326,535712,538138,459871,567828,3221302,170490,357922,528412,520918,557183,528192,559273,544257,810332,3520155,6741457,7815221,7815221
Bulgaria,2006,BG,BGR,EUR,181982,353837,535819,530075,576070,533065,537398,467443,564717,3208768,172832,345010,517842,510400,551175,522007,554549,551513,813958,3503602,6712370,7766036,7766036
Bulgaria,2007,BG,BGR,EUR,186873,344070,530943,516980,574530,529593,536077,473953,562162,3193295,177207,334593,511800,497353,546513,514936,549830,556389,817968,3482989,6676284,7719035,7719035
Bulgaria,2008,BG,BGR,EUR,192546,336540,529086,501862,571655,528495,532420,481630,560615,3176677,182413,326381,508794,482300,540376,510691,542448,562073,822467,3460355,6637032,7674913,7674913
Bulgaria,2009,BG,BGR,EUR,198219,332039,530258,484628,563526,532420,528447,488846,561213,3159080,187746,320935,508681,465472,529379,511761,535097,566927,828078,3436714,6595794,7634735,7634735
Bulgaria,2010,BG,BGR,EUR,201801,331514,533315,465178,553372,539752,522388,493704,563931,3138325,191204,319120,510324,446522,517256,516086,525696,568872,835891,3410323,6548648,7592273,7592273
Bulgaria,2011,BG,BGR,EUR,201699,333445,535144,444319,543974,548891,512841,495633,569424,3115082,191121,319777,510898,425619,507108,522642,512686,566114,847825,3381994,6497076,7543130,7543130
Bulgaria,2012,BG,BGR,EUR,198565,337946,536511,421924,534638,558469,503249,494578,576420,3089278,188195,323181,511376,402879,497780,530043,500107,559657,860715,3351181,6440459,7488344,7488344
Bulgaria,2013,BG,BGR,EUR,193233,344197,537430,398316,526679,561032,500531,491285,584324,3062167,183222,328311,511533,379364,489851,530816,494696,551669,873643,3320039,6382206,7431167,7431167
Bulgaria,2014,BG,BGR,EUR,186350,348377,534727,377690,518940,557233,504276,486462,592630,3037231,176566,331395,507961,359073,482828,525506,495883,541261,887674,3292225,6329456,7372141,7372141
Bulgaria,2015,BG,BGR,EUR,179842,349718,529560,361410,510457,552766,506113,482831,599318,3012895,170139,331696,501835,342832,475995,520060,495097,531339,899638,3264961,6277856,7309253,7309253
Bulgaria,2016,BG,BGR,EUR,174883,349937,524820,347589,500871,548489,504016,482015,604611,2987591,165475,331017,496492,328772,468305,515316,490446,526215,908012,3237066,6224657,7245975,7245975
Bulgaria,2017,BG,BGR,EUR,171101,349479,520580,336371,488358,546452,500500,480749,608948,2961378,162109,330135,492244,317109,457765,512746,484583,521768,914266,3208237,6169615,7182428,7182428
Bulgaria,2018,BG,BGR,EUR,168071,347716,515787,327557,473870,543046,499516,477091,614424,2935504,159192,328324,487516,307896,444960,508616,481905,514482,920765,3178624,6114128,7117431,7117431
Bulgaria,2019,BG,BGR,EUR,164928,345085,510013,321719,457299,533963,504075,472919,620930,2910905,156058,325659,481717,301453,430192,498994,485033,507130,927101,3149903,6060808,7052532,7052532
Bulgaria,2020,BG,BGR,EUR,161186,342112,503298,319802,438274,522854,511687,466042,623317,2881976,152569,322547,475116,298658,413034,488040,491043,497400,930602,3118777,6000753,6979175,6979175
Bulgaria,2021,BG,BGR,EUR,157261,338493,495754,319902,418151,512847,519982,454763,617953,2843598,148866,319039,467905,297957,393890,478986,498472,483367,925938,3078610,5922208,6885868,6885868
Bulgaria,2022,BG,BGR,EUR,153330,334868,488198,322831,397312,503712,527841,442894,605998,2800588,144987,316009,460996,300408,373358,471020,506327,469399,911662,3032174,5832762,6781953,6781953
Bulgaria,2023,BG,BGR,EUR,149485,330919,480404,328417,375720,496816,529148,438116,594590,2762807,141245,312631,453876,305606,352403,464813,507740,463023,897046,2990631,5753438,6687717,6687717
Bulgaria,2024,BG,BGR,EUR,145767,325123,470890,332295,357382,490259,525600,441484,591811,2738831,137731,307017,444748,309116,334926,459228,503532,464542,892797,2964141,5702972,6618615,6618615
Bulgaria,2025,BG,BGR,EUR,142489,318710,461199,333638,343450,483237,521966,444409,595876,2722576,134611,300833,435444,310176,321392,453833,499271,464977,896326,2945975,5668551,6565190,6565190
Bulgaria,2026,BG,BGR,EUR,139747,313121,452868,334467,331481,475495,518415,443793,601237,2704888,131990,295723,427713,310794,309499,447756,495484,461604,900555,2925692,5630580,6511163,6511163
Bulgaria,2027,BG,BGR,EUR,137273,308043,445316,335234,321663,465094,516850,441910,605582,2686333,129648,291109,420757,311675,299661,438975,493535,457168,903178,2904192,5590525,6456605,6456605
Bulgaria,2028,BG,BGR,EUR,135006,303176,438182,334832,314119,452919,513985,442266,609141,2667262,127520,286403,413923,311690,292210,428084,489976,455803,904405,2882168,5549430,6401541,6401541
Bulgaria,2029,BG,BGR,EUR,132951,297754,430705,333706,309488,438600,506211,447567,612896,2648468,125583,281079,406662,310936,287443,415186,481405,459842,905383,2860195,5508663,6346031,6346031
Bulgaria,2030,BG,BGR,EUR,131084,291563,422647,332435,308591,421560,497041,455544,615040,2630211,123819,275261,399080,309831,286094,399670,471963,466413,904259,2838230,5468441,6290166,6290166
Bulgaria,1950,BG,BGR,EUR,365682,603826,969508,684304,548406,503675,383207,227561,215412,2562565,362316,605254,967570,680566,551949,496645,393216,274137,261479,2657992,5220557,7157632,7157632
Bulgaria,1951,BG,BGR,EUR,365471,606977,972448,671896,576456,490743,397122,231705,219205,2587127,361924,611680,973604,672828,581184,487508,406441,277800,269794,2695555,5282682,7228734,7228734
Bulgaria,1952,BG,BGR,EUR,363473,614528,978001,659208,604367,476686,409463,237353,220517,2607594,359100,622185,981285,664092,609847,477087,418455,282415,274684,2726580,5334174,7293468,7293468
Bulgaria,1953,BG,BGR,EUR,360841,626229,987070,647291,627974,465064,420925,245734,221141,2628129,355438,636208,991646,655283,634024,468736,429662,288886,279275,2755866,5383995,7362708,7362708
Bulgaria,1954,BG,BGR,EUR,357633,640080,997713,635900,644041,459882,432161,256900,223150,2652034,350328,652279,1002607,646563,650508,466404,440015,297405,286350,2787245,5439279,7439598,7439598
Bulgaria,1955,BG,BGR,EUR,355788,652059,1007847,624888,652703,462663,443145,269888,225410,2678697,346837,665289,1012126,637945,659107,471531,449689,307192,293785,2819249,5497946,7517922,7517922
Bulgaria,1956,BG,BGR,EUR,355232,662266,1017498,614382,657760,472403,451598,284062,227311,2707516,345706,674547,1020253,629019,663278,483022,457267,318390,299846,2850822,5558338,7596096,7596096
Bulgaria,1957,BG,BGR,EUR,352802,672929,1025731,603870,662528,485997,456887,298436,230361,2738079,342812,683267,1026079,619172,666580,497965,462135,330680,305629,2882161,5620240,7672059,7672059
Bulgaria,1958,BG,BGR,EUR,348775,683949,1032724,593992,665691,501312,461394,312815,236492,2771696,338442,691284,1029726,609160,668281,514324,466490,343450,313486,2915191,5686887,7749341,7749341
Bulgaria,1959,BG,BGR,EUR,345248,692425,1037673,587399,664472,519532,464089,327238,242684,2805414,334456,695953,1030409,601651,666055,533207,469209,356297,320839,2947258,5752672,7820753,7820753
Bulgaria,1960,BG,BGR,EUR,342878,696630,1039508,586995,659068,542087,462429,341843,250066,2842488,331315,695918,1027233,600323,660308,555703,467389,369393,329415,2982531,5825019,7891756,7891756
Bulgaria,1961,BG,BGR,EUR,341277,697078,1038355,593375,651587,567531,456721,356220,260421,2885855,328876,691757,1020633,606273,652749,580313,461511,382439,341221,3024506,5910361,7969342,7969342
Bulgaria,1962,BG,BGR,EUR,339539,694576,1034115,604180,643595,592923,448350,369752,270307,2929107,326494,684739,1011233,616982,644478,604572,453444,394832,352006,3066314,5995421,8040772,8040772
Bulgaria,1963,BG,BGR,EUR,338098,689675,1027773,618280,635560,615009,439943,382669,280759,2972220,324520,675917,1000437,630851,636333,625442,445785,406644,362672,3107727,6079947,8108153,8108153
Bulgaria,1964,BG,BGR,EUR,337095,684453,1021548,633819,627070,631087,434940,395215,293567,3015698,323017,666574,989591,646441,628477,640189,441989,417854,375938,3150888,6166586,8177721,8177721
Bulgaria,1965,BG,BGR,EUR,334671,681999,1016670,647443,617987,640143,435803,407407,307065,3055848,320272,660895,981167,659527,620796,647803,444455,428561,390252,3191394,6247242,8245072,8245072
Bulgaria,1966,BG,BGR,EUR,330999,681643,1012642,658668,608564,644590,442861,417331,320786,3092800,316387,658975,975362,668865,613189,650612,453431,437420,404585,3228102,6320902,8308899,8308899
Bulgaria,1967,BG,BGR,EUR,329092,680132,1009224,669117,598701,647811,454283,423386,333829,3127127,314154,656520,970674,677013,605343,652268,466869,443241,418087,3262821,6389948,8369836,8369836
Bulgaria,1968,BG,BGR,EUR,332756,677159,1009915,679395,589014,649552,468184,427578,346823,3160546,317349,653194,970543,684554,597657,653101,482415,448065,431500,3297292,6457838,8438288,8438288
Bulgaria,1969,BG,BGR,EUR,340730,674782,1015512,687026,581949,648010,485053,429532,360181,3191751,324810,650678,975488,689292,592063,651514,500545,451396,445358,3330168,6521919,8512919,8512919
Bulgaria,2031,BG,BGR,EUR,129419,285272,414691,330531,309669,403175,489292,464292,614887,2611846,122242,269328,391570,308310,286724,381970,464729,474258,899962,2815953,5427799,6234059,6234059
Bulgaria,2032,BG,BGR,EUR,127959,278979,406938,327761,313165,383425,481937,473042,613967,2593297,120854,263233,384087,306269,289861,362266,458042,482614,894364,2793416,5386713,6177734,6177734
Bulgaria,2033,BG,BGR,EUR,126687,272882,399569,323842,318807,362325,476020,476081,617286,2574361,119648,257387,377035,302920,295082,341562,452318,484886,893505,2770273,5344634,6121236,6121236
Bulgaria,2034,BG,BGR,EUR,125619,267125,392744,318094,322719,344411,470208,474275,625220,2554927,118633,251954,370587,297330,298604,324281,447077,481524,897562,2746378,5301305,6064642,6064642
Bulgaria,2035,BG,BGR,EUR,124743,261997,386740,311725,324092,330818,463765,471823,632517,2534740,117806,247080,364886,291165,299681,310898,441922,477803,900172,2721641,5256381,6008012,6008012
Bulgaria,2036,BG,BGR,EUR,123968,257606,381574,306175,324954,319139,456530,469240,637756,2513794,117071,242896,359967,286075,300306,299142,436050,474438,900057,2696068,5209862,5951399,5951399
Bulgaria,2037,BG,BGR,EUR,123292,253684,376976,301131,325752,309564,446690,468307,640967,2492411,116429,239174,355603,281477,301206,289413,427491,472762,897610,2669959,5162370,5894951,5894951
Bulgaria,2038,BG,BGR,EUR,122719,250161,372880,296300,325391,302233,435132,466252,645368,2470676,115882,235849,351731,276787,301229,282056,416858,469572,896951,2643453,5114129,5838741,5838741
Bulgaria,2039,BG,BGR,EUR,122155,247048,369203,290917,324309,297769,421501,460018,654106,2448620,115346,232910,348256,271480,300492,277360,404249,461692,901390,2616663,5065283,5782742,5782742
Bulgaria,2040,BG,BGR,EUR,121579,244317,365896,284764,323086,296970,405222,452588,663701,2426331,114798,230320,345118,265678,299403,276059,389057,452993,906462,2589652,5015983,5727006,5727006
Bulgaria,2041,BG,BGR,EUR,120989,241888,362877,278511,321236,298109,387653,446406,671980,2403895,114237,228015,342252,259764,297898,276719,371726,446403,910049,2562559,4966454,5671575,5671575
Bulgaria,2042,BG,BGR,EUR,120332,239759,360091,272255,318522,301626,368769,440561,679614,2381347,113613,225989,339602,253687,295883,279862,352420,440336,913240,2535428,4916775,5616468,5616468
Bulgaria,2043,BG,BGR,EUR,119584,237925,357509,266197,314670,307251,348608,435983,686032,2358741,112904,224249,337153,247857,292549,285069,332137,435175,915505,2508292,4867033,5561697,5561697
Bulgaria,2044,BG,BGR,EUR,118777,236300,355077,260475,309006,311190,331609,431506,692345,2336131,112143,222702,334845,242441,286994,288604,315263,430472,917489,2481263,4817394,5507318,5507318
Bulgaria,2045,BG,BGR,EUR,117910,234859,352769,255380,302721,312635,318823,426354,697652,2313565,111318,221331,332649,237581,280862,289711,302242,425804,918173,2454373,4767938,5453350,5453350
Bulgaria,2046,BG,BGR,EUR,116945,233497,350442,251019,297246,313558,307847,420306,701130,2291106,110409,220039,330448,233408,275800,290365,290798,420371,916944,2427686,4718792,5399681,5399681
Bulgaria,2047,BG,BGR,EUR,115901,232174,348075,247125,292271,314401,298861,411771,704343,2268772,109419,218778,328197,229701,271224,291274,281328,412301,915399,2401227,4669999,5346269,5346269
Bulgaria,2048,BG,BGR,EUR,114791,230860,345651,243626,287505,314098,292038,401644,707673,2246584,108372,217530,325902,226386,266558,291318,274187,402209,914353,2375011,4621595,5293141,5293141
Bulgaria,2049,BG,BGR,EUR,113592,229495,343087,240538,282186,313088,287976,389588,711222,2224598,107238,216234,323472,223453,261276,290603,269666,390205,913868,2349071,4573669,5240228,5240228
Bulgaria,2050,BG,BGR,EUR,112234,228058,340292,237829,276101,311939,287423,375029,714501,2202822,105956,214867,320823,220876,255502,289542,268475,375684,913373,2323452,4526274,5187392,5187392
Bahrain,1970,BH,BHR,EMR,19015,32416,51431,22501,18138,13879,9008,4601,2986,71113,18398,30302,48700,17679,12201,9344,5983,3317,2778,51302,122415,222555,222555
Bahrain,1971,BH,BHR,EMR,19063,33770,52833,24538,18582,14204,9388,4874,3195,74781,18517,31259,49776,18982,12348,9587,6268,3480,2935,53600,128381,230992,230992
Bahrain,1972,BH,BHR,EMR,19304,35310,54614,28132,19973,14805,9709,5081,3333,81033,18799,32290,51089,20607,12776,9878,6497,3620,3023,56401,137434,243143,243143
Bahrain,1973,BH,BHR,EMR,19784,36403,56187,32177,21936,15565,10039,5280,3452,88449,19315,33179,52494,22368,13350,10211,6713,3756,3100,59498,147947,256632,256632
Bahrain,1974,BH,BHR,EMR,20520,36969,57489,36117,24357,16441,10418,5487,3562,96382,20099,33864,53963,24174,14042,10560,6946,3904,3171,62797,159179,270627,270627
Bahrain,1975,BH,BHR,EMR,21503,37139,58642,39742,27299,17448,10853,5706,3661,104709,21126,34374,55500,25973,14859,10930,7208,4052,3243,66265,170974,285116,285116
Bahrain,1976,BH,BHR,EMR,22599,37185,59784,42801,30788,18612,11359,5936,3756,113252,22265,34850,57115,27717,15825,11317,7494,4211,3321,69885,183137,300044,300044
Bahrain,1977,BH,BHR,EMR,23622,37423,61045,45074,34846,19979,11950,6183,3843,121875,23315,35477,58792,29342,16971,11733,7808,4376,3400,73630,195505,315337,315337
Bahrain,1978,BH,BHR,EMR,24458,38004,62462,46478,39406,21588,12626,6445,3918,130461,24161,36350,60511,30805,18301,12183,8166,4542,3479,77476,207937,330912,330912
Bahrain,1979,BH,BHR,EMR,25101,38952,64053,47032,44356,23498,13405,6724,3991,139006,24786,37475,62261,32076,19804,12684,8544,4717,3554,81379,220385,346697,346697
Bahrain,1980,BH,BHR,EMR,25563,40194,65757,46838,49512,25747,14301,7033,4064,147495,25204,38828,64032,33134,21469,13231,8941,4901,3643,85319,232814,362595,362595
Bahrain,1981,BH,BHR,EMR,25851,41739,67590,46967,53562,27711,15099,7374,4178,154891,25377,40267,65644,34276,23137,13713,9313,5111,3745,89295,244186,377430,377430
Bahrain,1982,BH,BHR,EMR,26207,43270,69477,48107,56122,29101,15646,7730,4369,161075,25536,41546,67082,35647,24778,14097,9638,5349,3871,93380,254455,391017,391017
Bahrain,1983,BH,BHR,EMR,26898,44452,71350,49536,58426,30521,16073,8080,4572,167208,26036,42581,68617,36969,26563,14504,9950,5608,4005,97599,264807,404772,404772
Bahrain,1984,BH,BHR,EMR,27959,45348,73307,50771,60931,32235,16462,8422,4779,173600,26965,43417,70382,38116,28554,14992,10250,5880,4142,101934,275534,419217,419217
Bahrain,1985,BH,BHR,EMR,29374,46054,75428,51706,63660,34258,16834,8736,4993,180187,28317,44048,72365,39097,30727,15587,10528,6173,4289,106401,286588,434375,434375
Bahrain,1986,BH,BHR,EMR,31005,46751,77756,52276,66574,36618,17202,9022,5212,186904,29933,44629,74562,39906,33039,16341,10783,6472,4434,110975,297879,450196,450196
Bahrain,1987,BH,BHR,EMR,32548,47788,80336,52369,69654,39349,17568,9283,5419,193642,31458,45520,76978,40470,35446,17297,11013,6781,4596,115603,309245,466565,466565
Bahrain,1988,BH,BHR,EMR,33840,49352,83192,51893,72839,42513,17960,9510,5616,200331,32690,46932,79622,40719,37905,18488,11219,7092,4769,120192,320523,483337,483337
Bahrain,1989,BH,BHR,EMR,34845,51451,86296,50836,75999,46151,18417,9684,5793,206880,33607,48879,82486,40611,40359,19969,11433,7368,4942,124682,331562,500349,500349
Bahrain,1990,BH,BHR,EMR,35487,54038,89525,49301,78989,50293,19005,9811,5938,213337,34158,51323,85481,40181,42741,21759,11652,7619,5122,129074,342411,517418,517418
Bahrain,1991,BH,BHR,EMR,35619,57512,93131,49770,80141,54190,19918,10054,6170,220243,34118,54160,88278,40499,44511,23614,11925,7879,5338,133766,354009,535415,535415
Bahrain,1992,BH,BHR,EMR,35564,61106,96670,52903,79552,57586,21150,10441,6520,228152,33805,56823,90628,41900,45683,25420,12261,8139,5616,139019,367171,554470,554470
Bahrain,1993,BH,BHR,EMR,35728,63716,99444,56742,79038,60934,22548,10803,6914,236979,33732,58880,92612,43654,46768,27333,12634,8391,5940,144720,381699,573755,573755
Bahrain,1994,BH,BHR,EMR,36065,65603,101668,60869,78838,64193,24134,11135,7332,246501,33859,60457,94316,45633,47827,29349,13071,8622,6269,150771,397272,593254,593254
Bahrain,1995,BH,BHR,EMR,36510,66988,103498,64897,79156,67355,25896,11465,7750,256519,34136,61637,95773,47717,48929,31451,13580,8859,6602,157138,413657,612934,612934
Bahrain,1996,BH,BHR,EMR,37007,68011,105018,68570,80162,70431,27818,11817,8150,266948,34507,62413,96920,49892,50133,33628,14174,9126,6916,163869,430817,632756,632756
Bahrain,1997,BH,BHR,EMR,37457,68742,106199,71734,81985,73398,29931,12182,8521,277751,34861,62837,97698,52147,51457,35876,14885,9398,7242,171005,448756,652643,652643
Bahrain,1998,BH,BHR,EMR,37786,69388,107174,74133,84700,76228,32284,12542,8853,288740,35091,63135,98226,54264,52911,38189,15742,9668,7557,178331,467071,672484,672484
Bahrain,1999,BH,BHR,EMR,37949,70172,108121,75460,88312,78978,34887,12902,9141,299680,35139,63558,98697,55976,54495,40593,16774,9943,7849,185630,485310,692133,692133
Bahrain,2000,BH,BHR,EMR,37903,71227,109130,75579,92704,81742,37740,13282,9392,310439,34928,64209,99137,57159,56146,43107,17982,10208,8134,192736,503175,711442,711442
Bahrain,2001,BH,BHR,EMR,37606,72517,110123,74643,97562,84680,40835,13689,9620,321029,34374,65084,99458,57806,57842,45732,19371,10457,8444,199652,520681,730257,730257
Bahrain,2002,BH,BHR,EMR,37011,73858,110869,73081,102349,87991,44172,14156,9826,331575,33378,66037,99415,58028,59563,48456,20959,10693,8766,206465,538040,748324,748324
Bahrain,2003,BH,BHR,EMR,36726,75117,111843,76354,108448,92295,48270,14847,10062,350276,32869,67128,99997,59718,61780,51453,23079,10958,9160,216148,566424,778256,778256
Bahrain,2004,BH,BHR,EMR,37656,75951,113607,88678,118567,98218,53700,15962,10418,385543,34128,68342,102470,64564,65332,54803,26112,11330,9674,231815,617358,833451,833451
Bahrain,2005,BH,BHR,EMR,39467,76233,115700,103002,132516,105602,59955,17547,10868,429490,36519,69401,105920,70436,70223,58212,29787,11885,10270,250813,680303,901921,901921
Bahrain,2006,BH,BHR,EMR,41438,76441,117879,112658,149376,114278,66363,19631,11321,473627,39031,70325,109356,75218,76071,61544,33711,12708,10866,270118,743745,970981,970981
Bahrain,2007,BH,BHR,EMR,43387,76969,120356,116921,169447,124448,72816,22344,11729,517705,41460,71381,112841,78768,82795,64936,37812,13891,11430,289632,807337,1040532,1040532
Bahrain,2008,BH,BHR,EMR,44925,78089,123014,116167,192117,136264,79355,25749,12098,561750,43279,72947,116226,81016,90268,68547,42059,15490,11978,309358,871108,1110343,1110343
Bahrain,2009,BH,BHR,EMR,45420,79877,125297,111641,215825,149875,86136,29872,12474,605823,43877,75223,119100,81904,98308,72584,46388,17512,12542,329238,935061,1179453,1179453
Bahrain,2010,BH,BHR,EMR,45835,81195,127030,106014,227181,157202,90353,33353,12866,626969,44215,76948,121163,80114,101861,74630,49524,19301,13049,338479,965448,1213645,1213645
Bahrain,2011,BH,BHR,EMR,46418,80975,127393,103370,227037,156321,90914,35533,13238,626413,44677,77037,121714,77095,100259,74193,50970,20663,13370,336550,962963,1212077,1212077
Bahrain,2012,BH,BHR,EMR,46471,79640,126111,102862,235494,158158,91384,37702,13716,639316,44738,75932,120670,75612,100441,74736,52164,22235,13662,338850,978166,1224939,1224939
Bahrain,2013,BH,BHR,EMR,47758,80544,128302,101680,243979,161774,94006,42071,15450,658960,45964,76800,122764,76147,104193,77113,54463,25186,14536,351638,1010598,1261673,1261673
Bahrain,2014,BH,BHR,EMR,50542,85165,135707,103020,243479,163937,97763,48286,18506,674991,48508,81159,129667,78626,109136,80478,57182,29287,16054,370763,1045754,1311134,1311134
Bahrain,2015,BH,BHR,EMR,52539,89329,141868,107113,248935,170276,101091,51872,20543,699830,50355,85233,135588,81058,112427,83765,58338,32029,17228,384845,1084675,1362142,1362142
Bahrain,2016,BH,BHR,EMR,53552,91840,145392,109611,261895,181475,104649,52714,21294,731638,51338,87909,139247,82239,114700,86624,58553,33440,17833,393389,1125027,1409661,1409661
Bahrain,2017,BH,BHR,EMR,54271,94387,148658,110015,273483,195771,109056,53351,21866,763542,52012,90597,142609,82423,117959,89485,59001,34753,18405,402026,1165568,1456834,1456834
Bahrain,2018,BH,BHR,EMR,54232,96958,151190,107663,273475,209632,113312,54229,22488,780799,52075,93145,145220,81726,120615,92542,59856,36215,19171,410125,1190924,1487340,1487340
Bahrain,2019,BH,BHR,EMR,53589,99280,152869,103797,261598,219234,116626,55604,23679,780538,51667,95322,146989,80581,118844,95129,60911,37952,20370,413787,1194325,1494188,1494188
Bahrain,2020,BH,BHR,EMR,51991,100879,152870,94265,242294,226707,120739,58196,25362,767563,50137,96905,147042,76900,112629,96573,62082,39937,21874,409995,1177558,1477469,1477469
Bahrain,2021,BH,BHR,EMR,49749,102269,152018,83538,220685,235590,127128,62214,27474,756629,47860,98295,146155,73563,106792,98304,64063,42163,23580,408465,1165094,1463265,1463265
Bahrain,2022,BH,BHR,EMR,47793,103744,151537,82784,206587,242716,132907,65863,29805,760662,45986,99671,145657,74670,103499,100312,66227,44177,25487,414372,1175034,1472233,1472233
Bahrain,2023,BH,BHR,EMR,45928,104637,150565,86969,197077,246090,137010,68726,32187,768059,44218,100578,144796,77742,101138,101702,68018,45849,27651,422100,1190159,1485509,1485509
Bahrain,2024,BH,BHR,EMR,44212,104827,149039,91530,188372,248330,141244,71534,34960,775970,42565,100843,143408,81416,98781,102720,69998,47259,30112,430286,1206256,1498712,1498712
Bahrain,2025,BH,BHR,EMR,42932,104297,147229,96259,181212,248554,145612,74351,38057,784045,41343,100343,141686,85398,96550,103416,72235,48400,32721,438720,1222765,1511676,1511676
Bahrain,2026,BH,BHR,EMR,42192,103182,145374,100814,177206,245137,150159,77396,41344,792056,40652,99253,139905,89351,94336,104081,74480,49435,35451,447134,1239190,1524461,1524461
Bahrain,2027,BH,BHR,EMR,41833,101610,143443,105116,177188,236806,155549,80613,44792,800064,40315,97768,138083,93093,92283,104753,76596,50470,38331,455526,1255590,1537124,1537124
Bahrain,2028,BH,BHR,EMR,41703,99486,141189,109100,180010,225073,161933,83845,48384,808345,40197,95805,136002,96506,90899,105248,78668,51509,41338,464168,1272513,1549710,1549710
Bahrain,2029,BH,BHR,EMR,41710,96913,138623,112447,184308,212620,168285,87115,52116,816891,40213,93412,133625,99347,90739,105210,80702,52571,44522,473091,1289982,1562228,1562228
Bahrain,2030,BH,BHR,EMR,41830,94254,136084,115153,188968,201037,173583,90612,56011,825364,40339,90811,131150,101719,91800,104393,82588,53734,47851,482085,1307449,1574679,1574679
Bahrain,1950,BH,BHR,EMR,10461,15127,25588,12655,10639,6609,4009,2339,1611,37862,9863,14166,24029,9874,7416,5002,3406,2217,1749,29664,67526,117149,117149
Bahrain,1951,BH,BHR,EMR,10612,15974,26586,12974,10960,6792,4091,2394,1649,38860,9932,14652,24584,10186,7568,5089,3444,2246,1784,30317,69177,120354,120354
Bahrain,1952,BH,BHR,EMR,10815,16744,27559,13395,11270,6986,4173,2450,1684,39958,10073,15071,25144,10545,7736,5178,3474,2275,1818,31026,70984,123685,123685
Bahrain,1953,BH,BHR,EMR,11127,17383,28510,13922,11573,7202,4255,2503,1726,41181,10350,15367,25717,10939,7921,5272,3501,2304,1843,31780,72961,127186,127186
Bahrain,1954,BH,BHR,EMR,11586,17843,29429,14552,11876,7457,4348,2561,1755,42549,10801,15538,26339,11357,8122,5376,3530,2329,1859,32573,75122,130895,130895
Bahrain,1955,BH,BHR,EMR,12117,18228,30345,15261,12187,7751,4455,2615,1777,44046,11320,15718,27038,11794,8350,5496,3561,2354,1879,33434,77480,134865,134865
Bahrain,1956,BH,BHR,EMR,12692,18616,31308,16021,12528,8080,4579,2666,1799,45673,11884,15969,27853,12235,8603,5629,3606,2374,1884,34331,80004,139171,139171
Bahrain,1957,BH,BHR,EMR,13361,18998,32359,16802,12934,8440,4723,2711,1819,47429,12567,16265,28832,12670,8884,5785,3658,2393,1888,35278,82707,143897,143897
Bahrain,1958,BH,BHR,EMR,14112,19410,33522,17573,13416,8829,4886,2748,1836,49288,13357,16646,30003,13093,9203,5960,3724,2398,1885,36263,85551,149077,149077
Bahrain,1959,BH,BHR,EMR,14910,19914,34824,18292,14000,9227,5066,2783,1850,51218,14211,17158,31369,13484,9555,6145,3793,2405,1884,37266,88484,154685,154685
Bahrain,1960,BH,BHR,EMR,15702,20563,36265,18925,14703,9631,5268,2810,1869,53206,15077,17850,32927,13825,9950,6352,3874,2401,1885,38287,91493,160691,160691
Bahrain,1961,BH,BHR,EMR,16398,21409,37807,19433,15507,10057,5491,2834,1890,55212,15867,18764,34631,14115,10375,6583,3961,2392,1891,39317,94529,166970,166970
Bahrain,1962,BH,BHR,EMR,16936,22460,39396,19810,16403,10515,5742,2865,1912,57247,16469,19908,36377,14348,10824,6843,4053,2383,1898,40349,97596,173359,173359
Bahrain,1963,BH,BHR,EMR,17343,23706,41049,20061,17361,11019,6024,2903,1920,59288,16897,21279,38176,14529,11287,7131,4162,2371,1895,41375,100663,179891,179891
Bahrain,1964,BH,BHR,EMR,17630,25115,42745,20211,18361,11585,6343,2958,1928,61386,17179,22846,40025,14690,11749,7457,4280,2369,1886,42431,103817,186587,186587
Bahrain,1965,BH,BHR,EMR,17924,26590,44514,20194,18917,12139,6726,3111,1996,63083,17398,24457,41855,14826,12067,7822,4463,2448,1941,43567,106650,193012,193012
Bahrain,1966,BH,BHR,EMR,18299,27974,46273,20158,18915,12611,7169,3378,2149,64380,17648,25934,43582,14999,12193,8180,4722,2614,2078,44786,109166,199019,199019
Bahrain,1967,BH,BHR,EMR,18632,29209,47841,20383,18763,13029,7626,3671,2316,65788,17914,27219,45133,15350,12247,8517,5014,2790,2233,46151,111939,204916,204916
Bahrain,1968,BH,BHR,EMR,18861,30335,49196,20894,18549,13386,8095,3976,2518,67418,18146,28357,46503,15912,12254,8831,5321,2964,2398,47680,115098,210801,210801
Bahrain,1969,BH,BHR,EMR,18990,31397,50387,21626,18326,13671,8563,4285,2738,69209,18307,29390,47697,16695,12236,9107,5651,3140,2584,49413,118622,216696,216696
Bahrain,2031,BH,BHR,EMR,42046,91762,133808,117375,193274,190661,177785,94407,60035,833537,40550,88343,128893,103717,93660,102895,84254,55171,51164,490861,1324398,1587097,1587097
Bahrain,2032,BH,BHR,EMR,42342,89527,131869,118982,197312,180858,181543,98403,64255,841353,40840,86219,127059,105191,96093,100876,85776,56854,54429,499219,1340572,1599504,1599504
Bahrain,2033,BH,BHR,EMR,42706,87540,130246,119873,201495,171405,184917,102457,68687,848834,41196,84339,125535,106095,99164,98529,87169,58636,57713,507306,1356140,1611918,1611918
Bahrain,2034,BH,BHR,EMR,43127,85839,128966,120069,206053,162754,187155,106626,73295,855952,41604,82703,124307,106364,102837,96185,88191,60599,60911,515087,1371039,1624315,1624315
Bahrain,2035,BH,BHR,EMR,43604,84680,128284,119539,210773,155644,187395,110936,78162,862449,42062,81607,123669,105865,106815,93964,88891,62809,63953,522297,1384746,1636698,1636698
Bahrain,2036,BH,BHR,EMR,44130,84156,128286,118431,215327,151676,184020,115424,83365,868243,42573,81129,123702,104774,110765,91759,89561,65023,66978,528860,1397103,1649093,1649093
Bahrain,2037,BH,BHR,EMR,44696,84098,128794,116865,219633,151673,175765,120746,88838,873520,43124,81086,124210,103296,114503,89720,90241,67110,70101,534971,1408491,1661491,1661491
Bahrain,2038,BH,BHR,EMR,45304,84335,129639,114749,223615,154496,164145,127047,94411,878463,43712,81326,125038,101334,117908,88349,90743,69154,73303,540791,1419254,1673928,1673928
Bahrain,2039,BH,BHR,EMR,45941,84767,130708,112180,226961,158794,151821,133306,100091,883153,44327,81753,126080,98940,120750,88199,90719,71164,76637,546409,1429562,1686356,1686356
Bahrain,2040,BH,BHR,EMR,46578,85365,131943,109529,229667,163451,140363,138534,106091,887635,44942,82335,127277,96350,123119,89266,89920,73031,80178,551864,1439499,1698716,1698716
Bahrain,2041,BH,BHR,EMR,47205,86109,133314,107044,231893,167761,130104,142688,112432,891922,45546,83060,128606,93885,125122,91127,88443,74685,83913,557175,1449097,1711015,1711015
Bahrain,2042,BH,BHR,EMR,47779,86971,134750,104820,233504,171798,120424,146412,119102,896060,46096,83898,129994,91763,126594,93562,86453,76205,87788,562365,1458425,1723162,1723162
Bahrain,2043,BH,BHR,EMR,48246,87944,136190,102840,234406,175982,111101,149760,125976,900065,46548,84841,131389,89884,127499,96626,84131,77596,91721,567457,1467522,1735093,1735093
Bahrain,2044,BH,BHR,EMR,48623,89005,137628,101143,234609,180536,102579,151992,133061,903920,46909,85867,132776,88253,127768,100295,81819,78623,95698,572456,1476376,1746778,1746778
Bahrain,2045,BH,BHR,EMR,48890,90119,139009,99989,234089,185259,95576,152261,140476,907650,47167,86946,134113,87159,127271,104266,79625,79336,99721,577378,1485028,1758146,1758146
Bahrain,2046,BH,BHR,EMR,49033,91278,140311,99471,232991,189809,91690,148977,148336,911274,47303,88061,135364,86682,126189,108204,77453,80016,103691,582235,1493509,1769175,1769175
Bahrain,2047,BH,BHR,EMR,49084,92415,141499,99413,231438,194112,91716,140924,157194,914797,47356,89159,136515,86643,124711,111937,75447,80707,107590,587035,1501832,1779843,1779843
Bahrain,2048,BH,BHR,EMR,49048,93492,142540,99653,229333,198093,94539,129590,167024,918232,47323,90200,137523,86880,122753,115339,74104,81223,111496,591795,1510027,1790091,1790091
Bahrain,2049,BH,BHR,EMR,48914,94505,143419,100089,226779,201444,98818,117587,176851,921568,47197,91176,138373,87306,120366,118177,73974,81227,115475,596525,1518093,1799885,1799885
Bahrain,2050,BH,BHR,EMR,48726,95412,144138,100686,224137,204156,103463,106435,185934,924811,47017,92049,139066,87894,117781,120544,75053,80466,119489,601227,1526038,1809237,1809237
Bahamas,1970,BS,BHS,AMR,14137,24750,38887,14979,13801,9244,6239,4046,2413,50722,13728,24064,37792,15211,12947,8922,6505,4470,3673,51728,102450,179129,179129
Bahamas,1971,BS,BHS,AMR,13833,25670,39503,15744,14264,9739,6398,4249,2520,52914,13552,24853,38405,15862,13370,9303,6627,4638,3806,53606,106520,184435,184435
Bahamas,1972,BS,BHS,AMR,13576,26474,40050,16464,14510,10191,6558,4434,2627,54784,13335,25601,38936,16540,13669,9665,6756,4804,3961,55395,110179,189181,189181
Bahamas,1973,BS,BHS,AMR,13302,27219,40521,17198,14604,10626,6727,4597,2759,56511,13049,26302,39351,17285,13884,10019,6895,4961,4132,57176,113687,193563,193563
Bahamas,1974,BS,BHS,AMR,13080,27745,40825,18040,14622,11070,6930,4737,2896,58295,12846,26753,39599,18124,14056,10387,7053,5111,4309,59040,117335,197767,197767
Bahamas,1975,BS,BHS,AMR,12935,27945,40880,19051,14610,11553,7160,4867,3054,60295,12730,26921,39651,19056,14210,10786,7240,5266,4496,61054,121349,201881,201881
Bahamas,1976,BS,BHS,AMR,12803,27945,40748,20228,14611,12068,7435,4985,3232,62559,12596,26974,39570,20083,14355,11217,7463,5413,4688,63219,125778,206096,206096
Bahamas,1977,BS,BHS,AMR,12702,27846,40548,21488,14673,12579,7758,5093,3422,65013,12486,26948,39434,21182,14522,11670,7719,5556,4883,65532,130545,210534,210534
Bahamas,1978,BS,BHS,AMR,12633,27663,40296,22731,14857,13055,8101,5194,3612,67550,12409,26835,39244,22280,14753,12118,8003,5692,5086,67932,135482,215016,215016
Bahamas,1979,BS,BHS,AMR,12633,27363,39996,23889,15171,13480,8453,5300,3788,70081,12398,26639,39037,23287,15093,12545,8302,5815,5274,70316,140397,219426,219426
Bahamas,1980,BS,BHS,AMR,12749,26936,39685,24915,15620,13847,8816,5416,3956,72570,12498,26356,38854,24147,15547,12928,8619,5924,5477,72642,145212,223752,223752
Bahamas,1981,BS,BHS,AMR,12957,26587,39544,25802,16188,13962,9089,5488,4128,74657,12686,26159,38845,24998,16150,13172,8892,5999,5690,74901,149558,227956,227956
Bahamas,1982,BS,BHS,AMR,13194,26443,39637,26582,16870,13854,9268,5518,4307,76399,12889,26096,38985,25888,16927,13278,9106,6039,5933,77171,153570,232177,232177
Bahamas,1983,BS,BHS,AMR,13462,26381,39843,27256,17649,13733,9432,5550,4478,78098,13143,26039,39182,26663,17849,13379,9320,6075,6172,79458,157556,236586,236586
Bahamas,1984,BS,BHS,AMR,13776,26450,40226,27707,18549,13640,9582,5587,4652,79717,13444,26119,39563,27160,18905,13494,9537,6139,6416,81651,161368,241166,241166
Bahamas,1985,BS,BHS,AMR,14101,26661,40762,27902,19618,13583,9731,5639,4803,81276,13777,26328,40105,27440,20077,13633,9782,6225,6635,83792,165068,245935,245935
Bahamas,1986,BS,BHS,AMR,14390,26908,41298,27979,20822,13563,9874,5684,4915,82837,14137,26508,40645,27678,21341,13792,10061,6316,6829,86017,168854,250804,250804
Bahamas,1987,BS,BHS,AMR,14588,27180,41768,27994,22069,13651,9998,5734,4987,84433,14455,26711,41166,27822,22664,14023,10340,6394,7014,88257,172690,255618,255618
Bahamas,1988,BS,BHS,AMR,14793,27432,42225,27972,23274,13923,10086,5797,5013,86065,14690,26993,41683,27886,23947,14411,10607,6474,7156,90481,176546,260452,260452
Bahamas,1989,BS,BHS,AMR,15092,27708,42800,27980,24340,14393,10125,5850,5048,87736,14939,27279,42218,27952,25076,15011,10853,6593,7252,92737,180473,265493,265493
Bahamas,1990,BS,BHS,AMR,15381,28021,43402,27929,25302,15116,10171,5999,5142,89659,15155,27502,42657,27975,26012,15777,11005,6819,7370,94958,184617,270679,270679
Bahamas,1991,BS,BHS,AMR,15727,28278,44005,27807,26102,15988,10350,6247,5242,91736,15396,27717,43113,27968,26796,16635,11174,7105,7531,97209,188945,276058,276058
Bahamas,1992,BS,BHS,AMR,16360,28463,44823,27730,26679,16805,10682,6517,5324,93737,15907,27976,43883,27956,27436,17584,11465,7402,7685,99528,193265,281973,281973
Bahamas,1993,BS,BHS,AMR,17039,28783,45822,27677,27136,17598,11067,6793,5427,95698,16553,28348,44901,27857,27942,18566,11837,7695,7842,101739,197437,288164,288164
Bahamas,1994,BS,BHS,AMR,17351,29322,46673,27618,27485,18439,11451,7060,5579,97632,16942,28853,45795,27746,28279,19597,12227,7984,8063,103896,201528,293997,293997
Bahamas,1995,BS,BHS,AMR,17485,29829,47314,27571,27726,19418,11811,7359,5754,99639,17120,29348,46468,27671,28559,20707,12592,8305,8302,106136,205775,299554,299554
Bahamas,1996,BS,BHS,AMR,17507,30302,47809,27544,27897,20522,12121,7695,5901,101680,17154,29885,47039,27549,28853,21880,12934,8677,8502,108395,210075,304933,304933
Bahamas,1997,BS,BHS,AMR,17246,30995,48241,27550,27963,21643,12463,8041,6057,103717,16911,30630,47541,27493,29012,23095,13304,9057,8718,110679,214396,310171,310171
Bahamas,1998,BS,BHS,AMR,16851,31821,48672,27545,27946,22719,12901,8386,6245,105742,16544,31436,47980,27555,29042,24244,13779,9435,8947,113002,218744,315398,315398
Bahamas,1999,BS,BHS,AMR,16449,32445,48894,27586,27925,23669,13446,8698,6477,107801,16169,32055,48224,27636,29051,25245,14400,9809,9206,115347,223148,320272,320272
Bahamas,2000,BS,BHS,AMR,16012,32888,48900,27807,27839,24503,14154,8909,6767,109979,15767,32490,48257,27853,29113,26119,15204,10058,9538,117885,227864,325014,325014
Bahamas,2001,BS,BHS,AMR,15678,33168,48846,28084,27790,25190,14930,9077,7047,112118,15481,32722,48203,28200,29245,26855,16044,10227,9889,120460,232578,329626,329626
Bahamas,2002,BS,BHS,AMR,15486,33370,48856,28254,27866,25728,15607,9329,7305,114089,15345,32871,48216,28501,29381,27439,16851,10453,10212,122837,236926,334002,334002
Bahamas,2003,BS,BHS,AMR,15343,33543,48886,28461,28007,26183,16256,9609,7578,116094,15256,33092,48348,28809,29479,27912,17683,10754,10536,125173,241267,338490,338490
Bahamas,2004,BS,BHS,AMR,15362,33486,48848,28760,28183,26548,16965,9865,7871,118192,15320,33178,48498,29153,29591,28256,18581,11063,10898,127542,245734,343089,343089
Bahamas,2005,BS,BHS,AMR,15498,33330,48828,29010,28341,26875,17801,10128,8189,120344,15477,33164,48641,29412,29714,28624,19576,11360,11299,129985,250329,347804,347804
Bahamas,2006,BS,BHS,AMR,15637,33209,48846,29255,28400,27229,18750,10376,8510,122520,15634,33191,48825,29639,29774,29091,20617,11647,11709,132477,254997,352664,352664
Bahamas,2007,BS,BHS,AMR,15771,33058,48829,29624,28349,27587,19735,10597,8859,124751,15826,33206,49032,29988,29799,29514,21713,11924,12131,135069,259820,357666,357666
Bahamas,2008,BS,BHS,AMR,15909,32930,48839,30092,28208,27879,20698,10897,9209,126983,16065,33212,49277,30357,29857,29897,22759,12302,12527,137699,264682,362795,362795
Bahamas,2009,BS,BHS,AMR,16094,32945,49039,30512,28044,28157,21560,11333,9509,129115,16312,33320,49632,30669,29926,30250,23694,12799,12932,140270,269385,368057,368057
Bahamas,2010,BS,BHS,AMR,15980,32979,48959,31015,28009,28351,22369,11941,9794,131479,16200,33380,49580,31228,30061,30555,24593,13492,13325,143254,274733,373272,373272
Bahamas,2011,BS,BHS,AMR,15484,32933,48417,31633,28109,28387,23156,12622,10128,134035,15632,33339,48971,31992,30223,30841,25447,14298,13723,146524,280559,377950,377950
Bahamas,2012,BS,BHS,AMR,14966,32866,47832,32236,28120,28403,23910,13228,10521,136418,14958,33328,48286,32686,30262,31064,26245,15079,14190,149526,285944,382061,382061
Bahamas,2013,BS,BHS,AMR,14302,32792,47094,32769,28127,28526,24525,13849,10915,138711,14103,33334,47437,33343,30296,31222,26909,15920,14719,152409,291120,385650,385650
Bahamas,2014,BS,BHS,AMR,13558,32770,46328,33165,28262,28690,24973,14572,11318,140980,13259,33308,46567,33857,30478,31331,27414,16902,15265,155247,296227,389131,389131
Bahamas,2015,BS,BHS,AMR,13103,32527,45630,33415,28531,28723,25386,15414,11754,143223,12788,32982,45770,34219,30720,31351,27960,17980,15845,158075,301298,392697,392697
Bahamas,2016,BS,BHS,AMR,12854,31971,44825,33543,28942,28571,25825,16343,12193,145417,12535,32314,44849,34497,31033,31274,28576,19074,16434,160888,306305,395976,395976
Bahamas,2017,BS,BHS,AMR,12551,31409,43960,33561,29505,28295,26238,17312,12617,147528,12231,31613,43844,34634,31563,31133,29094,20221,17040,163685,311213,399020,399020
Bahamas,2018,BS,BHS,AMR,12355,30713,43068,33480,30204,28006,26526,18269,13104,149589,12036,30785,42821,34605,32205,31045,29512,21318,17746,166431,316020,401906,401906
Bahamas,2019,BS,BHS,AMR,12171,29965,42136,33386,30905,27769,26732,19121,13683,151596,11855,29949,41804,34505,32848,31016,29810,22292,18547,169018,320614,404557,404557
Bahamas,2020,BS,BHS,AMR,11898,29275,41173,33270,31461,27649,26843,19843,14266,153332,11591,29207,40798,34297,33378,30977,30004,23132,19381,171169,324501,406471,406471
Bahamas,2021,BS,BHS,AMR,11754,28496,40250,33144,31933,27643,26820,20467,14777,154784,11450,28346,39796,34087,33834,30945,30194,23853,20172,173085,327869,407906,407906
Bahamas,2022,BS,BHS,AMR,11721,27660,39381,33059,32478,27615,26815,21100,15369,156436,11420,27351,38771,34040,34410,30911,30387,24567,21083,175398,331834,409984,409984
Bahamas,2023,BS,BHS,AMR,11748,26794,38542,32997,32998,27626,26945,21656,16103,158325,11451,26298,37749,34074,35041,30940,30550,25204,22208,178017,336342,412623,412623
Bahamas,2024,BS,BHS,AMR,11795,25869,37664,32989,33389,27762,27105,22062,16917,160224,11498,25278,36776,34084,35541,31111,30667,25694,23458,180555,340779,415223,415223
Bahamas,2025,BS,BHS,AMR,11857,25161,37018,32758,33634,28022,27148,22459,17858,161879,11560,24562,36122,33794,35895,31340,30702,26230,24810,182771,344650,417790,417790
Bahamas,2026,BS,BHS,AMR,11917,24790,36707,32216,33761,28430,27016,22883,18869,163175,11620,24189,35809,33156,36167,31642,30638,26836,26174,184613,347788,420306,420306
Bahamas,2027,BS,BHS,AMR,11994,24461,36455,31668,33788,28977,26773,23293,19895,164394,11695,23864,35559,32477,36304,32147,30508,27352,27589,186377,350771,422785,422785
Bahamas,2028,BS,BHS,AMR,12076,24288,36364,30982,33717,29656,26517,23585,20969,165426,11776,23693,35469,31672,36284,32766,30426,27769,29036,187953,353379,425211,425211
Bahamas,2029,BS,BHS,AMR,12143,24155,36298,30259,33637,30338,26314,23808,22034,166390,11845,23563,35408,30868,36206,33396,30413,28087,30488,189458,355848,427562,427562
Bahamas,2030,BS,BHS,AMR,12200,23964,36164,29604,33585,30925,26250,23962,23080,167406,11899,23385,35284,30171,36129,34010,30435,28329,31915,190989,358395,429846,429846
Bahamas,1950,BS,BHS,AMR,6206,9620,15826,6519,5435,4629,2534,1679,1636,22432,6014,9791,15805,8001,6508,5250,3384,2196,2241,27580,50012,81644,81644
Bahamas,1951,BS,BHS,AMR,6509,9866,16375,6588,5319,4753,2625,1665,1591,22541,6341,9816,16157,8097,6467,5372,3468,2203,2215,27822,50363,82895,82895
Bahamas,1952,BS,BHS,AMR,6832,10139,16971,6712,5265,4876,2742,1663,1562,22820,6676,9910,16586,8233,6474,5504,3569,2225,2209,28214,51034,84589,84589
Bahamas,1953,BS,BHS,AMR,7172,10450,17622,6906,5272,4986,2881,1669,1554,23268,7013,10090,17103,8401,6532,5638,3685,2264,2225,28745,52013,86739,86739
Bahamas,1954,BS,BHS,AMR,7510,10804,18314,7192,5363,5078,3035,1684,1558,23910,7337,10373,17710,8608,6646,5762,3823,2318,2260,29417,53327,89352,89352
Bahamas,1955,BS,BHS,AMR,7796,11256,19052,7589,5559,5163,3218,1711,1569,24809,7606,10798,18404,8857,6804,5869,3964,2387,2294,30175,54984,92444,92444
Bahamas,1956,BS,BHS,AMR,8068,11787,19855,8070,5841,5247,3430,1752,1571,25911,7866,11335,19201,9141,7003,5967,4120,2473,2326,31030,56941,96004,96004
Bahamas,1957,BS,BHS,AMR,8390,12341,20731,8611,6198,5343,3666,1810,1577,27205,8174,11913,20087,9461,7243,6058,4288,2567,2359,31976,59181,100005,100005
Bahamas,1958,BS,BHS,AMR,8744,12952,21696,9183,6608,5453,3919,1888,1587,28638,8516,12554,21070,9796,7520,6150,4469,2665,2400,33000,61638,104409,104409
Bahamas,1959,BS,BHS,AMR,9131,13637,22768,9768,7070,5589,4198,1991,1595,30211,8893,13257,22150,10147,7834,6247,4668,2762,2443,34101,64312,109233,109233
Bahamas,1960,BS,BHS,AMR,9553,14408,23961,10362,7579,5768,4493,2113,1603,31918,9304,14030,23334,10526,8177,6357,4875,2861,2486,35282,67200,114500,114500
Bahamas,1961,BS,BHS,AMR,10010,15256,25266,10955,8152,5991,4796,2257,1619,33770,9751,14866,24617,10928,8553,6490,5087,2970,2534,36562,70332,120216,120216
Bahamas,1962,BS,BHS,AMR,10483,16169,26652,11535,8787,6276,5093,2419,1643,35753,10214,15752,25966,11361,8959,6648,5289,3087,2588,37932,73685,126305,126305
Bahamas,1963,BS,BHS,AMR,10946,17117,28063,12098,9483,6612,5369,2597,1674,37833,10663,16672,27335,11831,9395,6831,5481,3209,2666,39413,77246,132639,132639
Bahamas,1964,BS,BHS,AMR,11434,17990,29424,12577,10122,6938,5555,2796,1730,39718,11126,17545,28671,12310,9842,7040,5639,3360,2774,40965,80683,138785,138785
Bahamas,1965,BS,BHS,AMR,12014,18779,30793,13007,10704,7227,5654,3007,1815,41414,11643,18379,30022,12817,10306,7273,5772,3551,2897,42616,84030,144849,144849
Bahamas,1966,BS,BHS,AMR,12644,19685,32329,13404,11321,7553,5743,3228,1907,43156,12188,19312,31500,13322,10797,7535,5902,3749,3035,44340,87496,151323,151323
Bahamas,1967,BS,BHS,AMR,13263,20792,34055,13726,11954,7923,5837,3450,2014,44904,12753,20407,33160,13761,11314,7833,6040,3947,3186,46081,90985,158197,158197
Bahamas,1968,BS,BHS,AMR,13853,22065,35918,14038,12579,8328,5943,3659,2144,46691,13329,21639,34968,14183,11855,8165,6192,4131,3346,47872,94563,165456,165456
Bahamas,1969,BS,BHS,AMR,14223,23495,37718,14396,13199,8762,6080,3855,2285,48577,13714,22970,36684,14639,12418,8535,6355,4304,3521,49772,98349,172745,172745
Bahamas,2031,BS,BHS,AMR,12239,23906,36145,28849,33537,31457,26307,24015,24106,168271,11940,23329,35269,29343,36089,34605,30484,28573,33285,192379,360650,432055,432055
Bahamas,2032,BS,BHS,AMR,12253,23958,36211,28028,33488,32012,26320,24060,25089,168997,11952,23385,35337,28363,36102,35228,30487,28793,34653,193626,362623,434166,434166
Bahamas,2033,BS,BHS,AMR,12243,24068,36311,27173,33432,32529,26348,24196,25967,169645,11941,23495,35436,27316,36138,35850,30526,28964,35989,194783,364428,436175,436175
Bahamas,2034,BS,BHS,AMR,12219,24184,36403,26256,33430,32912,26494,24362,26785,170239,11918,23614,35532,26300,36153,36349,30704,29090,37304,195900,366139,438082,438082
Bahamas,2035,BS,BHS,AMR,12171,24301,36472,25558,33211,33162,26767,24426,27697,170821,11872,23729,35601,25591,35864,36702,30939,29142,38738,196976,367797,439873,439873
Bahamas,2036,BS,BHS,AMR,12099,24404,36503,25189,32689,33299,27171,24341,28692,171381,11802,23829,35631,25217,35234,36975,31246,29107,40232,198011,369392,441526,441526
Bahamas,2037,BS,BHS,AMR,12009,24493,36502,24869,32152,33334,27711,24154,29682,171902,11711,23919,35630,24893,34560,37116,31753,29005,41682,199009,370911,443039,443039
Bahamas,2038,BS,BHS,AMR,11901,24566,36467,24698,31486,33279,28373,23953,30604,172393,11605,23991,35596,24724,33764,37105,32367,28951,43048,199959,372352,444418,444418
Bahamas,2039,BS,BHS,AMR,11781,24614,36395,24567,30781,33217,29040,23803,31456,172864,11488,24036,35524,24598,32971,37032,32990,28964,44328,200883,373747,445659,445659
Bahamas,2040,BS,BHS,AMR,11648,24625,36273,24383,30147,33179,29616,23780,32222,173327,11360,24043,35403,24417,32276,36964,33599,29004,45504,201764,375091,446760,446760
Bahamas,2041,BS,BHS,AMR,11513,24591,36104,24323,29413,33147,30137,23865,32876,173761,11228,24012,35240,24365,31456,36928,34191,29070,46615,202625,376386,447724,447724
Bahamas,2042,BS,BHS,AMR,11384,24513,35897,24379,28612,33109,30681,23906,33490,174177,11100,23936,35036,24420,30489,36951,34800,29094,47683,203437,377614,448557,448557
Bahamas,2043,BS,BHS,AMR,11251,24397,35648,24493,27780,33070,31184,23960,34094,174581,10970,23821,34791,24531,29453,36997,35416,29145,48682,204224,378805,449247,449247
Bahamas,2044,BS,BHS,AMR,11113,24254,35367,24608,26890,33085,31566,24128,34676,174953,10835,23680,34515,24647,28444,37018,35912,29333,49601,204955,379908,449788,449788
Bahamas,2045,BS,BHS,AMR,10979,24077,35056,24729,26212,32883,31817,24414,35245,175300,10704,23508,34212,24765,27744,36734,36260,29579,50564,205646,380946,450211,450211
Bahamas,2046,BS,BHS,AMR,10852,23873,34725,24831,25863,32384,31966,24822,35763,175629,10580,23308,33888,24870,27377,36117,36535,29892,51502,206293,381922,450527,450527
Bahamas,2047,BS,BHS,AMR,10734,23651,34385,24923,25551,31877,32019,25349,36187,175906,10459,23092,33551,24955,27058,35460,36681,30397,52313,206864,382770,450708,450708
Bahamas,2048,BS,BHS,AMR,10617,23412,34029,24995,25386,31241,31986,25986,36557,176151,10345,22855,33200,25028,26891,34678,36681,31004,53110,207392,383543,450774,450774
Bahamas,2049,BS,BHS,AMR,10516,23154,33670,25047,25265,30568,31946,26623,36908,176357,10250,22602,32852,25077,26770,33897,36626,31618,53876,207864,384221,450743,450743
Bahamas,2050,BS,BHS,AMR,10428,22889,33317,25054,25093,29963,31934,27182,37307,176533,10164,22343,32507,25086,26594,33224,36572,32220,54575,208271,384804,450625,450625
Bosnia and Herzegovina,1970,BA,BIH,EUR,216439,459299,675738,369118,259397,253846,107841,106228,84128,1180558,208519,450215,658734,366527,275215,266491,155623,129794,106885,1300535,2481093,3815561,3815561
Bosnia and Herzegovina,1971,BA,BIH,EUR,212285,457097,669382,384609,254679,262810,117781,102480,88418,1210777,204270,447288,651558,379418,269362,272757,165353,129232,111408,1327530,2538307,3859242,3859242
Bosnia and Herzegovina,1972,BA,BIH,EUR,209121,453946,663067,397450,252111,270020,130556,97764,92933,1240834,201157,443381,644538,389694,264876,278468,176677,127405,116330,1353450,2594284,3901895,3901895
Bosnia and Herzegovina,1973,BA,BIH,EUR,206524,449745,656269,407953,252340,275088,145398,92760,97493,1271032,198663,438439,637102,397780,262489,283000,188896,125013,121571,1378749,2649781,3943152,3943152
Bosnia and Herzegovina,1974,BA,BIH,EUR,204038,444381,648419,417280,255532,277590,161127,88447,101853,1301829,196385,432422,628807,404724,262590,285491,201031,123163,127008,1404007,2705836,3983063,3983063
Bosnia and Herzegovina,1975,BA,BIH,EUR,201593,438136,639729,425639,261844,277444,176891,85518,105756,1333092,194162,425686,619848,410674,265578,285580,212439,122599,132542,1429412,2762504,4022090,4022090
Bosnia and Herzegovina,1976,BA,BIH,EUR,198987,431402,630389,432830,271478,274768,192280,84002,109094,1364452,191711,418587,610298,415653,271757,283173,222712,123578,138030,1454903,2819355,4060039,4060039
Bosnia and Herzegovina,1977,BA,BIH,EUR,195908,424618,620526,438451,284470,269924,206818,84072,111792,1395527,188806,411474,600280,419323,281170,278420,231580,126296,143394,1480183,2875710,4096516,4096516
Bosnia and Herzegovina,1978,BA,BIH,EUR,192625,417819,610444,442032,300192,263730,220171,86138,113708,1425971,185690,404422,590112,421317,293178,272047,239278,130800,148377,1504997,2930968,4131521,4131521
Bosnia and Herzegovina,1979,BA,BIH,EUR,189563,411107,600670,443728,317106,257000,232249,90584,114724,1455391,182755,397555,580310,421795,306490,264903,246319,137100,152538,1529145,2984536,4165511,4165511
Bosnia and Herzegovina,1980,BA,BIH,EUR,187195,404738,591933,444158,333298,250891,242855,97443,114912,1483557,180505,391169,571674,421186,319475,258138,252938,145064,155864,1552665,3036222,4199820,4199820
Bosnia and Herzegovina,1981,BA,BIH,EUR,186303,398995,585298,443601,347410,246132,251864,106773,114324,1510104,179638,385548,565186,419769,330790,252563,259271,154650,158332,1575375,3085479,4235970,4235970
Bosnia and Herzegovina,1982,BA,BIH,EUR,187241,393791,581032,442003,358940,243238,259015,118524,113043,1534763,180458,380611,561069,417499,340043,248700,265212,165687,160000,1597141,3131904,4274013,4274013
Bosnia and Herzegovina,1983,BA,BIH,EUR,189448,388852,578300,439103,368366,242797,263947,131973,111391,1557577,182513,375938,558451,414189,347783,247058,270186,177526,161450,1618192,3175769,4312521,4312521
Bosnia and Herzegovina,1984,BA,BIH,EUR,192027,384016,576043,434766,377018,244720,266413,146032,110001,1578950,184924,371488,556412,409613,355063,247608,273442,189184,163292,1638202,3217152,4349597,4349597
Bosnia and Herzegovina,1985,BA,BIH,EUR,193941,379465,573406,429458,384964,249124,266358,159865,109266,1599035,186645,367493,554138,404227,361798,250570,274573,199895,165660,1656723,3255758,4383306,4383306
Bosnia and Herzegovina,1986,BA,BIH,EUR,194114,375835,569949,423499,391710,256456,263886,173025,109271,1617847,186675,364329,551004,398359,367704,256498,273433,209357,169226,1674577,3292424,4413374,4413374
Bosnia and Herzegovina,1987,BA,BIH,EUR,192328,373295,565623,417124,396727,266977,259285,185218,110389,1635720,184851,362174,547025,392244,372150,265674,269961,217517,174374,1691920,3327640,4440300,4440300
Bosnia and Herzegovina,1988,BA,BIH,EUR,189184,371569,560753,410285,399445,280234,253085,196259,112768,1652076,181723,360802,542525,385944,374543,277574,264507,224684,180727,1707979,3360055,4463320,4463320
Bosnia and Herzegovina,1989,BA,BIH,EUR,185085,370120,555205,403073,400082,294630,246054,206027,116424,1666290,177718,359602,537320,379508,375146,290753,257846,231266,187899,1722418,3388708,4481230,4481230
Bosnia and Herzegovina,1990,BA,BIH,EUR,180485,368187,548672,395867,399470,307999,239519,214386,121484,1678725,173317,357874,531191,373247,374500,303194,251364,237363,196062,1735730,3414455,4494310,4494310
Bosnia and Herzegovina,1991,BA,BIH,EUR,176133,365587,541720,388710,397879,318990,234221,221103,127755,1688658,169245,355453,524698,367242,372880,313263,246028,242847,205045,1747305,3435963,4502386,4502386
Bosnia and Herzegovina,1992,BA,BIH,EUR,165212,358078,523290,348313,358083,308369,221204,220332,129632,1585933,158314,347484,505798,329421,336299,305437,235375,243904,210274,1660710,3246643,4275730,4275730
Bosnia and Herzegovina,1993,BA,BIH,EUR,149043,349277,498320,297651,299608,285834,205096,213923,128932,1431044,141975,337898,479873,283042,283749,288756,223253,241754,213185,1533739,2964783,3942981,3942981
Bosnia and Herzegovina,1994,BA,BIH,EUR,134950,343753,478703,275422,263568,274186,196627,209589,132652,1352044,127868,331881,459749,263772,250519,280260,216888,240700,219687,1471826,2823870,3762330,3762330
Bosnia and Herzegovina,1995,BA,BIH,EUR,125293,340468,465761,281548,254057,275909,196690,207936,140623,1356763,118162,328348,446510,271824,240819,281910,216883,240706,229350,1481492,2838255,3750527,3750527
Bosnia and Herzegovina,1996,BA,BIH,EUR,121658,338756,460414,313692,272453,290373,205316,207622,151222,1440678,114434,326548,440982,306458,258675,294762,224243,240986,240547,1565671,3006349,3907751,3907751
Bosnia and Herzegovina,1997,BA,BIH,EUR,120767,333987,454754,340909,289757,302488,216451,205681,161573,1516859,113522,321369,434891,335354,275859,304950,234169,239239,251677,1641248,3158107,4047748,4047748
Bosnia and Herzegovina,1998,BA,BIH,EUR,121059,324548,445607,354933,297613,307560,227961,201348,170931,1560346,113790,311390,425180,349874,284214,308355,244650,234796,262034,1683923,3244269,4115059,4115059
Bosnia and Herzegovina,1999,BA,BIH,EUR,121148,312613,433761,362753,303118,309149,240303,195876,180430,1591629,113843,299167,413010,357412,290625,308456,256147,228894,273083,1714617,3306246,4153014,4153014
Bosnia and Herzegovina,2000,BA,BIH,EUR,120212,300332,420544,366906,309290,309607,252040,190563,189727,1618133,112937,286693,399630,360985,298075,307188,267286,223072,284440,1741046,3359179,4179350,4179350
Bosnia and Herzegovina,2001,BA,BIH,EUR,118148,288825,406973,367647,315787,309495,261853,186185,198537,1639504,110963,275043,386006,360923,306136,305335,276265,218303,295484,1762446,3401950,4194932,4194932
Bosnia and Herzegovina,2002,BA,BIH,EUR,114031,279430,393461,365367,321632,308424,269628,183238,207023,1655312,107136,265465,372601,357502,313644,302465,283189,214767,305458,1777025,3432337,4198410,4198410
Bosnia and Herzegovina,2003,BA,BIH,EUR,108954,270893,379847,359479,325147,305369,275475,182026,214779,1662275,102408,256695,359103,350296,318588,297676,288430,212838,314697,1782525,3444800,4183757,4183757
Bosnia and Herzegovina,2004,BA,BIH,EUR,104851,260892,365743,348799,324372,299402,280062,182163,221431,1656229,98474,246586,345060,338157,319074,290254,292262,212405,323676,1775828,3432057,4142860,4142860
Bosnia and Herzegovina,2005,BA,BIH,EUR,102122,250198,352320,336630,322409,292618,284076,183749,226089,1645571,95798,235848,331646,324701,318077,282393,295389,213493,330708,1764761,3410332,4094297,4094297
Bosnia and Herzegovina,2006,BA,BIH,EUR,100136,240186,340322,325744,322365,287117,287543,187627,229039,1639435,93866,225842,319708,312877,318326,276208,297983,217043,336183,1758620,3398055,4058086,4058086
Bosnia and Herzegovina,2007,BA,BIH,EUR,98661,231416,330077,312524,319503,281847,288650,193286,229261,1625071,92597,217767,310364,299055,315280,271532,297729,221983,336790,1742369,3367440,4007876,4007876
Bosnia and Herzegovina,2008,BA,BIH,EUR,97434,225585,323019,296675,313238,276744,286949,200455,226741,1600802,91755,213090,304845,283156,308437,268289,294545,227920,332379,1714726,3315528,3943392,3943392
Bosnia and Herzegovina,2009,BA,BIH,EUR,96002,221597,317599,280880,305438,271975,283593,208798,223526,1574210,90679,210076,300755,267680,299681,265433,290250,235205,326930,1685179,3259389,3877750,3877750
Bosnia and Herzegovina,2010,BA,BIH,EUR,94715,216623,311338,267797,296175,267300,279581,216865,220201,1547919,89651,206049,295700,255245,289308,262403,285673,242433,321062,1656124,3204043,3811088,3811088
Bosnia and Herzegovina,2011,BA,BIH,EUR,93654,209568,303222,258422,285819,262308,275568,223289,217526,1522932,88767,200043,288810,246694,277872,258692,281580,247820,315519,1628177,3151109,3743142,3743142
Bosnia and Herzegovina,2012,BA,BIH,EUR,92502,201220,293722,251993,275528,256396,271591,227005,216273,1498786,87825,192877,280702,241210,266462,253675,277966,250254,311595,1601162,3099948,3674374,3674374
Bosnia and Herzegovina,2013,BA,BIH,EUR,91045,193655,284700,245625,268414,251684,267445,230143,217634,1480945,86551,186107,272658,235183,258626,248914,273298,252298,310933,1579252,3060197,3617559,3617559
Bosnia and Herzegovina,2014,BA,BIH,EUR,89153,188303,277456,237811,263639,249089,262291,233874,221070,1467774,84803,180900,265703,227080,253640,245773,266666,255067,311908,1560134,3027908,3571068,3571068
Bosnia and Herzegovina,2015,BA,BIH,EUR,87100,184747,271847,229065,258366,247352,256171,236909,225206,1453069,82938,177199,260137,218420,248009,243655,259105,256956,313128,1539273,2992342,3524324,3524324
Bosnia and Herzegovina,2016,BA,BIH,EUR,85367,181941,267308,220063,252685,245972,250252,239737,230056,1438765,81347,174282,255629,209667,241960,241765,251876,258465,315548,1519281,2958046,3480986,3480986
Bosnia and Herzegovina,2017,BA,BIH,EUR,83845,179601,263446,212332,245618,244166,245051,241747,235666,1424580,79886,171976,251862,201921,234945,239322,245486,259072,319395,1500141,2924721,3440027,3440027
Bosnia and Herzegovina,2018,BA,BIH,EUR,82649,177369,260018,206460,236891,242439,240475,241781,242172,1410218,78687,169908,248595,196106,226182,236895,239883,257656,324585,1481307,2891525,3400129,3400129
Bosnia and Herzegovina,2019,BA,BIH,EUR,81730,174945,256675,200527,228378,240951,236503,240463,249012,1395834,77775,167661,245436,190592,217235,234781,235095,255000,330065,1462768,2858602,3360711,3360711
Bosnia and Herzegovina,2020,BA,BIH,EUR,80555,172619,253174,193064,221790,238963,233038,238585,254244,1379684,76638,165430,242068,183695,210296,232251,230761,251947,334536,1443486,2823170,3318407,3318407
Bosnia and Herzegovina,2021,BA,BIH,EUR,78879,170635,249514,184653,216856,236084,230033,236333,256697,1360656,75039,163449,238488,175973,205080,228896,227020,248560,336757,1422286,2782942,3270943,3270943
Bosnia and Herzegovina,2022,BA,BIH,EUR,76530,169481,246011,177652,214027,234443,227982,234535,257159,1345798,72730,162060,234790,170047,201844,226729,224701,245801,337802,1406924,2752722,3233526,3233526
Bosnia and Herzegovina,2023,BA,BIH,EUR,73711,168707,242418,173385,212081,234297,226954,232806,258409,1337932,69889,160964,230853,166905,199402,226199,223525,243122,340484,1399637,2737569,3210847,3210847
Bosnia and Herzegovina,2024,BA,BIH,EUR,71091,167201,238292,171265,208926,233631,226610,230249,263316,1333997,67212,159378,226590,165328,195861,225394,223108,239447,346353,1395491,2729488,3194378,3194378
Bosnia and Herzegovina,2025,BA,BIH,EUR,68980,164977,233957,170619,204716,232507,227144,227039,270188,1332213,64995,157260,222255,164719,191744,223879,223714,235156,353914,1393126,2725339,3181557,3181557
Bosnia and Herzegovina,2026,BA,BIH,EUR,67424,162238,229662,170532,199990,230903,228004,223759,277014,1330202,63326,154672,217998,164494,187385,221855,224483,230918,361381,1390516,2720718,3168378,3168378
Bosnia and Herzegovina,2027,BA,BIH,EUR,66380,158973,225353,170637,196168,227921,228490,220969,283825,1328010,62259,151418,213677,164509,183851,218765,224688,227260,368727,1387800,2715810,3154834,3154834
Bosnia and Herzegovina,2028,BA,BIH,EUR,65586,155600,221186,170546,193882,223238,229094,218578,290120,1325458,61522,147929,209451,164365,182047,213846,224854,224241,375419,1384772,2710230,3140867,3140867
Bosnia and Herzegovina,2029,BA,BIH,EUR,64854,152539,217393,170022,191438,218474,230023,216560,295816,1322333,60841,144753,205594,163723,180494,208410,225357,221847,381351,1381182,2703515,3126508,3126508
Bosnia and Herzegovina,2030,BA,BIH,EUR,64176,149491,213667,169463,187352,215313,230609,214975,301262,1318974,60207,141615,201822,162923,177474,204590,225552,219821,386964,1377324,2696298,3111789,3111789
Bosnia and Herzegovina,1950,BA,BIH,EUR,192810,323945,516755,298971,133102,138908,114370,54778,42074,782203,190421,324444,514865,302384,176196,153290,117151,65852,64208,879081,1661284,2692907,2692907
Bosnia and Herzegovina,1951,BA,BIH,EUR,201398,318029,519427,307261,144077,132793,118612,56865,41501,801109,199120,320103,519223,308293,186692,151503,120592,67845,63434,898359,1699468,2738117,2738117
Bosnia and Herzegovina,1952,BA,BIH,EUR,209448,313741,523189,313899,158174,125498,122595,59431,41387,820984,207320,317047,524367,314147,199005,148351,123645,70311,63378,918837,1739821,2787378,2787378
Bosnia and Herzegovina,1953,BA,BIH,EUR,217057,312312,529369,318344,174394,117893,126082,62538,41691,840942,214991,316350,531341,319173,212291,144667,126505,73253,63925,939814,1780756,2841474,2841474
Bosnia and Herzegovina,1954,BA,BIH,EUR,224310,314593,538903,319895,190989,111369,128782,66113,42189,859337,222111,318880,540991,322062,225235,141883,129440,76569,64601,959790,1819127,2899026,2899026
Bosnia and Herzegovina,1955,BA,BIH,EUR,230770,320663,551433,318660,206933,106844,130454,70021,42792,875704,228172,324913,553085,322478,237137,140812,132419,80179,65178,978203,1853907,2958430,2958430
Bosnia and Herzegovina,1956,BA,BIH,EUR,235815,330214,566029,315165,222068,104214,131222,74141,43486,890296,232682,334142,566824,320742,247783,141507,135481,84078,65564,995155,1885451,3018301,3018301
Bosnia and Herzegovina,1957,BA,BIH,EUR,239088,343268,582356,309770,236119,103504,131189,78418,44232,903232,235475,346425,581900,317045,256889,144079,138683,88157,65793,1010646,1913878,3078137,3078137
Bosnia and Herzegovina,1958,BA,BIH,EUR,240741,359132,599873,303182,248840,105179,130147,82794,45152,915294,236768,361192,597960,311955,264710,148642,141547,92245,66248,1025347,1940641,3138472,3138472
Bosnia and Herzegovina,1959,BA,BIH,EUR,241614,376363,617977,296101,260153,109761,127764,87138,46525,927442,237352,377217,614569,306122,271857,155253,143292,96170,67361,1040055,1967497,3200048,3200048
Bosnia and Herzegovina,1960,BA,BIH,EUR,242229,393236,635465,289666,269895,117229,124142,91356,48456,940744,237689,392961,630650,300554,278575,163715,143676,99884,69281,1055685,1996429,3262539,3262539
Bosnia and Herzegovina,1961,BA,BIH,EUR,242846,408305,651151,284612,278053,127616,119311,95532,50899,956023,238101,407005,645106,295965,285005,174020,142692,103423,71953,1073058,2029081,3325333,3325333
Bosnia and Herzegovina,1962,BA,BIH,EUR,243313,420840,664153,281536,284473,140953,113352,99583,53835,973732,238390,418622,657012,292918,291174,186048,140378,106726,75380,1092624,2066356,3387512,3387512
Bosnia and Herzegovina,1963,BA,BIH,EUR,243138,430998,674136,281430,288708,156335,107020,103264,57196,993953,237992,427972,665964,292343,296389,199037,137447,109932,79339,1114487,2108440,3448532,3448532
Bosnia and Herzegovina,1964,BA,BIH,EUR,241738,439829,681567,284821,290214,172374,101497,106316,60812,1016034,236328,435931,672259,294838,299533,211885,135138,113286,83423,1138103,2154137,3507959,3507959
Bosnia and Herzegovina,1965,BA,BIH,EUR,239175,447485,686660,291848,288992,188174,97581,108533,64579,1039707,233461,442561,676022,300616,300187,223937,134201,116727,87463,1163131,2202838,3565517,3565517
Bosnia and Herzegovina,1966,BA,BIH,EUR,235546,453748,689294,302462,285361,203500,95273,109985,68448,1065029,229431,447768,677199,309624,298412,234833,134818,120246,91399,1189332,2254361,3620849,3620849
Bosnia and Herzegovina,1967,BA,BIH,EUR,231040,458171,689211,316613,279722,217996,94717,110687,72300,1092035,224426,451220,675646,321735,294322,244265,137198,123804,95157,1216481,2308516,3673367,3673367
Bosnia and Herzegovina,1968,BA,BIH,EUR,226091,460337,686428,333505,272898,231315,96391,110412,76129,1120650,218987,452592,671579,336188,288561,252412,141449,126948,98857,1244415,2365065,3723067,3723067
Bosnia and Herzegovina,1969,BA,BIH,EUR,221169,460507,681676,351609,265737,243326,100747,108893,80062,1150374,213598,452103,665701,351640,281867,259741,147642,129024,102720,1272634,2423008,3770376,3770376
Bosnia and Herzegovina,2031,BA,BIH,EUR,63549,146191,209740,169202,181960,213673,230468,213890,306433,1315626,59619,138277,197896,162285,173248,202396,224997,218284,392198,1373408,2689034,3096667,3096667
Bosnia and Herzegovina,2032,BA,BIH,EUR,62962,142687,205649,168904,176371,212493,230285,213097,311078,1312228,59071,134791,193862,161541,168945,200698,224267,217179,396725,1369355,2681583,3081097,3081097
Bosnia and Herzegovina,2033,BA,BIH,EUR,62448,139077,201525,168136,172120,210580,230234,212579,315017,1308666,58584,131222,189806,160447,165813,198282,223793,216290,400475,1365100,2673766,3065088,3065088
Bosnia and Herzegovina,2034,BA,BIH,EUR,61964,135732,197696,166637,170012,207458,229643,212572,318274,1304596,58130,127865,185995,158863,164241,194761,223033,216056,403379,1360333,2664929,3048617,3048617
Bosnia and Herzegovina,2035,BA,BIH,EUR,61479,132948,194427,164416,169377,203278,228581,213298,320809,1299759,57680,125016,182696,156747,163635,190663,221562,216763,405414,1354784,2654543,3031666,3031666
Bosnia and Herzegovina,2036,BA,BIH,EUR,61019,130768,191787,161683,169291,198588,227053,214334,323167,1294116,57250,122761,180011,154163,163414,186326,219584,217623,407246,1348356,2642472,3014271,3014271
Bosnia and Herzegovina,2037,BA,BIH,EUR,60599,129144,189743,158424,169406,194788,224154,215036,325897,1287705,56861,121149,178010,150911,163429,182805,216548,217941,409352,1340986,2628691,2996445,2996445
Bosnia and Herzegovina,2038,BA,BIH,EUR,60219,127832,188051,155057,169325,192518,219581,215846,328476,1280803,56505,119927,176432,147426,163291,181010,211688,218224,411320,1332959,2613762,2978236,2978236
Bosnia and Herzegovina,2039,BA,BIH,EUR,59896,126617,186513,152002,168805,190092,214931,216956,330832,1273618,56204,118792,174996,144253,162651,179464,206326,218834,413055,1324583,2598201,2959706,2959706
Bosnia and Herzegovina,2040,BA,BIH,EUR,59616,125458,185074,148958,168254,186031,211881,217745,333356,1266225,55942,117712,173654,141118,161855,176460,202570,219136,414748,1315887,2582112,2940837,2940837
Bosnia and Herzegovina,2041,BA,BIH,EUR,59367,124376,183743,145660,168000,180676,210332,217845,336114,1258627,55709,116694,172403,137784,161218,172250,200431,218713,416508,1306904,2565531,2921671,2921671
Bosnia and Herzegovina,2042,BA,BIH,EUR,59132,123375,182507,142165,167706,175124,209243,217902,338718,1250858,55485,115755,171240,134302,160477,167969,198787,218107,418018,1297660,2548518,2902258,2902258
Bosnia and Herzegovina,2043,BA,BIH,EUR,58881,122477,181358,138560,166945,170908,207429,218060,341002,1242904,55249,114919,170168,130731,159385,164853,196422,217743,419034,1288168,2531072,2882595,2882595
Bosnia and Herzegovina,2044,BA,BIH,EUR,58602,121668,180270,135221,165451,168826,204402,217690,343212,1234802,54984,114162,169146,127379,157805,163291,192962,217090,419958,1278485,2513287,2862709,2862709
Bosnia and Herzegovina,2045,BA,BIH,EUR,58276,120909,179185,132443,163243,168205,200327,216867,345550,1226635,54675,113450,168125,124535,155693,162697,188921,215745,421076,1268667,2495302,2842606,2842606
Bosnia and Herzegovina,2046,BA,BIH,EUR,57877,120201,178078,130266,160519,168132,195740,215601,348121,1218379,54297,112789,167086,122281,153111,162482,184642,213909,422313,1258738,2477117,2822280,2822280
Bosnia and Herzegovina,2047,BA,BIH,EUR,57404,119550,176954,128645,157271,168257,192025,213019,350857,1210074,53853,112180,166033,120668,149868,162502,181168,211019,423484,1248709,2458783,2801773,2801773
Bosnia and Herzegovina,2048,BA,BIH,EUR,56865,118919,175784,127339,153918,168184,189803,208809,353686,1201739,53346,111585,164931,119447,146384,162368,179396,206345,424691,1238631,2440370,2781093,2781093
Bosnia and Herzegovina,2049,BA,BIH,EUR,56210,118318,174528,126129,150872,167678,187425,204550,356712,1193366,52733,111020,163753,118316,143218,161733,177876,201184,426205,1228532,2421898,2760168,2760168
Bosnia and Herzegovina,2050,BA,BIH,EUR,55449,117717,173166,124972,147835,167137,183448,201859,359731,1184982,52015,110452,162467,117236,140083,160943,174906,197608,427626,1218402,2403384,2739014,2739014
Belarus,1970,BY,BLR,EUR,381937,959239,1341176,745234,602326,652831,331787,287861,265814,2885853,365069,917637,1282706,715820,634474,752844,518914,510490,528513,3661055,6546908,9170786,9170786
Belarus,1971,BY,BLR,EUR,378816,941850,1320666,778780,584205,664895,360927,281242,274862,2944911,362534,899690,1262224,747421,608411,751297,552847,503629,545357,3708962,6653873,9236766,9236766
Belarus,1972,BY,BLR,EUR,377985,920730,1298715,806860,570618,674211,396380,273151,283781,3005001,362243,878513,1240756,773964,587392,751377,591797,492995,561941,3759466,6764467,9303940,9303940
Belarus,1973,BY,BLR,EUR,377608,896516,1274124,829451,563485,679276,436116,265107,292483,3065918,362400,855641,1218041,794384,573622,751080,631888,481326,579195,3811495,6877413,9369574,9369574
Belarus,1974,BY,BLR,EUR,378057,869986,1248043,848220,563784,678958,476957,258706,300927,3127552,363391,832399,1195790,810302,567905,747921,669253,470782,598032,3864195,6991747,9435592,9435592
Belarus,1975,BY,BLR,EUR,378268,843150,1221418,866552,569775,673113,515576,254693,308312,3188021,364101,810067,1174168,825709,569305,740131,701669,462117,618195,3917126,7105147,9500738,9500738
Belarus,1976,BY,BLR,EUR,377564,817838,1195402,884274,581654,662610,549211,253823,314799,3246371,363733,789298,1153031,841350,578280,727505,726919,457364,638151,3969569,7215940,9564377,9564377
Belarus,1977,BY,BLR,EUR,377636,794631,1172267,898254,603137,646981,575564,257247,320341,3301524,364320,769948,1134268,854596,598027,708683,742286,460122,657093,4020807,7322331,9628875,9628875
Belarus,1978,BY,BLR,EUR,379563,774268,1153831,906180,634545,626830,593896,265543,324341,3351335,367012,753114,1120126,862600,628918,684302,746528,471712,673962,4068022,7419357,9693316,9693316
Belarus,1979,BY,BLR,EUR,382629,759866,1142495,904452,672719,605085,605883,278693,325646,3392478,370695,741866,1112561,862547,667112,658594,742502,490794,687163,4108712,7501190,9756248,9756248
Belarus,1980,BY,BLR,EUR,386531,751799,1138330,892816,712956,583363,615189,297069,324026,3425419,375075,736138,1111213,854647,707644,632403,736867,516357,694371,4142289,7567708,9817257,9817257
Belarus,1981,BY,BLR,EUR,391301,747832,1139133,875605,748637,563656,623962,321485,320012,3453357,380246,733984,1114230,842282,744160,606695,734344,548628,694287,4170396,7623753,9877121,9877121
Belarus,1982,BY,BLR,EUR,396602,747523,1144125,855101,776294,549483,630450,351809,314532,3477669,385820,735122,1120942,827290,772870,585969,733970,585741,690365,4196205,7673874,9938931,9938931
Belarus,1983,BY,BLR,EUR,403007,750675,1153682,831329,797760,542425,632494,385915,309302,3499225,392335,738870,1131205,810801,794448,572677,732611,622948,686462,4219947,7719172,10004049,10004049
Belarus,1984,BY,BLR,EUR,409989,755445,1165434,805984,815429,542827,629332,420128,305177,3518877,399274,743503,1142777,794609,811410,567429,727675,656384,684757,4242264,7761141,10069349,10069349
Belarus,1985,BY,BLR,EUR,415979,760197,1176176,781127,833155,548565,621763,451523,303259,3539392,405183,748088,1153271,778809,828509,568945,717913,684554,685648,4264378,7803770,10133211,10133211
Belarus,1986,BY,BLR,EUR,422463,765136,1187599,758235,851175,559479,611071,478471,305443,3563874,411339,753123,1164462,763080,846566,577092,703794,705498,689704,4285734,7849608,10201670,10201670
Belarus,1987,BY,BLR,EUR,427046,771400,1198446,738500,865818,579581,595803,499074,311761,3590537,415469,759919,1175388,748296,861953,595811,683391,716609,700192,4306252,7896789,10270609,10270609
Belarus,1988,BY,BLR,EUR,426853,780952,1207805,722708,874300,609345,575699,512222,320810,3615084,414984,770114,1185098,735764,871486,625913,657559,716703,718064,4325489,7940573,10333480,10333480
Belarus,1989,BY,BLR,EUR,422693,792373,1215066,713778,873309,645431,553858,519704,331769,3637849,410665,781978,1192643,728029,872361,663384,630967,708601,738704,4342046,7979895,10387610,10387610
Belarus,1990,BY,BLR,EUR,413732,803603,1217335,711594,863062,683011,532060,525016,344344,3659087,401601,793529,1195130,725072,864868,703251,604027,699762,759998,4356978,8016065,10428525,10428525
Belarus,1991,BY,BLR,EUR,398215,815959,1214174,713474,847841,715536,512431,530063,359104,3678449,386173,805932,1192105,725322,852453,738727,578303,695166,782908,4372879,8051328,10457617,10457617
Belarus,1992,BY,BLR,EUR,379149,826512,1205661,719170,829480,739988,498530,533318,376974,3697460,367490,816298,1183788,728632,836646,766318,558437,692973,805996,4389002,8086462,10475907,10475907
Belarus,1993,BY,BLR,EUR,358467,832488,1190955,728601,808215,757947,491629,532285,396731,3715408,347433,822057,1169490,734580,818521,787305,546530,689559,828133,4404628,8120036,10480484,10480484
Belarus,1994,BY,BLR,EUR,335730,834278,1170008,738881,786571,771766,491781,526601,416620,3732220,325460,823679,1149139,741017,800343,804404,543020,683086,852151,4424021,8156241,10475395,10475395
Belarus,1995,BY,BLR,EUR,313819,830243,1144062,747854,765689,785750,496416,517184,434830,3747723,304172,819380,1123552,746552,782296,822136,545862,672709,876807,4446362,8194085,10461696,10461696
Belarus,1996,BY,BLR,EUR,293677,820007,1113684,756029,745949,800140,505166,504795,449909,3761988,284487,808596,1093083,751966,764117,840326,554966,658330,897995,4467700,8229688,10436459,10436459
Belarus,1997,BY,BLR,EUR,274717,803851,1078568,765159,728281,811155,521943,488419,461394,3776351,265846,791655,1057501,758947,747023,854895,574464,637870,915302,4488501,8264852,10400924,10400924
Belarus,1998,BY,BLR,EUR,259096,780663,1039759,777262,713230,815966,547470,468247,468866,3791041,250285,767440,1017725,768929,732223,862508,604788,612681,927812,4508941,8299982,10357466,10357466
Belarus,1999,BY,BLR,EUR,249056,751406,1000462,789546,703774,811350,579040,447248,473153,3804111,240177,737027,977204,778889,722363,860046,642160,587234,935816,4526508,8330619,10308283,10308283
Belarus,2000,BY,BLR,EUR,243556,718227,961783,799955,699823,798234,612132,428032,477861,3816037,234602,702786,937388,786875,717141,848604,681323,562049,945295,4541287,8357324,10256483,10256483
Belarus,2001,BY,BLR,EUR,241298,680016,921314,810695,698896,780783,640721,412769,484945,3828809,232107,663973,896080,794900,714598,832238,714760,539762,958749,4555007,8383816,10201209,10201209
Belarus,2002,BY,BLR,EUR,240536,639513,880049,819190,700736,760317,662132,403082,491681,3837138,231054,623257,854311,800610,714784,812103,740157,524140,972093,4563887,8401025,10135388,10135388
Belarus,2003,BY,BLR,EUR,239722,601387,841109,822394,705212,737986,678044,400197,496965,3840798,230104,585076,815180,801298,717377,789652,759364,516636,984467,4568794,8409592,10065878,10065878
Belarus,2004,BY,BLR,EUR,238282,567690,805972,820636,709750,716681,690893,403951,500420,3842331,228639,551393,780032,797554,719734,768416,774601,516828,994235,4571368,8413699,9999712,9999712
Belarus,2005,BY,BLR,EUR,237175,539869,777044,813326,712949,696718,703925,411032,500293,3838243,227516,523558,751074,788546,720644,748554,790466,521912,998682,4568804,8407047,9935163,9935163
Belarus,2006,BY,BLR,EUR,237704,517472,755176,800556,716196,677825,716966,421201,496321,3829065,227959,500875,728834,774400,721716,729236,805985,533493,996797,4561627,8390692,9874700,9874700
Belarus,2007,BY,BLR,EUR,241840,498827,740667,781010,723196,660533,727397,437876,488928,3818940,231790,481758,713548,754148,726492,711693,817652,555190,987657,4552832,8371772,9825986,9825986
Belarus,2008,BY,BLR,EUR,249165,484552,733717,754318,734623,646169,732066,461375,477766,3806317,238597,467191,705788,727441,735703,697278,822239,586166,973176,4542003,8348320,9787826,9787826
Belarus,2009,BY,BLR,EUR,258761,475763,734524,723598,745381,638583,727534,489527,464490,3789113,247452,458464,705916,697371,744803,689128,816527,623687,956638,4528154,8317267,9757708,9757708
Belarus,2010,BY,BLR,EUR,268533,472305,740838,689825,754998,636768,715421,517905,452503,3767420,256421,455152,711573,665111,753751,686300,803292,661613,941540,4511607,8279027,9731427,9731427
Belarus,2011,BY,BLR,EUR,276430,473842,750272,651991,765964,637638,700049,541556,445297,3742495,263702,456436,720138,629725,764548,686337,787091,691526,934843,4494070,8236565,9706981,9706981
Belarus,2012,BY,BLR,EUR,283491,479732,763223,613389,775689,641634,683100,560463,446016,3720291,270231,462101,732332,593593,774194,689619,768264,713707,938516,4477893,8198184,9693749,9693749
Belarus,2013,BY,BLR,EUR,290127,487917,778044,578250,780702,648765,665579,576083,453815,3703194,276408,470223,746631,560598,779653,695610,747797,730581,949031,4463270,8166464,9691137,9691137
Belarus,2014,BY,BLR,EUR,295089,497550,792639,548189,780752,656062,649813,589223,465198,3689237,280919,479644,760563,532027,781379,701351,730101,743357,963088,4451303,8140540,9693739,9693739
Belarus,2015,BY,BLR,EUR,299248,507223,806471,524322,775875,662407,635919,602705,477065,3678293,284514,488928,773442,509177,778742,705910,715060,756858,976657,4442404,8120697,9700609,9700609
Belarus,2016,BY,BLR,EUR,302572,516445,819017,506188,765466,669576,623000,616310,488581,3669121,287396,497648,785044,491474,771390,711391,700800,769918,989967,4434940,8104061,9708110,9708110
Belarus,2017,BY,BLR,EUR,299356,528432,827788,491746,747750,680786,610967,627462,500830,3659541,284167,508978,793145,476749,757385,721664,687743,779678,1004177,4427396,8086937,9707876,9707876
Belarus,2018,BY,BLR,EUR,288006,542910,830916,480847,723544,695696,601217,633694,514416,3649414,273355,522536,795891,465286,736278,736364,677358,783603,1020465,4419354,8068768,9695574,9695574
Belarus,2019,BY,BLR,EUR,273202,557750,830952,474010,695854,709276,597516,631699,528386,3636741,259571,535929,795500,458336,710598,750250,673130,778148,1040323,4410785,8047526,9673971,9673971
Belarus,2020,BY,BLR,EUR,257634,571431,829065,471723,664614,721429,598434,621574,538172,3615946,245238,547993,793231,456036,680356,763587,673248,765798,1056472,4395497,8011443,9633740,9633740
Belarus,2021,BY,BLR,EUR,242524,581849,824373,474199,628892,734610,600992,607634,544310,3590637,231190,557434,788624,457727,645122,777933,675334,750805,1067619,4374540,7965177,9578167,9578167
Belarus,2022,BY,BLR,EUR,231388,586093,817481,479692,591247,746140,606486,594484,554733,3572782,220935,561151,782086,463704,610085,790557,679810,734654,1083794,4362604,7935386,9534954,9534954
Belarus,2023,BY,BLR,EUR,225958,581619,807577,488081,557447,752445,613901,580307,570553,3562734,215693,556684,772377,472247,576539,797568,686339,716401,1106461,4355555,7918289,9498238,9498238
Belarus,2024,BY,BLR,EUR,223147,570490,793637,499653,529500,753729,620199,565403,587527,3556011,212374,546081,758455,482317,543807,799161,692509,699205,1129943,4346942,7902953,9455037,9455037
Belarus,2025,BY,BLR,EUR,220473,558059,778532,510343,507275,750322,625553,552775,604388,3550656,209245,534038,743283,491886,517205,795692,697247,684993,1153041,4340064,7890720,9412540,9412540
Belarus,2026,BY,BLR,EUR,217692,545513,763205,519751,490644,741171,631944,541529,620831,3545870,206135,521766,727901,500573,496544,786535,702658,671717,1176051,4334078,7879948,9371048,9371048
Belarus,2027,BY,BLR,EUR,214572,531070,745642,531679,477292,724622,642308,531554,636075,3543530,202938,507472,710410,512030,479269,769882,712624,659837,1197029,4330671,7874201,9330247,9330247
Belarus,2028,BY,BLR,EUR,211071,514615,725686,545546,467483,701807,656087,523737,648869,3543529,199624,491064,690688,525364,466113,745826,726831,650570,1214729,4329433,7872962,9289331,9289331
Belarus,2029,BY,BLR,EUR,207818,496820,704638,559512,462017,675427,668903,521074,657519,3544452,196609,473691,670300,538247,458420,717320,740255,646714,1227606,4328562,7873014,9247954,9247954
Belarus,2030,BY,BLR,EUR,205249,478237,683486,572439,461273,645549,680720,522739,662678,3545398,194213,455845,650058,549888,456109,684769,753177,646657,1236624,4327224,7872622,9206170,9206170
Belarus,1950,BY,BLR,EUR,376901,726991,1103892,746150,390424,422082,348689,261174,232960,2401479,364445,745660,1110105,832564,568329,623142,482144,366734,418472,3291385,5692864,7906860,7906860
Belarus,1951,BY,BLR,EUR,397976,714907,1112883,749416,412496,393612,342861,251186,222612,2372183,383831,730684,1114515,831578,594939,596248,487478,366034,403232,3279509,5651692,7879085,7879085
Belarus,1952,BY,BLR,EUR,415953,706248,1122201,750681,442736,367463,338834,242792,214394,2356900,400407,717297,1117704,830066,628547,569460,492181,365154,393315,3278723,5635623,7875527,7875527
Belarus,1953,BY,BLR,EUR,429891,701761,1131652,750633,478204,344690,335873,236398,208088,2353886,413245,706540,1119785,829591,665343,543830,496008,366176,386970,3287918,5641804,7893237,7893237
Belarus,1954,BY,BLR,EUR,440247,702441,1142688,748456,514867,326600,333520,232116,203464,2359023,423215,699854,1123069,828979,700156,521406,499274,369923,383154,3302892,5661915,7927675,7927675
Belarus,1955,BY,BLR,EUR,450935,707482,1158417,741969,549972,314106,331317,229622,200746,2367732,433374,698121,1131495,823978,730418,504125,502098,375807,382291,3318717,5686449,7976356,7976356
Belarus,1956,BY,BLR,EUR,463099,717672,1180771,730927,581540,307341,328796,228881,199565,2377050,444335,702694,1147029,813225,754778,493416,503885,383936,383263,3332503,5709553,8037362,8037362
Belarus,1957,BY,BLR,EUR,474742,736013,1210755,716060,608051,306388,325717,230077,199345,2385638,454751,716123,1170874,796481,772015,490211,504940,394409,384217,3342273,5727911,8109539,8109539
Belarus,1958,BY,BLR,EUR,485463,762389,1247852,697726,629550,311731,321875,232951,200591,2394424,464268,738488,1202756,773050,782458,495492,505572,406080,386874,3349526,5743950,8194565,8194565
Belarus,1959,BY,BLR,EUR,494943,794178,1289121,677231,647071,324202,316500,237339,202609,2404952,472503,766955,1239458,744182,787497,510322,504366,417739,391001,3355107,5760059,8288638,8288638
Belarus,1960,BY,BLR,EUR,502312,827889,1330201,657043,661212,344399,309362,243248,205402,2420666,478830,797979,1276809,713259,788131,534082,500128,429266,396642,3361508,5782174,8389183,8389183
Belarus,1961,BY,BLR,EUR,506797,860065,1366862,639315,672533,372497,301084,250401,209131,2444961,482731,828001,1310732,683652,785909,565355,493192,440937,404147,3373192,5818153,8495746,8495746
Belarus,1962,BY,BLR,EUR,507260,887782,1395042,625651,681186,407604,292429,257944,212515,2477329,482848,853979,1336827,657856,782507,602130,484196,452344,411624,3390657,5867986,8599859,8599859
Belarus,1963,BY,BLR,EUR,501832,909569,1411401,617654,686907,447452,284419,265425,216031,2517888,477237,874316,1351553,637762,778579,640557,474134,462983,420131,3414146,5932034,8694986,8694986
Belarus,1964,BY,BLR,EUR,488738,926435,1415173,616471,688563,488984,278563,272785,220711,2566077,464677,890228,1354905,624619,772529,676438,465198,473060,431750,3443594,6009671,8779744,8779744
Belarus,1965,BY,BLR,EUR,469250,942126,1411376,620607,684665,529337,275906,279586,226416,2616517,446336,905165,1351501,618222,761208,707595,458946,482799,446371,3475141,6091658,8854528,8854528
Belarus,1966,BY,BLR,EUR,446711,957111,1403822,630412,675421,565877,277001,285298,233004,2667013,425096,919464,1344560,619481,743858,732115,456866,491704,462379,3506403,6173416,8921796,8921796
Belarus,1967,BY,BLR,EUR,424130,968536,1392666,648737,661480,596328,282515,289569,240506,2719135,403992,930209,1334201,630926,721029,747936,460883,500005,478992,3539771,6258906,8985772,8985772
Belarus,1968,BY,BLR,EUR,404519,973987,1378506,675690,643450,620119,293070,291996,248623,2772948,385880,934502,1320382,652776,693541,754877,472230,507332,495212,3575968,6348916,9047801,9047801
Belarus,1969,BY,BLR,EUR,390098,970864,1360962,709195,622844,638401,309345,291659,257128,2828572,372544,930173,1302717,682540,663580,755249,491734,511595,511508,3616206,6444778,9108451,9108451
Belarus,2031,BY,BLR,EUR,203343,460353,663696,582245,465309,611352,693578,526109,666425,3545018,192414,438544,630958,558952,458248,647962,766955,648517,1243826,4324460,7869478,9164135,9164135
Belarus,2032,BY,BLR,EUR,202042,446605,648647,584872,473041,576273,704907,531389,669495,3539977,191160,425074,616234,561226,464810,609840,778429,653175,1249520,4317000,7856977,9121858,9121858
Belarus,2033,BY,BLR,EUR,201414,438125,639539,579266,482458,544530,711502,538960,672531,3529247,190545,416616,607161,555701,473731,574633,784802,660110,1254730,4303707,7832954,9079650,9079650
Belarus,2034,BY,BLR,EUR,201400,432131,633531,568595,493244,517068,713402,546661,676775,3515745,190512,410469,600981,545511,483868,543378,786688,666625,1261264,4287334,7803079,9037590,9037590
Belarus,2035,BY,BLR,EUR,201983,426895,628878,556552,503389,495298,710696,553352,682087,3501374,191036,405046,596082,533801,493447,517881,783540,671747,1269195,4269611,7770985,8995945,8995945
Belarus,2036,BY,BLR,EUR,203120,422199,625319,544241,512516,479126,702440,560721,687428,3486472,192089,400187,592276,521733,502123,497892,774697,677479,1276818,4250742,7737214,8954814,8954814
Belarus,2037,BY,BLR,EUR,204706,417777,622483,529918,524325,466259,687157,571467,692274,3471400,193579,395758,589337,507530,513568,480958,758411,687582,1282863,4230912,7702312,8914126,8914126
Belarus,2038,BY,BLR,EUR,206714,413659,620373,513535,538141,456882,665961,585146,696653,3456318,195471,391836,587307,491161,526892,467985,734821,701760,1287543,4210162,7666480,8874163,8874163
Belarus,2039,BY,BLR,EUR,209004,410404,619408,495797,552076,451755,641352,597921,701872,3440773,197626,388797,586423,473813,539759,460394,706818,715151,1292276,4188211,7628984,8834815,8834815
Belarus,2040,BY,BLR,EUR,211326,408429,619755,477279,564976,451227,613409,609774,707898,3424563,199809,386928,586737,455992,551395,458143,674830,728017,1296593,4164970,7589533,8796015,8796015
Belarus,2041,BY,BLR,EUR,213629,407667,621296,459458,574771,455358,581408,622536,714280,3407811,201973,386187,588160,438714,560450,460312,638656,741694,1300722,4140548,7548359,8757816,8757816
Belarus,2042,BY,BLR,EUR,215824,407959,623783,445762,577422,463116,548614,633912,721863,3390689,204029,386427,590456,425263,562729,466878,601205,753138,1305914,4115127,7505816,8720055,8720055
Belarus,2043,BY,BLR,EUR,217588,409345,626933,437318,571887,472541,519025,641027,731500,3373298,205671,387706,593377,416816,557225,475794,566634,759624,1312749,4088842,7462140,8682460,8682460
Belarus,2044,BY,BLR,EUR,218930,411629,630559,431350,561324,483323,493520,643840,742424,3355781,206919,389831,596750,410680,547062,485925,535970,761737,1320512,4061886,7417667,8644974,8644974
Belarus,2045,BY,BLR,EUR,219785,414538,634323,426137,549394,493481,473421,642348,753579,3338360,207720,392542,600262,405267,535383,495498,510989,758920,1328468,4034525,7372885,8607465,8607465
Belarus,2046,BY,BLR,EUR,219923,417986,637909,421466,537200,502629,458603,635715,765531,3321144,207841,395760,603601,400417,523345,504175,491431,750543,1337072,4006983,7328127,8569634,8569634
Belarus,2047,BY,BLR,EUR,219324,421773,641097,417067,523013,514405,446869,622764,780088,3304206,207271,399308,606579,395996,509172,515600,474877,734983,1348792,3979420,7283626,8531294,8531294
Belarus,2048,BY,BLR,EUR,217857,425547,643404,412969,506788,528144,438425,604527,796889,3287742,205889,402845,608734,392084,492854,528891,462215,712386,1363600,3952030,7239772,8491915,8491915
Belarus,2049,BY,BLR,EUR,215435,429180,644615,409739,489227,542003,433997,583140,813724,3271830,203602,406250,609852,389050,475550,541733,454851,685500,1378295,3924979,7196809,8451272,8451272
Belarus,2050,BY,BLR,EUR,212288,432365,644653,407779,470895,554834,433914,558687,830514,3256623,200633,409232,609865,387191,457773,553343,452740,654731,1392710,3898488,7155111,8409632,8409632
Belize,1970,BZ,BLZ,AMR,11199,18931,30130,10566,5993,4968,3707,2842,2464,30540,10877,18648,29525,10570,5961,4981,3608,2906,2685,30711,61251,120905,120905
Belize,1971,BZ,BLZ,AMR,11095,19504,30599,11085,6048,4998,3779,2858,2535,31303,10705,19163,29868,11049,5974,5003,3621,2933,2738,31318,62621,123091,123091
Belize,1972,BZ,BLZ,AMR,11062,19980,31042,11536,6098,5019,3855,2861,2596,31965,10603,19563,30166,11480,6001,5016,3644,2937,2793,31871,63836,125054,125054
Belize,1973,BZ,BLZ,AMR,11100,20366,31466,11963,6149,5036,3938,2856,2657,32599,10585,19836,30421,11888,6042,5004,3680,2926,2849,32389,64988,126875,126875
Belize,1974,BZ,BLZ,AMR,11263,20589,31852,12389,6219,5050,4015,2854,2707,33234,10714,19952,30666,12264,6103,4971,3727,2901,2906,32872,66106,128620,128620
Belize,1975,BZ,BLZ,AMR,11560,20687,32247,12923,6357,5073,4092,2862,2765,34072,10990,19971,30961,12724,6226,4944,3785,2878,2962,33519,67591,130801,130801
Belize,1976,BZ,BLZ,AMR,11906,20764,32670,13564,6571,5093,4170,2877,2831,35106,11325,19971,31296,13294,6428,4920,3869,2857,3035,34403,69509,133471,133471
Belize,1977,BZ,BLZ,AMR,12265,20830,33095,14201,6835,5100,4237,2885,2890,36148,11671,19938,31609,13885,6674,4880,3950,2836,3103,35328,71476,136183,136183
Belize,1978,BZ,BLZ,AMR,12627,20895,33522,14834,7136,5096,4299,2908,2946,37219,12020,19904,31924,14467,6950,4838,4024,2821,3167,36267,73486,138933,138933
Belize,1979,BZ,BLZ,AMR,12996,21006,34002,15463,7472,5088,4352,2946,2993,38314,12374,19927,32301,15023,7269,4804,4081,2813,3220,37210,75524,141823,141823
Belize,1980,BZ,BLZ,AMR,13376,21189,34565,16112,7870,5105,4393,3009,3039,39528,12740,20034,32774,15613,7637,4792,4135,2823,3267,38267,77795,145133,145133
Belize,1981,BZ,BLZ,AMR,13691,21380,35071,16726,8373,5174,4430,3091,3093,40887,13055,20246,33301,16202,8104,4831,4183,2864,3317,39501,80388,148764,148764
Belize,1982,BZ,BLZ,AMR,13894,21611,35505,17207,8957,5277,4468,3197,3150,42256,13282,20577,33859,16663,8667,4926,4223,2930,3378,40787,83043,152409,152409
Belize,1983,BZ,BLZ,AMR,14053,21970,36023,17541,9552,5414,4511,3307,3207,43532,13470,21045,34515,16985,9250,5067,4243,3012,3433,41990,85522,156053,156053
Belize,1984,BZ,BLZ,AMR,14199,22461,36660,17698,10156,5602,4562,3405,3260,44683,13646,21647,35293,17165,9815,5260,4261,3101,3480,43082,87765,159721,159721
Belize,1985,BZ,BLZ,AMR,14340,23039,37379,17719,10772,5844,4615,3496,3326,45772,13830,22299,36129,17265,10378,5494,4280,3196,3537,44150,89922,163436,163436
Belize,1986,BZ,BLZ,AMR,14490,23615,38105,17728,11365,6135,4669,3583,3401,46881,14014,22895,36909,17387,10941,5772,4307,3291,3588,45286,92167,167191,167191
Belize,1987,BZ,BLZ,AMR,14648,24156,38804,17776,11903,6488,4717,3673,3475,48032,14180,23463,37643,17559,11477,6100,4339,3378,3642,46495,94527,170980,170980
Belize,1988,BZ,BLZ,AMR,14806,24675,39481,17871,12377,6888,4767,3757,3545,49205,14328,24052,38380,17781,11971,6473,4381,3437,3705,47748,96953,174817,174817
Belize,1989,BZ,BLZ,AMR,14950,25198,40148,18032,12782,7321,4823,3818,3626,50402,14479,24630,39109,18058,12417,6874,4438,3476,3779,49042,99444,178695,178695
Belize,1990,BZ,BLZ,AMR,15090,25720,40810,18265,13087,7784,4902,3850,3725,51613,14640,25151,39791,18413,12810,7295,4489,3502,3864,50373,101986,182589,182589
Belize,1991,BZ,BLZ,AMR,15283,26274,41557,18523,13384,8246,4995,3869,3821,52838,14816,25615,40431,18739,13199,7700,4530,3531,3935,51634,104472,186462,186462
Belize,1992,BZ,BLZ,AMR,15525,26766,42291,19074,13689,8583,5046,3862,3861,54115,14993,26024,41017,19183,13575,8034,4594,3560,3930,52876,106991,190299,190299
Belize,1993,BZ,BLZ,AMR,15752,27150,42902,19943,13948,8805,5083,3844,3862,55485,15137,26416,41553,19835,13900,8330,4706,3588,3879,54238,109723,194177,194177
Belize,1994,BZ,BLZ,AMR,15933,27565,43498,20794,14252,9076,5175,3858,3876,57031,15239,26860,42099,20499,14246,8675,4859,3627,3888,55794,112825,198416,198416
Belize,1995,BZ,BLZ,AMR,16085,28073,44158,21596,14660,9487,5360,3909,3938,58950,15358,27393,42751,21150,14713,9126,5061,3683,3966,57699,116649,203556,203556
Belize,1996,BZ,BLZ,AMR,16224,28737,44961,22272,15227,10068,5663,4008,4063,61301,15500,28020,43520,21796,15352,9709,5336,3770,4092,60055,121356,209840,209840
Belize,1997,BZ,BLZ,AMR,16403,29522,45925,22815,15937,10771,6083,4149,4230,63985,15694,28669,44363,22490,16127,10404,5697,3867,4262,62847,126832,217117,217117
Belize,1998,BZ,BLZ,AMR,16684,30286,46970,23307,16703,11541,6579,4303,4404,66837,15982,29266,45248,23252,16935,11160,6127,3960,4421,65855,132692,224907,224907
Belize,1999,BZ,BLZ,AMR,17044,30950,47994,23821,17451,12326,7105,4449,4570,69722,16341,29797,46138,24020,17696,11938,6599,4038,4586,68877,138599,232733,232733
Belize,2000,BZ,BLZ,AMR,17437,31525,48962,24385,18155,13073,7652,4598,4717,72580,16723,30303,47026,24726,18438,12713,7096,4101,4759,71833,144413,240406,240406
Belize,2001,BZ,BLZ,AMR,17856,32064,49920,25064,18798,13733,8208,4749,4855,75407,17142,30909,48051,25418,19163,13431,7602,4188,4916,74718,150125,248100,248100
Belize,2002,BZ,BLZ,AMR,18261,32657,50918,25802,19417,14332,8759,4930,4999,78239,17566,31647,49213,26143,19882,14090,8126,4341,5035,77617,155856,255987,255987
Belize,2003,BZ,BLZ,AMR,18579,33366,51945,26541,20022,14920,9309,5151,5156,81099,17900,32460,50360,26905,20606,14705,8674,4558,5148,80596,161695,263998,263998
Belize,2004,BZ,BLZ,AMR,18822,34148,52970,27315,20588,15480,9870,5417,5328,83998,18165,33332,51497,27725,21290,15312,9253,4816,5262,83658,167656,272128,272128
Belize,2005,BZ,BLZ,AMR,18998,34972,53970,28108,21144,16038,10456,5734,5502,86982,18369,34235,52604,28573,21936,15949,9862,5114,5393,86827,173809,280375,280375
Belize,2006,BZ,BLZ,AMR,19125,35782,54907,28925,21694,16600,11062,6096,5699,90076,18526,35116,53642,29436,22565,16625,10499,5445,5534,90104,180180,288729,288729
Belize,2007,BZ,BLZ,AMR,19223,36575,55798,29758,22240,17170,11686,6503,5901,93258,18635,35959,54594,30294,23241,17332,11156,5819,5684,93526,186784,297173,297173
Belize,2008,BZ,BLZ,AMR,19303,37319,56622,30602,22809,17735,12324,6942,6119,96531,18693,36763,55456,31149,23976,18037,11825,6235,5846,97068,193599,305671,305671
Belize,2009,BZ,BLZ,AMR,19324,38016,57340,31465,23405,18293,12969,7407,6371,99910,18674,37510,56184,32056,24740,18733,12498,6681,6031,100739,200649,314171,314171
Belize,2010,BZ,BLZ,AMR,19194,38523,57717,32459,24191,18873,13552,7842,6595,103512,18486,37986,56472,32950,25548,19423,13121,7130,6224,104396,207908,322106,322106
Belize,2011,BZ,BLZ,AMR,19004,38819,57823,33513,25182,19489,14092,8239,6792,107307,18229,38181,56410,33774,26409,20107,13696,7587,6425,107998,215305,329538,329538
Belize,2012,BZ,BLZ,AMR,18909,39043,57952,34482,26239,20108,14620,8645,7019,111113,18094,38280,56374,34547,27296,20789,14271,8061,6651,111615,222728,337059,337059
Belize,2013,BZ,BLZ,AMR,18909,39155,58064,35415,27350,20728,15148,9074,7286,115001,18068,38261,56329,35286,28225,21449,14856,8560,6914,115290,230291,344688,344688
Belize,2014,BZ,BLZ,AMR,19002,39132,58134,36322,28494,21340,15685,9517,7571,118929,18132,38130,56262,36005,29177,22073,15464,9080,7212,119011,237940,352335,352335
Belize,2015,BZ,BLZ,AMR,19217,38952,58169,37163,29636,21957,16224,9969,7850,122799,18324,37854,56178,36678,30122,22680,16094,9622,7531,122727,245526,359871,359871
Belize,2016,BZ,BLZ,AMR,19474,38709,58183,37901,30768,22609,16755,10434,8138,126605,18567,37520,56087,37257,31053,23307,16752,10182,7876,126427,253032,367313,367313
Belize,2017,BZ,BLZ,AMR,19681,38553,58234,38505,31906,23300,17276,10918,8446,130351,18764,37272,56036,37730,31947,23979,17415,10747,8247,130065,260416,374693,374693
Belize,2018,BZ,BLZ,AMR,19868,38489,58357,38961,33042,24032,17791,11417,8759,134002,18941,37109,56050,38112,32810,24716,18066,11314,8638,133656,267658,382066,382066
Belize,2019,BZ,BLZ,AMR,19851,38495,58346,39338,34141,24817,18314,11908,9079,137597,18927,37012,55939,38417,33652,25501,18706,11879,9057,137212,274809,389095,389095
Belize,2020,BZ,BLZ,AMR,19552,38513,58065,39517,35017,25574,18821,12367,9448,140744,18638,36937,55575,38590,34388,26273,19331,12416,9532,140530,281274,394921,394921
Belize,2021,BZ,BLZ,AMR,19196,38555,57751,39573,35693,26326,19304,12776,9802,143474,18297,36904,55201,38667,35028,27029,19942,12910,10023,143599,287073,400031,400031
Belize,2022,BZ,BLZ,AMR,18854,38652,57506,39650,36357,27161,19792,13166,10115,146241,17967,36946,54913,38696,35648,27826,20553,13396,10494,146613,292854,405272,405272
Belize,2023,BZ,BLZ,AMR,18477,38825,57302,39669,37031,28073,20301,13586,10502,149162,17608,37079,54687,38624,36258,28663,21161,13919,11050,149675,298837,410825,410825
Belize,2024,BZ,BLZ,AMR,18259,38886,57145,39601,37722,29037,20825,14051,10973,152209,17402,37115,54517,38458,36867,29537,21754,14492,11685,152793,305002,416656,416656
Belize,2025,BZ,BLZ,AMR,18284,38794,57078,39391,38362,30013,21357,14535,11470,155128,17430,37013,54443,38153,37440,30403,22338,15097,12361,155792,310920,422440,422440
Belize,2026,BZ,BLZ,AMR,18344,38695,57039,39132,38922,30990,21930,15016,12008,157998,17487,36913,54400,37802,37932,31256,22940,15724,13078,158732,316730,428165,428165
Belize,2027,BZ,BLZ,AMR,18364,38555,56919,38965,39373,31976,22540,15489,12571,160914,17511,36774,54285,37547,38327,32080,23588,16360,13820,161722,322636,433836,433836
Belize,2028,BZ,BLZ,AMR,18367,38357,56724,38903,39700,32959,23188,15957,13158,163865,17514,36584,54098,37377,38640,32868,24287,16984,14585,164741,328606,439438,439438
Belize,2029,BZ,BLZ,AMR,18348,38116,56464,38907,39962,33910,23890,16429,13746,166844,17498,36357,53855,37271,38886,33639,25038,17595,15372,167801,334645,444964,444964
Belize,2030,BZ,BLZ,AMR,18323,37850,56173,38946,40187,34801,24640,16916,14348,169838,17472,36103,53575,37199,39075,34382,25805,18212,16177,170850,340688,450428,450428
Belize,1950,BZ,BLZ,AMR,5683,7596,13279,6376,4597,3897,2709,1779,1168,20526,5683,8019,13702,6840,4895,4010,2688,1880,1291,21604,42130,69116,69116
Belize,1951,BZ,BLZ,AMR,6319,7747,14066,6410,4707,3910,2772,1806,1204,20809,6245,8125,14370,6907,4997,4078,2736,1914,1346,21978,42787,71220,71220
Belize,1952,BZ,BLZ,AMR,6883,7973,14856,6445,4860,3916,2848,1848,1249,21166,6745,8297,15042,6959,5129,4132,2803,1960,1415,22398,43564,73461,73461
Belize,1953,BZ,BLZ,AMR,7320,8289,15609,6488,5015,3916,2932,1895,1308,21554,7132,8555,15687,7004,5269,4164,2876,2000,1477,22790,44344,75642,75642
Belize,1954,BZ,BLZ,AMR,7667,8682,16349,6539,5148,3916,3017,1944,1368,21932,7444,8888,16332,7051,5400,4194,2965,2040,1542,23192,45124,77807,77807
Belize,1955,BZ,BLZ,AMR,7901,9192,17093,6606,5251,3931,3099,1996,1433,22316,7664,9321,16985,7098,5512,4221,3063,2080,1614,23588,45904,79986,79986
Belize,1956,BZ,BLZ,AMR,8038,9801,17839,6690,5336,3954,3184,2051,1504,22719,7802,9842,17644,7156,5614,4247,3165,2120,1687,23989,46708,82196,82196
Belize,1957,BZ,BLZ,AMR,8180,10410,18590,6794,5404,3989,3257,2114,1578,23136,7954,10366,18320,7231,5710,4276,3274,2163,1753,24407,47543,84451,84451
Belize,1958,BZ,BLZ,AMR,8327,11005,19332,6920,5464,4037,3317,2182,1649,23569,8119,10881,19000,7328,5792,4314,3374,2217,1826,24851,48420,86746,86746
Belize,1959,BZ,BLZ,AMR,8464,11580,20044,7070,5525,4104,3362,2253,1723,24037,8273,11387,19660,7454,5867,4369,3452,2273,1897,25312,49349,89061,89061
Belize,1960,BZ,BLZ,AMR,8653,12120,20773,7238,5588,4181,3397,2326,1794,24524,8454,11890,20344,7571,5938,4427,3514,2337,1978,25765,50289,91403,91403
Belize,1961,BZ,BLZ,AMR,8923,12628,21551,7402,5650,4261,3421,2394,1849,24977,8700,12401,21101,7654,5994,4469,3563,2397,2048,26125,51102,93757,93757
Belize,1962,BZ,BLZ,AMR,9232,13148,22380,7577,5710,4354,3441,2454,1905,25441,8978,12940,21918,7747,6038,4509,3594,2451,2114,26453,51894,96188,96188
Belize,1963,BZ,BLZ,AMR,9595,13699,23294,7771,5760,4454,3458,2510,1969,25922,9309,13518,22827,7881,6063,4562,3622,2505,2182,26815,52737,98862,98862
Belize,1964,BZ,BLZ,AMR,9993,14291,24284,8000,5811,4552,3478,2566,2034,26441,9691,14120,23811,8068,6081,4620,3644,2569,2260,27242,53683,101772,101772
Belize,1965,BZ,BLZ,AMR,10371,14942,25313,8272,5863,4641,3502,2623,2103,27004,10079,14755,24834,8311,6081,4684,3650,2627,2336,27689,54693,104838,104838
Belize,1966,BZ,BLZ,AMR,10707,15670,26377,8598,5905,4725,3528,2679,2175,27610,10434,15455,25889,8621,6063,4755,3646,2688,2413,28186,55796,108062,108062
Belize,1967,BZ,BLZ,AMR,10988,16452,27440,8997,5931,4804,3560,2732,2245,28269,10722,16230,26952,9014,6032,4831,3634,2751,2481,28743,57012,111411,111411
Belize,1968,BZ,BLZ,AMR,11196,17294,28490,9468,5945,4874,3594,2776,2324,28981,10925,17068,27993,9479,5997,4899,3620,2808,2560,29363,58344,114825,114825
Belize,1969,BZ,BLZ,AMR,11273,18174,29447,10001,5956,4930,3645,2816,2392,29740,10990,17931,28921,10019,5969,4949,3613,2862,2626,30038,59778,118145,118145
Belize,2031,BZ,BLZ,AMR,18296,37560,55856,39006,40379,35604,25441,17412,14958,172800,17449,35824,53273,37179,39204,35076,26581,18846,17007,173893,346693,455824,455824
Belize,2032,BZ,BLZ,AMR,18267,37239,55506,39114,40518,36333,26308,17918,15582,175773,17419,35520,52939,37229,39253,35727,27385,19478,17865,176937,352710,461151,461151
Belize,2033,BZ,BLZ,AMR,18224,36870,55094,39292,40567,37032,27220,18419,16223,178753,17384,35167,52551,37366,39194,36350,28226,20090,18765,179991,358744,466383,466383
Belize,2034,BZ,BLZ,AMR,18185,36635,54820,39353,40505,37717,28156,18917,16900,181548,17344,34946,52290,37399,39028,36959,29088,20667,19726,182867,364415,471528,471528
Belize,2035,BZ,BLZ,AMR,18143,36636,54779,39265,40308,38356,29107,19427,17615,184078,17303,34952,52255,37296,38726,37529,29942,21238,20750,185481,369559,476595,476595
Belize,2036,BZ,BLZ,AMR,18082,36669,54751,39166,40061,38918,30060,19975,18357,186537,17247,34982,52229,37202,38380,38018,30787,21828,21818,188033,374570,481550,481550
Belize,2037,BZ,BLZ,AMR,18011,36660,54671,39029,39904,39370,31026,20561,19103,188993,17177,34979,52156,37065,38127,38415,31603,22464,22902,190576,379569,486398,486398
Belize,2038,BZ,BLZ,AMR,17943,36625,54568,38834,39850,39705,31991,21188,19860,191428,17109,34950,52059,36875,37959,38732,32386,23153,23994,193099,384527,491158,491158
Belize,2039,BZ,BLZ,AMR,17867,36569,54436,38597,39861,39978,32919,21855,20633,193843,17036,34897,51933,36649,37857,38980,33148,23888,25073,195595,389438,495805,495805
Belize,2040,BZ,BLZ,AMR,17767,36500,54267,38329,39906,40211,33792,22570,21408,196216,16943,34827,51770,36392,37790,39173,33889,24636,26171,198051,394267,500312,500312
Belize,2041,BZ,BLZ,AMR,17662,36415,54077,38044,39979,40408,34588,23338,22205,198562,16839,34747,51586,36117,37770,39310,34580,25396,27293,200466,399028,504690,504690
Belize,2042,BZ,BLZ,AMR,17546,36314,53860,37730,40093,40561,35305,24164,23008,200861,16731,34654,51385,35815,37823,39358,35225,26182,28434,202837,403698,508939,508939
Belize,2043,BZ,BLZ,AMR,17423,36212,53635,37361,40276,40623,35999,25031,23822,203112,16610,34549,51159,35466,37962,39301,35845,27003,29585,205162,408274,513071,513071
Belize,2044,BZ,BLZ,AMR,17301,36094,53395,37132,40344,40576,36681,25928,24668,205329,16494,34440,50934,35243,37998,39142,36451,27846,30755,207435,412764,517095,517095
Belize,2045,BZ,BLZ,AMR,17193,35955,53148,37137,40264,40398,37316,26834,25555,207504,16391,34303,50694,35249,37898,38852,37022,28686,31956,209663,417167,521005,521005
Belize,2046,BZ,BLZ,AMR,17098,35789,52887,37169,40175,40169,37883,27748,26489,209633,16295,34145,50440,35285,37803,38511,37516,29510,33215,211840,421473,524795,524795
Belize,2047,BZ,BLZ,AMR,17011,35604,52615,37165,40043,40034,38340,28670,27462,211714,16215,33967,50182,35282,37668,38262,37918,30312,34522,213964,425678,528472,528472
Belize,2048,BZ,BLZ,AMR,16931,35415,52346,37132,39858,39994,38688,29597,28474,213743,16134,33780,49914,35251,37481,38102,38235,31086,35881,216036,429779,532039,532039
Belize,2049,BZ,BLZ,AMR,16848,35219,52067,37077,39633,40024,38974,30494,29533,215735,16056,33593,49649,35196,37256,38007,38487,31839,37267,218052,433787,535494,535494
Belize,2050,BZ,BLZ,AMR,16774,35015,51789,37009,39378,40083,39223,31337,30642,217672,15981,33395,49376,35132,37004,37948,38690,32567,38663,220004,437676,538838,538838
Bermuda,1970,BM,BMU,AMR,2487,5327,7814,4721,4581,3664,2656,1883,1348,18853,2276,5233,7509,4234,3938,3195,2580,2028,1870,17845,36698,52019,52019
Bermuda,1971,BM,BMU,AMR,2405,5341,7746,4699,4708,3715,2709,1901,1403,19135,2207,5201,7408,4296,4088,3223,2639,2051,1955,18252,37387,52539,52539
Bermuda,1972,BM,BMU,AMR,2334,5268,7602,4723,4744,3715,2743,1908,1446,19279,2166,5082,7248,4427,4159,3244,2685,2068,2026,18609,37888,52743,52743
Bermuda,1973,BM,BMU,AMR,2284,5160,7444,4774,4780,3698,2789,1917,1486,19444,2136,4930,7066,4582,4211,3264,2739,2084,2087,18967,38411,52925,52925
Bermuda,1974,BM,BMU,AMR,2241,5035,7276,4846,4803,3671,2833,1934,1536,19623,2109,4766,6875,4734,4259,3279,2800,2112,2140,19324,38947,53102,53102
Bermuda,1975,BM,BMU,AMR,2188,4905,7093,4913,4828,3643,2875,1962,1577,19798,2080,4609,6689,4861,4318,3290,2860,2143,2200,19672,39470,53256,53256
Bermuda,1976,BM,BMU,AMR,2122,4787,6909,4959,4864,3616,2905,1991,1615,19950,2036,4476,6512,4939,4401,3308,2903,2169,2277,19997,39947,53373,53373
Bermuda,1977,BM,BMU,AMR,2045,4674,6719,4969,4919,3596,2935,2016,1645,20080,1980,4358,6338,4964,4510,3338,2937,2195,2356,20300,40380,53434,53434
Bermuda,1978,BM,BMU,AMR,1975,4555,6530,4932,5017,3578,2958,2032,1677,20194,1927,4242,6169,4935,4642,3384,2966,2217,2427,20571,40765,53462,53462
Bermuda,1979,BM,BMU,AMR,1917,4431,6348,4847,5144,3576,2967,2046,1715,20295,1866,4126,5992,4857,4787,3445,2988,2250,2499,20826,41121,53456,53456
Bermuda,1980,BM,BMU,AMR,1882,4312,6194,4789,5237,3611,2977,2062,1763,20439,1810,4028,5838,4784,4923,3539,2984,2296,2566,21092,41531,53565,53565
Bermuda,1981,BM,BMU,AMR,1878,4220,6098,4820,5255,3704,2996,2090,1811,20676,1790,3961,5751,4764,5022,3654,2972,2341,2630,21383,42059,53907,53907
Bermuda,1982,BM,BMU,AMR,1894,4127,6021,4880,5235,3835,3010,2131,1850,20941,1796,3895,5691,4774,5104,3755,2982,2387,2680,21682,42623,54338,54338
Bermuda,1983,BM,BMU,AMR,1914,4039,5953,4928,5225,3980,3014,2175,1879,21201,1817,3822,5639,4772,5174,3860,3000,2433,2729,21968,43169,54765,54765
Bermuda,1984,BM,BMU,AMR,1945,3943,5888,4963,5236,4117,3020,2215,1920,21471,1858,3732,5590,4760,5242,3970,3021,2485,2773,22251,43722,55197,55197
Bermuda,1985,BM,BMU,AMR,1979,3845,5824,4961,5282,4243,3025,2254,1963,21728,1902,3642,5544,4735,5317,4094,3037,2527,2811,22521,44249,55611,55611
Bermuda,1986,BM,BMU,AMR,2000,3756,5756,4933,5351,4364,3029,2297,1999,21973,1927,3573,5500,4680,5410,4213,3063,2555,2845,22766,44739,55995,55995
Bermuda,1987,BM,BMU,AMR,2010,3685,5695,4854,5457,4472,3040,2349,2017,22189,1944,3526,5470,4592,5533,4324,3103,2570,2890,23012,45201,56367,56367
Bermuda,1988,BM,BMU,AMR,2011,3645,5656,4706,5599,4575,3066,2404,2030,22380,1962,3502,5464,4450,5670,4424,3152,2595,2938,23229,45609,56740,56740
Bermuda,1989,BM,BMU,AMR,2004,3636,5640,4522,5745,4674,3108,2452,2053,22554,1977,3500,5477,4269,5803,4533,3216,2623,2990,23434,45988,57111,57111
Bermuda,1990,BM,BMU,AMR,1998,3646,5644,4333,5877,4757,3158,2490,2081,22696,1992,3516,5508,4076,5911,4656,3298,2644,3030,23615,46311,57470,57470
Bermuda,1991,BM,BMU,AMR,2011,3672,5683,4176,5949,4832,3234,2516,2127,22834,2015,3546,5561,3927,5945,4796,3392,2665,3082,23807,46641,57874,57874
Bermuda,1992,BM,BMU,AMR,2046,3699,5745,4065,5927,4922,3340,2527,2165,22946,2042,3585,5627,3855,5870,4949,3497,2690,3141,24002,46948,58322,58322
Bermuda,1993,BM,BMU,AMR,2080,3726,5806,3972,5852,5022,3467,2525,2205,23043,2057,3633,5690,3816,5737,5098,3609,2721,3210,24191,47234,58739,58739
Bermuda,1994,BM,BMU,AMR,2101,3757,5858,3879,5753,5147,3595,2524,2253,23151,2061,3680,5741,3771,5606,5232,3732,2744,3276,24361,47512,59111,59111
Bermuda,1995,BM,BMU,AMR,2102,3792,5894,3770,5657,5283,3720,2529,2294,23253,2052,3718,5770,3702,5499,5378,3862,2758,3343,24542,47795,59465,59465
Bermuda,1996,BM,BMU,AMR,2082,3836,5918,3644,5589,5389,3854,2548,2356,23380,2024,3762,5786,3618,5412,5530,3989,2782,3420,24751,48131,59840,59840
Bermuda,1997,BM,BMU,AMR,2050,3873,5923,3534,5505,5490,3982,2581,2438,23530,1992,3806,5798,3535,5337,5658,4111,2831,3508,24980,48510,60227,60227
Bermuda,1998,BM,BMU,AMR,2019,3880,5899,3452,5378,5617,4096,2632,2521,23696,1967,3829,5796,3467,5256,5762,4215,2903,3613,25216,48912,60603,60603
Bermuda,1999,BM,BMU,AMR,1996,3868,5864,3406,5223,5752,4213,2683,2601,23878,1962,3825,5787,3415,5154,5855,4324,2975,3728,25451,49329,60981,60981
Bermuda,2000,BM,BMU,AMR,1978,3848,5826,3422,5060,5843,4320,2740,2691,24076,1970,3807,5777,3415,5033,5900,4457,3056,3835,25696,49772,61371,61371
Bermuda,2001,BM,BMU,AMR,1973,3817,5790,3497,4887,5880,4405,2827,2789,24285,1966,3786,5752,3476,4872,5895,4600,3149,3944,25936,50221,61763,61763
Bermuda,2002,BM,BMU,AMR,1969,3781,5750,3580,4720,5868,4494,2944,2891,24497,1947,3753,5700,3568,4716,5845,4749,3252,4063,26193,50690,62139,62139
Bermuda,2003,BM,BMU,AMR,1960,3745,5705,3628,4580,5840,4601,3070,2986,24705,1919,3715,5634,3653,4575,5754,4890,3370,4170,26412,51117,62468,62468
Bermuda,2004,BM,BMU,AMR,1940,3702,5642,3649,4491,5773,4726,3183,3091,24913,1877,3690,5567,3704,4462,5649,5033,3491,4281,26620,51533,62740,62740
Bermuda,2005,BM,BMU,AMR,1912,3651,5563,3649,4419,5690,4860,3295,3178,25091,1825,3659,5484,3702,4376,5556,5194,3602,4380,26810,51901,62959,62959
Bermuda,2006,BM,BMU,AMR,1877,3603,5480,3621,4360,5645,4942,3423,3234,25225,1769,3613,5382,3678,4334,5447,5359,3726,4447,26991,52216,63081,63081
Bermuda,2007,BM,BMU,AMR,1831,3563,5394,3554,4348,5577,5021,3528,3295,25323,1722,3547,5269,3640,4342,5319,5489,3851,4512,27153,52476,63156,63156
Bermuda,2008,BM,BMU,AMR,1814,3523,5337,3466,4355,5450,5144,3632,3371,25418,1703,3477,5180,3581,4372,5196,5591,3956,4621,27317,52735,63258,63258
Bermuda,2009,BM,BMU,AMR,1827,3466,5293,3389,4350,5325,5258,3742,3454,25518,1695,3411,5106,3503,4408,5060,5662,4070,4739,27442,52960,63353,63353
Bermuda,2010,BM,BMU,AMR,1835,3413,5248,3339,4303,5228,5326,3837,3575,25608,1701,3346,5047,3438,4402,4941,5668,4219,4877,27545,53153,63447,63447
Bermuda,2011,BM,BMU,AMR,1830,3378,5208,3306,4216,5151,5364,3914,3737,25688,1706,3290,4996,3394,4335,4862,5626,4372,5055,27644,53332,63533,63533
Bermuda,2012,BM,BMU,AMR,1799,3350,5149,3259,4131,5088,5371,4008,3906,25763,1689,3248,4937,3335,4270,4790,5549,4517,5249,27710,53473,63560,63560
Bermuda,2013,BM,BMU,AMR,1726,3342,5068,3204,4059,5032,5344,4119,4051,25809,1649,3216,4865,3256,4240,4717,5440,4643,5464,27760,53569,63506,63506
Bermuda,2014,BM,BMU,AMR,1627,3341,4968,3131,4013,4977,5290,4252,4172,25835,1604,3180,4784,3192,4207,4647,5313,4769,5639,27767,53602,63355,63355
Bermuda,2015,BM,BMU,AMR,1540,3324,4864,3058,3964,4892,5228,4390,4309,25841,1550,3125,4675,3137,4134,4591,5202,4913,5786,27763,53604,63144,63144
Bermuda,2016,BM,BMU,AMR,1498,3303,4801,3028,3863,4788,5224,4491,4449,25843,1516,3085,4601,3106,4017,4559,5099,5065,5977,27823,53666,63068,63068
Bermuda,2017,BM,BMU,AMR,1504,3306,4810,3058,3682,4710,5222,4595,4623,25890,1498,3102,4600,3112,3834,4565,5019,5206,6234,27970,53860,63275,63275
Bermuda,2018,BM,BMU,AMR,1512,3334,4846,3139,3447,4654,5179,4733,4811,25963,1467,3162,4629,3151,3607,4605,4947,5333,6487,28130,54093,63571,63571
Bermuda,2019,BM,BMU,AMR,1508,3361,4869,3226,3228,4597,5111,4867,4983,26012,1430,3226,4656,3211,3371,4654,4854,5438,6747,28275,54287,63812,63812
Bermuda,2020,BM,BMU,AMR,1490,3394,4884,3307,3044,4527,5067,4957,5151,26053,1403,3274,4677,3272,3176,4660,4785,5495,7025,28413,54466,64031,64031
Bermuda,2021,BM,BMU,AMR,1453,3437,4890,3396,2881,4422,5052,5005,5318,26074,1369,3306,4675,3326,3039,4605,4763,5498,7315,28546,54620,64185,64185
Bermuda,2022,BM,BMU,AMR,1388,3439,4827,3463,2812,4274,5036,5021,5500,26106,1310,3302,4612,3367,2958,4520,4748,5452,7599,28644,54750,64184,64184
Bermuda,2023,BM,BMU,AMR,1319,3378,4697,3505,2828,4099,5011,5015,5707,26165,1255,3245,4500,3382,2937,4416,4724,5359,7888,28706,54871,64069,64069
Bermuda,2024,BM,BMU,AMR,1266,3290,4556,3545,2865,3935,4972,4980,5936,26233,1213,3171,4384,3375,2969,4268,4709,5248,8193,28762,54995,63935,63935
Bermuda,2025,BM,BMU,AMR,1219,3204,4423,3571,2925,3766,4886,4955,6177,26280,1173,3097,4270,3345,3042,4068,4696,5152,8495,28798,55078,63778,63778
Bermuda,2026,BM,BMU,AMR,1185,3121,4306,3570,3007,3578,4772,4976,6401,26304,1142,3015,4157,3314,3115,3859,4684,5062,8796,28830,55134,63603,63603
Bermuda,2027,BM,BMU,AMR,1162,3038,4200,3547,3098,3382,4681,4986,6619,26313,1119,2922,4041,3301,3174,3647,4681,4978,9087,28868,55181,63416,63416
Bermuda,2028,BM,BMU,AMR,1144,2956,4100,3517,3197,3187,4601,4944,6867,26313,1102,2819,3921,3313,3226,3431,4685,4889,9346,28890,55203,63218,63218
Bermuda,2029,BM,BMU,AMR,1133,2870,4003,3488,3279,3024,4525,4877,7116,26309,1091,2715,3806,3330,3277,3228,4698,4775,9598,28906,55215,63017,63017
Bermuda,2030,BM,BMU,AMR,1128,2770,3898,3467,3336,2901,4441,4826,7327,26298,1087,2619,3706,3334,3317,3079,4662,4686,9824,28902,55200,62806,62806
Bermuda,1950,BM,BMU,AMR,2435,3685,6120,3104,2669,2373,1816,1085,881,11928,2365,3623,5988,3268,3093,2543,1799,1180,1228,13111,25039,37142,37142
Bermuda,1951,BM,BMU,AMR,2474,3772,6246,3177,2711,2375,1856,1098,865,12082,2386,3674,6060,3253,3088,2551,1841,1196,1225,13154,25236,37541,37541
Bermuda,1952,BM,BMU,AMR,2483,3859,6342,3249,2764,2376,1892,1113,852,12246,2383,3732,6115,3248,3082,2548,1887,1220,1226,13211,25457,37910,37910
Bermuda,1953,BM,BMU,AMR,2497,3932,6429,3317,2830,2384,1927,1128,844,12430,2390,3784,6174,3251,3066,2542,1926,1246,1230,13261,25691,38297,38297
Bermuda,1954,BM,BMU,AMR,2516,4009,6525,3378,2909,2396,1963,1147,839,12632,2404,3835,6239,3251,3054,2537,1967,1273,1238,13320,25952,38708,38708
Bermuda,1955,BM,BMU,AMR,2520,4095,6615,3423,2989,2419,1996,1171,843,12841,2418,3889,6307,3240,3040,2534,2006,1303,1244,13367,26208,39136,39136
Bermuda,1956,BM,BMU,AMR,2524,4187,6711,3454,3076,2453,2031,1197,861,13072,2447,3953,6400,3220,3044,2535,2048,1340,1262,13449,26521,39630,39630
Bermuda,1957,BM,BMU,AMR,2542,4275,6817,3471,3180,2495,2074,1231,881,13332,2495,4022,6517,3185,3060,2530,2090,1378,1288,13531,26863,40198,40198
Bermuda,1958,BM,BMU,AMR,2562,4362,6924,3476,3292,2545,2116,1276,901,13606,2547,4093,6640,3145,3085,2524,2128,1421,1315,13618,27224,40798,40798
Bermuda,1959,BM,BMU,AMR,2592,4445,7037,3466,3411,2605,2155,1328,927,13892,2579,4168,6747,3121,3110,2518,2153,1466,1347,13715,27607,41398,41398
Bermuda,1960,BM,BMU,AMR,2633,4534,7167,3457,3527,2672,2188,1385,948,14177,2574,4248,6822,3122,3138,2523,2167,1522,1384,13856,28033,42026,42026
Bermuda,1961,BM,BMU,AMR,2663,4625,7288,3546,3622,2752,2216,1448,972,14556,2558,4354,6912,3210,3170,2568,2180,1584,1418,14130,28686,42889,42889
Bermuda,1962,BM,BMU,AMR,2675,4698,7373,3746,3689,2839,2241,1511,998,15024,2548,4462,7010,3380,3210,2640,2205,1642,1439,14516,29540,43926,43926
Bermuda,1963,BM,BMU,AMR,2679,4750,7429,3983,3740,2935,2263,1566,1016,15503,2544,4546,7090,3570,3243,2714,2236,1691,1467,14921,30424,44950,44950
Bermuda,1964,BM,BMU,AMR,2682,4804,7486,4223,3781,3040,2295,1620,1046,16005,2552,4624,7176,3753,3274,2795,2274,1732,1502,15330,31335,45996,45996
Bermuda,1965,BM,BMU,AMR,2684,4868,7552,4438,3828,3147,2341,1678,1080,16512,2564,4709,7273,3916,3306,2872,2321,1775,1546,15736,32248,47074,47074
Bermuda,1966,BM,BMU,AMR,2682,4944,7626,4610,3897,3253,2391,1732,1119,17002,2553,4816,7369,4043,3356,2951,2361,1830,1591,16132,33134,48133,48133
Bermuda,1967,BM,BMU,AMR,2669,5027,7696,4715,4007,3360,2446,1780,1164,17472,2508,4940,7448,4138,3436,3030,2403,1886,1642,16535,34007,49142,49142
Bermuda,1968,BM,BMU,AMR,2628,5128,7756,4761,4163,3463,2509,1821,1218,17935,2444,5061,7505,4196,3559,3096,2451,1946,1701,16949,34884,50148,50148
Bermuda,1969,BM,BMU,AMR,2565,5238,7803,4758,4361,3567,2586,1855,1283,18410,2365,5169,7534,4220,3736,3151,2511,1992,1779,17389,35799,51136,51136
Bermuda,2031,BM,BMU,AMR,1128,2657,3785,3456,3394,2814,4330,4804,7503,26301,1086,2524,3610,3323,3340,2994,4569,4645,10014,28885,55186,62578,62578
Bermuda,2032,BM,BMU,AMR,1132,2548,3680,3432,3442,2783,4182,4785,7665,26289,1091,2429,3520,3297,3358,2944,4465,4618,10178,28860,55149,62344,62344
Bermuda,2033,BM,BMU,AMR,1140,2462,3602,3370,3483,2799,4015,4768,7809,26244,1099,2357,3456,3241,3372,2921,4362,4597,10308,28801,55045,62100,62100
Bermuda,2034,BM,BMU,AMR,1151,2399,3550,3280,3523,2839,3853,4734,7941,26170,1109,2304,3413,3166,3364,2954,4216,4584,10427,28711,54881,61849,61849
Bermuda,2035,BM,BMU,AMR,1162,2347,3509,3194,3549,2900,3689,4652,8101,26085,1120,2260,3380,3092,3336,3029,4022,4574,10567,28620,54705,61594,61594
Bermuda,2036,BM,BMU,AMR,1174,2311,3485,3114,3549,2981,3508,4550,8280,25982,1131,2226,3357,3012,3307,3100,3817,4565,10703,28504,54486,61326,61326
Bermuda,2037,BM,BMU,AMR,1184,2292,3476,3033,3526,3073,3315,4468,8444,25859,1139,2208,3347,2918,3296,3160,3607,4563,10825,28369,54228,61041,61041
Bermuda,2038,BM,BMU,AMR,1193,2283,3476,2950,3497,3168,3124,4399,8569,25707,1147,2199,3346,2814,3306,3212,3394,4571,10923,28220,53927,60745,60745
Bermuda,2039,BM,BMU,AMR,1198,2282,3480,2863,3469,3249,2964,4328,8676,25549,1152,2196,3348,2709,3323,3263,3193,4585,10981,28054,53603,60434,60434
Bermuda,2040,BM,BMU,AMR,1202,2288,3490,2763,3450,3309,2848,4248,8770,25388,1156,2202,3358,2614,3325,3302,3046,4551,11038,27876,53264,60108,60108
Bermuda,2041,BM,BMU,AMR,1204,2298,3502,2650,3439,3368,2763,4146,8856,25222,1158,2214,3372,2517,3315,3325,2965,4461,11102,27685,52907,59772,59772
Bermuda,2042,BM,BMU,AMR,1203,2313,3516,2541,3414,3413,2736,4005,8918,25027,1158,2228,3386,2421,3289,3345,2915,4361,11153,27484,52511,59416,59416
Bermuda,2043,BM,BMU,AMR,1200,2330,3530,2456,3351,3453,2753,3849,8974,24836,1154,2244,3398,2348,3233,3360,2892,4262,11184,27279,52115,59044,59044
Bermuda,2044,BM,BMU,AMR,1194,2348,3542,2393,3264,3495,2790,3694,8999,24635,1150,2260,3410,2295,3160,3351,2927,4120,11208,27061,51696,58657,58657
Bermuda,2045,BM,BMU,AMR,1188,2363,3551,2343,3177,3521,2854,3534,9018,24447,1144,2274,3418,2252,3085,3322,3001,3931,11255,26846,51293,58255,58255
Bermuda,2046,BM,BMU,AMR,1179,2376,3555,2307,3096,3523,2932,3363,9023,24244,1136,2287,3423,2220,3004,3294,3074,3731,11298,26621,50865,57843,57843
Bermuda,2047,BM,BMU,AMR,1169,2385,3554,2286,3017,3501,3022,3183,9043,24052,1126,2296,3422,2203,2911,3284,3132,3526,11341,26397,50449,57417,57417
Bermuda,2048,BM,BMU,AMR,1156,2391,3547,2277,2936,3473,3120,2998,9042,23846,1114,2300,3414,2195,2808,3295,3184,3319,11366,26167,50013,56974,56974
Bermuda,2049,BM,BMU,AMR,1140,2392,3532,2277,2850,3443,3199,2849,9031,23649,1098,2302,3400,2195,2703,3310,3235,3123,11369,25935,49584,56514,56514
Bermuda,2050,BM,BMU,AMR,1122,2389,3511,2284,2751,3422,3257,2740,8992,23446,1081,2300,3381,2201,2608,3314,3274,2983,11327,25707,49153,56041,56041
Bolivia (Plurinational State of),1970,BO,BOL,AMR,381945,580681,962626,430695,311619,229465,152366,103088,80505,1307738,369437,568194,937631,429210,313984,236252,167390,125217,105644,1377697,2685435,4585693,4585693
Bolivia (Plurinational State of),1971,BO,BOL,AMR,390043,595507,985550,438771,321203,233603,157015,104973,81184,1336749,377056,582053,959109,437320,323679,240262,171461,127141,106993,1406856,2743605,4688267,4688267
Bolivia (Plurinational State of),1972,BO,BOL,AMR,398282,610478,1008760,447434,331095,237375,162356,106711,82030,1367001,384809,596039,980848,445905,333721,243934,176291,128809,108532,1437192,2804193,4793804,4793804
Bolivia (Plurinational State of),1973,BO,BOL,AMR,406559,625358,1031917,457723,340485,241053,168150,108360,83060,1398831,392584,609923,1002507,456058,343243,247516,181602,130319,110254,1468992,2867823,4902248,4902248
Bolivia (Plurinational State of),1974,BO,BOL,AMR,415016,640207,1055223,469927,348822,245132,173913,110094,84285,1432173,400496,623762,1024258,467831,351887,251470,186941,131809,112172,1502110,2934283,5013765,5013765
Bolivia (Plurinational State of),1975,BO,BOL,AMR,423543,655319,1078862,482846,356748,249828,179359,112024,85654,1466459,408480,637869,1046349,480018,360328,256042,192033,133427,114259,1536107,3002566,5127776,5127776
Bolivia (Plurinational State of),1976,BO,BOL,AMR,432167,670728,1102895,496002,364694,255091,184591,114084,87177,1501639,416604,652268,1068872,492390,368745,261198,196975,135117,116523,1570948,3072587,5244355,5244355
Bolivia (Plurinational State of),1977,BO,BOL,AMR,441119,686405,1127524,509561,372436,260997,189696,116233,88905,1537828,425044,666912,1091956,505113,376863,267007,201829,136814,118981,1606607,3144435,5363917,5363917
Bolivia (Plurinational State of),1978,BO,BOL,AMR,450266,702371,1152637,523372,379960,267685,194573,118640,90755,1574985,433665,681827,1115492,518044,384646,273602,206478,138728,121514,1643012,3217997,5486132,5486132
Bolivia (Plurinational State of),1979,BO,BOL,AMR,459368,718750,1178118,537300,387211,275199,199060,121565,92598,1612933,442264,697111,1139375,531037,392029,281041,210751,141151,123950,1679959,3292892,5610380,5610380
Bolivia (Plurinational State of),1980,BO,BOL,AMR,468420,735438,1203858,551247,394181,283401,203166,125043,94374,1651412,450861,712679,1163540,543998,398994,289212,214659,144159,126252,1717274,3368686,5736088,5736088
Bolivia (Plurinational State of),1981,BO,BOL,AMR,477273,752514,1229787,565167,401033,292081,206914,129051,96106,1690352,459342,728616,1187958,556885,405709,297904,218222,147773,128407,1754900,3445252,5862990,5862990
Bolivia (Plurinational State of),1982,BO,BOL,AMR,485676,770034,1255710,579146,408216,300905,210275,133598,97779,1729919,467498,744974,1212472,569783,412627,306777,221409,152008,130409,1793013,3522932,5991118,5991118
Bolivia (Plurinational State of),1983,BO,BOL,AMR,493671,787803,1281474,593026,416770,309120,213492,138468,99420,1770296,475343,761576,1236919,582570,420882,315027,224461,156619,132366,1831925,3602221,6120620,6120620
Bolivia (Plurinational State of),1984,BO,BOL,AMR,501545,805718,1307263,606890,427002,316229,217011,143258,101199,1811589,483116,778339,1261455,595319,430549,322334,227814,161219,134385,1871620,3683209,6251926,6251926
Bolivia (Plurinational State of),1985,BO,BOL,AMR,509620,823783,1333403,621033,437819,322868,221063,147758,103200,1853741,491120,795274,1286394,608342,440501,329369,231711,165576,136590,1912089,3765830,6385630,6385630
Bolivia (Plurinational State of),1986,BO,BOL,AMR,517990,841875,1359865,635532,448840,329479,225617,152055,105371,1896894,499438,812301,1311739,621701,450593,336327,236133,169780,138952,1953486,3850380,6521983,6521983
Bolivia (Plurinational State of),1987,BO,BOL,AMR,526867,859906,1386773,650365,460242,335866,230735,156220,107682,1941110,508211,829387,1337598,635400,461045,342989,241156,173905,141453,1995948,3937058,6661434,6661434
Bolivia (Plurinational State of),1988,BO,BOL,AMR,536162,877851,1414013,665570,471944,342033,236565,160184,110219,1986515,517374,846510,1363884,649489,471789,349358,246943,177879,144195,2039653,4026168,6804072,6804072
Bolivia (Plurinational State of),1989,BO,BOL,AMR,545415,895728,1441143,681231,483842,347991,243178,163838,113084,2033164,526513,863691,1390204,664038,482720,355426,253565,181571,147303,2084623,4117787,6949139,6949139
Bolivia (Plurinational State of),1990,BO,BOL,AMR,554415,913808,1468223,697202,495874,353780,250472,167213,116273,2080814,535311,881199,1416510,678905,493777,361239,260936,185011,150784,2130652,4211466,7096194,7096194
Bolivia (Plurinational State of),1991,BO,BOL,AMR,562880,932081,1494961,713575,508033,359605,258276,170349,119786,2129624,543424,899013,1442437,694172,504938,366973,268887,188217,154683,2177870,4307494,7244891,7244891
Bolivia (Plurinational State of),1992,BO,BOL,AMR,570328,950491,1520819,730423,520357,365847,266278,173230,123653,2179788,550428,917020,1467448,709892,516225,373016,277069,191159,158995,2226356,4406144,7394419,7394419
Bolivia (Plurinational State of),1993,BO,BOL,AMR,576536,968098,1544634,745253,532505,373735,273860,177494,132056,2234903,555956,933753,1489709,723810,526166,379301,283347,194526,168092,2275242,4510145,7544489,7544489
Bolivia (Plurinational State of),1994,BO,BOL,AMR,581325,985055,1566380,757840,544481,383637,280445,183328,144319,2294050,559968,949377,1509345,735826,534868,386088,287372,198481,181314,2323949,4617999,7693722,7693722
Bolivia (Plurinational State of),1995,BO,BOL,AMR,584711,1002617,1587328,770566,556731,394334,286496,189284,155517,2352928,562825,965590,1528415,748093,544031,393572,291135,202498,193466,2372795,4725723,7841471,7841471
Bolivia (Plurinational State of),1996,BO,BOL,AMR,587345,1020508,1607853,783672,569360,405430,292515,195292,165675,2411944,565234,982101,1547335,760732,553844,401603,294950,206567,204538,2422234,4834178,7989367,7989367
Bolivia (Plurinational State of),1997,BO,BOL,AMR,589334,1038340,1627674,797319,582353,417062,298407,201427,174928,2471496,567301,998572,1565873,773786,564357,410316,298688,210789,214644,2472580,4944076,8137619,8137619
Bolivia (Plurinational State of),1998,BO,BOL,AMR,591129,1055736,1646865,811635,595714,429075,304243,207829,183339,2531835,569341,1014729,1584070,787284,575668,419557,302423,215359,223864,2524155,5055990,8286928,8286928
Bolivia (Plurinational State of),1999,BO,BOL,AMR,594010,1071990,1666000,826803,609536,441332,310051,214513,190881,2593116,572422,1029970,1602392,801478,587953,429227,306253,220398,232238,2577547,5170663,8439052,8439052
Bolivia (Plurinational State of),2000,BO,BOL,AMR,597390,1086762,1684152,843083,623703,453784,315945,221448,197732,2655695,575927,1043857,1619784,816721,601068,439224,310253,225882,239878,2633026,5288721,8592656,8592656
Bolivia (Plurinational State of),2001,BO,BOL,AMR,600058,1100923,1700981,861968,638379,466201,322080,227573,201139,2717340,578757,1057636,1636393,834372,615908,450219,315541,231398,243932,2691370,5408710,8746084,8746084
Bolivia (Plurinational State of),2002,BO,BOL,AMR,602581,1113799,1716380,883425,653642,478564,328870,232774,201557,2778832,581374,1070783,1652157,854376,632426,462129,322533,236860,244893,2753217,5532049,8900583,8900583
Bolivia (Plurinational State of),2003,BO,BOL,AMR,605264,1124817,1730081,905792,669216,490835,337241,237543,202339,2842966,584054,1082198,1666252,875257,649396,473933,331211,242035,246255,2818087,5661053,9057378,9057378
Bolivia (Plurinational State of),2004,BO,BOL,AMR,607395,1135133,1742528,928695,685086,503123,347382,241545,203569,2909400,586153,1092824,1678977,896760,666643,485744,341556,246661,248011,2885375,5794775,9216279,9216279
Bolivia (Plurinational State of),2005,BO,BOL,AMR,609629,1144329,1753958,951901,701366,515758,358286,245425,205295,2978031,588278,1102286,1690564,918696,684111,497940,352480,251369,250239,2954835,5932866,9377388,9377388
Bolivia (Plurinational State of),2006,BO,BOL,AMR,613757,1151860,1765617,974978,718153,528794,369526,249577,207430,3048458,592172,1110108,1702280,940695,701788,510672,363766,256382,253002,3026305,6074763,9542663,9542663
Bolivia (Plurinational State of),2007,BO,BOL,AMR,619259,1158381,1777640,997395,735518,542194,381145,253875,209990,3120117,597319,1116996,1714315,962240,719624,523982,375444,261507,256284,3099081,6219198,9711152,9711152
Bolivia (Plurinational State of),2008,BO,BOL,AMR,624561,1164711,1789272,1018720,753552,555953,392956,258361,212999,3192541,602209,1123789,1725998,982922,737592,537960,387330,266783,260205,3172792,6365333,9880593,9880593
Bolivia (Plurinational State of),2009,BO,BOL,AMR,629627,1171360,1800987,1038267,772400,570202,404873,263107,216510,3265359,606830,1130838,1737668,1002126,755944,552781,399309,272272,264872,3247304,6512663,10051317,10051317
Bolivia (Plurinational State of),2010,BO,BOL,AMR,634427,1178507,1812934,1055728,792378,584838,416831,268169,220498,3338442,611228,1138207,1749435,1019438,775141,568341,411288,278029,270227,3322464,6660906,10223270,10223270
Bolivia (Plurinational State of),2011,BO,BOL,AMR,637928,1186735,1824663,1071382,813460,599932,428807,273700,224864,3412145,614429,1146412,1760841,1035120,795218,584661,423233,284204,276159,3398595,6810740,10396246,10396246
Bolivia (Plurinational State of),2012,BO,BOL,AMR,640232,1196073,1836305,1084854,835561,615503,440842,279934,229354,3486048,616543,1155412,1771955,1048885,816142,601686,435176,291100,282396,3475385,6961433,10569697,10569697
Bolivia (Plurinational State of),2013,BO,BOL,AMR,642306,1205314,1847620,1096482,858531,631382,452813,287530,233518,3560256,618496,1164153,1782649,1060899,837886,619136,447011,299512,288367,3552811,7113067,10743349,10743349
Bolivia (Plurinational State of),2014,BO,BOL,AMR,644044,1213685,1857729,1107413,882012,647538,464834,296628,237219,3635644,620175,1171974,1792149,1072112,860232,636838,458879,309432,293982,3631475,7267119,10916987,10916987
Bolivia (Plurinational State of),2015,BO,BOL,AMR,645264,1221784,1867048,1117218,905778,664085,477175,306349,240954,3711559,621380,1179488,1800868,1082146,882978,654747,471105,319851,299788,3710615,7422174,11090085,11090085
Bolivia (Plurinational State of),2016,BO,BOL,AMR,646002,1230352,1876354,1125385,929413,681128,489927,316391,245124,3787368,622130,1187476,1809606,1090550,905768,672842,483850,330597,306080,3789687,7577055,11263015,11263015
Bolivia (Plurinational State of),2017,BO,BOL,AMR,646400,1238994,1885394,1132546,952409,698744,503041,326774,249625,3863139,622568,1195558,1818126,1098033,928114,691093,497160,341719,312756,3868875,7732014,11435533,11435533
Bolivia (Plurinational State of),2018,BO,BOL,AMR,646542,1247151,1893693,1139471,974315,716976,516469,337281,254515,3939027,622765,1203168,1825933,1105371,949567,709445,511078,352971,319819,3948251,7887278,11606905,11606905
Bolivia (Plurinational State of),2019,BO,BOL,AMR,646636,1254669,1901305,1146662,994443,735970,530315,347839,259863,4015092,622919,1210168,1833087,1112895,969489,728108,525738,364232,327364,4027826,8042918,11777315,11777315
Bolivia (Plurinational State of),2020,BO,BOL,AMR,647011,1261381,1908392,1154592,1012721,755788,543363,356059,261348,4083871,623337,1216468,1839805,1121023,987764,747485,540580,374350,332882,4104084,8187955,11936162,11936162
Bolivia (Plurinational State of),2021,BO,BOL,AMR,647785,1266308,1914093,1163780,1029364,776305,555473,361518,258012,4144452,624148,1221130,1845278,1130176,1004563,767493,555407,382904,335107,4175650,8320102,12079472,12079472
Bolivia (Plurinational State of),2022,BO,BOL,AMR,649001,1269702,1918703,1174125,1044066,798060,568444,367522,255443,4207660,625321,1224370,1849691,1140124,1019585,788431,570983,391522,337407,4248052,8455712,12224110,12224110
Bolivia (Plurinational State of),2023,BO,BOL,AMR,650398,1272597,1922995,1184447,1057325,821448,583566,376873,259427,4283086,626692,1227217,1853909,1149910,1033205,810718,587959,401888,344899,4328579,8611665,12388571,12388571
Bolivia (Plurinational State of),2024,BO,BOL,AMR,651986,1275076,1927062,1193759,1069963,845746,600178,388775,268704,4367125,628338,1229738,1858076,1158671,1046116,833911,605877,413686,356809,4415070,8782195,12567336,12567336
Bolivia (Plurinational State of),2025,BO,BOL,AMR,653977,1277256,1931233,1202681,1081452,870312,617149,400982,278440,4451016,630389,1231987,1862376,1167008,1057845,857535,624025,425858,369250,4501521,8952537,12746148,12746148
Bolivia (Plurinational State of),2026,BO,BOL,AMR,656148,1279308,1935456,1211939,1091256,894720,634541,413532,288624,4534612,632636,1234129,1866765,1175686,1067881,881194,642350,438505,382213,4587829,9122441,12924657,12924657
Bolivia (Plurinational State of),2027,BO,BOL,AMR,658160,1281400,1939560,1221171,1099998,918484,652448,426389,299232,4617722,634755,1236295,1871050,1184342,1076920,904403,660830,451678,395676,4673849,9291571,13102178,13102178
Bolivia (Plurinational State of),2028,BO,BOL,AMR,659904,1283390,1943294,1229848,1108450,941211,670956,439547,310224,4700236,636590,1238407,1874997,1192461,1085761,926784,679457,465460,409583,4759506,9459742,13278039,13278039
Bolivia (Plurinational State of),2029,BO,BOL,AMR,661260,1285583,1946843,1237841,1117092,962238,690218,453087,321571,4782047,638030,1240770,1878800,1199922,1094713,947706,698459,479970,423887,4844657,9626704,13452352,13452352
Bolivia (Plurinational State of),2030,BO,BOL,AMR,662153,1288399,1950552,1244941,1126067,981274,710515,466934,333274,4863005,639041,1243738,1882779,1206581,1103840,966778,718270,495129,438576,4929174,9792179,13625507,13625507
Bolivia (Plurinational State of),1950,BO,BOL,AMR,252421,364984,617405,283308,196668,147571,104632,86859,86689,905727,245131,355268,600399,278936,203694,163008,119395,99038,102245,966316,1872043,3089843,3089843
Bolivia (Plurinational State of),1951,BO,BOL,AMR,254586,375456,630042,287197,201519,149752,105818,86005,85808,916099,247887,365746,613633,282690,207772,165137,121218,98718,101578,977113,1893212,3136895,3136895
Bolivia (Plurinational State of),1952,BO,BOL,AMR,256940,386291,643231,290788,207296,151764,107408,85008,85168,927432,250693,376622,627315,286258,212858,166983,123410,98261,101198,988968,1916400,3186943,3186943
Bolivia (Plurinational State of),1953,BO,BOL,AMR,260457,396564,657021,294441,213758,153692,109346,84010,84701,939948,254561,386940,641501,289910,218647,168670,125931,97772,101034,1001964,1941912,3240439,3240439
Bolivia (Plurinational State of),1954,BO,BOL,AMR,265603,405646,671249,298752,220334,155766,111549,83198,84322,953921,259733,396351,656084,294171,224606,170376,128689,97460,100994,1016296,1970217,3297544,3297544
Bolivia (Plurinational State of),1955,BO,BOL,AMR,271500,414312,685812,303925,226635,158130,113918,82640,83960,969208,265334,405597,670931,299292,230405,172269,131558,97423,101020,1031967,2001175,3357923,3357923
Bolivia (Plurinational State of),1956,BO,BOL,AMR,277670,423063,700733,309895,232788,160695,116487,82332,83630,985827,271158,414892,686050,305216,236145,174265,134578,97647,101104,1048955,2034782,3421566,3421566
Bolivia (Plurinational State of),1957,BO,BOL,AMR,284310,431633,715943,316683,238840,163361,119277,82265,83309,1003735,277439,423947,701386,311975,241871,176280,137763,98121,101231,1067241,2070976,3488300,3488300
Bolivia (Plurinational State of),1958,BO,BOL,AMR,291685,440005,731690,324408,244636,166340,122131,82467,82970,1022952,284447,432719,717166,319691,247426,178562,140935,98879,101370,1086863,2109815,3558666,3558666
Bolivia (Plurinational State of),1959,BO,BOL,AMR,299573,448190,747763,333124,249957,170000,124835,82979,82573,1043468,291951,441221,733172,328408,252571,181491,143856,99967,101472,1107765,2151233,3632171,3632171
Bolivia (Plurinational State of),1960,BO,BOL,AMR,307447,456273,763720,342681,254796,174382,127279,83813,82124,1065075,299425,449510,748935,338004,257305,185147,146419,101382,101530,1129787,2194862,3707515,3707515
Bolivia (Plurinational State of),1961,BO,BOL,AMR,315316,464489,779805,352850,259178,179448,129510,84952,81610,1087548,306882,457798,764680,348262,261624,189555,148627,103105,101537,1152710,2240258,3784744,3784744
Bolivia (Plurinational State of),1962,BO,BOL,AMR,323133,473294,796427,363287,263104,185272,131556,86402,81060,1110681,314279,466549,780828,358811,265507,194753,150518,105117,101503,1176209,2286890,3864140,3864140
Bolivia (Plurinational State of),1963,BO,BOL,AMR,330531,483780,814311,373130,266871,191571,133465,88101,80509,1133647,321248,476919,798167,368788,269262,200464,152214,107392,101487,1199607,2333254,3945729,3945729
Bolivia (Plurinational State of),1964,BO,BOL,AMR,337572,496270,833842,381824,271024,197798,135427,89971,80059,1156103,327858,488970,816828,377847,273391,206194,153866,109832,101566,1222696,2378799,4029472,4029472
Bolivia (Plurinational State of),1965,BO,BOL,AMR,344657,509541,854198,390128,275863,203683,137613,91969,79750,1179006,334497,501463,835960,386736,278186,211651,155636,112340,101801,1246350,2425356,4115511,4115511
Bolivia (Plurinational State of),1966,BO,BOL,AMR,351759,523114,874873,398524,281361,209348,139952,94116,79581,1202882,341151,514210,855361,395683,283646,216964,157468,114972,102214,1270947,2473829,4204065,4204065
Bolivia (Plurinational State of),1967,BO,BOL,AMR,358968,537148,896116,406763,287576,214873,142369,96440,79568,1227589,347904,527376,875280,404410,289842,222203,159300,117739,102793,1296287,2523876,4295269,4295269
Bolivia (Plurinational State of),1968,BO,BOL,AMR,366412,551467,917879,414841,294651,220141,145066,98803,79701,1253203,354879,540815,895694,412889,296929,227245,161370,120482,103557,1322472,2575675,4389249,4389249
Bolivia (Plurinational State of),1969,BO,BOL,AMR,374094,565984,940078,422789,302700,224986,148375,101041,80010,1279901,362072,554438,916510,421139,305004,231923,164036,123000,104501,1349603,2629504,4486098,4486098
Bolivia (Plurinational State of),2031,BO,BOL,AMR,662677,1291733,1954410,1250198,1135942,998570,731833,481147,345345,4943035,639692,1247238,1886930,1211526,1113649,984240,738930,510962,453659,5012966,9956001,13797344,13797344
Bolivia (Plurinational State of),2032,BO,BOL,AMR,663186,1295270,1958456,1253872,1146754,1013779,754105,495779,357844,5022133,640318,1250933,1891251,1215027,1124088,999828,760433,527431,469238,5096045,10118178,13967882,13967882
Bolivia (Plurinational State of),2033,BO,BOL,AMR,663867,1298674,1962541,1257023,1157330,1027218,777196,510678,370809,5100254,641090,1254502,1895592,1218095,1134130,1013716,782751,544301,485433,5178426,10278680,14136814,14136814
Bolivia (Plurinational State of),2034,BO,BOL,AMR,664265,1301908,1966173,1259785,1166932,1039971,800760,525819,384257,5177524,641556,1257940,1899496,1220835,1143131,1026813,805673,561431,502279,5260162,10437686,14303356,14303356
Bolivia (Plurinational State of),2035,BO,BOL,AMR,664031,1305069,1969100,1262242,1176141,1051612,824588,541304,398159,5254046,641404,1261331,1902735,1223303,1151705,1038747,829032,578803,519769,5341359,10595405,14467239,14467239
Bolivia (Plurinational State of),2036,BO,BOL,AMR,663555,1308031,1971586,1264564,1185678,1061612,848265,557199,412519,5329837,641012,1264541,1905553,1225657,1160606,1049025,852438,596369,537990,5422085,10751922,14629061,14629061
Bolivia (Plurinational State of),2037,BO,BOL,AMR,662728,1310808,1973536,1266928,1195180,1070578,871336,573580,427312,5404914,640262,1267591,1907853,1228032,1169491,1058318,875416,614106,556958,5502321,10907235,14788620,14788620
Bolivia (Plurinational State of),2038,BO,BOL,AMR,661453,1313488,1974941,1269181,1204137,1079264,893418,590530,442492,5479022,639083,1270490,1909573,1230343,1177833,1067418,897588,632017,576672,5581871,11060893,14945408,14945408
Bolivia (Plurinational State of),2039,BO,BOL,AMR,660096,1315490,1975586,1271633,1212420,1088132,913883,608185,458092,5552345,637825,1272680,1910505,1232901,1185520,1076628,918352,650311,597204,5660916,11213261,15099347,15099347
Bolivia (Plurinational State of),2040,BO,BOL,AMR,658830,1316393,1975223,1274694,1219820,1097336,932459,626799,474072,5625180,636652,1273813,1910465,1236053,1192406,1086007,937327,669410,618490,5739693,11364873,15250564,15250564
Bolivia (Plurinational State of),2041,BO,BOL,AMR,657402,1316684,1974086,1278262,1225397,1107424,949404,646373,490520,5697380,635308,1274327,1909635,1239728,1197587,1096055,954767,689364,640604,5818105,11515485,15399200,15399200
Bolivia (Plurinational State of),2042,BO,BOL,AMR,655942,1316599,1972541,1282019,1229406,1118417,964381,666856,507548,5768627,633912,1274454,1908366,1243584,1201310,1106719,970393,710155,663645,5895806,11664433,15545347,15545347
Bolivia (Plurinational State of),2043,BO,BOL,AMR,654573,1316230,1970803,1285628,1232883,1129174,977702,688113,525093,5838593,632585,1274276,1906861,1247305,1204592,1116977,984378,731762,687511,5972525,11811118,15688782,15688782
Bolivia (Plurinational State of),2044,BO,BOL,AMR,653186,1315490,1968676,1289057,1235963,1138975,990401,709812,543130,5907338,631216,1273707,1904923,1250879,1207537,1126193,997613,753968,712075,6048265,11955603,15829210,15829210
Bolivia (Plurinational State of),2045,BO,BOL,AMR,651850,1314214,1966064,1292401,1238732,1148385,1002072,731766,561729,5975085,629874,1272591,1902465,1254401,1210200,1134982,1009724,776599,737311,6123217,12098302,15966827,15966827
Bolivia (Plurinational State of),2046,BO,BOL,AMR,650489,1312523,1963012,1295543,1241350,1158106,1012184,753614,581008,6041805,628497,1271049,1899546,1257729,1212724,1144072,1020211,799297,763290,6197323,12239128,16101682,16101682
Bolivia (Plurinational State of),2047,BO,BOL,AMR,648768,1310445,1959213,1298488,1243981,1167768,1021321,774937,601007,6107502,626791,1269084,1895875,1260886,1215255,1153118,1029737,821602,790030,6270628,12378130,16233225,16233225
Bolivia (Plurinational State of),2048,BO,BOL,AMR,646714,1308001,1954715,1301319,1246495,1176880,1030199,795399,621786,6172078,624787,1266747,1891534,1263884,1217716,1161612,1039069,843164,817556,6343001,12515079,16361324,16361324
Bolivia (Plurinational State of),2049,BO,BOL,AMR,645012,1305445,1950457,1303469,1249180,1185318,1039257,814450,643528,6235202,623108,1264274,1887382,1266163,1220399,1169437,1048495,863415,846137,6414046,12649248,16487088,16487088
Bolivia (Plurinational State of),2050,BO,BOL,AMR,643255,1303027,1946282,1304525,1252455,1192875,1048628,831853,666381,6296717,621359,1261900,1883259,1267384,1223662,1176456,1058072,881993,876033,6483600,12780317,16609854,16609854
Brazil,1970,BR,BRA,AMR,7585088,13130909,20715997,9322329,6401762,4702787,3329820,2158630,1489043,27404371,7407369,12980439,20387808,9361409,6455306,5005802,3334563,2126681,1577944,27861705,55266076,96369875,96369875
Brazil,1971,BR,BRA,AMR,7633915,13409747,21043662,9678679,6569135,4799078,3431717,2222230,1554838,28255677,7453381,13251378,20704759,9719057,6614247,5118176,3464104,2199507,1647102,28762193,57017870,98766288,98766288
Brazil,1972,BR,BRA,AMR,7701776,13656535,21358311,10044640,6740757,4904647,3538634,2284686,1622356,29135720,7518019,13490092,21008111,10075302,6795585,5228399,3602692,2271524,1718754,29692256,58827976,101194394,101194394
Brazil,1973,BR,BRA,AMR,7793566,13869438,21663004,10404161,6935851,5019435,3649235,2347089,1692232,30048003,7606056,13694737,21300793,10426477,7004413,5338272,3748629,2343631,1793691,30655113,60703116,103666904,103666904
Brazil,1974,BR,BRA,AMR,7896638,14055538,21952176,10746128,7163024,5146083,3759639,2410371,1764962,30990207,7705131,13872313,21577444,10760161,7249609,5450933,3897803,2416773,1872267,31647546,62637753,106167372,106167372
Brazil,1975,BR,BRA,AMR,8004610,14225560,22230170,11080257,7414461,5282978,3867190,2475443,1840537,31960866,7808326,14033482,21841808,11085886,7523023,5566005,4046074,2492115,1954564,32667667,64628533,108700515,108700515
Brazil,1976,BR,BRA,AMR,8126266,14382529,22508795,11420692,7675854,5428086,3971148,2544110,1918164,32958054,7923972,14181446,22105418,11418914,7807882,5683788,4191517,2572091,2040034,33714226,66672280,111286504,111286504
Brazil,1977,BR,BRA,AMR,8262273,14530105,22792378,11764719,7951227,5581341,4071050,2618934,1996872,33984143,8053293,14319830,22373123,11757228,8106128,5806432,4332757,2659966,2127723,34790234,68774377,113939886,113939886
Brazil,1978,BR,BRA,AMR,8409734,14675739,23085473,12108250,8243964,5740566,4165949,2700793,2076661,35036183,8193956,14456146,22650102,12096121,8420988,5934319,4466570,2757205,2217426,35892629,70928812,116664382,116664382
Brazil,1979,BR,BRA,AMR,8572132,14821358,23393490,12440264,8554154,5905718,4256385,2788421,2157971,36102913,8349262,14592234,22941496,12423338,8752803,6069852,4591205,2862990,2309222,37009410,73112323,119447303,119447303
Brazil,1980,BR,BRA,AMR,8745347,14979879,23725226,12749969,8883362,6075947,4346458,2879928,2240024,37175688,8514478,14740534,23255012,12727596,9102763,6215114,4708151,2976351,2402470,38132445,75308133,122288383,122288383
Brazil,1981,BR,BRA,AMR,8915371,15166739,24082110,13030037,9232257,6240887,4443331,2974905,2321867,38243284,8675093,14916065,23591158,13001577,9460398,6373851,4821461,3097675,2496540,39251502,77494786,125168060,125168060
Brazil,1982,BR,BRA,AMR,9072712,15386156,24458868,13276302,9588397,6408451,4548863,3074232,2403772,39300017,8821541,15123126,23944667,13241149,9814667,6553229,4932952,3227617,2591928,40361542,79661559,128065095,128065095
Brazil,1983,BR,BRA,AMR,9209087,15640226,24849313,13489399,9938170,6597055,4662880,3176664,2486823,40350991,8945393,15364160,24309553,13447183,10163466,6758289,5044144,3364647,2689781,41467510,81818501,130977370,130977370
Brazil,1984,BR,BRA,AMR,9315898,15921010,25236908,13676863,10271988,6816210,4788118,3278928,2571967,41404074,9039009,15631351,24670360,13627317,10495636,6999400,5158305,3505278,2791490,42577426,83981500,133888775,133888775
Brazil,1985,BR,BRA,AMR,9385638,16217604,25603242,13849141,10598906,7059279,4922915,3378712,2659819,42468772,9097245,15912862,25010107,13792072,10820129,7269702,5274997,3645832,2898329,43701061,86169833,136783180,136783180
Brazil,1986,BR,BRA,AMR,9413392,16524928,25938320,14008732,10932225,7312715,5065294,3475631,2751549,43546146,9116619,16202385,25319004,13943915,11151862,7552658,5394512,3784765,3012172,44839884,88386030,139643355,139643355
Brazil,1987,BR,BRA,AMR,9405282,16834888,26240170,14158780,11267395,7578025,5214130,3569174,2848782,44636286,9102773,16492375,25595148,14085923,11487007,7847511,5518004,3920761,3135458,45994664,90630950,142466264,142466264
Brazil,1988,BR,BRA,AMR,9366929,17135706,26502635,14308219,11601904,7858658,5367330,3658581,2952258,45746950,9061083,16771592,25832675,14227118,11822218,8157428,5645627,4050677,3268646,47171714,92918664,145253973,145253973
Brazil,1989,BR,BRA,AMR,9305548,17422225,26727773,14459483,11927543,8156726,5525753,3744609,3061150,46875264,8998049,17035337,26033386,14369941,12148081,8484795,5780411,4173037,3410715,48366980,95242244,148003411,148003411
Brazil,1990,BR,BRA,AMR,9230323,17682272,26912595,14623667,12232343,8472389,5687329,3829283,3168843,48013854,8921954,17273593,26195547,14526249,12453175,8830491,5924288,4289212,3561032,49584447,97598301,150706446,150706446
Brazil,1991,BR,BRA,AMR,9147273,17897285,27044558,14812607,12507420,8806604,5842560,3919258,3274252,49162701,8838733,17468358,26307091,14707155,12728557,9184698,6080997,4402669,3718010,50822086,99984787,153336445,153336445
Brazil,1992,BR,BRA,AMR,9056604,18065022,27121626,15031912,12750445,9149663,6000554,4017971,3382769,50333314,8748475,17616565,26365040,14917242,12970814,9537767,6257916,4515039,3882032,52080810,102414124,155900790,155900790
Brazil,1993,BR,BRA,AMR,8973894,18182039,27155933,15286216,12962227,9487914,6178217,4124969,3494497,51534040,8665661,17715135,26380796,15161671,13180845,9886676,6459594,4627617,4053710,53370113,104904153,158440875,158440875
Brazil,1994,BR,BRA,AMR,8913037,18246791,27159828,15567910,13149701,9811833,6384822,4242538,3608062,52764866,8604441,17762101,26366542,15432709,13365692,10219632,6696635,4743166,4231398,54689232,107454098,160980472,160980472
Brazil,1995,BR,BRA,AMR,8875186,18261003,27136189,15865161,13321702,10128780,6614055,4368349,3720940,54018987,8566502,17760077,26326579,15717635,13534641,10544097,6963028,4860940,4413222,56033563,110052550,163515328,163515328
Brazil,1996,BR,BRA,AMR,8858316,18226111,27084427,16172600,13480685,10451793,6853262,4500492,3834300,55293132,8548673,17712265,26260938,16009737,13690097,10875277,7242585,4981230,4599697,57398623,112691755,166037122,166037122
Brazil,1997,BR,BRA,AMR,8858193,18148424,27006617,16484081,13631706,10778071,7104355,4638228,3950207,56586648,8546855,17624638,26171493,16303179,13836834,11210979,7534433,5105159,4791359,58781943,115368591,168546707,168546707
Brazil,1998,BR,BRA,AMR,8864399,18047721,26912120,16787321,13781291,11103149,7369372,4778818,4067705,57887656,8551496,17516094,26067590,16586172,13981633,11545991,7840709,5232295,4985645,60172445,118060101,171039804,171039804
Brazil,1999,BR,BRA,AMR,8853726,17944618,26798344,17076332,13930666,11418055,7649651,4922531,4185844,59183079,8539478,17406776,25946254,16853287,14125901,11870218,8163397,5365220,5180587,61558610,120741689,173486281,173486281
Brazil,2000,BR,BRA,AMR,8814234,17849833,26664067,17340749,14093241,11712410,7945625,5067140,4301095,60460260,8499111,17307011,25806122,17096816,14283984,12173606,8504042,5506203,5378610,62943261,123403521,175873720,175873720
Brazil,2001,BR,BRA,AMR,8748275,17768145,26516420,17563649,14285188,11981895,8260471,5205497,4420103,61716803,8433308,17220573,25653881,17300284,14471821,12451750,8855604,5660303,5585022,64324784,126041587,178211881,178211881
Brazil,2002,BR,BRA,AMR,8654458,17695280,26349738,17740885,14509750,12223115,8585127,5346160,4548809,62953846,8340632,17142843,25483475,17458222,14691711,12700105,9208140,5833819,5797636,65689633,128643479,180476685,180476685
Brazil,2003,BR,BRA,AMR,8522000,17635207,26157207,17866479,14766421,12432907,8905657,5503734,4686199,64161397,8210756,17077541,25288297,17564298,14943098,12915238,9556602,6029728,6013407,67022371,131183768,182629278,182629278
Brazil,2004,BR,BRA,AMR,8382810,17578860,25961670,17939776,15048854,12618412,9213566,5687537,4833771,65341916,8074406,17016058,25090464,17617642,15219349,13104670,9889622,6259924,6236791,68327998,133669914,184722043,184722043
Brazil,2005,BR,BRA,AMR,8264885,17515467,25780352,17962040,15346393,12789599,9516463,5894142,4992710,66501347,7958194,16948069,24906263,17620083,15507939,13278258,10214011,6520502,6468586,69609379,136110726,186797334,186797334
Brazil,2006,BR,BRA,AMR,8154574,17445171,25599745,17934756,15654022,12949272,9826559,6111817,5161197,67637623,7849251,16873188,24722439,17574727,15802255,13438550,10544617,6794963,6705767,70860879,138498502,188820682,188820682
Brazil,2007,BR,BRA,AMR,8048628,17362874,25411502,17866499,15966872,13101623,10140560,6340529,5335428,68751511,7744791,16786633,24531424,17490706,16097957,13589920,10879538,7080907,6945979,72085007,140836518,190779453,190779453
Brazil,2008,BR,BRA,AMR,7957332,17247835,25205167,17776000,16272730,13253198,10454793,6582688,5515170,69854579,7654483,16668786,24323269,17385746,16382687,13738960,11213725,7380472,7187715,73289305,143143884,192672317,192672317
Brazil,2009,BR,BRA,AMR,7871850,17108865,24980715,17683608,16566360,13405733,10760875,6839417,5699165,70955158,7569879,16527282,24097161,17280258,16651798,13887764,11537598,7695693,7431409,74484520,145439678,194517549,194517549
Brazil,2010,BR,BRA,AMR,7783662,16962455,24746117,17603299,16840129,13572547,11048991,7111135,5884604,72060705,7483109,16377618,23860727,17188292,16899615,14050103,11840947,8027722,7679269,75685948,147746653,196353492,196353492
Brazil,2011,BR,BRA,AMR,7707905,16797309,24505214,17540098,17077695,13768952,11314467,7400368,6069224,73170804,7408608,16210008,23618616,17113861,17110208,14241216,12118840,8369524,7937024,76890673,150061477,198185302,198185302
Brazil,2012,BR,BRA,AMR,7646091,16608044,24254135,17486666,17273323,13998040,11553592,7699365,6261768,74272754,7347570,16019542,23367112,17049269,17277689,14464180,12367409,8712792,8212372,78083711,152356465,199977707,199977707
Brazil,2013,BR,BRA,AMR,7592581,16394631,23987212,17445577,17421461,14261267,11764703,7998205,6476962,75368175,7294815,15806004,23100819,16996361,17396547,14720465,12584734,9054509,8512938,79265554,154633729,201721767,201721767
Brazil,2014,BR,BRA,AMR,7557556,16179483,23737039,17406081,17519081,14551551,11954510,8290126,6726799,76448148,7260130,15591205,22851335,16944584,17463192,15002064,12777476,9382806,8853010,80423132,156871280,203459650,203459650
Brazil,2015,BR,BRA,AMR,7543106,15981128,23524234,17355945,17565831,14857551,12130397,8577272,6997455,77484451,7245246,15393241,22638487,16882913,17479043,15297060,12955099,9701689,9225222,81541026,159025477,205188205,205188205
Brazil,2016,BR,BRA,AMR,7510121,15802161,23312282,17301967,17569237,15177290,12295342,8868378,7269893,78482107,7212692,15214986,22427678,16818485,17454412,15602735,13121863,10026339,9613674,82637508,161119615,206859578,206859578
Brazil,2017,BR,BRA,AMR,7473224,15640805,23114029,17238512,17535144,15504751,12454785,9164660,7555130,79452982,7176688,15054472,22231160,16745176,17394543,15911795,13281033,10356303,10017936,83706786,163159768,208504960,208504960
Brazil,2018,BR,BRA,AMR,7469455,15501539,22970994,17140129,17477827,15827117,12615280,9464292,7858805,80383450,7172580,14915775,22088355,16637940,17312588,16210672,13438509,10686634,10437446,84723789,165107239,210166592,210166592
Brazil,2019,BR,BRA,AMR,7445121,15386584,22831705,17017722,17418881,16139653,12777862,9758090,8175886,81288094,7148892,14801164,21950056,16506940,17230662,16495607,13596743,11008224,10874851,85713027,167001121,211782878,211782878
Brazil,2020,BR,BRA,AMR,7359265,15289229,22648494,16876265,17360340,16425922,12948042,10026911,8493317,82130797,7066450,14704018,21770468,16364138,17155519,16752485,13760649,11299527,11314232,86646550,168777347,213196304,213196304
Brazil,2021,BR,BRA,AMR,7264824,15183951,22448775,16703533,17300870,16660061,13128839,10253650,8795563,82842516,6975789,14599473,21575262,16196655,17085332,16958412,13936255,11543846,11739170,87459670,170302186,214326223,214326223
Brazil,2022,BR,BRA,AMR,7171418,15086740,22258158,16506311,17242801,16844473,13333065,10448789,9099431,83474870,6885774,14502932,21388706,16001742,17016920,17115392,14137564,11753685,12166465,88191768,171666638,215313498,215313498
Brazil,2023,BR,BRA,AMR,7048276,15030073,22078349,16291498,17200069,16990761,13586145,10640978,9453311,84162762,6766803,14446076,21212879,15784036,16960963,17231613,14386176,11957126,12648544,88968458,173131220,216422446,216422446
Brazil,2024,BR,BRA,AMR,6931787,14970738,21902525,16080662,17162980,17095241,13877759,10831614,9854253,84902509,6654055,14387461,21041516,15566674,16908780,17303247,14671243,12155479,13185329,89790752,174693261,217637297,217637297
Brazil,2025,BR,BRA,AMR,6851359,14870737,21722096,15887439,17115866,17151620,14185856,11011480,10270192,85622453,6575807,14290267,20866074,15367129,16848055,17326524,14970438,12340128,13740165,90592439,176214892,218803058,218803058
Brazil,2026,BR,BRA,AMR,6796159,14743434,21539593,15713303,17059406,17160929,14506142,11183538,10700689,86324007,6521971,14166997,20688968,15187122,16778608,17304531,15277946,12513930,14312436,91374573,177698580,219927144,219927144
Brazil,2027,BR,BRA,AMR,6746747,14613193,21359940,15556210,16988890,17128098,14831370,11350635,11143788,86998991,6473988,14040886,20514874,15024843,16695428,17242614,15586514,12679781,14899357,92128537,179127528,221002333,221002333
Brazil,2028,BR,BRA,AMR,6698343,14486375,21184718,15420982,16884843,17071708,15150658,11518457,11596199,87642847,6427130,13917791,20344921,14885164,16579650,17159100,15885098,12844226,15496827,92850065,180492912,222022547,222022547
Brazil,2029,BR,BRA,AMR,6648900,14345207,20994107,15309227,16756564,17011043,15458656,11688156,12052908,88276554,6379294,13780865,20160159,14769733,16439246,17073606,16168785,13008935,16098776,93559081,181835635,222989897,222989897
Brazil,2030,BR,BRA,AMR,6601128,14178773,20779901,15214183,16620059,16955890,15744271,11869618,12506752,88910773,6333085,13619793,19952878,14671818,16289254,16995523,16427663,13184699,16696460,94265417,183176190,223908968,223908968
Brazil,1950,BR,BRA,AMR,4686931,6970342,11657273,5333317,3892011,2829837,1854765,1037591,596340,15543861,4584202,6706927,11291129,5560983,3837305,2655559,1720791,993656,694806,15463100,31006961,53955359,53955359
Brazil,1951,BR,BRA,AMR,4897271,7148718,12045989,5429623,4005108,2903288,1920336,1077657,621702,15957714,4806448,6868797,11675245,5663879,3976736,2738195,1782554,1032076,718657,15912097,31869811,55591058,55591058
Brazil,1952,BR,BRA,AMR,5113536,7332260,12445796,5535133,4124732,2974262,1984872,1121029,649569,16389597,5020136,7058658,12078794,5761674,4126478,2818980,1843861,1073409,744749,16369151,32758748,57283338,57283338
Brazil,1953,BR,BRA,AMR,5316238,7539121,12855359,5648809,4248388,3043425,2050602,1167499,678679,16837402,5219412,7277138,12496550,5855132,4285196,2899001,1907383,1117782,771870,16836364,33673766,59025679,59025679
Brazil,1954,BR,BRA,AMR,5495288,7781318,13276606,5775530,4371930,3112717,2119223,1215661,709212,17304273,5393779,7538069,12931848,5949946,4447023,2979304,1974503,1163989,800092,17314857,34619130,60827590,60827590
Brazil,1955,BR,BRA,AMR,5662934,8053342,13716276,5915549,4492508,3184509,2189907,1265630,741646,17789749,5555558,7837654,13393212,6048951,4605281,3061231,2044503,1211948,829885,17801799,35591548,62701031,62701031
Brazil,1956,BR,BRA,AMR,5835596,8339627,14175223,6067470,4608855,3261622,2261137,1317850,775867,18292801,5721564,8156564,13878128,6154349,4757115,3147932,2116180,1261979,861181,18298736,36591537,64644887,64644887
Brazil,1957,BR,BRA,AMR,6010746,8643292,14654038,6230665,4719511,3347685,2332830,1371753,811230,18813674,5890146,8494828,14384974,6269179,4899711,3243395,2189249,1313361,893319,18808214,37621888,66660892,66660892
Brazil,1958,BR,BRA,AMR,6188006,8964101,15152107,6400563,4821955,3442365,2405232,1427160,847290,19344565,6061578,8847766,14909344,6392204,5031377,3349614,2264498,1366190,926025,19329908,38674473,68735926,68735926
Brazil,1959,BR,BRA,AMR,6366622,9304919,15671541,6579260,4917923,3545130,2478150,1484532,884291,19889286,6234501,9219620,15454121,6529366,5148902,3465610,2341415,1420639,959935,19865867,39755153,70880820,70880820
Brazil,1960,BR,BRA,AMR,6545329,9664902,16210231,6764924,5012021,3653522,2550370,1543072,923958,20447867,6407523,9607085,16014608,6682690,5254598,3590295,2418913,1476030,997289,20419815,40867682,73092515,73092515
Brazil,1961,BR,BRA,AMR,6722783,10036507,16759290,6941054,5110143,3762613,2620578,1600986,968520,21003894,6580361,9981427,16561788,6848165,5361707,3724837,2497318,1532390,1040616,21005033,42008927,75330008,75330008
Brazil,1962,BR,BRA,AMR,6895991,10410367,17306358,7118663,5216063,3874443,2689243,1658096,1017995,21574503,6749343,10339520,17088863,7033459,5471488,3869506,2575936,1589610,1089507,21629506,43204009,77599218,77599218
Brazil,1963,BR,BRA,AMR,7060530,10775568,17836098,7320712,5331308,3990029,2757474,1716126,1070613,22186262,6909073,10690719,17599792,7246510,5580519,4021559,2654377,1648411,1142034,22293410,44479672,79915555,79915555
Brazil,1964,BR,BRA,AMR,7209202,11121403,18330605,7556489,5459016,4105202,2826147,1776456,1125067,22848377,7052836,11023799,18076635,7496543,5692589,4176791,2733695,1710249,1197308,23007175,45855552,82262794,82262794
Brazil,1965,BR,BRA,AMR,7332654,11458987,18791641,7817927,5598371,4217354,2896363,1838550,1181595,23550160,7171624,11349665,18521289,7775336,5808277,4331171,2815254,1775014,1255607,23760659,47310819,84623747,84623747
Brazil,1966,BR,BRA,AMR,7426258,11803231,19229489,8088949,5746146,4325019,2970046,1901216,1240421,24271797,7260818,11683657,18944475,8064808,5926617,4481924,2901474,1841767,1316928,24533518,48805315,86979283,86979283
Brazil,1967,BR,BRA,AMR,7489864,12149068,19638932,8371940,5901296,4427142,3050161,1964411,1300637,25015587,7320648,12020965,19341613,8365262,6048733,4626994,2995837,1910272,1380061,25327159,50342746,89323288,89323288
Brazil,1968,BR,BRA,AMR,7526723,12492196,20018919,8670774,6062174,4522975,3137887,2028554,1361940,25784304,7354549,12356673,19711222,8680410,6175687,4763215,3100102,1980795,1444597,26144806,51929110,91659246,91659246
Brazil,1969,BR,BRA,AMR,7551720,12823244,20374964,8987017,6229195,4613303,3231744,2093634,1424706,26579599,7376824,12680453,20057277,9012030,6310401,4888907,3213351,2053279,1510580,26988548,53568147,94000381,94000381
Brazil,2031,BR,BRA,AMR,6551329,14029613,20580942,15110576,16464345,16910404,15990986,12075820,12953883,89506014,6284785,13475472,19760257,14566934,16120202,16928126,16645166,13385390,17285220,94931038,184437052,224778256,224778256
Brazil,2032,BR,BRA,AMR,6499200,13888071,20387271,15014898,16284701,16870453,16195659,12310390,13392181,90068282,6234173,13338412,19572585,14470729,15928033,16867092,16818215,13615088,17862247,95561404,185629686,225589538,225589538
Brazil,2033,BR,BRA,AMR,6449930,13717939,20167869,14959796,16081659,16840296,16354316,12574830,13820336,90631233,6186496,13173640,19360136,14414399,15713161,16816316,16943157,13875735,18425407,96188175,186819408,226347402,226347402
Brazil,2034,BR,BRA,AMR,6402867,13553150,19956017,14902161,15877547,16810735,16465265,12863301,14243437,91162446,6141152,13013852,19155004,14356391,15497747,16766953,17018033,14160564,18980168,96779856,187942302,227053318,227053318
Brazil,2035,BR,BRA,AMR,6354340,13425974,19780314,14804003,15690796,16771244,16530123,13167631,14668944,91632741,6094389,12890095,18984484,14259911,15300029,16709015,17045377,14459147,19534381,97307860,188940601,227705396,227705396
Brazil,2036,BR,BRA,AMR,6304816,13321896,19626712,14678646,15522846,16722461,16549841,13483804,15098930,92056528,6046667,12788584,18835251,14137436,15121721,16642313,17028215,14765851,20090018,97785554,189842082,228304039,228304039
Brazil,2037,BR,BRA,AMR,6257810,13221230,19479040,14550336,15371617,16659691,16529103,13804966,15533931,92449644,6001504,12690568,18692072,14012141,14961004,16561854,16971789,15073623,20647192,98227603,190677247,228848367,228848367
Brazil,2038,BR,BRA,AMR,6208407,13124390,19332797,14425386,15241831,16563846,16485847,14120930,15976114,92813954,5953951,12596587,18550538,13889857,14822734,16448937,16894149,15371747,21207976,98635400,191449354,229332682,229332682
Brazil,2039,BR,BRA,AMR,6157337,13028698,19186035,14286189,15135265,16444217,16438682,14426350,16421964,93152667,5904653,12503929,18408582,13753794,14708658,16311593,16814628,15655296,21768496,99012465,192165132,229759755,229759755
Brazil,2040,BR,BRA,AMR,6106668,12933189,19039857,14121940,15045410,16316671,16397042,14710847,16874519,93466429,5855768,12411459,18267227,13593677,14612209,16164862,16742474,15914626,22330929,99358777,192825206,230132293,230132293
Brazil,2041,BR,BRA,AMR,6053047,12834649,18887696,13974873,14947108,16170407,16364877,14959226,17342674,93759165,5803942,12315942,18119884,13450287,14508958,15999360,16680876,16133814,22904452,99677747,193436912,230444491,230444491
Brazil,2042,BR,BRA,AMR,5995671,12736296,18731967,13835367,14856639,16000670,16338100,15168575,17827972,94027323,5748422,12220669,17969091,13314136,14414447,15811005,16625562,16309958,23491317,99966425,193993748,230694805,230694805
Brazil,2043,BR,BRA,AMR,5938515,12638376,18576891,13667451,14806309,15807870,16320695,15335067,18330876,94268268,5693196,12125932,17819128,13150343,14359692,15600134,16580301,16439497,24092191,100222158,194490426,230886445,230886445
Brazil,2044,BR,BRA,AMR,5884054,12540975,18425029,13504834,14753320,15613845,16303545,15457057,18851063,94483664,5640437,12031756,17672193,12991502,14303205,15388659,16536251,16520462,24706450,100446529,194930193,231027408,231027408
Brazil,2045,BR,BRA,AMR,5833450,12442493,18275943,13379544,14659993,15436673,16276344,15536046,19388035,94676635,5591274,11936560,17527834,12868571,14208317,15194665,16483503,16555285,25331747,100642088,195318723,231122502,231122502
Brazil,2046,BR,BRA,AMR,5787849,12340043,18127892,13277169,14539579,15277791,16239679,15572925,19940671,94847814,5547018,11837450,17384468,12767800,14087464,15019864,16421875,16546922,25965133,100809058,195656872,231169239,231169239
Brazil,2047,BR,BRA,AMR,5747900,12236336,17984236,13178127,14416120,15135107,16188949,15572008,20504066,94994377,5508234,11737190,17245424,12670504,13963757,14862425,16346421,16500432,26601319,100944858,195939235,231168894,231168894
Brazil,2048,BR,BRA,AMR,5713371,12130433,17843804,13082847,14295864,15013219,16105637,15550234,21071199,95119000,5474732,11634819,17109551,12577201,13843002,14727143,16238700,16433389,27232647,101052082,196171082,231124440,231124440
Brazil,2049,BR,BRA,AMR,5677562,12025530,17703092,12988663,14161429,14914063,15999042,15525143,21634584,95222924,5440213,11533155,16973368,12485194,13708495,14615843,16106793,16364609,27851319,101132253,196355177,231031649,231031649
Brazil,2050,BR,BRA,AMR,5635292,11924857,17560149,12894625,14002110,14831336,15884742,15505454,22187639,95305906,5399458,11435484,16834942,12393363,13550009,14522051,15965605,16303003,28450693,101184724,196490630,230885725,230885725
Barbados,1970,BB,BRB,AMR,13186,31414,44600,22539,11348,11297,11046,9274,6765,72269,12878,31148,44026,22164,11638,12335,11484,10705,12169,80495,152764,241397,241397
Barbados,1971,BB,BRB,AMR,12703,31178,43881,23386,11591,11266,10754,9526,7098,73621,12411,30869,43280,23084,11799,12128,11354,10750,12448,81563,155184,242350,242350
Barbados,1972,BB,BRB,AMR,12300,30760,43060,24229,12023,11167,10427,9789,7429,75064,12030,30426,42456,24041,12180,11891,11266,10811,12677,82866,157930,243458,243458
Barbados,1973,BB,BRB,AMR,11989,30188,42177,25066,12660,10974,10127,10035,7754,76616,11732,29825,41557,24979,12754,11591,11227,10869,12869,84289,160905,244643,244643
Barbados,1974,BB,BRB,AMR,11762,29469,41231,25941,13389,10710,9909,10205,8080,78234,11516,29087,40603,25925,13450,11239,11218,10875,13077,85784,164018,245851,245851
Barbados,1975,BB,BRB,AMR,11603,28623,40226,26782,14223,10426,9800,10274,8411,79916,11361,28236,39597,26815,14267,10903,11227,10823,13317,87352,167268,247090,247090
Barbados,1976,BB,BRB,AMR,11493,27694,39187,27504,15204,10151,9802,10248,8744,81653,11246,27313,38559,27573,15231,10615,11249,10713,13579,88960,170613,248359,248359
Barbados,1977,BB,BRB,AMR,11415,26778,38193,28113,16223,9905,9919,10128,9082,83370,11165,26402,37567,28198,16259,10402,11271,10546,13863,90539,173909,249663,249663
Barbados,1978,BB,BRB,AMR,11382,25918,37300,28560,17253,9734,10092,9934,9425,84998,11127,25557,36684,28637,17314,10284,11282,10348,14164,92029,177027,251009,251009
Barbados,1979,BB,BRB,AMR,11391,25139,36530,28804,18268,9690,10228,9706,9784,86480,11132,24796,35928,28859,18386,10272,11253,10178,14451,93399,179879,252334,252334
Barbados,1980,BB,BRB,AMR,11378,24480,35858,28717,19256,9855,10226,9474,10189,87717,11105,24130,35235,28764,19463,10477,11172,10108,14779,94763,182480,253575,253575
Barbados,1981,BB,BRB,AMR,11304,23966,35270,28329,20184,10249,10094,9227,10618,88701,11027,23582,34609,28375,20503,10916,11049,10126,15133,96102,184803,254684,254684
Barbados,1982,BB,BRB,AMR,11214,23581,34795,27783,20997,10817,9908,8967,11034,89506,10942,23158,34100,27814,21458,11478,10895,10174,15432,97251,186757,255642,255642
Barbados,1983,BB,BRB,AMR,11104,23309,34413,27123,21704,11524,9677,8724,11391,90143,10854,22855,33709,27115,22299,12164,10716,10233,15719,98246,188389,256505,256505
Barbados,1984,BB,BRB,AMR,10993,23100,34093,26393,22344,12279,9431,8547,11660,90654,10776,22633,33409,26327,23051,12920,10539,10288,15990,99115,189769,257279,257279
Barbados,1985,BB,BRB,AMR,10880,22904,33784,25658,22874,13068,9223,8431,11840,91094,10712,22430,33142,25520,23676,13737,10410,10327,16227,99897,190991,257911,257911
Barbados,1986,BB,BRB,AMR,10735,22692,33427,24993,23241,13899,9066,8348,11922,91469,10612,22212,32824,24786,24123,14605,10362,10331,16434,100641,192110,258370,258370
Barbados,1987,BB,BRB,AMR,10559,22438,32997,24452,23475,14710,9003,8262,11931,91833,10465,21972,32437,24186,24400,15453,10423,10285,16630,101377,193210,258654,258654
Barbados,1988,BB,BRB,AMR,10351,22151,32502,24060,23545,15485,9074,8124,11891,92179,10247,21727,31974,23721,24499,16276,10605,10194,16807,102102,194281,258762,258762
Barbados,1989,BB,BRB,AMR,10150,21843,31993,23781,23460,16196,9297,7927,11835,92496,9999,21498,31497,23351,24423,17062,10890,10082,16965,102773,195269,258759,258759
Barbados,1990,BB,BRB,AMR,10020,21504,31524,23468,23374,16888,9649,7811,11784,92974,9807,21225,31032,22951,24314,17846,11183,10005,17039,103338,196312,258868,258868
Barbados,1991,BB,BRB,AMR,9983,21134,31117,23086,23341,17563,10078,7854,11741,93663,9724,20897,30621,22555,24236,18641,11482,10023,17060,103997,197660,259402,259402
Barbados,1992,BB,BRB,AMR,10014,20796,30810,22709,23236,18161,10551,7969,11687,94313,9726,20590,30316,22240,24077,19404,11832,10103,17102,104758,199071,260212,260212
Barbados,1993,BB,BRB,AMR,10060,20520,30580,22315,23045,18704,11062,8085,11653,94864,9773,20312,30085,21946,23811,20088,12265,10179,17171,105460,200324,260995,260995
Barbados,1994,BB,BRB,AMR,10036,20338,30374,21916,22761,19222,11621,8172,11659,95351,9784,20109,29893,21632,23464,20702,12802,10214,17280,106094,201445,261712,261712
Barbados,1995,BB,BRB,AMR,9907,20282,30189,21463,22421,19721,12212,8237,11699,95753,9696,20037,29733,21249,23094,21273,13414,10230,17369,106629,202382,262303,262303
Barbados,1996,BB,BRB,AMR,9704,20306,30010,20955,22128,20172,12832,8280,11746,96113,9529,20050,29579,20806,22750,21819,14048,10274,17397,107094,203207,262793,262793
Barbados,1997,BB,BRB,AMR,9487,20308,29795,20453,21887,20524,13480,8314,11810,96468,9339,20043,29382,20337,22507,22262,14721,10324,17425,107576,204044,263224,263224
Barbados,1998,BB,BRB,AMR,9337,20205,29542,20082,21599,20785,14111,8403,11890,96870,9188,19955,29143,19956,22254,22579,15405,10409,17476,108079,204949,263642,263642
Barbados,1999,BB,BRB,AMR,9324,20020,29344,19826,21234,20938,14752,8579,11973,97302,9146,19807,28953,19690,21859,22823,16104,10569,17523,108568,205870,264170,264170
Barbados,2000,BB,BRB,AMR,9369,19792,29161,19570,20839,20982,15405,8855,12053,97704,9156,19599,28755,19449,21417,22962,16844,10765,17601,109038,206742,264657,264657
Barbados,2001,BB,BRB,AMR,9414,19546,28960,19374,20504,20975,15974,9236,12130,98193,9152,19367,28519,19349,21057,22996,17599,10999,17706,109706,207899,265377,265377
Barbados,2002,BB,BRB,AMR,9465,19355,28820,19279,20204,20901,16484,9660,12253,98781,9154,19199,28353,19356,20823,22895,18297,11290,17837,110498,209279,266455,266455
Barbados,2003,BB,BRB,AMR,9469,19241,28710,19194,19937,20753,16951,10129,12360,99324,9132,19097,28229,19336,20682,22692,18884,11708,17922,111224,210548,267499,267499
Barbados,2004,BB,BRB,AMR,9390,19149,28539,19157,19727,20531,17394,10661,12435,99905,9064,19009,28073,19367,20549,22431,19419,12267,17953,111986,211891,268505,268505
Barbados,2005,BB,BRB,AMR,9268,19023,28291,19209,19458,20253,17871,11202,12541,100534,8986,18848,27834,19489,20357,22134,19983,12873,17980,112816,213350,269477,269477
Barbados,2006,BB,BRB,AMR,9142,18873,28015,19310,19114,20062,18329,11741,12620,101176,8909,18644,27553,19609,20134,21891,20559,13461,18025,113679,214855,270425,270425
Barbados,2007,BB,BRB,AMR,9071,18754,27825,19305,18820,19949,18678,12297,12723,101772,8851,18481,27332,19579,19958,21765,21034,14069,18112,114517,216289,271444,271444
Barbados,2008,BB,BRB,AMR,9128,18725,27853,19113,18672,19795,18926,12834,12914,102254,8890,18383,27273,19376,19893,21647,21375,14661,18305,115257,217511,272635,272635
Barbados,2009,BB,BRB,AMR,9197,18773,27970,18825,18597,19578,19065,13370,13191,102626,8924,18377,27301,19123,19863,21442,21653,15215,18602,115898,218524,273791,273791
Barbados,2010,BB,BRB,AMR,9159,18802,27961,18594,18537,19415,19125,13941,13468,103080,8830,18396,27226,18911,19767,21202,21836,15864,18869,116449,219529,274711,274711
Barbados,2011,BB,BRB,AMR,9048,18779,27827,18480,18504,19264,19191,14478,13753,103670,8672,18348,27020,18760,19663,20956,21910,16588,19089,116966,220636,275486,275486
Barbados,2012,BB,BRB,AMR,8835,18781,27616,18473,18447,19090,19218,14965,14105,104298,8471,18285,26756,18705,19540,20731,21905,17241,19402,117524,221822,276197,276197
Barbados,2013,BB,BRB,AMR,8489,18848,27337,18547,18365,18950,19199,15393,14506,104960,8176,18272,26448,18734,19366,20574,21848,17782,19812,118116,223076,276865,276865
Barbados,2014,BB,BRB,AMR,8169,18816,26985,18614,18339,18826,19147,15813,14941,105680,7896,18213,26109,18731,19266,20434,21691,18296,20296,118714,224394,277493,277493
Barbados,2015,BB,BRB,AMR,7995,18571,26566,18645,18423,18645,19036,16290,15404,106443,7732,17991,25723,18654,19285,20246,21460,18867,20843,119355,225798,278083,278083
Barbados,2016,BB,BRB,AMR,7885,18238,26123,18635,18580,18396,18960,16770,15865,107206,7628,17687,25315,18544,19333,20004,21276,19458,21385,120000,227206,278649,278649
Barbados,2017,BB,BRB,AMR,7800,17924,25724,18583,18664,18192,18962,17155,16373,107929,7549,17387,24936,18423,19271,19802,21181,19954,21979,120610,228539,279187,279187
Barbados,2018,BB,BRB,AMR,7738,17628,25366,18576,18564,18113,18919,17454,16943,108569,7492,17101,24593,18335,19080,19687,21082,20330,22645,121159,229728,279688,279688
Barbados,2019,BB,BRB,AMR,7699,17356,25055,18613,18382,18092,18813,17675,17589,109164,7455,16816,24271,18312,18875,19575,20894,20647,23383,121686,230850,280180,280180
Barbados,2020,BB,BRB,AMR,7677,17121,24798,18638,18215,18071,18701,17791,18318,109734,7433,16535,23968,18315,18700,19439,20669,20853,24227,122203,231937,280693,280693
Barbados,2021,BB,BRB,AMR,7666,16902,24568,18627,18119,18043,18559,17864,19056,110268,7419,16272,23691,18274,18559,19342,20430,20932,25132,122669,232937,281200,281200
Barbados,2022,BB,BRB,AMR,7653,16605,24258,18633,18123,17992,18398,17893,19790,110829,7412,15994,23406,18209,18510,19222,20213,20938,26052,123144,233973,281635,281635
Barbados,2023,BB,BRB,AMR,7640,16196,23836,18697,18203,17913,18266,17881,20486,111446,7400,15641,23041,18200,18541,19052,20065,20883,26931,123672,235118,281995,281995
Barbados,2024,BB,BRB,AMR,7620,15838,23458,18667,18271,17889,18151,17837,21192,112007,7378,15325,22703,18136,18542,18955,19937,20739,27834,124143,236150,282309,282309
Barbados,2025,BB,BRB,AMR,7591,15636,23227,18418,18305,17980,17984,17745,21952,112384,7353,15140,22493,17914,18466,18978,19757,20530,28825,124470,236854,282580,282580
Barbados,2026,BB,BRB,AMR,7562,15516,23078,18084,18298,18143,17760,17688,22693,112666,7323,15021,22344,17609,18358,19036,19524,20363,29819,124709,237375,282797,282797
Barbados,2027,BB,BRB,AMR,7526,15422,22948,17765,18250,18231,17571,17703,23372,112892,7288,14933,22221,17305,18241,18981,19334,20285,30750,124896,237788,282962,282962
Barbados,2028,BB,BRB,AMR,7491,15348,22839,17471,18246,18139,17511,17678,24031,113076,7253,14861,22114,17022,18149,18801,19230,20209,31630,125041,238117,283071,283071
Barbados,2029,BB,BRB,AMR,7456,15282,22738,17203,18283,17968,17506,17597,24658,113215,7219,14802,22021,16735,18128,18603,19128,20038,32501,125133,238348,283112,283112
Barbados,2030,BB,BRB,AMR,7411,15235,22646,16968,18295,17801,17488,17506,25250,113308,7179,14754,21933,16454,18130,18431,19000,19835,33347,125197,238505,283082,283082
Barbados,1950,BB,BRB,AMR,14976,23604,38580,17298,14319,12312,8517,3725,2684,58855,14821,23353,38174,18171,15279,14210,11370,7581,8326,74937,133792,210548,210548
Barbados,1951,BB,BRB,AMR,15236,24409,39645,18040,14247,12706,8834,3921,2728,60476,15090,24143,39233,18640,15357,14367,11760,7565,8381,76070,136546,215430,215430
Barbados,1952,BB,BRB,AMR,15412,25088,40500,18612,14075,13091,9065,4153,2836,61832,15283,24805,40088,18992,15437,14539,12049,7518,8500,77035,138867,219469,219469
Barbados,1953,BB,BRB,AMR,15543,25670,41213,18975,13865,13436,9245,4427,2974,62922,15422,25376,40798,19187,15529,14688,12254,7493,8652,77803,140725,222730,222730
Barbados,1954,BB,BRB,AMR,15721,26074,41795,19142,13695,13662,9428,4740,3089,63756,15598,25812,41410,19245,15612,14754,12395,7559,8785,78350,142106,225309,225309
Barbados,1955,BB,BRB,AMR,15892,26362,42254,19161,13598,13746,9623,5086,3184,64398,15768,26150,41918,19218,15687,14727,12493,7733,8890,78748,143146,227320,227320
Barbados,1956,BB,BRB,AMR,16000,26578,42578,18992,13559,13679,9829,5458,3251,64768,15883,26419,42302,19093,15729,14603,12526,8026,8990,78967,143735,228615,228615
Barbados,1957,BB,BRB,AMR,16126,26712,42838,18689,13608,13474,10030,5860,3274,64935,16005,26614,42619,18912,15764,14394,12495,8427,9066,79058,143993,229458,229458
Barbados,1958,BB,BRB,AMR,16260,26861,43121,18389,13744,13176,10241,6271,3290,65111,16126,26817,42943,18770,15804,14141,12452,8872,9134,79173,144284,230350,230350
Barbados,1959,BB,BRB,AMR,16384,27044,43428,18152,13885,12834,10473,6641,3351,65336,16233,27051,43284,18673,15840,13915,12428,9279,9218,79353,144689,231404,231404
Barbados,1960,BB,BRB,AMR,16486,27266,43752,18003,13978,12479,10711,6943,3489,65603,16304,27317,43621,18628,15847,13750,12427,9616,9306,79574,145177,232550,232550
Barbados,1961,BB,BRB,AMR,16602,27668,44270,17924,13922,12113,10981,7215,3706,65861,16383,27736,44119,18508,15614,13567,12450,9898,9407,79444,145305,233698,233698
Barbados,1962,BB,BRB,AMR,16676,28235,44911,17973,13710,11739,11287,7447,4027,66183,16416,28299,44715,18369,15131,13371,12504,10121,9522,79018,145201,234829,234829
Barbados,1963,BB,BRB,AMR,16607,28804,45411,18208,13388,11377,11572,7645,4385,66575,16310,28858,45168,18409,14566,13212,12555,10287,9693,78722,145297,235875,235875
Barbados,1964,BB,BRB,AMR,16383,29443,45826,18530,12988,11107,11781,7846,4745,66997,16060,29468,45528,18576,13944,13082,12547,10412,9923,78484,145481,236834,236834
Barbados,1965,BB,BRB,AMR,15999,30068,46067,18962,12572,10950,11877,8065,5102,67528,15662,30059,45721,18883,13336,12965,12468,10514,10216,78382,145910,237694,237694
Barbados,1966,BB,BRB,AMR,15490,30592,46082,19562,12156,10909,11868,8289,5445,68229,15146,30547,45693,19363,12777,12860,12329,10583,10581,78493,146722,238494,238494
Barbados,1967,BB,BRB,AMR,14914,31028,45942,20223,11770,10993,11750,8522,5781,69039,14573,30936,45509,19937,12305,12759,12120,10613,11009,78743,147782,239238,239238
Barbados,1968,BB,BRB,AMR,14320,31327,45647,20941,11464,11138,11549,8766,6109,69967,13987,31181,45168,20590,11936,12647,11877,10634,11441,79125,149092,239905,239905
Barbados,1969,BB,BRB,AMR,13735,31462,45197,21709,11305,11256,11304,9016,6443,71033,13414,31254,44668,21332,11702,12510,11655,10663,11836,79698,150731,240594,240594
Barbados,2031,BB,BRB,AMR,7370,15189,22559,16748,18273,17698,17465,17386,25799,113369,7137,14712,21849,16192,18085,18286,18910,19622,34113,125208,238577,282986,282986
Barbados,2032,BB,BRB,AMR,7324,15144,22468,16453,18278,17703,17422,17251,26295,113402,7089,14667,21756,15914,18020,18245,18794,19427,34793,125193,238595,282815,282815
Barbados,2033,BB,BRB,AMR,7270,15098,22368,16046,18349,17788,17354,17142,26724,113403,7041,14620,21661,15562,18009,18277,18633,19295,35357,125133,238536,282567,282567
Barbados,2034,BB,BRB,AMR,7226,15038,22264,15692,18319,17862,17339,17048,27124,113384,6996,14568,21564,15244,17950,18276,18547,19182,35839,125038,238422,282255,282255
Barbados,2035,BB,BRB,AMR,7177,14971,22148,15494,18076,17903,17431,16905,27526,113335,6950,14505,21455,15061,17730,18209,18576,19021,36328,124925,238260,281861,281861
Barbados,2036,BB,BRB,AMR,7124,14897,22021,15375,17747,17902,17595,16708,27936,113263,6899,14432,21331,14943,17430,18106,18638,18812,36844,124773,238036,281387,281387
Barbados,2037,BB,BRB,AMR,7079,14815,21894,15283,17434,17859,17691,16548,28356,113171,6852,14350,21202,14859,17128,17991,18591,18637,37375,124581,237752,280849,280849
Barbados,2038,BB,BRB,AMR,7030,14730,21760,15207,17148,17863,17610,16510,28707,113045,6806,14267,21073,14785,16847,17908,18418,18551,37842,124351,237396,280235,280235
Barbados,2039,BB,BRB,AMR,6975,14651,21626,15147,16882,17904,17453,16524,28992,112902,6752,14186,20938,14728,16565,17891,18233,18464,38200,124081,236983,279540,279540
Barbados,2040,BB,BRB,AMR,6919,14558,21477,15100,16649,17919,17299,16524,29234,112725,6698,14097,20795,14681,16283,17893,18068,18350,38492,123767,236492,278768,278768
Barbados,2041,BB,BRB,AMR,6858,14461,21319,15055,16432,17903,17207,16517,29419,112533,6640,14008,20648,14639,16023,17850,17937,18272,38703,123424,235957,277923,277923
Barbados,2042,BB,BRB,AMR,6785,14371,21156,15011,16142,17913,17221,16488,29544,112319,6568,13920,20488,14598,15748,17788,17898,18172,38834,123038,235357,277003,277003
Barbados,2043,BB,BRB,AMR,6709,14272,20981,14964,15745,17988,17308,16438,29639,112082,6493,13824,20317,14549,15401,17782,17934,18028,38932,122626,234708,276014,276014
Barbados,2044,BB,BRB,AMR,6632,14169,20801,14910,15396,17960,17387,16439,29746,111838,6419,13719,20138,14497,15085,17729,17945,17952,38983,122191,234029,274967,274967
Barbados,2045,BB,BRB,AMR,6551,14067,20618,14843,15200,17727,17436,16543,29811,111560,6342,13618,19960,14430,14902,17511,17879,17989,39001,121712,233272,273860,273860
Barbados,2046,BB,BRB,AMR,6470,13956,20426,14770,15084,17405,17446,16712,29857,111274,6262,13511,19773,14359,14789,17217,17782,18060,39020,121227,232501,272705,272705
Barbados,2047,BB,BRB,AMR,6397,13834,20231,14689,14994,17103,17413,16820,29968,110987,6189,13399,19588,14281,14701,16922,17678,18024,39105,120711,231698,271515,271515
Barbados,2048,BB,BRB,AMR,6330,13710,20040,14606,14922,16821,17424,16760,30143,110676,6123,13275,19398,14200,14631,16642,17600,17868,39234,120175,230851,270291,270291
Barbados,2049,BB,BRB,AMR,6265,13582,19847,14524,14866,16561,17470,16625,30315,110361,6063,13146,19209,14118,14576,16364,17586,17696,39290,119630,229991,269048,269048
Barbados,2050,BB,BRB,AMR,6209,13444,19653,14436,14820,16338,17490,16493,30459,110036,6010,13013,19023,14031,14531,16091,17595,17546,39276,119070,229106,267788,267788
Brunei Darussalam,1970,BN,BRN,WPR,11481,18780,30261,15113,9873,7290,4819,2895,1821,41811,10825,17933,28758,12229,7627,5542,3352,2152,1607,32509,74320,133343,133343
Brunei Darussalam,1971,BN,BRN,WPR,11699,19464,31163,15879,10499,7585,5036,2959,1897,43855,11035,18495,29530,13036,7914,5814,3487,2211,1651,34113,77968,138666,138666
Brunei Darussalam,1972,BN,BRN,WPR,11908,20289,32197,16633,11051,7784,5216,3019,1991,45694,11226,19057,30283,13864,8214,6053,3600,2250,1725,35706,81400,143886,143886
Brunei Darussalam,1973,BN,BRN,WPR,12133,21040,33173,17495,11592,7931,5359,3078,2100,47555,11417,19535,30952,14743,8559,6266,3702,2280,1835,37385,84940,149065,149065
Brunei Darussalam,1974,BN,BRN,WPR,12385,21559,33944,18473,12220,8111,5492,3151,2204,49651,11626,19884,31510,15658,8998,6475,3815,2317,1938,39201,88852,154314,154314
Brunei Darussalam,1975,BN,BRN,WPR,12676,21866,34542,19556,12927,8326,5622,3244,2303,51978,11853,20131,31984,16585,9524,6674,3954,2368,2041,41146,93124,159653,159653
Brunei Darussalam,1976,BN,BRN,WPR,12992,22038,35030,20687,13717,8574,5746,3344,2402,54470,12079,20324,32403,17486,10130,6850,4132,2425,2138,43161,97631,165064,165064
Brunei Darussalam,1977,BN,BRN,WPR,13311,22143,35454,21778,14620,8864,5873,3446,2490,57071,12323,20504,32827,18294,10858,7002,4346,2479,2228,45207,102278,170560,170560
Brunei Darussalam,1978,BN,BRN,WPR,13638,22258,35896,22740,15652,9196,5996,3539,2577,59700,12615,20710,33325,18964,11724,7140,4581,2531,2320,47260,106960,176176,176176
Brunei Darussalam,1979,BN,BRN,WPR,14000,22463,36463,23492,16820,9583,6115,3623,2648,62281,12945,20976,33921,19462,12735,7273,4823,2587,2409,49289,111570,181951,181951
Brunei Darussalam,1980,BN,BRN,WPR,14413,22827,37240,23968,18113,10025,6248,3711,2708,64773,13303,21313,34616,19794,13854,7436,5058,2655,2494,51291,116064,187921,187921
Brunei Darussalam,1981,BN,BRN,WPR,14830,23407,38237,24190,19478,10519,6385,3807,2766,67145,13665,21747,35412,20046,14986,7681,5283,2737,2570,53303,120448,194099,194099
Brunei Darussalam,1982,BN,BRN,WPR,15189,24143,39332,24389,20805,11027,6529,3910,2825,69485,14001,22343,36344,20449,16043,8027,5485,2830,2630,55464,124949,200630,200630
Brunei Darussalam,1983,BN,BRN,WPR,15572,24844,40416,24682,22080,11572,6686,4008,2905,71933,14365,22977,37342,21000,17060,8470,5672,2936,2688,57826,129759,207523,207523
Brunei Darussalam,1984,BN,BRN,WPR,16044,25443,41487,24987,23362,12231,6852,4091,3010,74533,14827,23516,38343,21564,18103,8986,5844,3057,2759,60313,134846,214682,214682
Brunei Darussalam,1985,BN,BRN,WPR,16585,25993,42578,25284,24630,13005,7041,4164,3117,77241,15410,23965,39375,22128,19178,9551,6014,3202,2847,62920,140161,222119,222119
Brunei Darussalam,1986,BN,BRN,WPR,17191,26525,43716,25576,25836,13925,7258,4231,3221,80047,16074,24384,40458,22663,20246,10196,6180,3380,2928,65593,145640,229815,229815
Brunei Darussalam,1987,BN,BRN,WPR,17808,27116,44924,25828,26944,15011,7501,4287,3308,82879,16698,24931,41629,23131,21277,10960,6338,3574,2998,68278,151157,237712,237712
Brunei Darussalam,1988,BN,BRN,WPR,18334,27869,46203,26017,27945,16271,7768,4334,3372,85707,17185,25686,42871,23494,22263,11872,6487,3760,3070,70946,156653,245729,245729
Brunei Darussalam,1989,BN,BRN,WPR,18712,28820,47532,26127,28831,17697,8058,4371,3429,88513,17526,26620,44146,23754,23217,12940,6628,3931,3156,73626,162139,253821,253821
Brunei Darussalam,1990,BN,BRN,WPR,18940,29932,48872,26139,29659,19249,8387,4411,3474,91319,17722,27707,45429,23869,24170,14121,6806,4089,3251,76306,167625,261928,261928
Brunei Darussalam,1991,BN,BRN,WPR,19050,31283,50333,26041,30273,20758,8810,4488,3519,93889,17806,29001,46807,23856,24996,15323,7059,4251,3341,78826,172715,269860,269860
Brunei Darussalam,1992,BN,BRN,WPR,19123,32932,52055,26029,30373,21968,9347,4658,3578,95953,17848,30477,48325,23929,25445,16446,7393,4444,3430,81087,177040,277416,277416
Brunei Darussalam,1993,BN,BRN,WPR,19156,34613,53769,26276,30126,22923,9973,4881,3665,97844,17869,31922,49791,24209,25634,17471,7806,4657,3522,83299,181143,284713,284713
Brunei Darussalam,1994,BN,BRN,WPR,19125,36076,55201,26807,29833,23788,10667,5114,3781,99990,17849,33192,51041,24665,25777,18467,8275,4875,3647,85706,185696,291935,291935
Brunei Darussalam,1995,BN,BRN,WPR,19058,37264,56322,27630,29518,24574,11402,5357,3930,102411,17809,34259,52068,25316,25882,19422,8774,5087,3807,88288,190699,299097,299097
Brunei Darussalam,1996,BN,BRN,WPR,18974,38147,57121,28737,29239,25265,12174,5616,4085,105116,17759,35070,52829,26214,25988,20310,9334,5289,3996,91131,196247,306196,306196
Brunei Darussalam,1997,BN,BRN,WPR,18866,38725,57591,30104,29052,25842,12988,5887,4231,108104,17667,35598,53265,27364,26133,21096,9989,5468,4198,94248,202352,313215,313215
Brunei Darussalam,1998,BN,BRN,WPR,18757,39007,57764,31670,29003,26309,13846,6154,4388,111370,17544,35861,53405,28688,26360,21780,10749,5624,4407,97608,208978,320152,320152
Brunei Darussalam,1999,BN,BRN,WPR,18670,39043,57713,33320,29121,26679,14740,6412,4543,114815,17444,35926,53370,30068,26708,22376,11617,5751,4628,101148,215963,327045,327045
Brunei Darussalam,2000,BN,BRN,WPR,18618,38896,57514,34953,29431,26990,15647,6668,4709,118398,17372,35858,53230,31421,27164,22911,12545,5887,4851,104779,223177,333926,333926
Brunei Darussalam,2001,BN,BRN,WPR,18578,38621,57199,36511,29923,27284,16522,6950,4891,122081,17293,35701,52994,32708,27705,23435,13481,6070,5072,108471,230552,340748,340748
Brunei Darussalam,2002,BN,BRN,WPR,18504,38252,56756,37949,30587,27579,17344,7271,5085,125815,17242,35448,52690,33878,28335,23970,14391,6328,5301,112203,238018,347463,347463
Brunei Darussalam,2003,BN,BRN,WPR,18390,37837,56227,39177,31430,27885,18126,7629,5284,129531,17220,35135,52355,34870,29059,24545,15279,6652,5530,115935,245466,354045,354045
Brunei Darussalam,2004,BN,BRN,WPR,18222,37440,55662,40118,32462,28221,18882,8013,5499,133195,17130,34851,51981,35652,29863,25158,16151,7021,5779,119624,252819,360461,360461
Brunei Darussalam,2005,BN,BRN,WPR,17976,37133,55109,40725,33664,28625,19620,8418,5722,136774,16945,34641,51586,36206,30740,25823,17014,7418,6044,123245,260019,366717,366717
Brunei Darussalam,2006,BN,BRN,WPR,17695,36904,54599,41000,35006,29127,20314,8839,5947,140233,16731,34465,51196,36512,31703,26554,17842,7864,6309,126784,267017,372808,372808
Brunei Darussalam,2007,BN,BRN,WPR,17435,36696,54131,40972,36427,29763,20967,9280,6152,143561,16492,34319,50811,36594,32721,27370,18615,8388,6559,130247,273808,378748,378748
Brunei Darussalam,2008,BN,BRN,WPR,17236,36481,53717,40707,37866,30543,21593,9749,6321,146779,16241,34186,50427,36514,33754,28276,19335,9005,6767,133651,280430,384568,384568
Brunei Darussalam,2009,BN,BRN,WPR,17119,36243,53362,40255,39255,31470,22212,10249,6447,149888,16058,34000,50058,36314,34746,29282,20015,9709,6939,137005,286893,390311,390311
Brunei Darussalam,2010,BN,BRN,WPR,17096,35969,53065,39679,40564,32549,22851,10764,6534,152941,15994,33738,49732,36029,35661,30378,20694,10458,7091,140311,293252,396053,396053
Brunei Darussalam,2011,BN,BRN,WPR,17200,35690,52890,38957,41452,33505,23677,11501,6683,155775,16064,33456,49520,35647,36275,31282,21477,11291,7339,143311,299086,401506,401506
Brunei Darussalam,2012,BN,BRN,WPR,17413,35415,52828,38168,41920,34257,24641,12480,6938,158404,16237,33228,49465,35155,36594,31913,22375,12197,7703,145937,304341,406634,406634
Brunei Darussalam,2013,BN,BRN,WPR,17656,35157,52813,37428,42207,35005,25566,13500,7247,160953,16442,33042,49484,34632,36819,32459,23310,13105,8134,148459,309412,411702,411702
Brunei Darussalam,2014,BN,BRN,WPR,17870,34912,52782,36822,42250,35753,26460,14557,7626,163468,16621,32829,49450,34215,36891,32927,24270,14030,8623,150956,314424,416656,416656
Brunei Darussalam,2015,BN,BRN,WPR,17993,34677,52670,36420,42025,36494,27329,15630,8067,165965,16716,32612,49328,33953,36814,33329,25236,14977,9169,153478,319443,421437,421437
Brunei Darussalam,2016,BN,BRN,WPR,17997,34511,52508,36168,41555,37228,28180,16685,8588,168404,16690,32481,49171,33764,36588,33693,26180,15918,9773,155916,324320,425994,425994
Brunei Darussalam,2017,BN,BRN,WPR,17873,34469,52342,35969,40908,37926,29010,17715,9171,170699,16554,32411,48965,33635,36247,34034,27089,16822,10438,158265,328964,430276,430276
Brunei Darussalam,2018,BN,BRN,WPR,17645,34545,52190,35774,40141,38579,29816,18710,9809,172829,16319,32376,48695,33520,35847,34361,27958,17689,11183,160558,333387,434274,434274
Brunei Darussalam,2019,BN,BRN,WPR,17330,34691,52021,35557,39320,39183,30600,19677,10517,174854,16020,32411,48431,33351,35412,34685,28783,18518,11994,162743,337597,438048,438048
Brunei Darussalam,2020,BN,BRN,WPR,16970,34851,51821,35333,38500,39756,31367,20610,11289,176855,15689,32489,48178,33130,34972,35012,29561,19334,12860,164869,341724,441725,441725
Brunei Darussalam,2021,BN,BRN,WPR,16606,34990,51596,35111,37700,40294,32118,21520,12110,178853,15365,32564,47929,32906,34548,35346,30269,20161,13767,166997,345850,445373,445373
Brunei Darussalam,2022,BN,BRN,WPR,16266,35089,51355,34892,36957,40761,32856,22401,12985,180852,15069,32608,47677,32743,34090,35667,30888,21013,14721,169122,349974,449002,449002
Brunei Darussalam,2023,BN,BRN,WPR,15956,35111,51067,34700,36292,41068,33592,23249,13924,182825,14802,32588,47390,32629,33635,35909,31430,21901,15729,171233,354058,452524,452524
Brunei Darussalam,2024,BN,BRN,WPR,15678,35024,50702,34517,35766,41144,34332,24072,14945,184776,14566,32483,47049,32484,33302,36021,31902,22817,16807,173333,358109,455858,455858
Brunei Darussalam,2025,BN,BRN,WPR,15441,34804,50245,34333,35457,40970,35072,24883,16027,186742,14360,32262,46622,32324,33132,35984,32313,23739,17943,175435,362177,459045,459045
Brunei Darussalam,2026,BN,BRN,WPR,15240,34454,49694,34212,35307,40562,35813,25681,17149,188724,14186,31925,46111,32236,33051,35814,32699,24648,19129,177577,366301,462103,462103
Brunei Darussalam,2027,BN,BRN,WPR,15069,34007,49076,34204,35220,39995,36526,26466,18299,190710,14038,31503,45541,32205,33032,35548,33066,25527,20340,179718,370428,465048,465048
Brunei Darussalam,2028,BN,BRN,WPR,14924,33478,48402,34313,35138,39326,37204,27236,19476,192693,13911,31018,44929,32207,33037,35234,33427,26378,21588,181871,374564,467894,467894
Brunei Darussalam,2029,BN,BRN,WPR,14801,32901,47702,34484,35035,38609,37843,27996,20687,194654,13804,30494,44298,32266,32986,34892,33791,27192,22869,183996,378650,470649,470649
Brunei Darussalam,2030,BN,BRN,WPR,14690,32317,47007,34664,34900,37878,38445,28745,21926,196558,13708,29972,43680,32368,32862,34538,34153,27963,24197,186081,382639,473312,473312
Brunei Darussalam,1950,BN,BRN,WPR,3685,5572,9257,4483,3600,2824,2116,1426,1091,15540,3384,5147,8531,4169,3363,2659,2051,1459,1244,14945,30485,48269,48269
Brunei Darussalam,1951,BN,BRN,WPR,4150,5786,9936,4767,3856,2975,2205,1469,1112,16384,3852,5357,9209,4429,3556,2733,2101,1491,1255,15565,31949,51093,51093
Brunei Darussalam,1952,BN,BRN,WPR,4721,6061,10782,5057,4098,3127,2289,1504,1118,17193,4420,5637,10057,4663,3686,2755,2112,1521,1248,15985,33178,54022,54022
Brunei Darussalam,1953,BN,BRN,WPR,5345,6349,11694,5349,4357,3295,2380,1553,1126,18060,5034,5936,10970,4911,3836,2797,2102,1566,1236,16448,34508,57177,57177
Brunei Darussalam,1954,BN,BRN,WPR,6017,6681,12698,5637,4628,3484,2472,1611,1127,18959,5699,6266,11965,5177,4005,2859,2075,1624,1229,16969,35928,60591,60591
Brunei Darussalam,1955,BN,BRN,WPR,6663,7126,13789,5916,4909,3693,2574,1686,1128,19906,6337,6720,13057,5449,4194,2941,2036,1688,1202,17510,37416,64267,64267
Brunei Darussalam,1956,BN,BRN,WPR,7226,7742,14968,6190,5196,3921,2682,1774,1129,20892,6911,7332,14243,5724,4398,3043,2001,1750,1189,18105,38997,68204,68204
Brunei Darussalam,1957,BN,BRN,WPR,7733,8483,16216,6443,5491,4165,2803,1871,1130,21903,7458,8048,15506,5996,4633,3169,1974,1801,1172,18745,40648,72376,72376
Brunei Darussalam,1958,BN,BRN,WPR,8160,9360,17520,6662,5800,4424,2945,1970,1135,22936,7935,8877,16812,6255,4892,3317,1954,1830,1163,19411,42347,76689,76689
Brunei Darussalam,1959,BN,BRN,WPR,8477,10373,18850,6835,6121,4696,3109,2067,1151,23979,8279,9844,18123,6477,5177,3487,1958,1824,1167,20090,44069,81046,81046
Brunei Darussalam,1960,BN,BRN,WPR,8666,11516,20182,7023,6418,4955,3283,2152,1184,25015,8458,10912,19370,6672,5457,3661,2006,1781,1201,20778,45793,85346,85346
Brunei Darussalam,1961,BN,BRN,WPR,8828,12684,21512,7352,6664,5148,3437,2201,1244,26046,8553,11957,20510,6871,5693,3811,2131,1713,1270,21489,47535,89561,89561
Brunei Darussalam,1962,BN,BRN,WPR,9048,13767,22815,7840,6882,5317,3570,2241,1314,27164,8684,12914,21598,7124,5901,3948,2282,1663,1346,22264,49428,93837,93837
Brunei Darussalam,1963,BN,BRN,WPR,9334,14704,24038,8448,7112,5496,3695,2291,1382,28424,8894,13772,22666,7454,6112,4097,2432,1644,1406,23145,51569,98277,98277
Brunei Darussalam,1964,BN,BRN,WPR,9684,15490,25174,9194,7374,5698,3816,2357,1450,29889,9180,14512,23692,7884,6328,4249,2568,1655,1462,24146,54035,102904,102904
Brunei Darussalam,1965,BN,BRN,WPR,10058,16136,26194,10063,7673,5919,3947,2441,1513,31556,9505,15156,24661,8417,6551,4406,2694,1704,1505,25277,56833,107686,107686
Brunei Darussalam,1966,BN,BRN,WPR,10402,16708,27110,11034,8006,6152,4087,2532,1572,33383,9813,15757,25570,9045,6773,4581,2815,1784,1531,26529,59912,112597,112597
Brunei Darussalam,1967,BN,BRN,WPR,10704,17230,27934,12084,8378,6408,4244,2631,1639,35384,10088,16327,26415,9764,6978,4784,2940,1877,1551,27894,63278,117628,117628
Brunei Darussalam,1968,BN,BRN,WPR,10979,17721,28700,13164,8794,6681,4414,2732,1699,37484,10346,16873,27219,10556,7171,5017,3072,1978,1571,29365,66849,122764,122764
Brunei Darussalam,1969,BN,BRN,WPR,11237,18223,29460,14199,9284,6975,4609,2821,1757,39645,10593,17404,27997,11392,7376,5269,3208,2070,1588,30903,70548,128012,128012
Brunei Darussalam,2031,BN,BRN,WPR,14586,31764,46350,34815,34733,37137,39002,29477,23195,198359,13614,29483,43097,32451,32690,34165,34510,28660,25585,188061,386420,475868,475868
Brunei Darussalam,2032,BN,BRN,WPR,14487,31258,45745,34912,34537,36426,39478,30198,24499,200050,13529,29044,42573,32498,32547,33736,34845,29276,27050,189952,390002,478322,478322
Brunei Darussalam,2033,BN,BRN,WPR,14394,30806,45200,34941,34351,35779,39793,30926,25833,201623,13444,28657,42101,32484,32437,33290,35100,29824,28601,191736,393359,480655,480655
Brunei Darussalam,2034,BN,BRN,WPR,14304,30413,44717,34856,34176,35272,39884,31658,27208,203054,13363,28317,41680,32379,32296,32966,35225,30310,30228,193404,396458,482853,482853
Brunei Darussalam,2035,BN,BRN,WPR,14226,30066,44292,34639,33999,34977,39727,32391,28619,204352,13292,28015,41307,32161,32141,32808,35205,30737,31912,194964,399316,484918,484918
Brunei Darussalam,2036,BN,BRN,WPR,14164,29762,43926,34292,33883,34834,39350,33129,30039,205527,13235,27750,40985,31828,32057,32735,35050,31136,33595,196401,401928,486844,486844
Brunei Darussalam,2037,BN,BRN,WPR,14108,29494,43602,33849,33882,34754,38808,33837,31445,206575,13186,27517,40703,31409,32031,32720,34801,31521,35252,197734,404309,488611,488611
Brunei Darussalam,2038,BN,BRN,WPR,14058,29258,43316,33326,33996,34680,38175,34502,32824,207503,13141,27309,40450,30928,32031,32732,34500,31893,36877,198961,406464,490225,490225
Brunei Darussalam,2039,BN,BRN,WPR,14014,29048,43062,32754,34166,34582,37489,35128,34195,208314,13099,27124,40223,30404,32093,32684,34179,32263,38457,200080,408394,491692,491692
Brunei Darussalam,2040,BN,BRN,WPR,13965,28860,42825,32175,34349,34453,36786,35717,35560,209040,13057,26957,40014,29886,32195,32562,33836,32631,40014,201124,410164,493006,493006
Brunei Darussalam,2041,BN,BRN,WPR,13917,28696,42613,31623,34502,34293,36084,36262,36916,209680,13010,26810,39820,29402,32283,32395,33483,32995,41527,202085,411765,494191,494191
Brunei Darussalam,2042,BN,BRN,WPR,13872,28541,42413,31125,34604,34104,35410,36732,38258,210233,12969,26670,39639,28965,32332,32254,33071,33335,42997,202954,413187,495249,495249
Brunei Darussalam,2043,BN,BRN,WPR,13832,28399,42231,30677,34634,33923,34795,37052,39629,210710,12934,26541,39475,28579,32318,32150,32643,33598,44471,203759,414469,496172,496172
Brunei Darussalam,2044,BN,BRN,WPR,13789,28268,42057,30282,34552,33754,34317,37159,41033,211097,12897,26423,39320,28239,32217,32012,32338,33729,45940,204475,415572,496951,496951
Brunei Darussalam,2045,BN,BRN,WPR,13739,28142,41881,29940,34342,33586,34046,37040,42473,211427,12849,26311,39160,27942,32000,31863,32190,33727,47389,205111,416538,497572,497572
Brunei Darussalam,2046,BN,BRN,WPR,13674,28029,41703,29642,34004,33475,33922,36710,43910,211663,12788,26207,38995,27680,31671,31782,32123,33597,48818,205671,417334,498039,498039
Brunei Darussalam,2047,BN,BRN,WPR,13596,27928,41524,29379,33567,33483,33857,36233,45328,211847,12717,26115,38832,27449,31256,31760,32121,33374,50197,206157,418004,498353,498353
Brunei Darussalam,2048,BN,BRN,WPR,13502,27844,41346,29145,33048,33596,33795,35666,46696,211946,12628,26037,38665,27241,30778,31766,32140,33107,51536,206568,418514,498521,498521
Brunei Darussalam,2049,BN,BRN,WPR,13397,27758,41155,28937,32488,33776,33712,35053,48023,211989,12528,25959,38487,27058,30262,31833,32099,32811,52837,206900,418889,498529,498529
Brunei Darussalam,2050,BN,BRN,WPR,13283,27659,40942,28753,31918,33960,33594,34427,49320,211972,12423,25868,38291,26893,29746,31939,31986,32503,54107,207174,419146,498373,498373
Bhutan,1970,BT,BTN,SEA,25914,35499,61413,27906,26063,19153,11643,6251,3495,94511,25365,34843,60208,25918,21732,15520,10048,5929,3613,82760,177271,298894,298894
Bhutan,1971,BT,BTN,SEA,26829,36883,63712,28278,26975,19952,12182,6508,3635,97530,26236,36175,62411,26350,22473,16070,10413,6131,3746,85183,182713,308837,308837
Bhutan,1972,BT,BTN,SEA,27767,38338,66105,28676,27878,20765,12743,6783,3777,100622,27125,37575,64700,26814,23220,16641,10799,6343,3887,87704,188326,319128,319128
Bhutan,1973,BT,BTN,SEA,28725,39863,68588,29213,28672,21587,13336,7080,3932,103820,28034,39046,67080,27410,23878,17220,11206,6564,4030,90308,194128,329800,329800
Bhutan,1974,BT,BTN,SEA,29697,41464,71161,29880,29382,22411,13960,7390,4101,107124,28953,40581,69534,28124,24480,17803,11627,6804,4184,93022,200146,340842,340842
Bhutan,1975,BT,BTN,SEA,30690,43129,73819,30730,29957,23233,14608,7722,4273,110523,29896,42175,72071,28976,25005,18394,12065,7054,4354,95848,206371,352269,352269
Bhutan,1976,BT,BTN,SEA,31721,44854,76575,31784,30379,24059,15287,8079,4460,114048,30871,43824,74695,29986,25437,18999,12525,7320,4529,98796,212844,364119,364119
Bhutan,1977,BT,BTN,SEA,32779,46638,79417,32893,30806,24898,15987,8455,4664,117703,31875,45523,77398,31054,25882,19624,13002,7600,4716,101878,219581,376387,376387
Bhutan,1978,BT,BTN,SEA,33857,48472,82329,34062,31225,25750,16709,8857,4868,121471,32903,47277,80180,32185,26331,20274,13496,7897,4910,105093,226564,389072,389072
Bhutan,1979,BT,BTN,SEA,34958,50348,85306,35276,31621,26609,17442,9283,5093,125324,33949,49062,83011,33373,26775,20946,14002,8205,5120,108421,233745,402063,402063
Bhutan,1980,BT,BTN,SEA,36063,52264,88327,36527,31968,27473,18178,9728,5328,129202,35001,50884,85885,34607,27205,21644,14517,8531,5338,111842,241044,415257,415257
Bhutan,1981,BT,BTN,SEA,37151,54233,91384,37817,32277,28331,18919,10190,5569,133103,36036,52754,88790,35896,27620,22357,15048,8872,5570,115363,248466,428641,428641
Bhutan,1982,BT,BTN,SEA,38216,56254,94470,39148,32561,29157,19666,10677,5834,137043,37052,54673,91725,37229,28040,23070,15586,9224,5808,118957,256000,442201,442201
Bhutan,1983,BT,BTN,SEA,39251,58324,97575,40548,32949,29871,20420,11185,6101,141074,38044,56635,94679,38633,28568,23696,16138,9597,6065,122697,263771,456033,456033
Bhutan,1984,BT,BTN,SEA,40262,60434,100696,42034,33445,30494,21171,11715,6387,145246,39006,58642,97648,40106,29197,24256,16690,9982,6334,126565,271811,470165,470165
Bhutan,1985,BT,BTN,SEA,41245,62572,103817,43582,34091,30973,21916,12269,6698,149529,39933,60684,100617,41638,29945,24741,17246,10383,6613,130566,280095,484528,484528
Bhutan,1986,BT,BTN,SEA,42207,64735,106942,45193,34895,31297,22658,12840,7022,153905,40842,62748,103590,43226,30830,25135,17814,10800,6906,134711,288616,499151,499151
Bhutan,1987,BT,BTN,SEA,43152,66910,110062,46861,35742,31601,23405,13430,7370,158409,41732,64826,106558,44872,31762,25527,18394,11228,7210,138993,297402,514026,514026
Bhutan,1988,BT,BTN,SEA,44060,69086,113146,48577,36618,31874,24154,14039,7731,162993,42590,66906,109496,46559,32738,25913,18992,11674,7543,143419,306412,529051,529051
Bhutan,1989,BT,BTN,SEA,44926,71261,116187,50326,37534,32113,24913,14658,8112,167656,43404,68986,112390,48285,33767,26292,19614,12132,7881,147971,315627,544209,544209
Bhutan,1990,BT,BTN,SEA,45674,73336,119010,51972,38351,32240,25636,15259,8504,171962,44105,70976,115081,49954,34767,26608,20233,12584,8236,152382,324344,558442,558442
Bhutan,1991,BT,BTN,SEA,45938,74782,120720,53163,38808,32034,26132,15733,8840,174710,44335,72363,116698,51218,35489,26684,20702,12947,8541,155581,330291,567710,567710
Bhutan,1992,BT,BTN,SEA,43583,72089,115672,51528,37214,30101,25175,15353,8706,168077,42029,69743,111772,49734,34333,25330,20032,12603,8385,150417,318494,545944,545944
Bhutan,1993,BT,BTN,SEA,40889,68874,109763,49635,35476,28133,23956,14868,8532,160600,39406,66623,106029,47971,33014,23944,19148,12183,8187,144447,305047,520838,520838
Bhutan,1994,BT,BTN,SEA,40173,68959,109132,50175,35570,27732,23842,15070,8765,161154,38701,66685,105386,48536,33339,23857,19144,12340,8374,145590,306744,521260,521260
Bhutan,1995,BT,BTN,SEA,39798,69753,109551,51326,36144,27789,23888,15438,9107,163692,38328,67433,105761,49679,34098,24146,19299,12631,8673,148526,312218,527536,527536
Bhutan,1996,BT,BTN,SEA,39576,70960,110536,52885,37051,28192,23998,15915,9542,167583,38105,68576,106681,51209,35160,24729,19520,13023,9047,152688,320271,537494,537494
Bhutan,1997,BT,BTN,SEA,39152,72006,111158,54446,38020,28592,24098,16391,9984,171531,37689,69560,107249,52733,36258,25324,19750,13423,9435,156923,328454,546865,546865
Bhutan,1998,BT,BTN,SEA,38643,73056,111699,56162,39179,29112,24235,16910,10468,176066,37194,70547,107741,54382,37502,26016,20016,13860,9857,161633,337699,557143,557143
Bhutan,1999,BT,BTN,SEA,38101,74716,112817,59177,40946,29973,24275,17349,11159,182879,36613,71974,108587,56164,38742,26816,20221,14297,10461,166701,349580,570990,570990
Bhutan,2000,BT,BTN,SEA,37528,76596,114124,63410,43271,31139,24250,17604,12036,191710,35921,73618,109539,58033,39881,27642,20375,14653,11250,171834,363544,587207,587207
Bhutan,2001,BT,BTN,SEA,36944,77875,114819,67713,45855,32442,24410,17736,12917,201073,35189,74910,110099,60073,41070,28470,20638,14927,12060,177238,378311,603234,603234
Bhutan,2002,BT,BTN,SEA,36346,78640,114986,71868,48783,33882,24797,17748,13792,210870,34461,75740,110201,62320,42333,29300,21037,15110,12886,182986,393856,619048,619048
Bhutan,2003,BT,BTN,SEA,35794,78909,114703,75661,52136,35484,25437,17634,14656,221008,33829,75922,109751,64840,43690,30131,21584,15196,13720,189161,410169,634627,634627
Bhutan,2004,BT,BTN,SEA,35258,78758,114016,78978,55965,37258,26300,17444,15480,231425,33317,75421,108738,67660,45166,30977,22240,15213,14552,195808,427233,649991,649991
Bhutan,2005,BT,BTN,SEA,34872,78340,113212,81143,59529,38884,27223,17430,16141,240350,33073,74323,107396,70261,46744,31829,22947,15326,15263,202370,442720,663323,663323
Bhutan,2006,BT,BTN,SEA,34818,77644,112462,81998,62089,40076,28008,17756,16604,246531,33184,72865,106049,72050,48394,32705,23644,15639,15794,208226,454757,673260,673260
Bhutan,2007,BT,BTN,SEA,34872,76621,111493,82595,64118,41083,28667,18266,17007,251736,33351,71405,104756,73265,50107,33605,24306,16080,16262,213625,465361,681614,681614
Bhutan,2008,BT,BTN,SEA,34791,75487,110278,83374,66051,42117,29293,18821,17449,257105,33301,70195,103496,74173,51892,34518,24950,16564,16760,218857,475962,689737,689737
Bhutan,2009,BT,BTN,SEA,34539,74485,109024,84160,67877,43168,29908,19402,17928,262443,32986,69344,102330,74756,53725,35443,25567,17101,17289,223881,486324,697678,697678
Bhutan,2010,BT,BTN,SEA,34142,73676,107818,84872,69591,44261,30520,20023,18441,267708,32458,68832,101290,75014,55590,36393,26161,17708,17836,228702,496410,705516,705516
Bhutan,2011,BT,BTN,SEA,33719,72969,106688,85448,71201,45442,31152,20670,18973,272886,31894,68539,100433,74914,57461,37387,26766,18385,18405,233318,506204,713331,713331
Bhutan,2012,BT,BTN,SEA,33429,72303,105732,85735,72759,46742,31828,21322,19525,277911,31475,68319,99794,74415,59333,38457,27424,19095,18982,237706,515617,721145,721145
Bhutan,2013,BT,BTN,SEA,33235,71707,104942,85584,74368,48181,32561,21946,20100,282740,31204,68102,99306,73532,61197,39658,28145,19803,19571,241906,524646,728889,728889
Bhutan,2014,BT,BTN,SEA,32962,71186,104148,84994,76146,49741,33323,22512,20702,287418,30918,67790,98708,72461,63015,41028,28906,20487,20190,246087,533505,736357,736357
Bhutan,2015,BT,BTN,SEA,32412,70727,103139,84010,78182,51381,34109,23017,21342,292041,30395,67346,97741,71461,64701,42531,29660,21149,20843,250345,542386,743274,743274
Bhutan,2016,BT,BTN,SEA,31648,70330,101978,82711,80528,53039,34884,23458,22032,296652,29618,66788,96406,70680,66225,44121,30365,21780,21551,254722,551374,749761,749761
Bhutan,2017,BT,BTN,SEA,30690,69781,100471,81016,83024,55102,35830,23949,22446,301367,28732,66035,94767,70229,67825,45941,31106,22377,22039,259517,560884,756121,756121
Bhutan,2018,BT,BTN,SEA,29470,68955,98425,79133,85316,57622,36984,24544,22605,306204,27700,65052,92752,70063,69432,48003,31930,22933,22350,264711,570915,762096,762096
Bhutan,2019,BT,BTN,SEA,28162,67907,96069,77440,87150,60226,38177,25174,22858,311025,26552,63896,90448,69999,70718,50139,32801,23447,22803,269907,580932,767459,767459
Bhutan,2020,BT,BTN,SEA,27022,66614,93636,75978,88323,62927,39457,25869,23219,315773,25577,62529,88106,69942,71611,52341,33750,23965,23384,274993,590766,772506,772506
Bhutan,2021,BT,BTN,SEA,25999,65345,91344,74702,88732,65704,40886,26646,23654,320324,24794,61150,85944,69819,72072,54566,34812,24549,24054,279872,600196,777486,777486
Bhutan,2022,BT,BTN,SEA,25071,64172,89243,73578,88422,68510,42487,27523,24164,324684,24034,59980,84014,69556,72134,56786,36029,25235,24767,284507,609191,782455,782455
Bhutan,2023,BT,BTN,SEA,24477,62813,87290,72578,87499,71317,44314,28472,24718,328898,23469,58811,82280,69097,71868,59001,37472,26011,25496,288945,617843,787424,787424
Bhutan,2024,BT,BTN,SEA,24225,61166,85391,71698,86129,74101,46371,29468,25301,333068,23230,57412,80642,68464,71416,61205,39137,26833,26228,293283,626351,792382,792382
Bhutan,2025,BT,BTN,SEA,24160,59326,83486,70935,84427,76827,48610,30503,25909,337211,23171,55856,79027,67711,70928,63351,40968,27651,26986,297595,634806,797335,797335
Bhutan,2026,BT,BTN,SEA,24136,57426,81562,70245,82530,79511,50962,31557,26575,341380,23152,54249,77401,66883,70504,65398,42885,28446,27800,301916,643296,802260,802260
Bhutan,2027,BT,BTN,SEA,24137,55524,79661,69552,80594,82069,53361,32616,27292,345484,23154,52612,75766,66013,70206,67268,44858,29230,28649,306224,651708,807152,807152
Bhutan,2028,BT,BTN,SEA,24149,53732,77881,68744,78751,84348,55826,33710,28077,349456,23166,51034,74200,65045,70060,68874,46892,30044,29545,310460,659916,811997,811997
Bhutan,2029,BT,BTN,SEA,24164,52188,76352,67713,77099,86174,58371,34837,28935,353129,23178,49663,72841,63902,70008,70163,49002,30901,30475,314451,667580,816780,816780
Bhutan,2030,BT,BTN,SEA,24170,51004,75174,66436,75664,87343,61005,36060,29910,356418,23183,48641,71824,62546,69969,71062,51173,31835,31496,318081,674499,821498,821498
Bhutan,1950,BT,BTN,SEA,15839,23570,39409,17529,12725,8993,6048,3673,2178,51146,15188,22200,37388,16359,11941,8433,5771,3644,2270,48418,99564,176367,176367
Bhutan,1951,BT,BTN,SEA,15553,24200,39753,18083,13190,9248,6177,3728,2207,52633,15047,22804,37851,16792,12276,8640,5894,3703,2298,49603,102236,179833,179833
Bhutan,1952,BT,BTN,SEA,15330,24837,40167,18646,13679,9522,6310,3788,2231,54176,14950,23417,38367,17234,12624,8856,6022,3763,2329,50828,105004,183545,183545
Bhutan,1953,BT,BTN,SEA,15270,25365,40635,19209,14198,9816,6460,3849,2262,55794,15000,23939,38939,17689,12989,9087,6156,3829,2364,52114,107908,187481,187481
Bhutan,1954,BT,BTN,SEA,15359,25813,41172,19759,14738,10129,6617,3919,2294,57456,15178,24397,39575,18139,13371,9329,6300,3897,2401,53437,110893,191638,191638
Bhutan,1955,BT,BTN,SEA,15641,26130,41771,20296,15301,10470,6787,3997,2330,59181,15489,24779,40268,18585,13767,9582,6450,3970,2439,54793,113974,196014,196014
Bhutan,1956,BT,BTN,SEA,16116,26299,42415,20840,15883,10832,6971,4078,2367,60971,15948,25063,41011,19045,14174,9848,6608,4050,2485,56210,117181,200607,200607
Bhutan,1957,BT,BTN,SEA,16613,26491,43104,21393,16486,11219,7167,4165,2408,62838,16431,25363,41794,19519,14601,10133,6770,4137,2532,57692,120530,205425,205425
Bhutan,1958,BT,BTN,SEA,17133,26698,43831,21958,17102,11628,7379,4260,2460,64787,16934,25678,42612,20021,15035,10429,6946,4225,2582,59238,124025,210468,210468
Bhutan,1959,BT,BTN,SEA,17675,26922,44597,22553,17726,12068,7599,4360,2505,66811,17456,26009,43465,20558,15479,10738,7130,4325,2642,60872,127683,215741,215741
Bhutan,1960,BT,BTN,SEA,18240,27164,45404,23184,18348,12538,7839,4470,2561,68940,18001,26350,44351,21132,15928,11063,7321,4429,2696,62569,131509,221266,221266
Bhutan,1961,BT,BTN,SEA,18837,27422,46259,23842,18978,13033,8096,4590,2620,71159,18577,26712,45289,21741,16395,11403,7521,4539,2762,64361,135520,227071,227071
Bhutan,1962,BT,BTN,SEA,19470,27730,47200,24559,19678,13581,8381,4724,2692,73615,19185,27113,46298,22393,16900,11778,7741,4655,2832,66299,139914,233417,233417
Bhutan,1963,BT,BTN,SEA,20148,28198,48346,25212,20425,14174,8697,4868,2778,76154,19839,27667,47506,22974,17440,12176,7974,4788,2903,68255,144409,240268,240268
Bhutan,1964,BT,BTN,SEA,20873,28821,49694,25776,21170,14796,9036,5027,2857,78662,20537,28350,48887,23497,17984,12595,8221,4924,2980,70201,148863,247444,247444
Bhutan,1965,BT,BTN,SEA,21640,29640,51280,26218,21925,15449,9396,5195,2951,81134,21275,29184,50459,23946,18540,13031,8484,5071,3070,72142,153276,255010,255010
Bhutan,1966,BT,BTN,SEA,22444,30679,53123,26525,22692,16136,9782,5378,3043,83556,22049,30184,52233,24307,19114,13488,8762,5224,3159,74054,157610,262976,262976
Bhutan,1967,BT,BTN,SEA,23278,31780,55058,26847,23487,16854,10200,5574,3146,86108,22850,31251,54101,24686,19714,13966,9059,5384,3261,76070,162178,271339,271339
Bhutan,1968,BT,BTN,SEA,24136,32949,57085,27185,24309,17600,10648,5784,3255,88781,23670,32377,56047,25082,20346,14468,9369,5554,3371,78190,166971,280102,280102
Bhutan,1969,BT,BTN,SEA,25013,34187,59200,27543,25168,18370,11130,6008,3374,91593,24508,33575,58083,25497,21017,14986,9697,5736,3491,80424,172017,289296,289296
Bhutan,2031,BT,BTN,SEA,24161,49969,74130,65181,74421,87762,63721,37422,31004,359511,23173,47847,71020,61180,69865,71534,53369,32876,32632,321456,680967,826118,826118
Bhutan,2032,BT,BTN,SEA,24135,49055,73190,64024,73324,87468,66468,38957,32195,362436,23149,47103,70252,60018,69608,71611,55559,34074,33872,324742,687178,830618,830618
Bhutan,2033,BT,BTN,SEA,24085,48484,72569,62678,72346,86575,69218,40704,33442,364963,23101,46560,69661,58856,69164,71362,57751,35488,35165,327786,692749,834985,834985
Bhutan,2034,BT,BTN,SEA,23997,48254,72251,61044,71486,85236,71951,42663,34712,367092,23017,46344,69361,57470,68544,70928,59933,37126,36480,330481,697573,839181,839181
Bhutan,2035,BT,BTN,SEA,23877,48201,72078,59218,70741,83574,74636,44790,36024,368983,22900,46292,69192,55919,67801,70463,62059,38908,37793,332943,701926,843199,843199
Bhutan,2036,BT,BTN,SEA,23733,48173,71906,57336,70073,81717,77267,47022,37365,370780,22760,46264,69024,54324,66994,70060,64085,40777,39095,335335,706115,847047,847047
Bhutan,2037,BT,BTN,SEA,23558,48158,71716,55451,69396,79824,79778,49294,38731,372474,22593,46250,68843,52698,66134,69779,65940,42695,40412,337658,710132,850697,850697
Bhutan,2038,BT,BTN,SEA,23365,48125,71490,53678,68605,78024,82018,51623,40160,374108,22405,46220,68625,51126,65180,69649,67533,44668,41758,339914,714022,854140,854140
Bhutan,2039,BT,BTN,SEA,23159,48056,71215,52150,67593,76413,83812,54030,41671,375669,22203,46153,68356,49764,64053,69615,68815,46714,43167,342128,717797,857356,857356
Bhutan,2040,BT,BTN,SEA,22925,47950,70875,50972,66336,75015,84967,56520,43335,377145,21978,46044,68022,48749,62710,69589,69715,48824,44704,344291,721436,860331,860331
Bhutan,2041,BT,BTN,SEA,22664,47804,70468,49953,65102,73802,85391,59097,45215,378560,21720,45901,67621,47965,61359,69492,70195,50959,46434,346404,724964,863045,863045
Bhutan,2042,BT,BTN,SEA,22373,47609,69982,49051,63964,72732,85125,61716,47300,379888,21440,45712,67152,47227,60212,69254,70290,53096,48384,348463,728351,865481,865481
Bhutan,2043,BT,BTN,SEA,22047,47371,69418,48487,62639,71781,84278,64350,49610,381145,21124,45481,66605,46690,59066,68821,70067,55242,50574,350460,731605,867621,867621
Bhutan,2044,BT,BTN,SEA,21679,47085,68764,48263,61028,70945,82997,66972,52108,382313,20768,45197,65965,46475,57688,68217,69668,57381,52970,352399,734712,869441,869441
Bhutan,2045,BT,BTN,SEA,21293,46737,68030,48215,59230,70222,81417,69551,54774,383409,20396,44859,65255,46428,56154,67495,69240,59469,55487,354273,737682,870966,870966
Bhutan,2046,BT,BTN,SEA,20905,46333,67238,48194,57369,69574,79647,72090,57533,384407,20022,44470,64492,46406,54572,66702,68874,61464,58054,356072,740479,872205,872205
Bhutan,2047,BT,BTN,SEA,20520,45876,66396,48180,55507,68920,77845,74510,60338,385300,19647,44025,63672,46394,52960,65862,68624,63284,60660,357784,743084,873151,873151
Bhutan,2048,BT,BTN,SEA,20147,45362,65509,48152,53756,68153,76135,76663,63217,386076,19288,43523,62811,46363,51402,64930,68525,64855,63338,359413,745489,873814,873814
Bhutan,2049,BT,BTN,SEA,19804,44795,64599,48092,52251,67166,74606,78398,66227,386740,18956,42968,61924,46298,50053,63823,68517,66122,66120,360933,747673,874192,874192
Bhutan,2050,BT,BTN,SEA,19479,44181,63660,47989,51092,65937,73285,79537,69433,387273,18645,42374,61019,46192,49048,62504,68517,67024,69061,362346,749619,874294,874294
Botswana,1970,BW,BWA,AFR,59232,89111,148343,41556,24953,21948,16844,8768,8412,122481,58432,90604,149036,57216,38961,28512,20564,12321,14810,172384,294865,592244,592244
Botswana,1971,BW,BWA,AFR,60138,91778,151916,43902,23749,21762,17141,8789,8462,123805,59280,92981,152261,59717,39030,29026,21129,12331,14925,176158,299963,604139,604139
Botswana,1972,BW,BWA,AFR,61642,95447,157089,48509,23865,22435,17717,9120,8497,130143,60678,96310,156988,63226,39733,30066,21791,12570,14999,182385,312528,626601,626601
Botswana,1973,BW,BWA,AFR,63793,99444,163237,54290,25164,23886,18600,9811,8547,140298,62680,100329,163009,67621,40897,31458,22547,13125,15048,190696,330994,657246,657246
Botswana,1974,BW,BWA,AFR,66480,103437,169917,60003,27443,25560,19591,10704,8634,151935,65196,104545,169741,72001,42749,32887,23342,13886,15117,199982,351917,691569,691569
Botswana,1975,BW,BWA,AFR,69672,107416,177088,65316,30519,27188,20624,11705,8767,164119,68204,108774,176978,76106,45269,34226,24168,14773,15204,209746,373865,727930,727930
Botswana,1976,BW,BWA,AFR,73391,111447,184838,70539,34026,28793,21690,12831,8935,176814,71753,113032,184785,80295,48074,35495,25016,15810,15304,219994,396808,766424,766424
Botswana,1977,BW,BWA,AFR,77497,115639,193136,75648,37948,30381,22782,14088,9150,189997,75722,117395,193117,84586,51123,36707,25879,17000,15428,230723,420720,806968,806968
Botswana,1978,BW,BWA,AFR,81769,120113,201882,80638,42299,31981,23940,15408,9416,203682,79886,121971,201857,89001,54437,37895,26793,18262,15583,241971,445653,849394,849394
Botswana,1979,BW,BWA,AFR,86062,124934,210996,85520,47062,33622,25205,16678,9757,217844,84068,126824,210892,93544,58037,39102,27803,19471,15812,253769,471613,893500,893500
Botswana,1980,BW,BWA,AFR,90236,130156,220392,90226,52117,35267,26534,17831,10176,232151,88129,131977,220106,98127,61883,40334,28896,20547,16131,265918,498069,938578,938578
Botswana,1981,BW,BWA,AFR,94124,135776,229900,94558,57154,36690,27845,18793,10654,245694,91920,137317,229237,102489,65900,41510,30050,21434,16531,277914,523608,982747,982747
Botswana,1982,BW,BWA,AFR,97452,141540,238992,98225,61465,37430,28961,19495,11171,256747,95189,142942,238131,106493,69877,42357,31222,22189,16998,289136,545883,1023009,1023009
Botswana,1983,BW,BWA,AFR,100211,147450,247661,101478,65259,37709,29915,20042,11744,266147,97926,148954,246880,110353,73867,42983,32394,22884,17548,300029,566176,1060717,1060717
Botswana,1984,BW,BWA,AFR,102607,153705,256312,104757,68838,38473,30811,20573,12398,275850,100313,155353,255666,114260,77666,44109,33512,23581,18214,311342,587192,1099170,1099170
Botswana,1985,BW,BWA,AFR,104727,160270,264997,108096,72072,39814,31617,21145,13124,285868,102414,162231,264645,118317,81184,45794,34538,24362,18994,323189,609057,1138704,1138704
Botswana,1986,BW,BWA,AFR,106606,167101,273707,111539,75270,41387,32319,21743,13927,296185,104251,169558,273809,122552,84760,47667,35456,25201,19915,335551,631736,1179263,1179263
Botswana,1987,BW,BWA,AFR,108241,173974,282215,115171,78452,43164,32903,22334,14809,306833,105812,177065,282877,127018,88435,49703,36259,26070,20968,348453,655286,1220361,1220361
Botswana,1988,BW,BWA,AFR,109584,180560,290144,119050,81624,45153,33373,22922,15713,317835,107071,184299,291370,131773,92220,51927,36951,26968,22090,361929,679764,1261272,1261272
Botswana,1989,BW,BWA,AFR,110581,186741,297322,123222,84836,47368,33756,23515,16575,329272,107999,191026,299025,136848,96150,54388,37568,27886,23220,376060,705332,1301671,1301671
Botswana,1990,BW,BWA,AFR,111208,192524,303732,127760,88058,49792,34060,24101,17368,341139,108579,197197,305776,142288,100203,57099,38125,28806,24303,390824,731963,1341474,1341474
Botswana,1991,BW,BWA,AFR,111495,197878,309373,132720,91214,52417,34259,24705,18087,353402,108849,202801,311650,148153,104273,60051,38595,29754,25324,406150,759552,1380584,1380584
Botswana,1992,BW,BWA,AFR,111793,203107,314900,138170,94775,55642,34513,25355,18721,367176,109108,207431,316539,154030,108318,63692,39107,30679,26257,422083,789259,1420695,1420695
Botswana,1993,BW,BWA,AFR,112435,208050,320485,144073,98800,59517,34923,26015,19267,382595,109677,211019,320696,159852,112251,67992,39746,31527,27122,438490,821085,1462262,1462262
Botswana,1994,BW,BWA,AFR,113344,212200,325544,150362,102706,63200,35716,26608,19795,398387,110531,213897,324428,166031,115966,72093,40846,32278,27969,455183,853570,1503544,1503544
Botswana,1995,BW,BWA,AFR,114125,215594,329719,157024,106459,66528,36951,27094,20355,414411,111274,216131,327405,172532,119479,75879,42481,32882,28841,472094,886505,1543634,1543634
Botswana,1996,BW,BWA,AFR,114459,218313,332772,164026,110180,69890,38372,27481,20917,430866,111588,217805,329393,179298,122814,79631,44310,33359,29725,489137,920003,1582169,1582169
Botswana,1997,BW,BWA,AFR,114322,220636,334958,171137,113943,73301,39995,27776,21488,447640,111465,219220,330685,186075,126049,83316,46304,33711,30621,506076,953716,1619354,1619354
Botswana,1998,BW,BWA,AFR,113963,222838,336801,178046,117793,76711,41813,27999,22054,464416,111118,220687,331805,192493,129325,86908,48478,33976,31499,522679,987095,1655699,1655699
Botswana,1999,BW,BWA,AFR,113735,224835,338570,184627,121774,80126,43806,28180,22578,481091,110886,222131,333017,198370,132746,90404,50843,34196,32320,538879,1019970,1691558,1691558
Botswana,2000,BW,BWA,AFR,114053,226229,340282,190857,125958,83489,45955,28339,23061,497659,111190,223141,334331,203683,136430,93759,53374,34401,33059,554706,1052365,1726985,1726985
Botswana,2001,BW,BWA,AFR,115220,226745,341965,196707,130419,86694,48245,28457,23509,514031,112326,223421,335747,208419,140497,96889,56064,34571,33747,570187,1084218,1761930,1761930
Botswana,2002,BW,BWA,AFR,116925,226402,343327,202251,135329,89278,50536,28554,23942,529890,113983,222784,336767,212632,144994,99440,58935,34747,34394,585142,1115032,1795130,1795130
Botswana,2003,BW,BWA,AFR,118694,225820,344514,207261,140779,91365,52788,28676,24357,545226,115701,221823,337524,216188,149970,101501,61935,35006,35004,599604,1144830,1826863,1826863
Botswana,2004,BW,BWA,AFR,120462,225668,346130,211401,146756,93517,54860,29119,24731,560384,117418,221344,338762,218875,155519,103459,64702,35680,35569,613804,1174188,1859085,1859085
Botswana,2005,BW,BWA,AFR,122439,226068,348507,214732,153269,95781,56719,29952,25097,575550,119328,221458,340786,220772,161657,105398,67212,36835,36089,627963,1203513,1892807,1892807
Botswana,2006,BW,BWA,AFR,124725,227006,351731,217335,160359,98344,58662,30951,25433,591084,121536,222139,343675,221978,168322,107385,69726,38214,36595,642220,1233304,1928704,1928704
Botswana,2007,BW,BWA,AFR,127375,228153,355528,219516,167846,101365,60761,32138,25761,607387,124096,223066,347162,222835,175276,109570,72286,39822,37112,656901,1264288,1966977,1966977
Botswana,2008,BW,BWA,AFR,130319,229303,359622,221528,175337,104857,63029,33538,26124,624413,126949,224034,350983,223670,182179,112152,74936,41681,37681,672299,1296712,2007320,2007320
Botswana,2009,BW,BWA,AFR,133294,230714,364008,223226,182550,108784,65449,35119,26545,641673,129845,225278,355123,224383,188794,115273,77680,43765,38306,688201,1329874,2048997,2048997
Botswana,2010,BW,BWA,AFR,136009,232964,368973,224223,189347,113217,68008,36838,27033,658666,132496,227350,359846,224568,195042,119065,80483,46028,39000,704186,1362852,2091664,2091664
Botswana,2011,BW,BWA,AFR,138237,236392,374629,224171,195433,118212,70600,38586,27538,674540,134686,230592,365278,223868,200815,123619,83199,48352,39729,719582,1394122,2134037,2134037
Botswana,2012,BW,BWA,AFR,140119,240701,380820,223408,200581,123671,73143,40343,28038,689184,136541,234732,371273,222549,205845,128881,85709,50721,40452,734157,1423341,2175425,2175425
Botswana,2013,BW,BWA,AFR,141846,245379,387225,222747,204876,129603,75766,42200,28528,703720,138238,239270,377508,221341,210013,134818,88191,53258,41199,748820,1452540,2217278,2217278
Botswana,2014,BW,BWA,AFR,143385,250134,393519,222635,208385,136019,78566,44038,29224,718867,139747,243908,383655,220696,213319,141448,90806,55809,42259,764337,1483204,2260376,2260376
Botswana,2015,BW,BWA,AFR,144751,254847,399598,223195,211326,142961,81643,45901,30182,735208,141084,248526,389610,220754,215734,148670,93588,58343,43673,780762,1515970,2305171,2305171
Botswana,2016,BW,BWA,AFR,146059,259430,405489,224410,213914,150430,85072,47999,31277,753102,142360,253044,395404,221545,217411,156451,96620,61097,45300,798424,1551526,2352416,2352416
Botswana,2017,BW,BWA,AFR,147262,264092,411354,225865,216413,158178,88876,50311,32508,772151,143535,257641,401176,222701,218702,164530,99984,64072,47171,817160,1589311,2401840,2401840
Botswana,2018,BW,BWA,AFR,148339,268891,417230,227252,218880,165742,92973,52742,33856,791445,144564,262339,406903,223893,219790,172307,103577,67055,49206,835828,1627273,2451409,2451409
Botswana,2019,BW,BWA,AFR,149336,273521,422857,228739,220972,172857,97284,55197,35300,810349,145507,266832,412339,225257,220637,179522,107420,69956,51372,854164,1664513,2499702,2499702
Botswana,2020,BW,BWA,AFR,150034,277647,427681,230929,222309,179591,101894,57591,36713,829027,146162,270822,416984,227340,221054,186245,111664,72761,53644,872708,1701735,2546402,2546402
Botswana,2021,BW,BWA,AFR,150222,281196,431418,234233,222604,185669,106605,59639,37570,846320,146316,274239,420555,230524,220659,192143,116196,75192,55422,890136,1736456,2588423,2588423
Botswana,2022,BW,BWA,AFR,149974,284296,434270,238650,222379,191298,111791,61743,38673,864534,146086,277202,423288,234691,219953,197331,121279,77510,57436,908200,1772734,2630296,2630296
Botswana,2023,BW,BWA,AFR,149373,287089,436462,243711,222355,196577,117756,64259,40546,885204,145551,279869,425420,239335,219614,201957,127116,80016,60229,928267,1813471,2675352,2675352
Botswana,2024,BW,BWA,AFR,148466,289621,438087,248845,222670,201016,124156,66863,42491,906041,144719,282326,427045,244024,219666,205682,133509,82518,63112,948511,1854552,2719694,2719694
Botswana,2025,BW,BWA,AFR,147510,291708,439218,253894,223429,204661,130959,69571,44485,926999,143844,284371,428215,248620,220195,208535,140441,85035,66078,968904,1895903,2763338,2763338
Botswana,2026,BW,BWA,AFR,146690,293244,439934,258741,224627,207604,138100,72402,46528,948002,143100,285887,428987,253047,221192,210616,147836,87588,69098,989377,1937379,2806300,2806300
Botswana,2027,BW,BWA,AFR,146024,294237,440261,263567,225964,210137,145362,75406,48622,969058,142496,286900,429396,257485,222342,212241,155442,90256,72165,1009931,1978989,2848644,2848644
Botswana,2028,BW,BWA,AFR,145477,294747,440224,268444,227272,212494,152466,78662,50803,990141,141989,287458,429447,262013,223457,213733,162878,93169,75309,1030559,2020700,2890377,2890377
Botswana,2029,BW,BWA,AFR,145053,294879,439932,273117,228849,214592,159276,82240,53103,1011177,141608,287658,429266,266383,224810,215056,169916,96449,78573,1051187,2062364,2931568,2931568
Botswana,2030,BW,BWA,AFR,144770,294679,439449,277284,231279,216087,165757,86193,55526,1032126,141369,287538,428907,270315,226975,215895,176472,100193,81934,1071784,2103910,2972271,2972271
Botswana,1950,BW,BWA,AFR,33325,52657,85982,40091,28723,16859,12552,9254,6789,114268,32855,52298,85153,40326,29397,17798,15896,13572,11087,128076,242344,413481,413481
Botswana,1951,BW,BWA,AFR,35114,53024,88138,40994,29605,17171,12806,9163,6940,116679,34661,52716,87377,41400,30423,18012,16014,13471,11380,130700,247379,422885,422885
Botswana,1952,BW,BWA,AFR,37081,53327,90408,42019,30325,17573,13066,9019,7087,119089,36634,53073,89707,42624,31278,18379,16143,13287,11677,133388,252477,432592,432592
Botswana,1953,BW,BWA,AFR,39248,53605,92853,43010,30888,18073,13293,8862,7234,121360,38779,53435,92214,43881,31982,18900,16243,13068,11981,136055,257415,442483,442483
Botswana,1954,BW,BWA,AFR,41127,54371,95498,43735,31291,18667,13440,8753,7371,123257,40622,54314,94936,44990,32584,19571,16254,12900,12264,138563,261820,452263,452263
Botswana,1955,BW,BWA,AFR,42617,55741,98358,44113,31581,19333,13505,8717,7490,124739,42078,55810,97888,45871,33144,20356,16165,12821,12528,140885,265624,461880,461880
Botswana,1956,BW,BWA,AFR,44124,57336,101460,44186,31755,20093,13487,8743,7609,125873,43548,57534,101082,46534,33651,21285,15982,12813,12783,143048,268921,471466,471466
Botswana,1957,BW,BWA,AFR,45670,59167,104837,44010,31825,20971,13384,8839,7724,126753,45060,59474,104534,46996,34122,22372,15696,12887,13030,145103,271856,481225,481225
Botswana,1958,BW,BWA,AFR,47185,61284,108469,43697,31868,21884,13269,8987,7816,127521,46541,61669,108210,47303,34627,23530,15382,13009,13255,147106,274627,491313,491313
Botswana,1959,BW,BWA,AFR,48609,63731,112340,43358,31976,22704,13220,9141,7883,128282,47931,64170,112101,47534,35241,24600,15175,13135,13432,149117,277399,501837,501837
Botswana,1960,BW,BWA,AFR,49934,66501,116435,43069,32163,23384,13286,9276,7907,129085,49215,66971,116186,47728,35977,25521,15143,13220,13555,151144,280229,512865,512865
Botswana,1961,BW,BWA,AFR,51134,69592,120726,42831,32466,23927,13448,9417,7899,129988,50376,70059,120435,47882,36864,26301,15266,13298,13635,153246,283234,524403,524403
Botswana,1962,BW,BWA,AFR,52199,72988,125187,42648,32907,24328,13700,9559,7850,130992,51412,73432,124844,47998,37914,26933,15525,13379,13655,155404,286396,536428,536428
Botswana,1963,BW,BWA,AFR,53251,76605,129856,42560,33380,24622,14054,9686,7796,132098,52432,76992,129424,48160,39027,27456,15941,13432,13649,157665,289763,549041,549041
Botswana,1964,BW,BWA,AFR,54394,79897,134291,43088,33749,24849,14519,9769,7779,133753,53546,80210,133756,48892,40043,27934,16511,13418,13680,160478,294231,562274,562274
Botswana,1965,BW,BWA,AFR,55420,81955,137375,43126,33309,24757,14924,9739,7814,133669,54570,82454,137024,49980,40505,28216,17103,13335,13769,162908,296577,570975,570975
Botswana,1966,BW,BWA,AFR,56285,83202,139487,42233,32017,24307,15273,9585,7899,131314,55450,84087,139537,51014,40409,28261,17725,13174,13922,164505,295819,574855,574855
Botswana,1967,BW,BWA,AFR,57142,84502,141644,41544,30476,23749,15725,9362,8037,128893,56323,85660,141983,52236,40145,28267,18480,12924,14150,166202,295095,578723,578723
Botswana,1968,BW,BWA,AFR,57932,85874,143806,41125,28721,23132,16204,9105,8201,126488,57129,87224,144353,53655,39763,28271,19281,12632,14409,168011,294499,582655,582655
Botswana,1969,BW,BWA,AFR,58597,87362,145959,41023,26815,22505,16581,8893,8326,124143,57807,88832,146639,55295,39324,28335,19990,12415,14635,169994,294137,586737,586737
Botswana,2031,BW,BWA,AFR,144586,294119,438705,280864,234942,216753,171867,90571,58049,1053046,141226,287076,428302,273714,230323,216037,182472,104479,85361,1092386,2145432,3012432,3012432
Botswana,2032,BW,BWA,AFR,144502,293266,437768,283980,239556,216861,177484,95363,60636,1073880,141180,286345,427525,276685,234597,215740,187776,109333,88800,1112931,2186811,3052105,3052105
Botswana,2033,BW,BWA,AFR,144587,292172,436759,286780,244577,216955,182426,100528,63312,1094578,141300,285380,426680,279383,239250,215525,192265,114710,92277,1133410,2227988,3091424,3091424
Botswana,2034,BW,BWA,AFR,144807,290895,435702,289324,249666,217381,186607,106070,66075,1115123,141550,284242,425792,281867,243946,215690,195903,120598,95786,1153790,2268913,3130405,3130405
Botswana,2035,BW,BWA,AFR,145143,289710,434853,291427,254674,218228,190065,111950,68925,1135269,141906,283197,425103,283941,248553,216316,198716,126970,99338,1173834,2309103,3169059,3169059
Botswana,2036,BW,BWA,AFR,145598,288762,434360,292983,259485,219501,192890,118113,71871,1154843,142372,282381,424753,285494,252987,217398,200810,133757,102923,1193369,2348212,3207327,3207327
Botswana,2037,BW,BWA,AFR,146023,288057,434080,294002,264273,220910,195339,124368,74973,1173865,142809,281792,424601,286546,257443,218629,202480,140726,106620,1212444,2386309,3244988,3244988
Botswana,2038,BW,BWA,AFR,146384,287635,434019,294538,269112,222293,197642,130484,78291,1192360,143181,281466,424647,287143,261981,219827,204026,147535,110563,1231075,2423435,3282099,3282099
Botswana,2039,BW,BWA,AFR,146737,287470,434207,294701,273745,223932,199704,136341,81933,1210356,143540,281397,424937,287381,266358,221263,205411,153978,114882,1249273,2459629,3318773,3318773
Botswana,2040,BW,BWA,AFR,147079,287560,434639,294536,277890,226394,201213,141932,85916,1227881,143897,281562,425459,287301,270302,223480,206334,159990,119652,1267059,2494940,3355041,3355041
Botswana,2041,BW,BWA,AFR,147380,287868,435248,294009,281460,230032,201956,147205,90260,1244922,144210,281937,426147,286879,273724,226849,206586,165508,124898,1284444,2529366,3390767,3390767
Botswana,2042,BW,BWA,AFR,147687,288241,435928,293201,284577,234581,202179,152063,94935,1261536,144532,282380,426912,286190,276723,231120,206427,170394,130609,1301463,2562999,3425834,3425834
Botswana,2043,BW,BWA,AFR,147980,288719,436699,292152,287387,239509,202392,156346,99919,1277705,144846,282921,427767,285272,279451,235755,206338,174547,136746,1318109,2595814,3460278,3460278
Botswana,2044,BW,BWA,AFR,148181,289324,437505,290923,289945,244508,202911,159984,105210,1293481,145065,283581,428646,284178,281968,240431,206608,177936,143304,1334425,2627906,3494050,3494050
Botswana,2045,BW,BWA,AFR,148269,290034,438303,289781,292068,249426,203826,163006,110764,1308871,145179,284335,429514,283179,284083,245023,207324,180586,150252,1350447,2659318,3527139,3527139
Botswana,2046,BW,BWA,AFR,148222,290812,439034,288875,293658,254155,205143,165504,116562,1323897,145153,285156,430309,282406,285679,249451,208478,182591,157533,1366138,2690035,3559380,3559380
Botswana,2047,BW,BWA,AFR,148074,291573,439647,288213,294714,258863,206597,167700,122479,1338566,145029,285966,430995,281857,286779,253890,209781,184231,164994,1381532,2720098,3590737,3590737
Botswana,2048,BW,BWA,AFR,147855,292259,440114,287829,295306,263611,208032,169780,128391,1352949,144830,286694,431524,281569,287430,258412,211057,185770,172466,1396704,2749653,3621294,3621294
Botswana,2049,BW,BWA,AFR,147483,292842,440325,287694,295532,268170,209718,171674,134282,1367070,144483,287322,431805,281530,287728,262783,212562,187173,179887,1411663,2778733,3650860,3650860
Botswana,2050,BW,BWA,AFR,146920,293307,440227,287817,295433,272260,212173,173090,140161,1380934,143949,287834,431783,281732,287712,266729,214822,188161,187247,1426403,2807337,3679340,3679340
Central African Republic,1970,CF,CAF,AFR,177665,258016,435681,189041,133085,102178,73969,51279,38520,588072,174257,255428,429685,189612,136981,107180,79311,56646,44183,613913,1201985,2067356,2067356
Central African Republic,1971,CF,CAF,AFR,182407,265198,447605,193993,134874,103335,75062,51802,39079,598145,178882,262373,441255,194138,138757,108376,80731,57278,44946,624226,1222371,2111224,2111224
Central African Republic,1972,CF,CAF,AFR,186642,272913,459555,198803,136268,104283,76168,52274,39641,607437,183026,269843,452869,198485,140113,109380,82182,57845,45749,633754,1241191,2153613,2153613
Central African Republic,1973,CF,CAF,AFR,190244,281211,471455,203911,137396,105136,77301,52742,40232,616718,186569,277889,464458,203082,141225,110293,83659,58406,46608,643273,1259991,2195905,2195905
Central African Republic,1974,CF,CAF,AFR,193403,289975,483378,208652,139370,105961,78440,53255,40849,626527,189686,286394,476080,207430,143038,111172,85100,59054,47526,653320,1279847,2239305,2239305
Central African Republic,1975,CF,CAF,AFR,196389,298905,495294,212816,142497,106755,79558,53835,41490,636951,192649,295073,487722,211364,145812,112007,86460,59824,48485,663952,1300903,2283927,2283927
Central African Republic,1976,CF,CAF,AFR,198588,305620,504208,216489,146644,107367,79981,53810,42040,646331,194670,301669,496339,215793,148880,111744,86331,59581,49145,671474,1317805,2318349,2318349
Central African Republic,1977,CF,CAF,AFR,200432,309852,510284,219478,151669,107904,79695,53120,42405,654271,196207,305779,501986,220648,152176,110443,84627,58226,49387,675507,1329778,2342048,2342048
Central African Republic,1978,CF,CAF,AFR,203122,313588,516710,222219,156809,108653,79355,52401,42613,662050,198646,309147,507793,225490,155748,109232,82704,56783,49451,679408,1341458,2365957,2365957
Central African Republic,1979,CF,CAF,AFR,206789,316782,523571,224792,161969,109661,78952,51679,42650,669703,202101,311790,513891,230306,159576,108158,80595,55247,49284,683166,1352869,2390329,2390329
Central African Republic,1980,CF,CAF,AFR,211471,319354,530825,227272,167096,110955,78490,50963,42511,677287,206599,313715,520314,235076,163670,107265,78338,53623,48883,686855,1364142,2415276,2415276
Central African Republic,1981,CF,CAF,AFR,216743,321725,538468,229754,172142,112526,78024,50259,42209,684914,211695,315375,527070,239794,168054,106571,75991,51918,48232,690560,1375474,2441010,2441010
Central African Republic,1982,CF,CAF,AFR,222056,324399,546455,232316,177119,114295,77598,49586,41747,692661,216850,317292,534142,244430,172793,106033,73622,50166,47331,694375,1387036,2467635,2467635
Central African Republic,1983,CF,CAF,AFR,227255,327405,554660,235038,182084,116154,77228,48929,41164,700597,221906,319544,541450,248989,177954,105620,71248,48350,46226,698387,1398984,2495097,2495097
Central African Republic,1984,CF,CAF,AFR,232263,330981,563244,237894,186174,118948,76906,48239,40493,708654,226784,322381,549165,253354,182810,106063,68875,46394,44986,702482,1411136,2523538,2523538
Central African Republic,1985,CF,CAF,AFR,237152,335309,572461,240684,189125,122900,76631,47497,39760,716597,231538,326034,557572,257308,187110,107604,66493,44272,43648,706435,1423032,2553075,2553075
Central African Republic,1986,CF,CAF,AFR,241945,340369,582314,243379,191703,127201,76441,46724,38988,724436,236192,330512,566704,260796,191400,109604,64144,41998,42236,710178,1434614,2583631,2583631
Central African Republic,1987,CF,CAF,AFR,246759,346208,592967,245907,194037,131670,76412,45951,38169,732146,240870,335854,576724,263770,195737,111964,61929,39620,40737,713757,1445903,2615594,2615594
Central African Republic,1988,CF,CAF,AFR,252054,354071,606125,248909,196202,136503,77044,45557,37410,741625,246115,343246,589361,266430,200472,115384,60712,37759,39364,720121,1461746,2657235,2657235
Central African Republic,1989,CF,CAF,AFR,258644,366222,624866,253825,198387,142093,79150,46216,36926,756597,252851,354928,607779,269403,206299,121136,61980,37547,38503,734868,1491465,2724109,2724109
Central African Republic,1990,CF,CAF,AFR,266063,381660,647723,260191,200742,148055,82322,47566,36732,775608,260445,370138,630583,272677,212703,128442,64988,38456,38041,755307,1530915,2809221,2809221
Central African Republic,1991,CF,CAF,AFR,273292,397858,671150,267249,203451,153817,85733,48962,36732,795944,267708,386532,654240,276429,218916,135943,68279,39459,37687,776713,1572657,2898052,2898052
Central African Republic,1992,CF,CAF,AFR,280091,414618,694709,275612,206826,159488,89354,50437,36936,818653,274444,403801,678245,281464,225036,143719,71815,40597,37492,800123,1618776,2991727,2991727
Central African Republic,1993,CF,CAF,AFR,286556,431559,718115,285125,210936,165056,93028,51971,37312,843428,280790,421395,702185,287790,231065,151763,75507,41858,37437,825420,1668848,3089146,3089146
Central African Republic,1994,CF,CAF,AFR,293159,447804,740963,295582,215548,169556,97372,53515,37780,869353,287239,438342,725581,295327,236798,159265,79907,43179,37474,851950,1721303,3187844,3187844
Central African Republic,1995,CF,CAF,AFR,299745,461974,761719,305458,219270,172011,102142,54914,38148,891943,293744,453039,746783,302591,241348,165561,84913,44415,37428,876256,1768199,3276706,3276706
Central African Republic,1996,CF,CAF,AFR,306490,475329,781819,315783,222946,173624,106849,56290,38534,914026,300404,466872,767276,310698,245141,171395,90100,45690,37421,900445,1814471,3363570,3363570
Central African Republic,1997,CF,CAF,AFR,313583,489188,802771,327983,227716,175261,111691,57826,39082,939559,307312,481299,788611,321223,248805,177170,95574,47187,37567,927526,1867085,3458472,3458472
Central African Republic,1998,CF,CAF,AFR,320854,502774,823628,341105,232817,176657,116377,59488,39699,966143,314357,495379,809736,333196,251975,182630,101136,48841,37778,955556,1921699,3555064,3555064
Central African Republic,1999,CF,CAF,AFR,328489,516444,844933,355328,238389,178057,120880,61320,40382,994356,321708,509440,831148,346792,254866,187795,106746,50669,38057,984925,1979281,3655360,3655360
Central African Republic,2000,CF,CAF,AFR,336285,530389,866674,370690,244278,179571,125145,63308,41112,1024104,329189,523604,852793,361992,257577,192624,112365,52665,38375,1015598,2039702,3759170,3759170
Central African Republic,2001,CF,CAF,AFR,343260,541866,885126,383785,248437,179998,128411,65179,41613,1047423,336017,534825,870842,375127,259293,196413,117493,54566,38489,1041381,2088804,3844773,3844773
Central African Republic,2002,CF,CAF,AFR,350284,552900,903184,396831,253199,180640,131354,67097,42195,1071316,342908,545543,888451,388378,261576,199861,122632,56554,38693,1067694,2139010,3930648,3930648
Central African Republic,2003,CF,CAF,AFR,358219,565691,923910,410823,259114,182115,134382,69077,42984,1098495,350581,558242,908823,402624,264180,203006,127991,58687,39131,1095619,2194114,4026841,4026841
Central African Republic,2004,CF,CAF,AFR,366090,578379,944469,422823,264368,183300,136286,71457,43693,1121927,358198,570723,928921,414812,266373,205216,132601,61260,39560,1119822,2241749,4115138,4115138
Central African Republic,2005,CF,CAF,AFR,373991,591741,965732,434938,270989,185057,137351,74561,44504,1147400,365828,583854,949682,427197,270247,207203,136673,64579,40121,1146020,2293420,4208834,4208834
Central African Republic,2006,CF,CAF,AFR,382204,605035,987239,445202,276581,186224,137639,77589,45236,1168471,373784,596871,970655,437648,273513,207936,140195,67999,40694,1167985,2336456,4294352,4294352
Central African Republic,2007,CF,CAF,AFR,390981,618176,1009157,454346,281648,187028,137419,80493,45994,1186928,382356,609675,992031,446904,276689,207653,143340,71490,41373,1187449,2374377,4375569,4375569
Central African Republic,2008,CF,CAF,AFR,400307,632024,1032331,464698,288454,188493,137280,83437,47000,1209362,391468,623156,1014624,457418,282071,207384,146522,75204,42323,1210922,2420284,4467233,4467233
Central African Republic,2009,CF,CAF,AFR,410270,646396,1056666,475486,296201,190156,137134,86265,48169,1233411,401175,637135,1038310,468354,288869,206866,149569,79023,43472,1236153,2469564,4564540,4564540
Central African Republic,2010,CF,CAF,AFR,420956,660721,1081677,485764,303781,191305,136796,88810,49379,1255835,411594,651036,1062630,478642,295914,205577,152226,82836,44731,1259926,2515761,4660067,4660067
Central African Republic,2011,CF,CAF,AFR,431206,674938,1106144,492466,307448,190447,135606,90721,50362,1267050,421556,664840,1086396,484914,299279,202222,153790,86354,45877,1272436,2539486,4732022,4732022
Central African Republic,2012,CF,CAF,AFR,440146,689121,1129267,494759,305865,187294,133388,91921,51052,1264279,430190,678611,1108801,486318,297487,196670,154050,89552,46878,1270955,2535234,4773306,4773306
Central African Republic,2013,CF,CAF,AFR,447180,703754,1150934,496233,301906,183239,130852,92711,51637,1256578,437001,692818,1129819,486950,293511,190397,153611,92695,47932,1265096,2521674,4802428,4802428
Central African Republic,2014,CF,CAF,AFR,450784,718179,1168963,494864,292098,176794,127295,92299,52186,1235536,440527,706779,1147306,484744,283950,182166,151809,95102,49154,1246925,2482461,4798734,4798734
Central African Republic,2015,CF,CAF,AFR,451994,733841,1185835,499892,285908,172513,124603,91516,53551,1227983,441781,721952,1163733,489098,277847,176177,150138,97325,51191,1241776,2469759,4819333,4819333
Central African Republic,2016,CF,CAF,AFR,453529,751787,1205316,515868,289809,173370,124112,91367,55834,1250360,443431,739427,1182858,504873,281639,175218,149702,100113,54102,1265647,2516007,4904177,4904177
Central African Republic,2017,CF,CAF,AFR,456586,770004,1226590,532380,294537,174763,123720,90995,58152,1274547,446576,757169,1203745,521419,286421,175203,148788,102780,57246,1291857,2566404,4996741,4996741
Central African Republic,2018,CF,CAF,AFR,462080,787079,1249159,549353,300048,176523,123286,90446,60441,1300097,452085,773811,1225896,538506,292039,175968,147285,105265,60566,1319629,2619726,5094780,5094780
Central African Republic,2019,CF,CAF,AFR,470528,802862,1273390,568305,308579,179648,123167,89960,62800,1332459,460434,789240,1249674,557561,300541,178353,145575,107662,64112,1353804,2686263,5209324,5209324
Central African Republic,2020,CF,CAF,AFR,482922,817081,1300003,588980,321065,184568,123267,89394,64809,1372083,472596,803187,1275783,578352,312877,182744,143729,109814,67634,1395150,2767233,5343020,5343020
Central African Republic,2021,CF,CAF,AFR,497715,829391,1327106,605583,331235,188000,122397,88179,65775,1401169,487095,815245,1302340,594863,322913,186077,140915,111164,70603,1426535,2827704,5457154,5457154
Central African Republic,2022,CF,CAF,AFR,512722,842719,1355441,622598,342889,191900,121906,87084,66528,1432905,501737,828335,1330072,611937,334556,190043,138396,112215,73574,1460721,2893626,5579144,5579144
Central African Republic,2023,CF,CAF,AFR,528428,858061,1386489,644820,361359,198872,123063,86896,67829,1482839,516934,843464,1360398,634507,353127,196920,137321,113586,77125,1512586,2995425,5742315,5742315
Central African Republic,2024,CF,CAF,AFR,544814,874103,1418917,666963,381990,206251,124946,87212,69382,1536744,532792,859248,1392040,656851,373955,204203,137017,114910,80994,1567930,3104674,5915627,5915627
Central African Republic,2025,CF,CAF,AFR,561179,890885,1452064,688952,404509,214225,127595,87872,71122,1594275,548805,875765,1424570,678901,396794,212064,137640,116016,85121,1626536,3220811,6097449,6097449
Central African Republic,2026,CF,CAF,AFR,576865,909301,1486166,710937,428171,223094,130891,88753,72860,1654706,564295,893918,1458213,700848,420895,220828,139170,116783,89341,1687865,3342571,6286949,6286949
Central African Republic,2027,CF,CAF,AFR,592765,929299,1522064,732611,452379,232927,134728,89725,74457,1716827,580063,913595,1493658,722445,445614,230593,141544,117122,93538,1750856,3467683,6483409,6483409
Central African Republic,2028,CF,CAF,AFR,609127,951267,1560394,752659,477149,243928,139084,90714,75943,1779477,596290,935169,1531459,742417,470964,241554,144776,117000,97676,1814387,3593864,6685708,6685708
Central African Republic,2029,CF,CAF,AFR,624981,976236,1601217,770678,502064,256368,144007,91681,77322,1842120,611972,959713,1571685,760376,496512,253976,148914,116488,101697,1877963,3720083,6892981,6892981
Central African Republic,2030,CF,CAF,AFR,639891,1004696,1644587,786374,526470,270563,149647,92555,78596,1904205,626650,987775,1614425,776038,521566,268185,154076,115624,105563,1941052,3845257,7104274,7104274
Central African Republic,1950,CF,CAF,AFR,107100,155605,262705,128365,101240,80606,61806,41532,32302,445851,106632,157326,263958,129900,102421,81900,64577,45711,39570,464079,909930,1436591,1436591
Central African Republic,1951,CF,CAF,AFR,111015,158183,269198,129693,102386,81047,62187,41738,32496,449547,110187,159968,270155,131341,103994,82428,65025,45790,39457,468035,917582,1456939,1456939
Central African Republic,1952,CF,CAF,AFR,114895,160868,275763,131058,103673,81465,62486,42116,32656,453454,113724,162708,276432,132831,105714,82903,65396,46084,39319,472247,925701,1477900,1477900
Central African Republic,1953,CF,CAF,AFR,118973,163520,282493,132472,105063,81898,62763,42618,32785,457599,117412,165456,282868,134361,107522,83382,65753,46544,39172,476734,934333,1499680,1499680
Central African Republic,1954,CF,CAF,AFR,122265,167203,289468,133916,106476,82396,63086,43164,32873,461911,120451,169070,289521,135906,109290,83971,66171,47074,39004,481416,943327,1522317,1522317
Central African Republic,1955,CF,CAF,AFR,124520,172218,296738,135392,107872,82988,63483,43705,32950,466390,122643,173807,296450,137476,110970,84725,66666,47623,38855,486315,952705,1545898,1545898
Central African Republic,1956,CF,CAF,AFR,126698,177589,304287,136929,109280,83663,63960,44246,33003,471081,124756,178877,303633,139104,112575,85625,67245,48202,38706,491457,962538,1570453,1570453
Central African Republic,1957,CF,CAF,AFR,128944,183116,312060,138580,110707,84408,64512,44804,33039,476050,126938,184083,311021,140845,114108,86657,67917,48802,38551,496880,972930,1596022,1596022
Central African Republic,1958,CF,CAF,AFR,131255,188724,319979,140426,112151,85253,65105,45349,33107,481391,129194,189362,318556,142774,115586,87834,68638,49402,38464,502698,984089,1622618,1622618
Central African Republic,1959,CF,CAF,AFR,133647,194371,328018,142552,113618,86243,65694,45856,33259,487222,131533,194669,326202,144979,117088,89171,69332,49978,38483,509031,996253,1650466,1650466
Central African Republic,1960,CF,CAF,AFR,136176,200070,336246,144984,115106,87371,66267,46331,33511,493570,134008,200013,334021,147470,118618,90644,69981,50527,38647,515887,1009457,1679728,1679728
Central African Republic,1961,CF,CAF,AFR,138915,205844,344759,147641,116612,88629,66826,46761,33870,500339,136674,205430,342104,150168,120178,92236,70597,51043,38941,523163,1023502,1710364,1710364
Central African Republic,1962,CF,CAF,AFR,141897,211804,353701,150401,118168,90017,67371,47143,34333,507433,139566,211031,350597,152954,121792,93966,71170,51511,39370,530763,1038196,1742502,1742502
Central African Republic,1963,CF,CAF,AFR,145153,218113,363266,153137,119769,91500,67933,47509,34866,514714,142707,216915,359622,155753,123447,95785,71748,51974,39901,538608,1053322,1776214,1776214
Central African Republic,1964,CF,CAF,AFR,148759,223851,372610,156829,121408,93011,68550,47916,35397,523111,146175,222354,368529,159361,125127,97576,72428,52488,40465,547445,1070556,1811694,1811694
Central African Republic,1965,CF,CAF,AFR,152754,228801,381555,161781,123082,94516,69248,48373,35908,532908,150025,227164,377189,164035,126840,99299,73258,53064,41024,557520,1090428,1849171,1849171
Central African Republic,1966,CF,CAF,AFR,157162,233894,391056,167084,124816,96044,70022,48890,36413,543269,154284,232102,386386,169037,128612,100969,74218,53711,41591,568138,1111407,1888853,1888853
Central African Republic,1967,CF,CAF,AFR,161971,239315,401286,172548,126668,97605,70873,49472,36911,554077,158951,237342,396293,174184,130501,102590,75311,54439,42178,579203,1133280,1930861,1930861
Central African Republic,1968,CF,CAF,AFR,167170,245097,412267,178121,128702,99194,71813,50092,37420,565342,164017,242936,406953,179417,132569,104180,76540,55203,42789,590698,1156040,1975257,1975257
Central African Republic,1969,CF,CAF,AFR,172536,251325,423861,183698,130929,100764,72868,50707,37961,576927,169250,248958,418208,184650,134819,105749,77898,55951,43457,602524,1179451,2021519,2021519
Central African Republic,2031,CF,CAF,AFR,653323,1035800,1689123,800501,550550,286512,155848,93506,79830,1966747,639840,1018483,1658323,790130,546306,284191,160040,114686,109255,2004608,3971355,7318809,7318809
Central African Republic,2032,CF,CAF,AFR,665143,1067416,1732559,815263,574275,303801,162483,94785,81073,2031680,651460,1049684,1701144,804830,570675,301621,166592,114024,112803,2070545,4102225,7535935,7535935
Central African Republic,2033,CF,CAF,AFR,675629,1099025,1774654,830887,597498,322449,169510,96401,82376,2099121,661795,1080868,1742663,820384,594487,320552,173603,113721,116236,2138983,4238104,7755423,7755423
Central African Republic,2034,CF,CAF,AFR,685007,1130487,1815494,847044,620193,342756,176708,98446,83716,2168863,671054,1111955,1783009,836426,617665,341317,180837,113962,119486,2209693,4378556,7977059,7977059
Central African Republic,2035,CF,CAF,AFR,693383,1161136,1854519,863884,642410,364556,184299,100981,85028,2241158,679313,1142284,1821597,853117,640245,363744,188489,114900,122406,2282901,4524059,8200171,8200171
Central African Republic,2036,CF,CAF,AFR,700479,1189878,1890357,882304,664364,387223,192593,103973,86297,2316754,686305,1170773,1857078,871366,662451,387175,196884,116544,124948,2359368,4676122,8423550,8423550
Central African Republic,2037,CF,CAF,AFR,706400,1217233,1923633,902221,685803,410241,201681,107372,87544,2394862,692126,1197969,1890095,891055,684088,411033,206135,118880,127114,2438305,4833167,8646900,8646900
Central African Republic,2038,CF,CAF,AFR,711321,1243721,1955042,924022,705550,433682,211770,111162,88737,2474923,696974,1224337,1921311,912557,704009,435398,216442,121912,128889,2519207,4994130,8870492,8870492
Central African Republic,2039,CF,CAF,AFR,714814,1268623,1983437,948712,723268,457213,223117,115396,89863,2557569,700468,1249114,1949582,936941,721886,459902,228074,125699,130276,2602778,5160347,9093368,9093368
Central African Republic,2040,CF,CAF,AFR,717649,1291641,2009290,976768,738686,480246,236013,120183,90885,2642781,703334,1271940,1975274,964754,737458,483915,241325,130326,131293,2689071,5331852,9316419,9316419
Central African Republic,2041,CF,CAF,AFR,720823,1311993,2032816,1007379,752556,502959,250473,125415,91976,2730758,706544,1292094,1998638,995138,751458,507612,256227,135622,132166,2778223,5508981,9540435,9540435
Central African Republic,2042,CF,CAF,AFR,723759,1329642,2053401,1038489,767022,525334,266127,131011,93351,2821334,709550,1309580,2019130,1026009,766035,530967,272439,141427,133196,2870073,5691407,9763939,9763939
Central African Republic,2043,CF,CAF,AFR,726181,1345008,2071189,1069602,782329,547267,283013,136948,95045,2914204,712030,1324848,2036878,1056872,781444,553806,290049,147642,134488,2964301,5878505,9986569,9986569
Central African Republic,2044,CF,CAF,AFR,728888,1357908,2086796,1100571,798180,568751,301391,143046,97119,3009058,714726,1337729,2052455,1087643,797350,576082,309345,154060,136123,3060603,6069661,10208909,10208909
Central African Republic,2045,CF,CAF,AFR,731430,1369175,2100605,1130745,814709,589835,321120,149489,99558,3105456,717248,1349015,2066263,1117678,813911,597836,330192,160861,138106,3158584,6264040,10430913,10430913
Central African Republic,2046,CF,CAF,AFR,733380,1379544,2112924,1159070,832780,610707,341642,156542,102316,3203057,719191,1359403,2078594,1145916,832015,619279,351986,168334,140427,3257957,6461014,10652537,10652537
Central African Republic,2047,CF,CAF,AFR,735478,1388556,2124034,1186050,852300,631122,362493,164273,105360,3301598,721279,1368469,2089748,1172892,851525,640207,374191,176569,143054,3358438,6660036,10873819,10873819
Central African Republic,2048,CF,CAF,AFR,737866,1396084,2133950,1212166,873611,649971,383744,172847,108644,3400983,723656,1376066,2099722,1199058,872791,659523,396893,185733,145969,3459967,6860950,11094632,11094632
Central African Republic,2049,CF,CAF,AFR,740076,1402505,2142581,1236741,897676,666940,405109,182495,112193,3501154,725876,1382552,2108428,1223661,896837,676920,419752,196073,149234,3562477,7063631,11314636,11314636
Central African Republic,2050,CF,CAF,AFR,741920,1408114,2150034,1259476,924949,681765,426062,193461,116053,3601766,727731,1388245,2115976,1246353,924187,692137,442194,207863,152914,3665648,7267414,11533423,11533423
Canada,1970,CA,CAN,AMR,962685,2340708,3303393,1985463,1428578,1296933,1122279,839161,770262,7442676,918973,2237323,3156296,1948315,1391712,1251856,1143317,855837,941176,7532213,14974889,21434577,21434577
Canada,1971,CA,CAN,AMR,939320,2340053,3279373,2074437,1518087,1310078,1148329,862333,788521,7701785,897276,2237163,3134439,2031255,1465127,1252403,1168364,883750,972185,7773084,15474869,21888679,21888679
Canada,1972,CA,CAN,AMR,924862,2316502,3241364,2133771,1599490,1314942,1172288,878265,805410,7904166,882167,2213938,3096105,2083297,1544039,1253518,1192051,905768,1001910,7980583,15884749,22222221,22222221
Canada,1973,CA,CAN,AMR,916800,2276334,3193134,2183019,1675759,1316937,1195445,889913,822407,8083480,872246,2174737,3046983,2127258,1621752,1256749,1214906,925529,1032230,8178424,16261904,22502029,22502029
Canada,1974,CA,CAN,AMR,912289,2234220,3146509,2240027,1754125,1323449,1215868,903215,840963,8277647,866465,2133401,2999866,2180733,1697300,1265115,1233835,947890,1063540,8388413,16666060,22812432,22812432
Canada,1975,CA,CAN,AMR,907948,2193226,3101174,2297622,1830939,1333458,1230823,920786,862071,8475699,861959,2092729,2954688,2236665,1771291,1277620,1246306,974840,1097973,8604695,17080394,23136252,23136252
Canada,1976,CA,CAN,AMR,903974,2149730,3053704,2346488,1901062,1348744,1241247,941070,885723,8664334,858790,2049259,2908049,2285497,1841947,1295231,1251838,1004776,1136740,8816029,17480363,23442114,23442114
Canada,1977,CA,CAN,AMR,903239,2100160,3003399,2382678,1961712,1372199,1249449,961674,910293,8838005,858976,1999318,2858294,2321928,1908081,1319860,1252363,1035671,1177714,9015617,17853622,23715308,23715308
Canada,1978,CA,CAN,AMR,906805,2043014,2949819,2410558,2013916,1405028,1256018,980513,935557,9001590,862394,1942730,2805124,2348617,1969027,1352700,1250679,1064177,1220949,9206149,18207739,23962690,23962690
Canada,1979,CA,CAN,AMR,912877,1986478,2899355,2434979,2066824,1446356,1260190,998066,962340,9168755,867391,1887817,2755208,2369042,2030969,1392813,1247892,1088860,1266223,9395799,18564554,24219124,24219124
Canada,1980,CA,CAN,AMR,919097,1943451,2862548,2453197,2124064,1494773,1263840,1017249,989754,9342877,872939,1845671,2718610,2381751,2095801,1438682,1246158,1112385,1312697,9587474,18930351,24511510,24511510
Canada,1981,CA,CAN,AMR,925603,1916772,2842375,2454183,2175574,1554424,1268352,1039234,1015071,9506838,879418,1819383,2698801,2376788,2152802,1497083,1247052,1136676,1357371,9767772,19274610,24815786,24815786
Canada,1982,CA,CAN,AMR,934014,1901069,2835083,2432058,2217807,1625420,1272414,1063258,1037511,9648468,887191,1804683,2691874,2347531,2198756,1570443,1249583,1161638,1398145,9926096,19574564,25101518,25101518
Canada,1983,CA,CAN,AMR,942539,1890260,2832799,2394892,2257455,1695782,1276542,1088002,1058873,9771546,894517,1795523,2690040,2302629,2240501,1645764,1253810,1185853,1437784,10066341,19837887,25360726,25360726
Canada,1984,CA,CAN,AMR,947474,1881449,2828923,2353151,2298915,1760630,1281585,1110172,1083290,9887743,898768,1788795,2687563,2253945,2281976,1715468,1260230,1205110,1481119,10197848,20085591,25602075,25602075
Canada,1985,CA,CAN,AMR,947349,1874065,2821414,2311107,2344340,1824287,1288456,1127499,1113413,10009102,899139,1783061,2682200,2207033,2324334,1782260,1269325,1216929,1531324,10331205,20340307,25843922,25843922
Canada,1986,CA,CAN,AMR,946763,1872447,2819210,2265799,2396408,1888820,1302212,1142195,1147715,10143149,900062,1781317,2681379,2159633,2368847,1849799,1284407,1223941,1585703,10472330,20615479,26116071,26116071
Canada,1987,CA,CAN,AMR,950699,1882692,2833391,2211385,2451651,1954096,1327773,1156636,1184861,10286402,905237,1789458,2694695,2107081,2415326,1920629,1309181,1229096,1641077,10622390,20908792,26436889,26436889
Canada,1988,CA,CAN,AMR,958772,1903247,2862019,2154387,2505352,2022720,1365983,1169792,1222665,10440899,913485,1807254,2720739,2056895,2463740,1997020,1345483,1232166,1696105,10791409,21232308,26815064,26815064
Canada,1989,CA,CAN,AMR,971702,1927295,2898997,2108293,2550603,2097800,1412687,1179939,1260883,10610205,925783,1829058,2754841,2018205,2507814,2080542,1390528,1232497,1750782,10980368,21590573,27244406,27244406
Canada,1990,CA,CAN,AMR,987691,1948677,2936368,2076033,2572770,2173304,1463808,1188256,1300375,10774546,941360,1849991,2791351,1987583,2527886,2162621,1441113,1231524,1804200,11154927,21929473,27657204,27657204
Canada,1991,CA,CAN,AMR,1003495,1968145,2971640,2055182,2567036,2235758,1524963,1195624,1338034,10916597,956930,1869993,2826923,1964973,2517826,2229278,1504259,1231348,1852910,11300594,22217191,28015761,28015761
Canada,1992,CA,CAN,AMR,1018732,1987952,3006684,2042548,2540672,2283034,1598735,1202075,1372909,11039973,971002,1889141,2860143,1952631,2491593,2281291,1582941,1234112,1898268,11440836,22480809,28347641,28347641
Canada,1993,CA,CAN,AMR,1028467,2006747,3035214,2036200,2505136,2329424,1675016,1210756,1406003,11162535,979290,1907021,2886311,1946659,2457801,2331419,1665862,1241597,1940770,11584108,22746643,28668166,28668166
Canada,1994,CA,CAN,AMR,1027337,2025539,3052876,2036412,2467689,2381705,1747977,1222654,1438651,11295088,977434,1925396,2902830,1946088,2419893,2385049,1745694,1253346,1980331,11730401,23025489,28981189,28981189
Canada,1995,CA,CAN,AMR,1017378,2044980,3062358,2041882,2427316,2437167,1819043,1235956,1472418,11433782,967709,1943910,2911619,1951169,2380313,2440766,1822260,1267902,2019261,11881671,23315453,29289423,29289423
Canada,1996,CA,CAN,AMR,1002334,2063948,3066282,2052202,2384117,2493808,1889483,1252239,1507601,11579450,953274,1961535,2914809,1959844,2337755,2495875,1895776,1286276,2057784,12033310,23612760,29593849,29593849
Canada,1997,CA,CAN,AMR,982448,2080945,3063393,2066644,2335029,2547889,1959165,1275037,1543682,11727446,934060,1977896,2911956,1970640,2289006,2546630,1967492,1310973,2095210,12179951,23907397,29882752,29882752
Canada,1998,CA,CAN,AMR,959421,2092274,3051695,2085215,2277886,2594229,2027075,1306562,1577852,11868819,912907,1989558,2902465,1985517,2234553,2588550,2039151,1343856,2130208,12321835,24190654,30144812,30144812
Canada,1999,CA,CAN,AMR,936926,2096396,3033322,2109327,2225869,2629037,2096328,1344981,1608268,12013810,893010,1994703,2887713,2005959,2183461,2617677,2113823,1382986,2161031,12464937,24478747,30399778,30399778
Canada,2000,CA,CAN,AMR,916656,2097091,3013747,2137376,2194635,2650467,2167202,1389323,1639610,12178613,874472,1996957,2871429,2030419,2148165,2632125,2189696,1427067,2192045,12619517,24798130,30683313,30683313
Canada,2001,CA,CAN,AMR,898562,2098591,2997153,2165250,2184895,2656826,2231306,1448012,1673638,12359927,857146,1999071,2856217,2056444,2133500,2630926,2257039,1485656,2225895,12789460,25149387,31002763,31002763
Canada,2002,CA,CAN,AMR,883924,2098776,2982700,2188934,2184262,2647178,2286043,1523610,1706710,12536737,842617,1998751,2841368,2079766,2131302,2615463,2313139,1562662,2259258,12961590,25498327,31322398,31322398
Canada,2003,CA,CAN,AMR,876047,2090052,2966099,2210281,2183355,2625715,2339356,1602701,1740362,12701770,833689,1990793,2824482,2100304,2132946,2590163,2366173,1644299,2293217,13127102,25828872,31619450,31619450
Canada,2004,CA,CAN,AMR,875216,2069575,2944791,2234590,2183090,2600697,2396536,1677501,1776693,12869107,830725,1972717,2803442,2122759,2138749,2560816,2421067,1721869,2329062,13294322,26163429,31911668,31911668
Canada,2005,CA,CAN,AMR,879562,2040664,2920226,2261908,2185949,2573730,2457462,1749983,1817588,13046620,832760,1945693,2778453,2148083,2149833,2529490,2477618,1796792,2368802,13470618,26517238,32215916,32215916
Canada,2006,CA,CAN,AMR,888598,2010097,2898695,2284865,2195399,2539140,2520326,1820745,1865482,13225957,840671,1914357,2755028,2172847,2167862,2493609,2533625,1868850,2415393,13652186,26878143,32531867,32531867
Canada,2007,CA,CAN,AMR,902129,1984281,2886410,2297583,2216368,2493851,2583247,1890070,1919981,13401100,854978,1885381,2740359,2193895,2196385,2451933,2586332,1937494,2468556,13834595,27235695,32862459,32862459
Canada,2008,CA,CAN,AMR,919572,1963627,2883199,2305446,2249258,2442017,2642332,1960235,1980471,13579759,873595,1861787,2735382,2211161,2234688,2407687,2633502,2005477,2527689,14020204,27599963,33218541,33218541
Canada,2009,CA,CAN,AMR,939001,1945232,2884233,2315653,2287424,2392258,2688525,2035283,2045506,13764649,893298,1842256,2735554,2226829,2276723,2367994,2669892,2076737,2591310,14209485,27974134,33593917,33593917
Canada,2010,CA,CAN,AMR,957437,1928544,2885981,2327727,2321400,2354157,2713360,2113015,2116427,13946086,911493,1825970,2737463,2240251,2314625,2341510,2688733,2148689,2660066,14393874,28339960,33963412,33963412
Canada,2011,CA,CAN,AMR,971534,1919333,2890867,2339658,2350173,2335008,2715584,2181175,2200623,14122221,925779,1818534,2744313,2244190,2345495,2333933,2689495,2212716,2740301,14566130,28688351,34323531,34323531
Canada,2012,CA,CAN,AMR,980074,1922933,2903007,2349314,2379806,2332968,2700610,2236792,2299662,14299152,934791,1825763,2760554,2234352,2371368,2341555,2678610,2269748,2833530,14729163,29028315,34691878,34691878
Canada,2013,CA,CAN,AMR,984377,1936924,2921301,2351824,2412491,2337751,2676050,2290676,2403275,14472067,939275,1844746,2784021,2216064,2393660,2354857,2661521,2328896,2931313,14886311,29358378,35063691,35063691
Canada,2014,CA,CAN,AMR,986028,1954795,2940823,2343299,2444214,2341203,2646504,2346893,2502932,14625045,941264,1868614,2809878,2192466,2410435,2368215,2640307,2391447,3025991,15028861,29653906,35404608,35404608
Canada,2015,CA,CAN,AMR,988284,1974599,2962883,2328459,2475436,2344837,2612979,2403635,2600663,14766009,943837,1894903,2838740,2168927,2423749,2381976,2615411,2454724,3119707,15164494,29930503,35732126,35732126
Canada,2016,CA,CAN,AMR,992116,1998061,2990177,2321285,2513579,2357823,2575336,2459574,2701497,14929094,947017,1922456,2869473,2159309,2443639,2401281,2585385,2515738,3219433,15324785,30253879,36113532,36113532
Canada,2017,CA,CAN,AMR,993942,2023622,3017564,2330042,2559552,2386315,2531194,2512107,2806063,15125273,947272,1947767,2895039,2168322,2474131,2430098,2547044,2569959,3326911,15516465,30641738,36554348,36554348
Canada,2018,CA,CAN,AMR,992511,2049698,3042209,2350234,2612214,2430199,2482295,2559358,2914223,15348523,944592,1971037,2915629,2188432,2512254,2468187,2503440,2616252,3440328,15728893,31077416,37035254,37035254
Canada,2019,CA,CAN,AMR,988982,2075096,3064078,2366218,2665949,2482647,2437543,2596618,3028089,15577064,940496,1993103,2933599,2206061,2552140,2511389,2464797,2652336,3561123,15947846,31524910,37522584,37522584
Canada,2020,CA,CAN,AMR,982092,2090728,3072820,2350869,2706066,2530189,2405681,2617637,3143280,15753722,933606,2005890,2939496,2201679,2578331,2549176,2438523,2671285,3683673,16122667,31876389,37888705,37888705
Canada,2021,CA,CAN,AMR,974676,2094585,3069261,2314897,2734612,2570943,2390575,2620206,3259510,15890743,926562,2007244,2933806,2184242,2591475,2579611,2427723,2670860,3807287,16261198,32151941,38155012,38155012
Canada,2022,CA,CAN,AMR,972147,2091847,3063994,2289926,2765516,2611880,2389687,2606661,3382649,16046319,924316,2001753,2926069,2177882,2607525,2609940,2430115,2655610,3936866,16417938,32464257,38454327,38454327
Canada,2023,CA,CAN,AMR,975006,2082268,3057274,2273725,2797649,2654740,2396848,2584182,3510438,16217582,926990,1990080,2917070,2178629,2627518,2641381,2439450,2632728,4069654,16589360,32806942,38781291,38781291
Canada,2024,CA,CAN,AMR,981516,2068875,3050391,2257111,2823863,2700314,2408575,2559363,3639159,16388385,932847,1975381,2908228,2176459,2645955,2673406,2452921,2607442,4203856,16760039,33148424,39107046,39107046
Canada,2025,CA,CAN,AMR,990272,2055994,3046266,2241632,2839670,2747209,2425084,2533230,3768917,16555742,940826,1961439,2902265,2172027,2659130,2705730,2470480,2580430,4339378,16927175,33482917,39431447,39431447
Canada,2026,CA,CAN,AMR,999402,2045796,3045198,2236887,2839429,2792287,2448207,2503886,3898250,16718946,949151,1950317,2899468,2173248,2662487,2736031,2493441,2550658,4474296,17090161,33809107,39753766,39753766
Canada,2027,CA,CAN,AMR,1007697,2037903,3045600,2244730,2824715,2834058,2480295,2468499,4025941,16878238,956735,1941773,2898508,2182698,2656826,2762477,2523898,2515865,4607326,17249090,34127328,40071427,40071427
Canada,2028,CA,CAN,AMR,1015671,2032092,3047763,2256565,2803883,2872816,2520678,2427727,4152375,17034044,964048,1935505,2899553,2193977,2649230,2785335,2559902,2477036,4739042,17404522,34438566,40385878,40385878
Canada,2029,CA,CAN,AMR,1023380,2029140,3052520,2267509,2779261,2910472,2565160,2389542,4273933,17185877,971124,1931998,2903122,2203654,2641181,2806531,2596968,2441696,4865974,17556004,34741881,40697516,40697516
Canada,2030,CA,CAN,AMR,1030028,2029339,3059367,2277743,2751725,2948344,2610498,2363213,4383681,17335204,977247,1931662,2908909,2212148,2631943,2828304,2632975,2418352,4981405,17705127,35040331,41008596,41008596
Canada,1950,CA,CAN,AMR,840084,1246403,2086487,1089013,1059496,921328,715570,557611,537396,4880414,805051,1202391,2007442,1087940,1085736,889879,669793,514318,521063,4768729,9649143,13743069,13743069
Canada,1951,CA,CAN,AMR,878742,1300417,2179159,1080784,1074741,951890,731829,558889,554949,4953082,842071,1250892,2092963,1082222,1110906,921301,682901,522226,540963,4860519,9813601,14085724,14085724
Canada,1952,CA,CAN,AMR,911167,1366886,2278053,1090120,1101006,981345,752173,563305,570665,5058614,871806,1311964,2183770,1086190,1135393,952507,700028,532034,559152,4965304,10023918,14485745,14485745
Canada,1953,CA,CAN,AMR,939117,1437122,2376239,1107197,1131096,1008848,773942,569056,585439,5175578,897753,1377875,2275628,1095936,1156740,982407,719394,542577,577025,5074079,10249657,14901525,14901525
Canada,1954,CA,CAN,AMR,966641,1511055,2477696,1123925,1159901,1034902,795958,575213,599697,5289596,924590,1448979,2373569,1108492,1175466,1011426,739245,552521,595187,5182337,10471933,15323201,15323201
Canada,1955,CA,CAN,AMR,991531,1585917,2577448,1139774,1186193,1058452,817834,581696,613479,5397428,950356,1522966,2473322,1123290,1192002,1038453,758089,560553,613337,5285724,10683152,15733923,15733923
Canada,1956,CA,CAN,AMR,1019561,1659978,2679539,1163200,1212550,1081817,840707,589594,625883,5513751,978429,1596007,2574436,1145052,1208884,1066326,779111,568786,631154,5399313,10913064,16167047,16167047
Canada,1957,CA,CAN,AMR,1057269,1735716,2792985,1197898,1237602,1106837,864923,599519,636007,5642786,1013646,1668507,2682153,1176867,1224466,1096990,805178,579569,649054,5532124,11174910,16650052,16650052
Canada,1958,CA,CAN,AMR,1093357,1810035,2903392,1231431,1254073,1131095,890059,611480,645508,5763646,1046626,1737917,2784543,1209115,1231553,1126606,833999,592686,667847,5661806,11425452,17113389,17113389
Canada,1959,CA,CAN,AMR,1118387,1880891,2999278,1260273,1261206,1153138,915523,625870,655914,5871924,1069353,1803424,2872777,1238017,1230522,1153669,864089,607425,687207,5780929,11652853,17524906,17524906
Canada,1960,CA,CAN,AMR,1137563,1949900,3087463,1289250,1261508,1173344,938886,641033,666899,5970920,1086814,1867088,2953902,1269095,1226816,1178231,893828,622011,707089,5897070,11867990,17909356,17909356
Canada,1961,CA,CAN,AMR,1154302,2011368,3165670,1326607,1255485,1191569,959201,656195,676825,6065882,1102731,1924134,3026865,1309238,1221095,1199572,921133,637158,727077,6015273,12081155,18273684,18273684
Canada,1962,CA,CAN,AMR,1166902,2062224,3229126,1380183,1244182,1207458,976892,671841,685074,6165630,1114751,1972766,3087517,1363883,1213112,1217222,945223,654251,746381,6140072,12305702,18622345,18622345
Canada,1963,CA,CAN,AMR,1172596,2109069,3281665,1446298,1233354,1223013,992666,688216,692643,6276190,1119371,2017890,3137261,1430103,1207536,1232355,967613,672764,765522,6275893,12552083,18971005,18971005
Canada,1964,CA,CAN,AMR,1168803,2154728,3323531,1517304,1229464,1240041,1008022,705873,701001,6401705,1113876,2061442,3175318,1500953,1208991,1246460,990480,692836,786049,6425769,12827474,19326326,19326326
Canada,1965,CA,CAN,AMR,1152819,2200466,3353285,1589337,1236078,1257925,1024615,725039,710898,6543892,1095329,2106195,3201524,1573855,1218785,1258872,1014499,714861,809227,6590099,13133991,19688805,19688805
Canada,1966,CA,CAN,AMR,1123757,2244489,3368246,1666592,1254633,1274132,1042598,745809,720829,6704593,1065548,2149160,3214708,1649871,1237349,1267353,1039823,739408,833877,6767681,13472274,20055232,20055232
Canada,1967,CA,CAN,AMR,1084698,2281787,3366485,1749591,1282779,1285188,1061030,768198,730720,6877506,1029312,2183602,3212914,1726513,1263486,1269469,1066179,766673,858825,6951145,13828651,20408050,20408050
Canada,1968,CA,CAN,AMR,1040452,2311112,3351564,1828892,1317443,1289739,1079751,791522,741781,7049128,989179,2209630,3198809,1798496,1296175,1265120,1092498,795748,884393,7132430,14181558,20731929,20731929
Canada,1969,CA,CAN,AMR,997414,2330012,3327426,1900026,1359567,1289723,1098921,814546,754239,7217022,950247,2226569,3176816,1865631,1335729,1256882,1117796,825329,911308,7312675,14529697,21033940,21033940
Canada,2031,CA,CAN,AMR,1035902,2032631,3068533,2284844,2726763,2985688,2655478,2352448,4476938,17482159,982661,1934513,2917174,2216937,2625960,2850320,2667409,2410556,5080831,17852013,35334172,41319872,41319872
Canada,2032,CA,CAN,AMR,1041312,2039472,3080784,2284497,2708542,3021762,2698882,2354316,4555554,17623553,987659,1940913,2928572,2213967,2626468,2871594,2700074,2414795,5166509,17993407,35616960,41626319,41626319
Canada,2033,CA,CAN,AMR,1045680,2050716,3096396,2276372,2694913,3055162,2742302,2363194,4626347,17758290,991715,1951296,2943011,2203828,2629547,2892775,2732033,2425117,5245288,18128588,35886878,41926289,41926289
Canada,2034,CA,CAN,AMR,1049145,2065346,3114491,2264119,2680757,3082687,2788399,2376487,4694301,17886750,994928,1964635,2959563,2190314,2629627,2912412,2764595,2439516,5321535,18257999,36144749,42218806,42218806
Canada,2035,CA,CAN,AMR,1052342,2081053,3133395,2252018,2667561,3099894,2835832,2394448,4760525,18010278,997892,1979031,2976923,2177174,2627313,2926833,2797488,2457966,5395834,18382608,36392886,42503204,42503204
Canada,2036,CA,CAN,AMR,1055572,2096205,3151777,2242344,2664842,3101170,2881474,2418769,4822023,18130622,1000879,1992912,2993791,2166582,2630480,2931476,2828401,2481699,5465332,18503970,36634592,42780162,42780162
Canada,2037,CA,CAN,AMR,1059159,2110091,3169250,2234945,2674787,3088375,2923988,2451686,4875275,18249056,1004195,2005665,3009860,2158516,2642051,2927429,2855627,2512741,5526643,18623007,36872063,43051176,43051176
Canada,2038,CA,CAN,AMR,1062849,2122649,3185498,2229616,2688683,3069639,2963606,2492544,4921500,18365588,1007623,2017241,3024864,2152719,2655452,2921602,2879365,2549167,5581341,18739646,37105234,43315598,43315598
Canada,2039,CA,CAN,AMR,1066310,2134066,3200376,2227041,2701455,3047126,3002148,2537327,4964886,18479983,1010853,2027779,3038632,2149564,2667014,2915320,2901472,2586638,5633778,18853786,37333769,43572770,43572770
Canada,2040,CA,CAN,AMR,1069768,2144090,3213858,2227432,2712678,3021066,3040605,2582809,5007969,18592559,1014078,2037039,3051117,2149382,2676507,2907203,2923874,2622968,5685508,18965442,37558001,43822969,43822969
Canada,2041,CA,CAN,AMR,1073202,2153118,3226320,2230100,2719084,2996266,3077925,2627637,5049944,18700956,1017292,2045358,3062650,2151511,2680509,2901055,2945960,2657518,5735792,19072345,37773301,44062266,44062266
Canada,2042,CA,CAN,AMR,1076020,2161874,3237894,2235709,2717137,2977548,3113671,2670729,5090145,18804939,1019942,2053425,3073367,2156537,2675792,2900792,2967040,2690211,5783966,19174338,37979277,44290533,44290533
Canada,2043,CA,CAN,AMR,1078076,2169652,3247728,2245837,2707373,2963273,3146708,2713798,5130119,18907108,1021861,2060625,3082486,2165677,2663819,2902971,2987976,2722185,5831037,19273665,38180773,44510982,44510982
Canada,2044,CA,CAN,AMR,1079811,2176285,3256096,2259502,2693568,2948511,3173988,2759548,5172411,19007528,1023481,2066774,3090255,2177942,2648544,2902203,3007423,2754813,5879744,19370669,38378197,44724547,44724547
Canada,2045,CA,CAN,AMR,1081264,2182639,3263903,2274403,2680033,2934785,3191145,2806718,5218650,19105734,1024848,2072664,3097512,2191441,2633761,2899139,3021752,2787862,5931080,19465035,38570769,44932177,44932177
Canada,2046,CA,CAN,AMR,1082082,2189097,3271179,2288903,2668980,2931465,3192549,2852204,5267797,19201898,1025632,2078660,3104292,2204595,2621579,2901546,3026382,2819000,5983698,19556800,38758698,45134172,45134172
Canada,2047,CA,CAN,AMR,1082394,2195386,3277780,2302263,2660133,2940556,3179940,2894609,5318667,19296168,1025934,2084510,3110444,2216761,2611849,2912174,3022302,2846495,6036667,19646248,38942416,45330641,45330641
Canada,2048,CA,CAN,AMR,1082825,2200974,3283799,2314392,2653285,2953390,3161357,2934154,5371849,19388427,1026327,2089700,3116027,2227855,2604301,2924442,3016357,2870536,6089939,19733430,39121857,45521680,45521680
Canada,2049,CA,CAN,AMR,1083275,2205996,3289271,2325476,2649252,2965041,3139013,2972670,5427801,19479253,1026735,2094374,3121109,2238017,2599469,2934812,3009919,2892958,6143468,19818643,39297896,45708266,45708266
Canada,2050,CA,CAN,AMR,1083440,2210703,3294143,2335239,2648289,2975105,3113158,3011120,5486121,19569032,1026878,2098769,3125647,2246982,2597711,2943051,3001632,2915650,6196973,19901999,39471031,45890819,45890819
Switzerland,1970,CH,CHE,EUR,256169,493028,749197,478790,476235,396864,333441,300667,284502,2270499,245352,474519,719871,473438,459226,400714,349540,341212,417525,2441655,4712154,6181227,6181227
Switzerland,1971,CH,CHE,EUR,251441,501114,752555,468263,480543,403879,339593,299020,291480,2282778,240414,481709,722123,465262,466489,402877,356041,337299,428286,2456254,4739032,6213708,6213708
Switzerland,1972,CH,CHE,EUR,246009,506569,752578,466744,490459,407819,345572,295986,298859,2305439,233740,485574,719314,466738,476612,405044,363595,332565,439264,2483818,4789257,6261153,6261153
Switzerland,1973,CH,CHE,EUR,237916,510212,748128,466993,501141,411733,351686,292465,306599,2330617,225643,488620,714263,470495,486730,407408,371441,327125,451160,2514359,4844976,6307361,6307361
Switzerland,1974,CH,CHE,EUR,228737,512300,741037,465080,509254,416554,357575,289351,314275,2352089,216603,490442,707045,470812,495610,410380,378787,322160,463292,2541041,4893130,6341217,6341217
Switzerland,1975,CH,CHE,EUR,217655,510319,727974,461653,510507,418448,360712,288630,321596,2361546,205879,488066,693945,466946,498525,411438,382571,320282,475038,2554800,4916346,6338267,6338267
Switzerland,1976,CH,CHE,EUR,204700,503732,708432,459763,505006,417788,360328,290285,328017,2361187,194122,480934,675056,462869,494058,411205,382185,321236,485854,2557407,4918594,6302074,6302074
Switzerland,1977,CH,CHE,EUR,194516,494626,689142,462673,498423,420516,360593,291719,334398,2368322,184918,471745,656663,462851,489573,413780,381668,322326,496515,2566713,4935035,6280837,6280837
Switzerland,1978,CH,CHE,EUR,188101,483676,671777,469269,492308,427028,362355,292761,340880,2384601,178912,460815,639727,466173,487030,419414,382427,323514,506860,2585418,4970019,6281526,6281526
Switzerland,1979,CH,CHE,EUR,183713,470842,654555,478751,486622,435799,365467,293848,346814,2407301,174986,448085,623071,472325,484611,427020,383569,325491,516245,2609261,5016562,6294186,6294186
Switzerland,1980,CH,CHE,EUR,182291,456714,639005,489534,482726,445646,369759,296301,351069,2435035,173845,434721,608566,479960,483346,435382,384985,329349,523489,2636511,5071546,6319113,6319113
Switzerland,1981,CH,CHE,EUR,183680,442461,626141,499342,481244,456765,374156,300648,353494,2465649,174704,421395,596099,487599,482849,444999,386655,335525,528182,2665809,5131458,6353698,6353698
Switzerland,1982,CH,CHE,EUR,185392,429231,614623,506516,482077,468686,378161,305604,355684,2496728,176267,408412,584679,493409,482885,455997,388465,342193,531972,2694921,5191649,6390952,6390952
Switzerland,1983,CH,CHE,EUR,186800,416663,603463,510003,483064,479481,381901,310319,357393,2522161,178023,395926,573949,495509,483011,466655,389966,348533,535166,2718840,5241001,6418413,6418413
Switzerland,1984,CH,CHE,EUR,188173,405216,593389,511406,484568,488520,385698,314678,359444,2544314,179103,384982,564085,495394,483726,475606,391534,354255,539146,2739661,5283975,6441449,6441449
Switzerland,1985,CH,CHE,EUR,188661,396116,584777,511685,488698,496745,389315,317755,363705,2567903,179654,376836,556490,493960,486549,483014,393482,357585,546064,2760654,5328557,6469824,6469824
Switzerland,1986,CH,CHE,EUR,188795,389345,578140,509961,496016,502840,394267,319090,369701,2591875,180573,370802,551375,491363,491995,488552,397063,358098,555069,2782140,5374015,6503528,6503528
Switzerland,1987,CH,CHE,EUR,189600,385068,574668,505345,506353,506174,401904,320862,375462,2616100,181724,367198,548922,487354,499789,492279,403197,358430,563717,2804766,5420866,6544453,6544453
Switzerland,1988,CH,CHE,EUR,191876,383423,575299,497534,518336,508490,411614,323394,380594,2639962,183776,366099,549875,480350,509598,495124,411060,359465,571943,2827540,5467502,6592671,6592671
Switzerland,1989,CH,CHE,EUR,194953,384094,579047,487378,532184,510291,422331,326666,385209,2664059,186871,366511,553382,470599,521303,497123,420054,360474,580164,2849717,5513776,6646208,6646208
Switzerland,1990,CH,CHE,EUR,199613,387228,586841,476364,548238,513104,433339,330532,389484,2691061,191030,369672,560702,460760,534084,499728,429300,361481,587732,2873085,5564146,6711693,6711693
Switzerland,1991,CH,CHE,EUR,206239,392380,598619,464952,566886,517592,444489,333648,393599,2721166,196637,373885,570522,451926,553547,503556,438707,362288,595075,2905099,5626265,6795393,6795393
Switzerland,1992,CH,CHE,EUR,212440,398810,611250,454164,580477,522446,455498,335699,397811,2746095,202041,378851,580892,442914,570432,507749,448941,362852,602049,2934937,5681032,6873179,6873179
Switzerland,1993,CH,CHE,EUR,216412,406562,622974,444706,586013,527582,466557,338332,402332,2765522,205354,386106,591460,433571,578274,511986,459819,363881,608634,2956165,5721687,6936121,6936121
Switzerland,1994,CH,CHE,EUR,217769,413972,631741,436126,587876,533812,476694,342116,407315,2783939,206396,392781,599177,425205,583210,517445,469685,365486,615660,2976691,5760630,6991538,6991538
Switzerland,1995,CH,CHE,EUR,217380,420473,637853,429594,585206,540819,485786,345912,412924,2800241,206090,398360,604450,419047,583927,524797,478119,367297,622565,2995752,5795993,7038297,7038297
Switzerland,1996,CH,CHE,EUR,215458,425945,641403,424274,577486,548691,491902,350316,418728,2811397,204405,403106,607511,412984,580094,533444,483848,370306,628704,3009380,5820777,7069691,7069691
Switzerland,1997,CH,CHE,EUR,212239,429734,641973,420107,565679,557387,494287,356906,424731,2819097,201302,406384,607686,407436,571724,542456,487010,375355,634267,3018248,5837345,7086998,7086998
Switzerland,1998,CH,CHE,EUR,208718,432629,641347,418530,551859,567341,495536,365875,431117,2830258,198046,408773,606819,404809,560008,552696,489437,382500,640347,3029797,5860055,7108221,7108221
Switzerland,1999,CH,CHE,EUR,206378,435171,641549,419712,537540,579282,496709,376120,438349,2847712,195962,410873,606835,404873,547001,564896,491534,391029,646768,3046101,5893813,7142198,7142198
Switzerland,2000,CH,CHE,EUR,205033,436718,641751,422699,523288,590761,498315,386554,446274,2867891,194348,412118,606466,407376,534494,577096,494088,399780,653121,3065955,5933846,7182059,7182059
Switzerland,2001,CH,CHE,EUR,198818,436013,634831,426299,516029,600518,501233,397220,454216,2895515,188342,412812,601154,412469,525083,589181,496981,408836,660350,3092900,5988415,7224403,7224403
Switzerland,2002,CH,CHE,EUR,192209,435511,627720,430475,512149,609480,506416,409038,461815,2929373,181917,413624,595541,417967,518215,600479,501254,419367,666567,3123849,6053222,7276480,7276480
Switzerland,2003,CH,CHE,EUR,190237,435095,625332,435771,504586,616564,512648,421372,469500,2960441,179600,412872,592472,423141,511036,609323,506483,430835,671669,3152487,6112928,7330729,7330729
Switzerland,2004,CH,CHE,EUR,188603,432846,621449,441508,497901,620729,519857,432596,478510,2991101,177992,410165,588157,428434,504461,615123,512949,441099,678372,3180438,6171539,7381151,7381151
Switzerland,2005,CH,CHE,EUR,187859,428687,616546,446791,493071,621901,528565,442913,488225,3021466,177403,405648,583051,432592,499486,617303,521539,450156,686302,3207378,6228844,7428435,7428435
Switzerland,2006,CH,CHE,EUR,187985,422843,610828,451858,490045,620987,539400,450727,499477,3052494,177616,399798,577414,436458,496027,616692,532115,457033,695948,3234273,6286767,7475010,7475010
Switzerland,2007,CH,CHE,EUR,188975,417776,606751,458000,492963,620171,553207,455753,513758,3093852,178716,394413,573129,441643,497262,614978,544574,462011,707707,3268175,6362027,7541904,7541904
Switzerland,2008,CH,CHE,EUR,191683,414586,606269,465269,502736,619015,570771,460196,529990,3147977,181278,390880,572158,447834,504476,612260,559680,466450,721185,3311885,6459862,7638288,7638288
Switzerland,2009,CH,CHE,EUR,195234,412403,607637,470205,512248,613922,590154,464602,547134,3198265,184216,388817,573033,452603,512714,607049,576884,470468,735749,3355467,6553732,7734405,7734405
Switzerland,2010,CH,CHE,EUR,198826,410962,609788,474521,524064,604022,607985,468569,563367,3242528,187662,388769,576431,456692,520222,599200,593108,474449,750014,3393685,6636213,7822435,7822435
Switzerland,2011,CH,CHE,EUR,202708,409761,612469,478354,537106,594557,623277,473409,580198,3286901,191749,388725,580474,459729,528315,591362,607774,478452,765499,3431131,6718032,7910982,7910982
Switzerland,2012,CH,CHE,EUR,206384,408782,615166,479667,546578,589098,635743,480122,598661,3329869,194985,387695,582680,460521,536468,585115,620537,483598,781775,3468014,6797883,7995738,7995738
Switzerland,2013,CH,CHE,EUR,209927,409899,619826,480034,556897,586535,646784,488053,616884,3375187,198204,388641,586845,460507,545804,580706,631924,490080,797479,3506500,6881687,8088367,8088367
Switzerland,2014,CH,CHE,EUR,213347,412800,626147,479213,567801,586129,655947,497860,634633,3421583,201715,391012,592727,459482,556141,578560,641261,498579,813314,3547337,6968920,8187791,8187791
Switzerland,2015,CH,CHE,EUR,216358,416059,632417,478358,576931,588010,661424,509074,651269,3465066,204424,394305,598729,457629,564977,578931,646927,509060,827992,3585516,7050582,8281732,8281732
Switzerland,2016,CH,CHE,EUR,219545,420543,640088,479147,585289,590975,663306,521742,666813,3507272,207154,398927,606081,454313,572012,581008,649552,521177,841398,3619460,7126732,8372898,8372898
Switzerland,2017,CH,CHE,EUR,222166,426189,648355,477450,591311,594254,661319,535674,681601,3541609,209898,404070,613968,448712,576909,584492,648876,534241,854532,3647762,7189371,8451687,8451687
Switzerland,2018,CH,CHE,EUR,223894,431777,655671,471858,594045,598629,655012,550783,695917,3566244,212058,408987,621045,442884,579715,589085,644226,547998,867568,3671476,7237720,8514434,8514434
Switzerland,2019,CH,CHE,EUR,224724,437654,662378,466883,595897,604343,645782,567446,710490,3590841,213211,414078,627289,438691,580974,594551,636608,563385,880875,3695084,7285925,8575588,8575588
Switzerland,2020,CH,CHE,EUR,224485,443895,668380,464075,597634,611986,636091,583604,724229,3617619,213077,419496,632573,436030,581553,601859,628637,578531,893420,3720030,7337649,8638613,8638613
Switzerland,2021,CH,CHE,EUR,223986,448743,672729,460458,595043,619200,626811,599130,740622,3641264,212508,424183,636691,432385,577596,608364,621098,593548,907731,3740722,7381986,8691406,8691406
Switzerland,2022,CH,CHE,EUR,223561,451910,675471,456566,588828,624816,618921,613801,762030,3664962,212143,427519,639662,429551,569899,613275,613947,608013,925688,3760373,7425335,8740472,8740472
Switzerland,2023,CH,CHE,EUR,223264,454361,677625,455664,582160,631037,613041,626132,785023,3693057,212026,430137,642163,429969,561643,619041,607793,620516,944861,3783823,7476880,8796669,8796669
Switzerland,2024,CH,CHE,EUR,223143,455705,678848,456334,574195,637063,608721,635741,809144,3721198,211962,431857,643819,431732,552169,624512,603068,630513,965568,3807562,7528760,8851431,8851431
Switzerland,2025,CH,CHE,EUR,223436,456038,679474,457209,566344,641515,607235,642079,834602,3748984,212505,431935,644440,434253,542856,628384,601127,637022,988065,3831707,7580691,8904610,8904610
Switzerland,2026,CH,CHE,EUR,223044,456669,679713,459080,557608,644626,608122,645257,861458,3776151,212397,432319,644716,437530,533123,631003,601223,640679,1011985,3855543,7631694,8956124,8956124
Switzerland,2027,CH,CHE,EUR,221825,457603,679428,462479,548480,646337,610534,645138,889878,3802846,211231,433766,644997,441374,523304,632242,603163,641157,1037453,3878693,7681539,9005960,9005960
Switzerland,2028,CH,CHE,EUR,220394,458240,678634,466458,540545,646283,614654,640934,920049,3828923,209862,434924,644786,445451,514994,631839,606661,637772,1064794,3901511,7730434,9053856,9053856
Switzerland,2029,CH,CHE,EUR,218791,458407,677198,470766,534317,644299,619711,633552,951842,3854487,208327,435445,643772,449542,509313,629259,610891,631281,1094019,3924305,7778792,9099767,9099767
Switzerland,2030,CH,CHE,EUR,217137,457585,674722,475031,530055,640631,625705,624887,983637,3879946,206734,435178,641912,453432,505655,624667,616347,623750,1123262,3947113,7827059,9143698,9143698
Switzerland,1950,CH,CHE,EUR,214952,349501,564453,332600,328549,343699,294900,206450,190741,1696939,205151,337801,542952,347150,343350,363800,331700,247501,254797,1888298,3585237,4692639,4692639
Switzerland,1951,CH,CHE,EUR,213302,361701,575003,333051,333751,340849,301301,210601,194251,1713804,203505,349150,552655,347099,349702,359751,337001,252850,260230,1906633,3620437,4748093,4748093
Switzerland,1952,CH,CHE,EUR,212206,374751,586957,335050,341254,337551,307151,215502,197569,1734077,202407,361150,563557,350050,356051,355302,341350,258698,265576,1927027,3661104,4811622,4811622
Switzerland,1953,CH,CHE,EUR,211508,387851,599359,337051,348602,333652,313301,220353,201057,1754016,201707,373102,574809,352903,362454,350052,345952,264896,271278,1947535,3701551,4875717,4875717
Switzerland,1954,CH,CHE,EUR,211360,400102,611462,339500,355555,329850,318854,225703,204255,1773717,201710,384299,586009,355452,368706,345002,350098,271397,277109,1967764,3741481,4938947,4938947
Switzerland,1955,CH,CHE,EUR,212061,411904,623965,341847,360604,328148,323651,231953,207013,1793216,202611,394649,597260,357651,373055,342801,353400,278398,282663,1987968,3781184,5002410,5002410
Switzerland,1956,CH,CHE,EUR,214159,420956,635115,346500,363402,329098,327202,238253,209887,1814342,204610,402605,607215,361349,375208,343553,355251,285646,288272,2009279,3823621,5065953,5065953
Switzerland,1957,CH,CHE,EUR,217460,425706,643166,355497,366453,329597,329500,244553,213366,1838966,207712,407107,614819,368050,377605,344254,356299,292546,294872,2033626,3872592,5130575,5130575
Switzerland,1958,CH,CHE,EUR,220911,427760,648671,367702,369652,329245,332098,250504,217620,1866821,210811,409061,619872,377149,380753,344854,357701,298696,302398,2061551,3928372,5196912,5196912
Switzerland,1959,CH,CHE,EUR,224364,428010,652374,382054,372801,328946,334246,256054,222412,1896513,213763,409661,623424,387601,383756,346152,358500,304449,310491,2090949,3987462,5263258,5263258
Switzerland,1960,CH,CHE,EUR,227184,427155,654339,398335,376201,329918,334012,261677,226863,1927006,216643,409515,626158,399246,386344,349231,357024,310569,318360,2120774,4047780,5328273,5328273
Switzerland,1961,CH,CHE,EUR,231835,433222,665057,420426,383420,335677,331308,267318,231823,1969972,222082,417181,639263,416687,390628,356181,353246,316396,327245,2160383,4130355,5434676,5434676
Switzerland,1962,CH,CHE,EUR,238788,444729,683517,447147,393499,345106,327580,272752,236877,2022961,229460,430453,659913,439256,396854,365121,348695,321453,336451,2207830,4230791,5574217,5574217
Switzerland,1963,CH,CHE,EUR,246238,451898,698136,470711,402732,354633,323242,278285,240969,2070572,236831,437723,674554,460030,402662,374069,343217,326625,344811,2251414,4321986,5694676,5694676
Switzerland,1964,CH,CHE,EUR,254532,455322,709854,484689,411464,363058,319291,283486,246044,2108032,244751,440111,684862,473314,407761,382184,337969,331400,354377,2287005,4395037,5789744,5789744
Switzerland,1965,CH,CHE,EUR,263049,456979,720028,488168,417737,368346,318490,288247,251916,2132904,252274,440339,692613,477046,411649,386932,336108,335204,364570,2311509,4444413,5857047,5857047
Switzerland,1966,CH,CHE,EUR,269376,459701,729077,488817,424859,371381,321102,291907,257929,2155995,257503,442696,700199,477579,416470,388871,337832,337608,374947,2333307,4489302,5918581,5918581
Switzerland,1967,CH,CHE,EUR,271184,464999,736183,491211,436578,375988,323721,294565,265030,2187093,259006,448322,707328,479903,425038,391438,339883,339265,386209,2361736,4548829,5992334,5992334
Switzerland,1968,CH,CHE,EUR,268836,472971,741807,492153,451413,381749,326059,297474,271747,2220595,256618,455845,712463,482180,436393,394748,342027,341189,396804,2393341,4613936,6068204,6068204
Switzerland,1969,CH,CHE,EUR,262872,483052,745924,489216,467672,388230,328697,299916,277931,2251662,250859,464838,715697,481608,449574,397937,345095,342480,406821,2423515,4675177,6136799,6136799
Switzerland,2031,CH,CHE,EUR,215398,456270,671668,479003,526807,636201,632417,616236,1014128,3904792,205064,434186,639250,457507,502869,619019,622267,616522,1151668,3969852,7874644,9185565,9185565
Switzerland,2032,CH,CHE,EUR,213669,454840,668509,482410,524240,631284,638644,609130,1043011,3928719,203406,432864,636270,461088,501434,612602,627739,609888,1179351,3992102,7920821,9225604,9225604
Switzerland,2033,CH,CHE,EUR,212163,453119,665282,484868,523375,624697,644909,603781,1070158,3951788,201962,431383,633345,463710,501861,604395,633543,604075,1205963,4013547,7965335,9263953,9263953
Switzerland,2034,CH,CHE,EUR,210930,451405,662335,486223,524073,616811,650981,599941,1095637,3973666,200786,429790,630576,465436,503635,594973,639052,599670,1231361,4034127,8007793,9300709,9300709
Switzerland,2035,CH,CHE,EUR,209969,450046,660015,486566,524973,609044,655496,598853,1119161,3994093,199870,428745,628615,465521,506165,585714,642974,598005,1254853,4053232,8047325,9335953,9335953
Switzerland,2036,CH,CHE,EUR,209391,447920,657311,487210,526871,600395,658692,600077,1140949,4014194,199315,426969,626284,465913,509451,576032,645651,598333,1276699,4072079,8086273,9369870,9369870
Switzerland,2037,CH,CHE,EUR,209283,444976,654259,488150,530289,591351,660489,602770,1161062,4034111,199209,424152,623361,467365,513304,566265,646953,600467,1296765,4091119,8125230,9402847,9402847
Switzerland,2038,CH,CHE,EUR,209490,442047,651537,488797,534285,583489,660532,607091,1178979,4053173,199404,421345,620749,468527,517391,558005,646621,604116,1314743,4109403,8162576,9434849,9434849
Switzerland,2039,CH,CHE,EUR,209940,439220,649160,488976,538605,577327,658659,612299,1195454,4071320,199832,418640,618472,469053,521484,552363,644119,608471,1331431,4126921,8198241,9465878,9465878
Switzerland,2040,CH,CHE,EUR,210689,436607,647296,488167,542886,573125,655112,618409,1210795,4088494,200542,416136,616678,468793,525385,548740,639613,614034,1347069,4143634,8232128,9496104,9496104
Switzerland,2041,CH,CHE,EUR,211705,434294,645999,486864,546874,569931,650810,625199,1225032,4104710,201508,413912,615420,467812,529468,545985,634059,620049,1362143,4159516,8264226,9525647,9525647
Switzerland,2042,CH,CHE,EUR,212837,432460,645297,485445,550296,567410,646021,631512,1239253,4119937,202590,412155,614745,466495,533056,544584,627740,625612,1377056,4174543,8294480,9554525,9554525
Switzerland,2043,CH,CHE,EUR,214082,431162,645244,483739,552776,566590,639583,637859,1253512,4134059,203775,410911,614686,465020,535687,545034,619637,631502,1391738,4188618,8322677,9582608,9582608
Switzerland,2044,CH,CHE,EUR,215468,430388,645856,482029,554150,567325,631858,644021,1267708,4147091,205084,410170,615254,463431,537423,546825,610333,637102,1406614,4201728,8348819,9609938,9609938
Switzerland,2045,CH,CHE,EUR,216886,430179,647065,480685,554517,568265,624253,648678,1282690,4159088,206418,409966,616384,462394,537521,549378,601190,641145,1422332,4213960,8373048,9636489,9636489
Switzerland,2046,CH,CHE,EUR,218242,430619,648861,478571,555184,570192,615777,652053,1298170,4169947,207700,410380,618080,460625,537921,552680,591631,643971,1438468,4225296,8395243,9662180,9662180
Switzerland,2047,CH,CHE,EUR,219550,431646,651196,475639,556148,573631,606905,654059,1313359,4179741,208942,411357,620299,457815,539381,556544,581981,645433,1454571,4235725,8415466,9686961,9686961
Switzerland,2048,CH,CHE,EUR,220786,433102,653888,472721,556815,577649,599197,654326,1327838,4188546,210118,412743,622861,455014,540553,560644,573827,645271,1469954,4245263,8433809,9710561,9710561
Switzerland,2049,CH,CHE,EUR,221844,434944,656788,469906,557015,581984,593173,652701,1341630,4196409,211132,414481,625613,452317,541094,564756,568276,642951,1484595,4253989,8450398,9732793,9732793
Switzerland,2050,CH,CHE,EUR,222770,437110,659880,467305,556231,586287,589085,649436,1355057,4203401,212021,416529,628550,449819,540842,568672,564732,638658,1499191,4261914,8465315,9753753,9753753
Chile,1970,CL,CHL,AMR,661865,1223498,1885363,968780,680674,577970,384454,245201,167154,3024233,645677,1205948,1851625,953429,658045,567816,395703,271703,212568,3059264,6083497,9820481,9820481
Chile,1971,CL,CHL,AMR,661471,1237934,1899405,995192,692023,580803,399999,250689,171790,3090496,644251,1219495,1863746,979947,670818,570772,411079,278298,219813,3130727,6221223,9984378,9984378
Chile,1972,CL,CHL,AMR,660610,1250095,1910705,1020609,706634,580739,417523,255776,176156,3157437,642328,1230701,1873029,1005702,686931,571322,428621,284665,227347,3204588,6362025,10145765,10145765
Chile,1973,CL,CHL,AMR,658544,1261408,1919952,1043856,724652,579459,436210,261206,181014,3226397,639725,1240820,1880545,1029526,706601,570789,447318,291072,235642,3280948,6507345,10307842,10307842
Chile,1974,CL,CHL,AMR,655757,1271415,1927172,1066475,745046,579437,454408,267648,186794,3299808,636416,1249365,1885781,1052617,728482,571053,465291,297976,244564,3359983,6659791,10472743,10472743
Chile,1975,CL,CHL,AMR,653178,1279367,1932545,1088686,767554,581521,470607,275102,193015,3376485,633261,1255597,1888858,1074996,752182,572992,481237,305786,254443,3441636,6818121,10639531,10639531
Chile,1976,CL,CHL,AMR,651392,1285085,1936477,1109671,791881,585406,484852,283064,198895,3453769,631050,1259276,1890326,1096159,777819,576569,495248,314158,264336,3524289,6978058,10804869,10804869
Chile,1977,CL,CHL,AMR,650352,1288856,1939208,1130198,816900,591322,497270,291250,205085,3532025,629526,1261018,1890544,1116753,804344,582084,507531,322810,274553,3608075,7140100,10969861,10969861
Chile,1978,CL,CHL,AMR,650523,1291001,1941524,1150065,842343,599203,507568,300328,212339,3611846,629135,1261261,1890396,1136529,831545,589647,517921,332430,285922,3693994,7305840,11137748,11137748
Chile,1979,CL,CHL,AMR,651475,1291412,1942887,1169077,868015,608918,515420,311250,219288,3691968,629604,1259855,1889459,1155234,859143,598998,525957,343982,296699,3780013,7471981,11304331,11304331
Chile,1980,CL,CHL,AMR,652860,1290628,1943488,1186668,894599,619685,521282,324304,225922,3772460,630459,1257497,1887956,1172160,886873,610230,531843,357620,307200,3865926,7638386,11469828,11469828
Chile,1981,CL,CHL,AMR,654993,1289982,1944975,1201403,921861,632062,525045,339691,233210,3853272,631905,1255235,1887140,1186158,914534,623991,535584,373356,318605,3952228,7805500,11637613,11637613
Chile,1982,CL,CHL,AMR,657631,1289603,1947234,1213930,947917,647717,526498,357153,240928,3934143,633821,1253240,1887061,1197794,941064,640946,537144,391269,330745,4038962,7973105,11807408,11807408
Chile,1983,CL,CHL,AMR,660611,1288986,1949597,1225612,971787,666682,526610,375029,248163,4013883,636256,1251256,1887512,1208281,965511,661320,537534,410083,342787,4125516,8139399,11976513,11976513
Chile,1984,CL,CHL,AMR,664924,1288431,1953355,1236072,994866,687514,527263,391596,255395,4092706,640191,1249435,1889626,1217333,989294,683771,538557,427836,355281,4212072,8304778,12147758,12147758
Chile,1985,CL,CHL,AMR,671074,1288641,1959715,1244913,1017620,710360,529875,406324,264033,4173125,645942,1248362,1894304,1224491,1012774,708194,541212,443565,369016,4299252,8472377,12326396,12326396
Chile,1986,CL,CHL,AMR,678773,1290203,1968976,1252046,1039829,735681,534677,419735,274454,4256422,653174,1248697,1901871,1229688,1035689,734891,545608,457587,383771,4387234,8643656,12514502,12514502
Chile,1987,CL,CHL,AMR,688114,1293093,1981207,1257774,1062352,762245,541906,432113,286441,4342831,661805,1250340,1912145,1233491,1058673,762748,551967,470053,399663,4476595,8819426,12712784,12712784
Chile,1988,CL,CHL,AMR,698609,1297399,1996008,1262223,1084915,789539,551319,442852,299760,4430608,671168,1253514,1924682,1236097,1081456,791526,560323,480750,416939,4567091,8997699,12918389,12918389
Chile,1989,CL,CHL,AMR,709466,1303756,2013222,1265078,1107240,817106,562251,451093,314858,4517626,680620,1258900,1939520,1237304,1103816,821023,570517,489308,436281,4658249,9175875,13128619,13128619
Chile,1990,CL,CHL,AMR,720243,1312308,2032551,1266903,1128793,845762,573887,457202,331583,4604130,689789,1266438,1956227,1237787,1125112,851077,582659,495745,457574,4749954,9354084,13342868,13342868
Chile,1991,CL,CHL,AMR,729873,1322995,2052868,1268987,1148231,875650,587447,461734,350010,4692059,698001,1276000,1974001,1238510,1144182,881534,597486,500181,481109,4843002,9535061,13561945,13561945
Chile,1992,CL,CHL,AMR,735606,1335832,2071438,1271336,1166008,904969,604898,464892,370732,4782835,703086,1287386,1990472,1239447,1161424,911334,615731,502789,506831,4937556,9720391,13782297,13782297
Chile,1993,CL,CHL,AMR,736751,1350257,2087008,1273302,1183173,932588,626091,467367,392150,4874671,704159,1300139,2004298,1240176,1177792,939395,637541,504435,533066,5032405,9907076,13998386,13998386
Chile,1994,CL,CHL,AMR,734154,1366416,2100570,1275040,1198985,959435,649200,470582,413039,4966281,701894,1314490,2016384,1240772,1192664,966798,661459,506656,559093,5127442,10093723,14210674,14210674
Chile,1995,CL,CHL,AMR,727088,1384190,2111278,1277150,1212732,985504,673863,475125,432853,5057227,695563,1330222,2025785,1241751,1205205,993645,687301,510255,584348,5222505,10279732,14416796,14416796
Chile,1996,CL,CHL,AMR,716274,1402198,2118472,1280217,1224202,1010417,700399,480993,451490,5147718,685366,1346334,2031700,1243762,1215076,1019587,715252,515415,608504,5317596,10465314,14615483,14615483
Chile,1997,CL,CHL,AMR,704071,1417864,2121935,1284398,1233561,1035064,727884,488786,469691,5239384,673434,1360534,2033968,1246728,1222864,1045187,744244,522442,632536,5414001,10653385,14809289,14809289
Chile,1998,CL,CHL,AMR,690736,1430049,2120785,1289891,1241086,1059414,756178,498434,487690,5332693,660555,1371435,2031990,1250991,1228903,1070200,774040,531285,655851,5511270,10843963,14996742,14996742
Chile,1999,CL,CHL,AMR,675483,1438848,2114331,1297356,1246728,1083402,784985,509738,505296,5427505,646009,1379120,2025129,1257322,1232995,1094525,804446,541905,678247,5609440,11036945,15176410,15176410
Chile,2000,CL,CHL,AMR,659710,1443095,2102805,1306906,1251014,1106447,814766,522162,523560,5524855,630942,1382464,2013406,1265672,1235862,1117482,835319,554413,701992,5710740,11235595,15351799,15351799
Chile,2001,CL,CHL,AMR,644873,1442394,2087267,1318420,1255159,1127011,845246,536053,542407,5624296,617136,1380885,1998021,1275988,1238478,1137810,866393,569297,726419,5814385,11438681,15523978,15523978
Chile,2002,CL,CHL,AMR,631961,1436357,2068318,1331978,1259348,1145601,874749,553075,561158,5725909,605420,1374363,1979783,1288116,1241024,1156050,896605,587333,750652,5919780,11645689,15693790,15693790
Chile,2003,CL,CHL,AMR,620501,1424592,2045093,1347152,1263204,1163641,902426,573609,579700,5829732,594719,1362927,1957646,1301669,1243331,1173350,924958,608835,774486,6026629,11856361,15859112,15859112
Chile,2004,CL,CHL,AMR,609956,1407170,2017126,1364177,1266993,1180525,929289,596308,597832,5935124,584485,1346477,1930962,1316963,1245586,1189185,952657,632581,797784,6134756,12069880,16017966,16017966
Chile,2005,CL,CHL,AMR,601316,1384827,1986143,1382985,1271460,1195558,955568,621080,616114,6042765,575917,1325495,1901412,1333873,1248524,1202862,979884,658422,821416,6244981,12287746,16175311,16175311
Chile,2006,CL,CHL,AMR,594828,1359766,1954594,1402304,1277334,1208607,980932,648038,635475,6152690,569349,1301967,1871316,1351435,1252877,1214114,1006116,686287,845145,6355974,12508664,16334575,16334575
Chile,2007,CL,CHL,AMR,590858,1335239,1926097,1419576,1284623,1219864,1005958,675798,655084,6260903,565406,1278836,1844242,1367290,1258625,1223471,1031854,714957,868100,6464297,12725200,16495538,16495538
Chile,2008,CL,CHL,AMR,591317,1311060,1902377,1433446,1293383,1229563,1030512,704056,675606,6366566,566010,1255833,1821843,1379951,1266023,1231261,1057107,744420,891919,6570681,12937247,16661462,16661462
Chile,2009,CL,CHL,AMR,596283,1285902,1882185,1443908,1304244,1237581,1054658,732851,698372,6471614,571229,1231672,1802901,1389400,1275737,1237296,1081798,774582,917934,6676747,13148361,16833447,16833447
Chile,2010,CL,CHL,AMR,603144,1262111,1865255,1449836,1317313,1244390,1077923,762520,720744,6572726,578577,1208636,1787213,1394503,1287668,1242213,1105153,805090,944334,6778961,13351687,17004162,17004162
Chile,2011,CL,CHL,AMR,609581,1241431,1851012,1450871,1332573,1251284,1099065,792837,744165,6670795,585348,1188837,1774185,1394737,1301747,1247090,1126055,835764,972188,6877581,13548376,17173573,17173573
Chile,2012,CL,CHL,AMR,613646,1225197,1838843,1446773,1350094,1258451,1118601,822297,770126,6766342,589545,1173776,1763321,1390141,1317875,1252105,1145117,865641,1002385,6973264,13739606,17341771,17341771
Chile,2013,CL,CHL,AMR,614672,1214871,1829543,1437328,1369649,1265547,1137679,849831,798577,6858611,590853,1164311,1755164,1380981,1335852,1257125,1163363,893800,1035479,7066600,13925211,17509925,17509925
Chile,2014,CL,CHL,AMR,613914,1210201,1824115,1423414,1392436,1273347,1156093,876434,829705,6951429,590244,1160189,1750433,1368152,1357040,1262881,1180527,921366,1071159,7161125,14112554,17687108,17687108
Chile,2015,CL,CHL,AMR,611680,1209545,1821225,1405443,1418169,1282432,1173124,902289,863268,7044725,588152,1160057,1748209,1351768,1381073,1269865,1195849,948412,1109000,7255967,14300692,17870124,17870124
Chile,2016,CL,CHL,AMR,607891,1211512,1819403,1389472,1449953,1295551,1189568,927656,900331,7152531,584973,1162238,1747211,1337928,1411370,1280877,1209832,974946,1149782,7364735,14517266,18083879,18083879
Chile,2017,CL,CHL,AMR,603380,1215647,1819027,1384343,1492285,1316418,1207284,954091,940930,7295351,581188,1166548,1747736,1335652,1452797,1299322,1224475,1002172,1192039,7506457,14801808,18368577,18368577
Chile,2018,CL,CHL,AMR,598821,1222616,1821437,1385109,1540569,1343668,1225573,981000,983943,7459862,577092,1173937,1751029,1339642,1500670,1324162,1239493,1029662,1235497,7669126,15128988,18701450,18701450
Chile,2019,CL,CHL,AMR,594464,1232574,1827038,1382672,1587497,1374501,1242753,1007856,1028086,7623365,573156,1184268,1757424,1340166,1547658,1353028,1253454,1056823,1280531,7831660,15455025,19039485,19039485
Chile,2020,CL,CHL,AMR,589608,1241568,1831176,1368165,1619440,1403275,1256723,1032606,1068571,7748780,568508,1193813,1762321,1327294,1579967,1380312,1264804,1081845,1323813,7958035,15706815,19300315,19300315
Chile,2021,CL,CHL,AMR,586226,1246854,1833080,1346185,1636775,1430266,1268576,1053436,1106703,7841941,564805,1199963,1764768,1306128,1597732,1406280,1274564,1103437,1365257,8053398,15895339,19493184,19493184
Chile,2022,CL,CHL,AMR,584346,1245322,1829668,1315803,1634505,1453261,1277929,1071589,1146771,7899858,562291,1199188,1761479,1275678,1596095,1428636,1282169,1122336,1407811,8112725,16012583,19603733,19603733
Chile,2023,CL,CHL,AMR,581186,1236941,1818127,1278852,1609933,1470815,1284738,1089777,1189736,7923851,558587,1191428,1750015,1237146,1572535,1445813,1287326,1140215,1454563,8137598,16061449,19629590,19629590
Chile,2024,CL,CHL,AMR,576750,1226291,1803041,1250302,1576890,1489724,1291911,1108259,1236092,7953178,553781,1181289,1735070,1206742,1540781,1464229,1292649,1157404,1505741,8167546,16120724,19658839,19658839
Chile,2025,CL,CHL,AMR,571086,1215004,1786090,1229996,1536977,1510109,1299733,1125205,1283504,7985524,547911,1170324,1718235,1184823,1502160,1483913,1298698,1172595,1558280,8200469,16185993,19690323,19690323
Chile,2026,CL,CHL,AMR,564216,1203888,1768104,1216398,1492959,1530748,1308937,1140444,1331977,8021463,541053,1159495,1700548,1169666,1459198,1503923,1306222,1185528,1612176,8236713,16258176,19726828,19726828
Chile,2027,CL,CHL,AMR,556267,1193219,1749486,1207941,1448552,1549058,1319573,1154178,1381561,8060863,533300,1148956,1682256,1159986,1415286,1521910,1315203,1196726,1667209,8276320,16337183,19768916,19768916
Chile,2028,CL,CHL,AMR,548010,1181777,1729787,1205391,1404077,1563664,1331723,1166590,1432247,8103692,525269,1137476,1662745,1156901,1370680,1536264,1325928,1206468,1723236,8319477,16423169,19815709,19815709
Chile,2029,CL,CHL,AMR,540394,1168607,1709001,1209606,1359251,1574571,1346073,1177582,1484114,8151197,517853,1124399,1642252,1160994,1325169,1546931,1339164,1214641,1780246,8367145,16518342,19869597,19869597
Chile,2030,CL,CHL,AMR,533247,1155085,1688332,1218039,1317786,1580650,1362835,1187641,1536811,8203762,510924,1110881,1621805,1169977,1282485,1552812,1354930,1221968,1837701,8419873,16623635,19933769,19933769
Chile,1950,CL,CHL,AMR,496399,792645,1289044,710811,494251,354797,242593,151442,102458,2056352,486025,765922,1251947,687051,481085,347546,239771,154644,116210,2026307,4082659,6623645,6623645
Chile,1951,CL,CHL,AMR,512304,805809,1318113,714682,511027,361547,247678,155681,99910,2090525,501496,779914,1281410,690479,497010,354638,245565,159663,111265,2058620,4149145,6748673,6748673
Chile,1952,CL,CHL,AMR,526371,822161,1348532,715802,530570,368063,253080,159913,99631,2127059,515307,797013,1312320,691429,515445,361412,251752,164676,110347,2095061,4222120,6882966,6882966
Chile,1953,CL,CHL,AMR,538389,841828,1380217,715523,551467,374541,258838,164107,100778,2165254,527258,817400,1344658,691121,535128,368074,258363,169665,111654,2134005,4299259,7024138,7024138
Chile,1954,CL,CHL,AMR,549930,863193,1413123,716018,571392,381456,264925,168330,102820,2204941,538798,839533,1378331,691492,553914,375114,265351,174659,114487,2175017,4379958,7171410,7171410
Chile,1955,CL,CHL,AMR,561327,885825,1447152,718334,588959,389073,271210,172363,105244,2245183,550226,863117,1413343,693647,570475,382906,272640,179597,118259,2217524,4462707,7323194,7323194
Chile,1956,CL,CHL,AMR,572581,909974,1482555,722601,604507,397146,277817,176216,108199,2286486,561507,888435,1449942,697624,585188,391205,280380,184408,122858,2261663,4548149,7480649,7480649
Chile,1957,CL,CHL,AMR,584223,934532,1518755,729010,618270,405513,284957,179955,111616,2329321,573040,914278,1487318,703505,598215,399622,288540,188989,127662,2306533,4635854,7641931,7641931
Chile,1958,CL,CHL,AMR,595444,959244,1554688,737586,629894,414834,292426,183737,115746,2374223,584084,940430,1524514,711470,609125,408894,296855,193676,133130,2353150,4727373,7806572,7806572
Chile,1959,CL,CHL,AMR,606089,983998,1590087,748149,638783,426298,299512,187654,119998,2420394,594634,966834,1561468,721313,617484,420216,304755,198615,139219,2401602,4821996,7973548,7973548
Chile,1960,CL,CHL,AMR,616062,1009599,1625661,759524,645001,440113,306116,191776,124381,2466911,604606,993269,1597875,732854,623452,433688,312097,203785,145493,2451369,4918280,8141820,8141820
Chile,1961,CL,CHL,AMR,624850,1036065,1660915,772343,648521,456435,312561,196313,129304,2515477,613481,1019655,1633136,746717,626868,449485,319192,209427,152313,2504002,5019479,8313535,8313535
Chile,1962,CL,CHL,AMR,632604,1061439,1694043,788218,649196,475129,318444,201077,134258,2566322,621293,1044986,1666279,763568,627626,467541,325873,215448,159423,2559479,5125801,8486120,8486120
Chile,1963,CL,CHL,AMR,639700,1084673,1724373,807223,648243,494596,323709,205626,138671,2618068,628412,1068208,1696620,783578,626880,486553,332219,221606,166101,2616937,5235005,8656006,8656006
Chile,1964,CL,CHL,AMR,645832,1107031,1752863,827796,647846,512925,329483,210444,142739,2671233,634603,1090505,1725108,805180,626569,504560,338885,228128,172510,2675832,5347065,8825046,8825046
Chile,1965,CL,CHL,AMR,650871,1128517,1779388,849523,649143,529169,336562,215894,147162,2727453,639443,1112033,1751476,827946,627618,520310,346450,235100,179191,2736615,5464068,8994936,8994936
Chile,1966,CL,CHL,AMR,654527,1148673,1803200,872552,651895,543301,344237,221656,151271,2784912,642464,1132457,1774921,852099,630000,533922,354510,242398,185683,2798612,5583524,9161649,9161649
Chile,1967,CL,CHL,AMR,657316,1168379,1825695,895887,656297,555328,352037,227721,155219,2842489,644288,1152282,1796570,876714,634069,545684,362655,250089,192305,2861516,5704005,9326268,9326268
Chile,1968,CL,CHL,AMR,660018,1187583,1847601,919535,662706,565218,360601,233755,159373,2901188,645774,1171321,1817095,901754,640078,555377,371606,257726,199072,2925613,5826801,9491502,9491502
Chile,1969,CL,CHL,AMR,661812,1206194,1868006,943520,671092,572676,371264,239551,163159,2961262,646402,1189471,1835873,927321,648035,562625,382557,264911,205710,2991159,5952421,9656299,9656299
Chile,2031,CL,CHL,AMR,526347,1142980,1669327,1226661,1282404,1581310,1381978,1197906,1589337,8259596,504261,1098455,1602716,1179826,1245847,1553118,1373121,1229417,1894788,8476117,16735713,20007762,20007762
Chile,2032,CL,CHL,AMR,519977,1133241,1653218,1231667,1254771,1575727,1403389,1208495,1641855,8315904,498122,1088279,1586401,1186215,1217231,1547297,1393446,1237114,1951559,8532862,16848766,20088390,20088390
Chile,2033,CL,CHL,AMR,514260,1124360,1638620,1231760,1236032,1562800,1426355,1218966,1694906,8370819,492608,1079067,1571675,1187640,1197314,1534641,1415236,1244813,2008411,8588055,16958874,20169162,20169162
Chile,2034,CL,CHL,AMR,508746,1114812,1623558,1228228,1225496,1542038,1450827,1229424,1747801,8423814,487276,1069337,1556613,1185213,1185503,1514481,1438508,1252599,2064814,8641118,17064932,20245117,20245117
Chile,2035,CL,CHL,AMR,503476,1104185,1607661,1222472,1221596,1513965,1476540,1240395,1799758,8474726,482172,1058707,1540879,1180218,1180628,1487060,1462876,1261026,2120083,8691891,17166617,20315156,20315156
Chile,2036,CL,CHL,AMR,498893,1092151,1591044,1215356,1222180,1480774,1502036,1252460,1850490,8523296,477726,1046904,1524630,1173699,1180283,1454347,1487171,1270710,2173863,8740073,17263369,20379048,20379048
Chile,2037,CL,CHL,AMR,494755,1079132,1573887,1207358,1225441,1445900,1524672,1265629,1900183,8569183,473712,1034297,1508009,1166000,1182901,1419473,1508969,1281612,2226386,8785341,17354524,20436429,20436429
Chile,2038,CL,CHL,AMR,491102,1066176,1557278,1197539,1232183,1409639,1543074,1279995,1949018,8611448,470170,1021757,1491927,1156209,1189621,1382662,1526653,1294013,2277799,8826957,17438405,20487618,20487618
Chile,2039,CL,CHL,AMR,487831,1053829,1541660,1185133,1243001,1371368,1557089,1296134,1996894,8649619,467002,1009785,1476787,1143874,1200720,1343337,1540023,1308598,2327915,8864467,17514086,20532535,20532535
Chile,2040,CL,CHL,AMR,484819,1041881,1526700,1171610,1254972,1334174,1565307,1314142,2043831,8684036,464081,998212,1462293,1130267,1213469,1304612,1547712,1325271,2376847,8898178,17582214,20571208,20571208
Chile,2041,CL,CHL,AMR,481992,1030514,1512506,1158895,1264225,1300619,1567071,1333950,2089966,8714726,461337,987212,1448549,1117108,1223983,1269530,1548850,1343910,2424758,8928139,17642865,20603919,20603919
Chile,2042,CL,CHL,AMR,479364,1019824,1499188,1148142,1267701,1272807,1561770,1355538,2135666,8741624,458797,976875,1435672,1105773,1228701,1240500,1543066,1364294,2471917,8954251,17695875,20630732,20630732
Chile,2043,CL,CHL,AMR,477259,1010118,1487377,1138106,1265270,1252832,1548771,1378422,2181220,8764621,456759,967483,1424242,1095266,1227372,1219154,1530082,1385944,2518604,8976422,17741043,20652665,20652665
Chile,2044,CL,CHL,AMR,475622,1000964,1476586,1127442,1259065,1240759,1527937,1402707,2226291,8784201,455160,958615,1413775,1084279,1222006,1205660,1509568,1409003,2564637,8995153,17779354,20669717,20669717
Chile,2045,CL,CHL,AMR,474127,992327,1466454,1115766,1250707,1235261,1499901,1428161,2270733,8800529,453698,950233,1403931,1072467,1214151,1199071,1481865,1433127,2609891,9010572,17811101,20681489,20681489
Chile,2046,CL,CHL,AMR,472879,984580,1457459,1102781,1241179,1234308,1466870,1453399,2314882,8813419,452490,942712,1395202,1059593,1204957,1197090,1448972,1457189,2654748,9022549,17835968,20688625,20688625
Chile,2047,CL,CHL,AMR,471998,977520,1449518,1088940,1231011,1236150,1432239,1475850,2359015,8823205,451642,935862,1387504,1046048,1194844,1198206,1413999,1478811,2699461,9031369,17854574,20691596,20691596
Chile,2048,CL,CHL,AMR,470932,971504,1442436,1075313,1219298,1241598,1396288,1494189,2403446,8830132,450619,930025,1380644,1032737,1182927,1203554,1377161,1496421,2744513,9037313,17867445,20690521,20690521
Chile,2049,CL,CHL,AMR,469534,966375,1435909,1062451,1205296,1251245,1358414,1508289,2448698,8834393,449290,925038,1374328,1020172,1168772,1213427,1337895,1509822,2790500,9040588,17874981,20685213,20685213
Chile,2050,CL,CHL,AMR,467832,961692,1429524,1050127,1190484,1262218,1321667,1516789,2494984,8836269,447677,920480,1368157,1008156,1153673,1225119,1299295,1517675,2837513,9041431,17877700,20675378,20675378
China,1970,CN,CHN,WPR,69832681,102780584,172613265,81419585,53208436,45156257,32556102,21636083,12529020,246505483,66138852,97608461,163747313,77309238,47517029,41455322,32001764,23377289,18007747,239668389,486173872,822534450,822534450
China,1971,CN,CHN,WPR,70497478,105924333,176421811,84981456,53806849,46177311,33221501,22112616,12953959,253253692,66734337,100559041,167293378,80971459,48194026,42283519,32500129,23753684,18613722,246316539,499570231,843285424,843285424
China,1972,CN,CHN,WPR,71059671,108356438,179416109,88295976,54812821,47175994,33929891,22604747,13395206,260214635,67232403,102854082,170086485,84425022,49307346,43018284,33001304,24170054,19201163,253123173,513337808,862840403,862840403
China,1973,CN,CHN,WPR,70615446,111612436,182227882,90975675,56229354,47980449,34845840,23071838,13870794,266973950,66770040,105950042,172720082,87205680,50918887,43517992,33705259,24556894,19825452,259730164,526704114,881652080,881652080
China,1974,CN,CHN,WPR,68734946,117213900,185948846,91796391,58128753,48584992,35807057,23523365,14406435,272246993,64945074,111276179,176221253,88075978,53097768,43863523,34458052,24924221,20531015,264950557,537197550,899367640,899367640
China,1975,CN,CHN,WPR,65755602,123787803,189543405,91117163,60636303,49094279,36736833,24084878,14955599,276625055,62090200,117504805,179595005,87409621,55935650,44201503,35166050,25418066,21230306,269361196,545986251,915124661,915124661
China,1976,CN,CHN,WPR,62137690,130450790,192588480,89727221,63472541,49698592,37645928,24746074,15487611,280777967,58638731,123795939,182434670,86011439,59136137,44686327,35845471,26031474,21863953,273574801,554352768,929375924,929375924
China,1977,CN,CHN,WPR,58549820,134467312,193017132,89757584,66981375,50231820,38595061,25401169,16043612,287010621,55219262,127560369,182779631,85961671,62944700,45149794,36575739,26650182,22491856,279773942,566784563,942581333,942581333
China,1978,CN,CHN,WPR,55036933,134381821,189418754,93066302,70974488,50449345,39732095,26016645,16695824,296934699,51867326,127421546,179288872,89034264,67188177,45357038,37470103,27225703,23221329,289496614,586431313,955138943,955138943
China,1979,CN,CHN,WPR,52442823,132923206,185366029,97117467,74911689,50627194,40838161,26683381,17446505,307624397,49374160,125980265,175354425,92827540,71349544,45541083,38338629,27833031,24064293,299954120,607578517,968298969,968298969
China,1980,CN,CHN,WPR,51356962,131066972,182423934,100212318,78984939,51009223,41822308,27448445,18199466,317676699,48298217,124164505,172462722,95722938,75574223,45938177,39151388,28500204,24922182,309809112,627485811,982372466,982372466
China,1981,CN,CHN,WPR,51536673,128489749,180026422,103388226,82550014,51685602,42878031,28186550,18917801,327606224,48408664,121661129,170069793,98719042,79265585,46686170,40032418,29088863,25764991,319557069,647163293,997259502,997259502
China,1982,CN,CHN,WPR,53028390,125831709,178860099,105869234,85879429,52758013,43908678,28951666,19633508,337000528,49740636,119078304,168818940,101077278,82758739,47862355,40823120,29674435,26607674,328803601,665804129,1013483166,1013483166
China,1983,CN,CHN,WPR,54668817,122227842,176896659,109155583,88590281,54224561,44758223,29888797,20333173,346950618,51198236,115591761,166789997,104222539,85589646,49523430,41389802,30437426,27426790,338589633,685540251,1029226907,1029226907
China,1984,CN,CHN,WPR,55651974,118088537,173740511,114738080,89477112,56151427,45415304,30857054,21053923,357692900,52018896,111586785,163605681,109561951,86528875,51735104,41804375,31236987,28265815,349133107,706826007,1044172197,1044172197
China,1985,CN,CHN,WPR,56802739,114338433,171141172,121280330,88883650,58663734,45980833,31800039,21869501,368478087,52961626,107948483,160910109,115792855,85935530,54590234,42207544,31993585,29190868,359710616,728188703,1060239979,1060239979
China,1986,CN,CHN,WPR,58347622,111174585,169522207,127909506,87577244,61485299,46631416,32718301,22741962,379063728,54224568,104859948,159084516,122082297,84601356,57793822,42747009,32718657,30156938,370100079,749163807,1077770523,1077770523
China,1987,CN,CHN,WPR,60086406,109288324,169374730,131935105,87646983,64943359,47206309,33658378,23617772,389007906,55611617,102964678,158576295,125869604,84579353,61580528,43260001,33483268,31120160,379892914,768900820,1096851843,1096851843
China,1988,CN,CHN,WPR,62120997,107593405,169714402,131923883,90914435,68855414,47482358,34762215,24533056,398471361,57229003,101232541,158461544,125787712,87619815,65779784,43524197,34398874,32132105,389242487,787713848,1115889802,1115889802
China,1989,CN,CHN,WPR,64441415,106108484,170549899,130531702,94871930,72690964,47716681,35840031,25564146,407215454,59071868,99673010,158744878,124382324,91333562,69877538,43759231,35290318,33261516,397904489,805119943,1134414723,1134414723
China,1990,CN,CHN,WPR,66652455,106231823,172884278,128750086,97888440,76656173,48143753,36806853,26668435,414913740,60764871,99591935,160356806,122606647,94157584,74033316,44196308,36124735,34430841,405549431,820463171,1153704252,1153704252
China,1991,CN,CHN,WPR,66960374,107963617,174923991,126252787,100971069,80120038,48850872,37826814,27720904,421742484,60707721,100971123,161678844,120139147,97064812,77653423,44963315,37001811,35458343,412280851,834023335,1170626171,1170626171
China,1992,CN,CHN,WPR,64619231,111151282,175770513,123637384,103326009,83334436,49929157,38822536,28805854,427855376,58254667,103649762,161904429,117548815,99293435,81054470,46131593,37784559,36470197,418283069,846138445,1183813389,1183813389
China,1993,CN,CHN,WPR,61580166,114795329,176375495,120098192,106473924,85947571,51381845,39668227,30032998,433602757,55190534,106697611,161888145,114072784,102302728,83804369,47770578,38371682,37667027,423989168,857591925,1195855558,1195855558
China,1994,CN,CHN,WPR,58244223,118095641,176339864,116064671,111907347,86790763,53273764,40343027,31306398,439685970,51887391,109359249,161246640,110118819,107511193,84698101,49948320,38818856,38918920,430014209,869700179,1207286675,1207286675
China,1995,CN,CHN,WPR,54136006,121433149,175569155,112422825,118298853,86186680,55730695,40941478,32640860,446221391,47921069,111976038,159897107,106538172,113614504,84076220,52759784,39257433,40210655,436456768,882678159,1218144426,1218144426
China,1996,CN,CHN,WPR,50805351,123279629,174084980,109351446,124779598,84878552,58484139,41620559,33994637,453108931,44691437,113182097,157873534,103496275,119776384,82714679,55912741,39825046,41506267,443231392,896340323,1228298836,1228298836
China,1997,CN,CHN,WPR,48906922,122708135,171615057,107549358,128732241,84933026,61846821,42231240,35359252,460651938,42784108,112147881,154931989,101647603,123489033,82656683,59633580,40365686,42809876,450602461,911254399,1237801448,1237801448
China,1998,CN,CHN,WPR,47369088,121743793,169112881,105942990,128756804,88143260,65643079,42584682,36885406,467956221,41232722,110742417,151975139,99972399,123412965,85642292,63761091,40686200,44316923,457791870,925748091,1246836105,1246836105
China,1999,CN,CHN,WPR,46038645,120774915,166813560,104543532,127463572,92065288,69373778,42916323,38481085,474843578,39897409,109331578,149228987,98471001,122068458,89327192,67798263,40988249,45893939,464547102,939390680,1255433236,1255433236
China,2000,CN,CHN,WPR,45137637,118923852,164061489,104717189,125777070,95064691,73225397,43425988,40034551,482244886,38963375,107107917,146071292,98420641,120347980,92132683,71888984,41482058,47449057,471721403,953966289,1264099069,1264099069
China,2001,CN,CHN,WPR,44506303,115992475,160498778,106475883,123394731,98136651,76594309,44197837,41570175,490369586,38289455,103913857,142203312,99819529,117960940,95040273,75473367,42311229,49062565,479667903,970037489,1272739582,1272739582
China,2002,CN,CHN,WPR,43930235,111895159,155825394,109679565,120938721,100542460,79746372,45319577,43081999,499308694,37687613,99688899,137376512,102517757,115504511,97333314,78874260,43536856,50648809,488415507,987724201,1280926120,1280926120
China,2003,CN,CHN,WPR,43564082,107457567,151021649,113324015,117561655,103724525,82318538,46776749,44545345,508250827,37286194,95202341,132488535,105572707,112157633,100396022,81634744,45200313,52150936,497112355,1005363182,1288873367,1288873367
China,2004,CN,CHN,WPR,43441601,102923126,146364727,116618506,113666114,109110536,83158681,48619065,45869790,517042692,37110521,90684579,127795100,108237612,108302111,105598531,82556790,47370461,53548677,505614182,1022656874,1296816711,1296816711
China,2005,CN,CHN,WPR,43322497,98046318,141368815,119943966,110144293,115421086,82590373,50983597,47153354,526236669,36953301,85900508,122853809,110853971,104803451,111674309,81980319,50156672,54959542,514428264,1040664933,1304887562,1304887562
China,2006,CN,CHN,WPR,43367806,94203821,137571627,121792474,107186290,121822410,81347704,53630089,48523380,534302347,36952753,82098754,119051507,112069821,101840363,117813038,80677116,53279207,56481547,522161092,1056463439,1313086567,1313086567
China,2007,CN,CHN,WPR,43846419,91827278,135673697,121250915,105474249,125745644,81446963,56829235,49834642,540581648,37339852,79671636,117011488,111068469,100054794,121530942,80660773,56944269,57987151,528246398,1068828046,1321513224,1321513224
China,2008,CN,CHN,WPR,44603240,90005446,134608686,120316245,103939063,125823339,84622775,60401430,51035225,546138077,37981411,77786338,115767749,109693288,98424982,121500652,83635797,60982290,59415626,533652635,1079790712,1330167148,1330167148
China,2009,CN,CHN,WPR,45514369,88623556,134137925,119383159,102607789,124614922,88490031,63892395,52268379,551256675,38770800,76334217,115105017,108318575,96970233,120219846,87301091,64924727,60891511,538625983,1089882658,1339125595,1339125595
China,2010,CN,CHN,WPR,46336066,87667933,134003999,117595736,102856410,123035647,91472656,67493276,53622123,556075848,39501792,75297145,114798937,106156976,96985363,118584331,90116043,68924427,62545456,543312596,1099388444,1348191368,1348191368
China,2011,CN,CHN,WPR,46955374,87142876,134098250,114748082,104684268,120779845,94521642,70636862,55188679,560559378,40079393,74672780,114752173,103037966,98450955,116289576,93026890,72425423,64454872,547685682,1108245060,1357095481,1357095481
China,2012,CN,CHN,WPR,47737866,87103972,134841838,110744231,107941008,118446863,96922498,73582266,57029631,564666497,40818683,74505233,115323916,98892389,101206674,113918878,95330806,75745211,66634604,551728562,1116395059,1366560818,1366560818
China,2013,CN,CHN,WPR,48390472,87551638,135942110,106397738,111634196,115216388,100078276,75994009,59112615,568433222,41468259,74791539,116259798,94481028,104319990,110672396,98396532,78450111,69145126,555465183,1123898405,1376100308,1376100308
China,2014,CN,CHN,WPR,48671553,88391435,137062988,101943478,114970424,111480174,105346081,76772706,61406329,571919192,41822929,75446765,117269694,90024504,107036967,106922450,103556519,79365797,72031563,558937800,1130856992,1385189668,1385189668
China,2015,CN,CHN,WPR,48679581,89139557,137819138,97144471,118332625,108113547,111490471,76230519,64129313,575440946,41961965,76057226,118019191,85295628,109702889,103526921,109568642,78820370,75521720,562436170,1137877116,1393715448,1393715448
China,2016,CN,CHN,WPR,48628874,89846494,138475368,93372519,120231085,105306020,117710591,75063962,67155022,578839199,42068442,76667749,118736191,81543912,110979306,100667081,115640938,77569923,79437757,565838917,1144678116,1401889681,1401889681
China,2017,CN,CHN,WPR,48482936,91141188,139624124,91048414,119747662,103716499,121538169,75197988,70527966,581776698,42112163,77820491,119932654,79154030,110040496,98969703,119341782,77590614,83845855,568942480,1150719178,1410275957,1410275957
China,2018,CN,CHN,WPR,47477803,92580709,140058512,89264708,118864009,102296766,121698974,78291008,74134090,584549555,41413406,79134958,120548364,77292045,108719621,97424474,119385288,80545364,88546245,571913037,1156462592,1417069468,1417069468
China,2019,CN,CHN,WPR,45604247,93800790,139405037,87908595,117966616,101064962,120633964,82054988,77747759,587376884,39949146,80299675,120248821,75849759,107380400,96039368,118199607,84173775,93190388,574833297,1162210181,1421864031,1421864031
China,2020,CN,CHN,WPR,43090360,94656652,137747012,86991229,116222114,101373050,119187071,84979778,81493506,590246748,37908986,81189310,119098296,74837667,105255109,96096233,116648695,86977141,98022883,577837728,1168084476,1424929781,1424929781
China,2021,CN,CHN,WPR,39707251,95248215,134955466,86507218,113421294,103220860,117073342,87944653,84927627,593094994,35082450,81889971,116972421,74242688,102170060,97576520,114439533,89867945,102573846,580870592,1173965586,1425893465,1425893465
China,2022,CN,CHN,WPR,35674474,95897857,131572331,86484324,109449965,106455217,114865070,90313678,88503448,596071702,31664783,82680524,114345307,74078792,98035681,100315221,112136026,92170678,107161596,583897994,1179969696,1425887337,1425887337
China,2023,CN,CHN,WPR,32318569,95557666,127876235,86937354,105132223,110107997,111783958,93408883,91926150,599296565,28826051,82638653,111464704,74358983,93627831,103398939,108962260,95216983,111468840,587033836,1186330401,1425671352,1425671352
China,2024,CN,CHN,WPR,29918891,93981250,123900141,87782056,100713844,113410738,108226942,98434712,94085797,602654089,26817193,81539994,108357187,75009137,89180841,106092656,105298518,100270823,114415383,590267358,1192921447,1425178782,1425178782
China,2025,CN,CHN,WPR,28321178,91487223,119808401,88535704,95956578,116740972,105033901,104233591,95465183,605965929,25511104,79645900,105157004,75615915,84463810,108736933,101984727,106125590,116523614,593450589,1199416518,1424381924,1424381924
China,2026,CN,CHN,WPR,27645097,88061491,115706588,89247114,92213334,118619509,102385579,110066812,96582580,609114928,25019765,76929423,101949188,76222940,80713782,109996241,99197054,112016242,118338236,596484495,1205599423,1423255202,1423255202
China,2027,CN,CHN,WPR,27306713,83893003,111199716,90543588,89905710,118147058,100927189,113701196,99278704,612503445,24827981,73561296,98389277,77371090,78319206,109055552,97555696,115618393,121796694,599716631,1212220076,1421809059,1421809059
China,2028,CN,CHN,WPR,26981123,79546504,106527627,91985149,88142550,117288841,99631554,114002228,104843596,615893918,24644474,70033760,94678234,78682444,76460493,107745074,96064924,115720442,128272425,602945802,1218839720,1420045580,1420045580
China,2029,CN,CHN,WPR,26667044,75289483,101956527,93208251,86809089,116422153,98508634,113157865,110921812,619027804,24464927,66572396,91037323,79846287,75027698,106424896,94730890,114636013,135287196,605952980,1224980784,1417974640,1417974640
China,2030,CN,CHN,WPR,26381432,71189616,97571048,94064768,85890068,114698352,98871317,111911889,116393052,621829446,24302299,63233663,87535962,80732463,74000821,104302993,94807495,113172592,141653088,608669452,1230498898,1415605906,1415605906
China,1950,CN,CHN,WPR,40526812,59237497,99764309,51622119,40286299,33183188,25643192,17852274,11735492,180322564,37450508,52050182,89500690,46379048,37877695,31621370,24663170,18157603,15692789,174391675,354714239,543979233,543979233
China,1951,CN,CHN,WPR,43027406,59701583,102728989,52577011,40779955,33457184,25858790,17819098,11585705,182077743,40135683,52640928,92776611,47134234,38227526,31867240,25095014,18211148,15495479,176030641,358108384,553613988,553613988
China,1952,CN,CHN,WPR,45801087,60644537,106445624,53519316,41337361,33759940,26080152,17772071,11503420,183972260,43130370,53730749,96861119,47800019,38593029,32163720,25517435,18233464,15367850,177675517,361647777,564954522,564954522
China,1953,CN,CHN,WPR,48579427,62052657,110632084,54246161,42152855,34030168,26333671,17725905,11482073,185970833,46077641,55357241,101434882,48209546,39198419,32408681,25961164,18245965,15317105,179340880,365311713,577378682,577378682
China,1954,CN,CHN,WPR,50948576,63997439,114946015,54753449,43033739,34266249,26721666,17664409,11487111,187926623,48493786,57586525,106080311,48450071,39862466,32600974,26502734,18270159,15296653,180983057,368909680,589936004,589936004
China,1955,CN,CHN,WPR,53052095,66610707,119662802,55147631,43873896,34644115,27090773,17695502,11433145,189885062,50537983,60520203,111058186,48677298,40472620,32940469,26955286,18424042,15244380,182714095,372599157,603320147,603320147
China,1956,CN,CHN,WPR,54427712,69572383,124000095,55632569,44687892,35159898,27301233,17872218,11337246,191991056,51828452,63823465,115651917,49055313,41051705,33434618,27185421,18734528,15178362,184639947,376631003,616283022,616283022
China,1957,CN,CHN,WPR,55464644,73268540,128733184,56029870,45555573,35663763,27464446,18080752,11299172,194093576,52795402,67773089,120568491,49403014,41692004,33934514,27327612,19068517,15182116,186607777,380701353,630003025,630003025
China,1958,CN,CHN,WPR,56068837,77494427,133563264,56069327,46640208,36084040,27713984,18304256,11319871,196131686,53350444,72190891,125541335,49466478,42514076,34359448,27530215,19410568,15274505,188555290,384686976,643791581,643791581
China,1959,CN,CHN,WPR,54493764,81484598,135978362,55999217,47618464,36463444,28015897,18462472,11232532,197792026,51810184,76365589,128175773,49458457,43260118,34751712,27786052,19713422,15263268,190233029,388025055,652179194,652179194
China,1960,CN,CHN,WPR,50498581,85242207,135740788,56042867,48339881,36841546,28181507,18457595,10938115,198801511,47920316,80261834,128182150,49593999,43861561,35128708,27946133,19901036,15014807,191446244,390247755,654170692,654170692
China,1961,CN,CHN,WPR,46298329,88359469,134657798,56399387,49147762,37211686,28298022,18479996,10664701,200201554,43854184,83503456,127357640,50092841,44535576,35422773,28085588,20125763,14780846,193043387,393244941,655260380,655260380
China,1962,CN,CHN,WPR,45004871,91501239,136506110,57279069,50032811,37752331,28585377,18663406,10617591,202930585,42618083,86796030,129414113,51117243,45179593,35801730,28377642,20478540,14809097,195763845,398694430,664614650,664614650
China,1963,CN,CHN,WPR,48429331,94144941,142574272,58641450,50762864,38585026,28918315,18949288,10695374,206552317,45892983,89549761,135442744,52695543,45609501,36438175,28679539,20917243,14994226,199334227,405886544,683903557,683903557
China,1964,CN,CHN,WPR,54096489,94855972,148952461,60509088,51284093,39471698,29225279,19329521,10771672,210591351,51299213,90331438,141630651,54854819,45876697,37124229,28939043,21429623,15194898,203419309,414010660,704593772,704593772
China,1965,CN,CHN,WPR,59888562,94023394,153911956,63004340,51710604,40327651,29667267,19708120,10892723,215310705,56812382,89545176,146357558,57682198,46139147,37762714,29337618,21872475,15471973,208266125,423576830,723846349,723846349
China,1966,CN,CHN,WPR,65792408,92462114,158254522,65833782,52239145,41166845,30238453,19993446,11109058,220580729,62411550,88016460,150428010,60873489,46556789,38374444,29877709,22140974,15861878,213685283,434266012,742948541,742948541
China,1967,CN,CHN,WPR,68977695,92373820,161351515,69353775,52696582,42058470,30808076,20266390,11398630,226581923,65419107,87882832,153301939,64682186,46954848,39044236,30425287,22344410,16319922,219770889,446352812,761006260,761006260
China,1968,CN,CHN,WPR,68992052,95669370,164661422,73372951,52825720,43156922,31321960,20633124,11750986,233061663,65407698,90957432,156365130,68932969,47088243,39888278,30914503,22612787,16846970,226283750,459345413,780371956,780371956
China,1969,CN,CHN,WPR,69077008,99720433,168797441,77330557,52912193,44221273,31880280,21124779,12134943,239604025,65456629,94751650,160208279,73094092,47195253,40701991,31425278,22986874,17417741,232821229,472425254,801430976,801430976
China,2031,CN,CHN,WPR,26139879,67140049,93279928,94656604,85394240,111921923,100729173,110017292,121677569,624396801,24170081,59921234,84091315,81429300,73381933,101218101,96283324,111056608,147808694,611177960,1235574761,1412946005,1412946005
China,2032,CN,CHN,WPR,25948040,62782202,88730242,95311428,85378763,108007328,103949841,108009760,126438478,627095598,24071915,56320669,80392584,82221010,73216744,97110946,99011216,108841688,153392841,613794445,1240890043,1410012866,1410012866
China,2033,CN,CHN,WPR,25808584,59113366,84921950,94982155,85845300,103756234,107576497,105193983,131578557,628932726,24008586,53307171,77315757,82184471,73503558,92739559,102080789,105790663,159340907,615639947,1244572673,1406810379,1406810379
China,2034,CN,CHN,WPR,25705582,56409312,82114894,93419865,86700642,99404771,110859226,101965998,137289074,629639576,23967117,51125336,75092453,81093005,74158548,88328774,104763746,102280434,165843394,616467901,1246107477,1403314815,1403314815
China,2035,CN,CHN,WPR,25645924,54533405,80179329,90941815,87465203,94719927,114174408,99102040,142956184,629359577,23956417,49661536,73617953,79207157,74770060,83650390,107399813,99119991,172243223,616390634,1245750211,1399547500,1399547500
China,2036,CN,CHN,WPR,25642113,53620714,79262827,87533745,88187210,91037333,116060648,96767215,148381605,627967756,23989184,49041142,73030326,76499971,75381441,79932411,108662786,96478052,178331151,615285812,1243253568,1395546723,1395546723
China,2037,CN,CHN,WPR,25689660,53094428,78784088,83385116,89490957,88772272,115636044,95565312,153211352,626061053,24063536,48753658,72817194,73142395,76532115,77560181,107746285,94954886,183740214,613676076,1239737129,1391338420,1391338420
China,2038,CN,CHN,WPR,25794734,52633081,78427815,79058969,90938853,87045143,114825344,94509183,157594487,623971979,24187379,48509142,72696521,69625627,77845346,75720095,106460288,93574547,188629790,611855693,1235827672,1386952006,1386952006
China,2039,CN,CHN,WPR,25951760,52219497,78171257,74821533,92169031,85742974,113997472,93601448,161382453,621714911,24355859,48290324,72646183,66174553,79011230,74303096,105160588,92339695,192845613,609834775,1231549686,1382367124,1382367124
China,2040,CN,CHN,WPR,26129851,51877524,78007375,70740322,93034224,84851220,112332184,94095252,164230445,619283647,24540972,48119081,72660053,62845594,79900199,73289653,103068717,92474924,196026777,607605864,1226889511,1377556938,1377556938
China,2041,CN,CHN,WPR,26305019,51635191,77940210,66708963,93635810,84378417,109640144,96005201,166306154,616674689,24720943,48021534,72742477,59542792,80600240,72681662,100026231,93971257,198342838,605165020,1221839709,1372522398,1372522398
China,2042,CN,CHN,WPR,26462782,51493623,77956405,62370336,94300232,84381307,105839084,99210178,167804145,613905282,24882066,47999395,72881461,55952567,81394843,72524594,95975244,96686733,199989974,602523955,1216429237,1367267104,1367267104
China,2043,CN,CHN,WPR,26559341,51461657,78020998,58718036,93984372,84861897,101709536,102787217,168920043,610981101,24983836,48061391,73045227,52947980,81363328,72817048,91663577,99727642,201170348,599689923,1210671024,1361737252,1361737252
China,2044,CN,CHN,WPR,26594353,51517917,78112270,56026911,92440273,85728066,97482457,106032110,170201349,607911166,25026477,48189792,73216269,50773076,80279741,73475879,87313651,102388484,202442290,596673121,1204584287,1355912820,1355912820
China,2045,CN,CHN,WPR,26562145,51638439,78200584,54160948,89983594,86504414,92937159,109317935,171801625,604705675,25004043,48365521,73369564,49314527,78403817,74091678,82703105,105007550,203960400,593481077,1198186752,1349756901,1349756901
China,2046,CN,CHN,WPR,26431096,51811713,78242809,53254788,86599719,87238198,89371366,111220376,173690500,601374947,24886286,48579461,73465747,48697431,75708450,74707284,79041667,106276788,205695126,590126746,1191501693,1343210240,1343210240
China,2047,CN,CHN,WPR,26197522,52018759,78216281,52733569,82478105,88549043,87184421,110891619,176097036,597933793,24670790,48816027,73486817,48412418,72364503,75859516,76707048,105406777,207875757,586626019,1184559812,1336262908,1336262908
China,2048,CN,CHN,WPR,25866583,52221982,78088565,52276888,78179371,90002386,85522004,110175929,178233673,594390251,24362773,49042657,73405430,48170190,68861758,77173312,74897817,104167674,209718616,582989367,1177379618,1328873607,1328873607
China,2049,CN,CHN,WPR,25423241,52415509,77838750,51867645,73968362,91238779,84275581,109425462,179963882,590739711,23947532,49254762,73202294,47953550,65424418,78340202,73507126,102906872,211091293,579223461,1169963172,1321004205,1321004205
China,2050,CN,CHN,WPR,24874124,52562831,77436955,51529660,69912273,92111820,83431946,107874002,182137735,586997436,23431977,49418433,72850410,47784350,62108720,79231165,72516119,100872815,212838357,575351526,1162348962,1312636325,1312636325
Côte d'Ivoire,1970,CI,CIV,AFR,530911,685054,1215965,460949,422371,323196,203626,113374,68661,1592177,532995,708159,1241154,460546,361222,266764,172499,101525,65231,1427787,3019964,5477086,5477086
Côte d'Ivoire,1971,CI,CIV,AFR,553975,718743,1272718,480322,439081,338938,214499,118749,72199,1663788,555585,741393,1296978,480999,373826,277447,179982,105282,67844,1485380,3149168,5718867,5718867
Côte d'Ivoire,1972,CI,CIV,AFR,578687,754275,1332962,502902,457100,356019,226264,124587,76031,1742903,579857,776463,1356320,503823,387173,288879,187971,109309,70642,1547797,3290700,5979984,5979984
Côte d'Ivoire,1973,CI,CIV,AFR,605480,791660,1397140,528350,474904,373910,238752,130815,80056,1826787,606204,813352,1419556,529018,400452,300811,196419,113586,73605,1613891,3440678,6257373,6257373
Côte d'Ivoire,1974,CI,CIV,AFR,634717,830911,1465628,555603,492259,392088,251570,137648,84228,1913396,634971,852008,1486979,554768,414980,313010,205052,118385,76723,1682918,3596314,6548923,6548923
Côte d'Ivoire,1975,CI,CIV,AFR,666197,871779,1537976,583705,510339,410345,264674,145085,88546,2002694,665987,892218,1558205,580489,431693,325325,213845,123713,80045,1755110,3757804,6853981,6853981
Côte d'Ivoire,1976,CI,CIV,AFR,692209,903828,1596037,629885,531565,419190,272011,149949,92497,2095097,686248,927188,1613436,632849,445831,326422,219169,128314,85542,1838127,3933224,7142690,7142690
Côte d'Ivoire,1977,CI,CIV,AFR,717490,928106,1645596,685777,555561,420115,274527,152653,95797,2184430,703093,954469,1657562,703842,460194,318385,221396,132293,92200,1928310,4112740,7415900,7415900
Côte d'Ivoire,1978,CI,CIV,AFR,751789,956967,1708756,726149,579186,424118,279434,156532,98735,2264154,733878,979997,1713875,759553,480779,314903,224784,136763,97252,2014034,4278188,7700816,7700816
Côte d'Ivoire,1979,CI,CIV,AFR,792698,991968,1784666,752899,601138,431118,286536,161529,101532,2334752,775367,1007023,1782390,800167,506092,316212,229263,141708,101123,2094565,4429317,7996368,7996368
Côte d'Ivoire,1980,CI,CIV,AFR,839077,1033309,1872386,769543,620751,440683,295348,167479,104410,2398214,825252,1037778,1863030,827952,534637,321711,234551,147032,104297,2170180,4568394,8303810,8303810
Côte d'Ivoire,1981,CI,CIV,AFR,885912,1083049,1968961,780155,637847,452008,305317,174142,107495,2456964,876222,1077396,1953618,846271,565126,330414,240392,152642,107228,2242073,4699037,8621621,8621621
Côte d'Ivoire,1982,CI,CIV,AFR,928102,1143753,2071855,788042,652495,464237,316029,181330,110822,2512955,921362,1130697,2052059,858059,596515,341501,246615,158428,110126,2311244,4824199,8948119,8948119
Côte d'Ivoire,1983,CI,CIV,AFR,965467,1213743,2179210,795489,664990,476610,327195,188977,114420,2567681,960619,1196029,2156648,865445,628150,354422,253082,164355,113061,2378515,4946196,9282050,9282050
Côte d'Ivoire,1984,CI,CIV,AFR,998225,1290933,2289158,804177,674716,489446,338530,196879,118497,2622245,994726,1270905,2265631,870100,657603,370666,259647,170146,116215,2444377,5066622,9621405,9621405
Côte d'Ivoire,1985,CI,CIV,AFR,1025683,1373959,2399642,815200,680718,503804,349869,205038,123079,2677708,1023270,1353729,2376999,873234,683442,391245,266325,175792,119687,2509725,5187433,9964075,9964075
Côte d'Ivoire,1986,CI,CIV,AFR,1048764,1460319,2509083,829648,682708,519830,361262,213665,128001,2735114,1047278,1441963,2489241,876249,705963,415368,273404,181587,123435,2576006,5311120,10309440,10309440
Côte d'Ivoire,1987,CI,CIV,AFR,1063654,1540941,2604595,866499,688543,533318,369727,221262,133414,2812763,1059211,1529006,2588217,901833,724984,436105,278970,187036,128997,2657925,5470688,10663498,10663498
Côte d'Ivoire,1988,CI,CIV,AFR,1063013,1597045,2660058,964497,718404,535752,368394,224372,139504,2950923,1044189,1599679,2643868,998091,743750,437914,278128,190906,139565,2788354,5739277,11043193,11043193
Côte d'Ivoire,1989,CI,CIV,AFR,1074231,1646628,2720859,1063859,756643,540154,368376,228361,146850,3104243,1045539,1656962,2702501,1098971,769794,443077,278209,195112,150180,2935343,6039586,11462943,11462943
Côte d'Ivoire,1990,CI,CIV,AFR,1108914,1705215,2814129,1124616,787320,554189,376559,236260,155094,3234038,1083215,1710892,2794107,1157531,802554,465973,284026,200639,157539,3068262,6302300,11910540,11910540
Côte d'Ivoire,1991,CI,CIV,AFR,1149189,1757183,2906372,1188309,822108,568002,384767,243837,163225,3370248,1127918,1755580,2883498,1221512,836927,489878,290196,205823,164821,3209157,6579405,12369269,12369269
Côte d'Ivoire,1992,CI,CIV,AFR,1194576,1801244,2995820,1256343,860903,581879,392729,251117,171220,3514191,1178010,1790124,2968134,1292934,873280,514725,296604,210651,171979,3360173,6874364,12838314,12838314
Côte d'Ivoire,1993,CI,CIV,AFR,1238491,1844889,3083380,1327022,903703,596483,400025,258026,179109,3664368,1223930,1825882,3049812,1368892,912074,540678,303123,215079,179049,3518895,7183263,13316448,13316448
Côte d'Ivoire,1994,CI,CIV,AFR,1276115,1893976,3170091,1398417,950254,611756,407113,264445,186881,3818866,1261227,1869353,3130580,1446269,953611,566369,311436,219069,185986,3682740,7501606,13802285,13802285
Côte d'Ivoire,1995,CI,CIV,AFR,1312586,1946085,3258671,1469560,999903,627425,415124,270350,194531,3976893,1297465,1916267,3213732,1523153,997815,591352,322666,222670,192781,3850437,7827330,14299727,14299727
Côte d'Ivoire,1996,CI,CIV,AFR,1351655,2000086,3351741,1538743,1052226,643833,424307,275829,202046,4136984,1336500,1965891,3302391,1596916,1044764,616625,336074,226037,199414,4019830,8156814,14810946,14810946
Côte d'Ivoire,1997,CI,CIV,AFR,1394117,2056726,3450843,1604439,1106664,661789,434442,281114,209399,4297847,1378967,2019581,3398548,1665169,1094337,642296,351413,229252,205754,4188221,8486068,15335453,15335453
Côte d'Ivoire,1998,CI,CIV,AFR,1442626,2116942,3559568,1658932,1159262,682669,445381,286264,215554,4448062,1427666,2078654,3506320,1719432,1145035,669316,368371,232207,210683,4345044,8793106,15858990,15858990
Côte d'Ivoire,1999,CI,CIV,AFR,1495906,2181378,3677284,1693986,1203231,705801,456274,290970,219464,4569726,1481319,2144274,3625593,1750624,1191878,696813,385981,234678,213310,4473284,9043010,16345894,16345894
Côte d'Ivoire,2000,CI,CIV,AFR,1548781,2252341,3801122,1716663,1237924,729994,466279,295277,222223,4668360,1534218,2219337,3753555,1765555,1232442,723428,403600,236840,214769,4576634,9244994,16799670,16799670
Côte d'Ivoire,2001,CI,CIV,AFR,1597889,2331945,3929834,1734438,1268490,755613,475481,299426,225012,4758460,1582757,2305822,3888579,1771217,1271156,749636,421366,239034,216183,4668592,9427052,17245468,17245468
Côte d'Ivoire,2002,CI,CIV,AFR,1637818,2410296,4048114,1752935,1305893,784464,484654,303769,229421,4861136,1619422,2390220,4009642,1775563,1315166,774752,438946,241593,218988,4765008,9626144,17683897,17683897
Côte d'Ivoire,2003,CI,CIV,AFR,1667978,2481409,4149387,1779005,1350383,816816,494354,307988,235335,4983881,1643987,2462274,4106261,1790366,1363460,799162,456401,244432,223099,4876920,9860801,18116451,18116451
Côte d'Ivoire,2004,CI,CIV,AFR,1692900,2548063,4240963,1812331,1394293,851427,504348,312101,241137,5115637,1663709,2525765,4189474,1815229,1410799,824311,472798,248636,227056,4998829,10114466,18544903,18544903
Côte d'Ivoire,2005,CI,CIV,AFR,1714078,2611309,4325387,1850210,1437831,887948,514561,317096,246876,5254522,1680378,2583863,4264241,1845775,1456380,850220,487774,255061,230860,5126070,10380592,18970215,18970215
Côte d'Ivoire,2006,CI,CIV,AFR,1733563,2672032,4405595,1890714,1480163,926050,525321,323160,252627,5398035,1696458,2637332,4333790,1880676,1498732,877173,502307,263099,234649,5256636,10654671,19394057,19394057
Côte d'Ivoire,2007,CI,CIV,AFR,1751676,2730418,4482094,1933656,1521030,965444,537288,330058,258524,5546000,1712199,2686652,4398851,1920220,1536886,905432,516748,272765,238700,5390751,10936751,19817700,19817700
Côte d'Ivoire,2008,CI,CIV,AFR,1768139,2788735,4556874,1978151,1560408,1005355,551435,337538,264637,5697524,1727033,2734742,4461775,1963930,1570702,934923,531708,283871,243139,5528273,11225797,20244449,20244449
Côte d'Ivoire,2009,CI,CIV,AFR,1784840,2847056,4631896,2023675,1598187,1045344,568444,345348,270989,5851987,1742692,2781994,4524686,2011312,1600537,965762,547536,296064,247984,5669195,11521182,20677762,20677762
Côte d'Ivoire,2010,CI,CIV,AFR,1803413,2903138,4706551,2072777,1634187,1085034,588581,353273,277561,6011413,1760552,2826474,4587026,2064331,1626674,997676,564218,309027,253128,5815054,11826467,21120042,21120042
Côte d'Ivoire,2011,CI,CIV,AFR,1828676,2970714,4799390,2118226,1651732,1122148,610833,360282,281694,6144915,1788702,2885414,4674116,2112793,1638110,1033764,581918,321805,256104,5944494,12089409,21562914,21562914
Côte d'Ivoire,2012,CI,CIV,AFR,1857856,3049667,4907523,2164034,1649731,1158263,635340,366635,283600,6257603,1823462,2960246,4783708,2158707,1633889,1076514,601263,334399,257099,6061871,12319474,22010712,22010712
Côte d'Ivoire,2013,CI,CIV,AFR,1883372,3124374,5007746,2218448,1648401,1194602,662840,373617,285781,6383689,1852968,3033698,4886666,2208959,1631386,1122155,622550,347640,258484,6191174,12574863,22469268,22469268
Côte d'Ivoire,2014,CI,CIV,AFR,1907229,3197389,5104618,2284662,1662291,1234224,695025,382098,289155,6547455,1879120,3108480,4987600,2267667,1645591,1172088,647539,361256,261738,6355879,12903334,22995555,22995555
Côte d'Ivoire,2015,CI,CIV,AFR,1930936,3271046,5201982,2363147,1690127,1277323,731595,392070,294286,6748548,1903284,3186934,5090218,2337860,1673455,1225576,676416,375143,267544,6555994,13304542,23596741,23596741
Côte d'Ivoire,2016,CI,CIV,AFR,1955704,3343920,5299624,2444400,1721319,1318269,770137,402913,300428,6957466,1927422,3266792,5194214,2409627,1704623,1276413,707572,389297,274797,6762329,13719795,24213622,24213622
Côte d'Ivoire,2017,CI,CIV,AFR,1985613,3413597,5399210,2527875,1756295,1356437,810117,415037,307411,7173172,1956593,3344107,5300700,2483136,1740089,1323255,741105,403889,283463,6974937,14148109,24848016,24848016
Côte d'Ivoire,2018,CI,CIV,AFR,2018165,3478503,5496668,2614969,1794962,1391702,850710,429226,315112,7396681,1988371,3416557,5404928,2560731,1780227,1365385,776691,419284,293396,7195714,14592395,25493988,25493988
Côte d'Ivoire,2019,CI,CIV,AFR,2050655,3540174,5590829,2704927,1837557,1423984,891419,446055,323354,7627296,2019958,3485439,5505397,2642045,1825175,1402431,814174,435768,304441,7424034,15051330,26147551,26147551
Côte d'Ivoire,2020,CI,CIV,AFR,2084100,3601170,5685270,2795111,1887464,1453126,931334,465000,330322,7862357,2052280,3553000,5605280,2724747,1877926,1434461,853148,453078,315530,7658890,15521247,26811790,26811790
Côte d'Ivoire,2021,CI,CIV,AFR,2117532,3662907,5780439,2882870,1946362,1476743,970815,485576,334909,8097275,2084518,3620385,5704903,2806676,1939703,1458340,894854,470642,325419,7895634,15992909,27478249,27478249
Côte d'Ivoire,2022,CI,CIV,AFR,2148483,3727494,5875977,2968034,2016301,1494989,1012097,508720,339447,8339588,2114498,3689366,5803864,2888509,2011473,1474640,941794,489434,335255,8141105,16480693,28160542,28160542
Côte d'Ivoire,2023,CI,CIV,AFR,2179879,3791766,5971645,3049653,2094627,1515419,1055046,535640,346999,8597384,2145257,3756435,5901692,2969711,2087725,1494230,992556,510910,347177,8402309,16999693,28873034,28873034
Côte d'Ivoire,2024,CI,CIV,AFR,2214948,3852668,6067616,3127075,2174364,1542235,1097830,565695,356913,8864112,2179888,3818402,5998290,3049588,2161703,1521839,1044396,534955,360801,8673282,17537394,29603302,29603302
Côte d'Ivoire,2025,CI,CIV,AFR,2250838,3911949,6162787,3202892,2256182,1573133,1139489,597575,367546,9136817,2215463,3876946,6092409,3130725,2236382,1553353,1095652,560871,375186,8952169,18088986,30344181,30344181
Côte d'Ivoire,2026,CI,CIV,AFR,2286806,3971556,6258362,3277437,2340393,1607032,1179099,631004,379247,9414212,2251149,3934863,6186012,3212708,2312339,1587898,1144548,588787,390579,9236859,18651071,31095448,31095448
Côte d'Ivoire,2027,CI,CIV,AFR,2323920,4033305,6357225,3348398,2426484,1644430,1216194,665633,392292,9693431,2287868,3995099,6282967,3291701,2389720,1626410,1189828,618787,407077,9523523,19216954,31857148,31857148
Côte d'Ivoire,2028,CI,CIV,AFR,2362583,4098039,6460622,3414256,2515714,1685181,1250634,700811,407164,9973760,2325970,4058587,6384557,3365424,2470650,1669059,1230756,650610,424940,9811439,19785199,32630380,32630380
Côte d'Ivoire,2029,CI,CIV,AFR,2402008,4166330,6568338,3476522,2607261,1729447,1282278,736111,424116,10255735,2364795,4125687,6490482,3435199,2554747,1716023,1267006,684130,444200,10101305,20357040,33415862,33415862
Côte d'Ivoire,2030,CI,CIV,AFR,2441459,4235866,6677325,3537745,2698232,1780113,1310959,771080,443114,10541243,2403677,4194114,6597791,3503299,2639527,1769904,1298531,719029,464629,10394919,20936162,34211272,34211272
Côte d'Ivoire,1950,CI,CIV,AFR,247938,362115,610053,275702,199307,135353,88086,50292,26806,775546,243274,347945,591219,262326,189343,130369,89131,55233,33675,760077,1535623,2736909,2736909
Côte d'Ivoire,1951,CI,CIV,AFR,251070,369017,620087,284209,207872,140480,91404,52369,28112,804446,251237,355577,606814,269700,196110,134240,91589,56796,34548,782983,1587429,2814320,2814320
Côte d'Ivoire,1952,CI,CIV,AFR,256036,375369,631405,292335,216332,145651,94772,54466,29418,832974,260311,362976,623287,276969,202913,138194,94097,58389,35462,806024,1638998,2893687,2893687
Côte d'Ivoire,1953,CI,CIV,AFR,263726,380578,644304,300209,224851,150961,98226,56607,30766,861620,271202,369756,640958,284147,209834,142275,96678,60019,36434,829387,1691007,2976271,2976271
Côte d'Ivoire,1954,CI,CIV,AFR,273730,385308,659038,307795,233221,156837,101793,58805,32175,890626,282299,377809,660108,291176,216611,146860,99351,61698,37473,853169,1743795,3062945,3062945
Côte d'Ivoire,1955,CI,CIV,AFR,284531,391169,675700,315112,241541,163352,105503,61068,33659,920235,292541,388344,680885,298032,223287,151982,102145,63436,38580,877462,1797697,3154282,3154282
Côte d'Ivoire,1956,CI,CIV,AFR,295658,398670,694328,322336,250266,170246,109395,63423,35229,950895,303039,400303,703342,304848,230247,157345,105064,65239,39765,902508,1853403,3251073,3251073
Côte d'Ivoire,1957,CI,CIV,AFR,307225,407640,714865,329691,259460,177559,113496,65888,36901,982995,313985,413525,727510,311775,237514,162970,108121,67116,41033,928529,1911524,3353893,3353893
Côte d'Ivoire,1958,CI,CIV,AFR,319243,417976,737219,337409,269144,185344,117835,68475,38674,1016881,325415,427912,753327,319028,245107,168890,111336,69065,42382,955808,1972689,3463232,3463232
Côte d'Ivoire,1959,CI,CIV,AFR,331704,429720,761424,345819,279540,193763,122495,71213,40565,1053395,337397,443398,780795,326959,253129,175195,114758,71123,43816,984980,2038375,3580593,3580593
Côte d'Ivoire,1960,CI,CIV,AFR,345162,442954,788116,355180,290919,203006,127573,74157,42603,1093438,350525,460110,810635,335677,261735,181994,118427,73293,45350,1016476,2109914,3708661,3708661
Côte d'Ivoire,1961,CI,CIV,AFR,359869,457897,817766,365266,303428,213146,133118,77319,44793,1137070,365004,478291,843295,344963,271013,189311,122367,75584,46973,1050211,2187281,3848336,3848336
Côte d'Ivoire,1962,CI,CIV,AFR,375628,475014,850642,375305,316902,224086,139106,80693,47104,1183196,380591,498288,878879,354334,280886,197105,126565,77996,48690,1085576,2268772,3998287,3998287
Côte d'Ivoire,1963,CI,CIV,AFR,392520,495024,887544,384139,330711,235572,145438,84218,49489,1229567,397311,520657,917968,363090,291015,205276,130993,80517,50480,1121371,2350938,4156453,4156453
Côte d'Ivoire,1964,CI,CIV,AFR,410504,517589,928093,392012,344282,247140,152365,87872,51929,1275600,415107,543883,958990,372784,301051,213442,135924,83145,52337,1158683,2434283,4321368,4321368
Côte d'Ivoire,1965,CI,CIV,AFR,429139,541807,970946,400384,357419,258756,159912,91659,54442,1322572,433484,567407,1000891,384542,310858,221582,141357,85880,54265,1198484,2521056,4492890,4492890
Côte d'Ivoire,1966,CI,CIV,AFR,448218,567445,1015663,409795,370125,270716,167784,95593,57026,1371039,452202,592417,1044619,397413,320471,229985,147014,88720,56264,1239867,2610906,4671196,4671196
Côte d'Ivoire,1967,CI,CIV,AFR,467910,594481,1062391,420161,382488,283005,175987,99677,59709,1421027,471500,618910,1090410,411295,329986,238651,152911,91681,58342,1282866,2703893,4856689,4856689
Côte d'Ivoire,1968,CI,CIV,AFR,488195,623015,1111210,431585,394744,295614,184563,103934,62479,1472919,491331,646975,1138306,426181,339586,247566,159059,94773,60511,1327676,2800595,5050106,5050106
Côte d'Ivoire,1969,CI,CIV,AFR,509133,653166,1162299,444851,407683,308855,193689,108457,65431,1528966,511743,676695,1188438,442392,349826,256859,165545,98029,62786,1375437,2904403,5255149,5255149
Côte d'Ivoire,2031,CI,CIV,AFR,2480972,4305001,6785973,3599532,2786980,1839702,1335096,806506,463965,10831781,2442609,4262246,6704855,3571038,2723815,1832808,1323180,756900,486037,10693778,21525559,35016385,35016385
Côte d'Ivoire,2032,CI,CIV,AFR,2520949,4372450,6893399,3663820,2871950,1908702,1354075,843550,486529,11128626,2482038,4328802,6810840,3639986,2806542,1904076,1340736,799335,508447,10999122,22127748,35831986,35831986
Côte d'Ivoire,2033,CI,CIV,AFR,2560450,4441823,7002273,3727520,2951629,1983853,1374025,880984,510743,11428754,2521018,4397372,6918390,3706749,2886577,1977795,1360435,844267,532091,11307914,22736668,36657338,36657338
Côte d'Ivoire,2034,CI,CIV,AFR,2597481,4515712,7113193,3787966,3027384,2060505,1399748,917747,536583,11729933,2557556,4470580,7028136,3768549,2965428,2049552,1387465,889715,557236,11617945,23347878,37489206,37489206
Côte d'Ivoire,2035,CI,CIV,AFR,2632582,4590475,7223057,3846854,3101648,2139211,1429309,953568,564010,12034600,2592205,4544807,7137012,3827021,3045573,2122075,1418200,934669,584160,11931698,23966298,38326368,38326368
Côte d'Ivoire,2036,CI,CIV,AFR,2666272,4665380,7331652,3906080,3174706,2220197,1461659,987680,593064,12343386,2625484,4619225,7244709,3884900,3126578,2195859,1451775,977600,613141,12249853,24593239,39169609,39169609
Côte d'Ivoire,2037,CI,CIV,AFR,2697830,4741868,7439698,3967393,3244295,2302963,1497217,1019679,623682,12655229,2656660,4695163,7351823,3945065,3204659,2271032,1488996,1017422,644305,12571479,25226708,40018237,40018237
Côte d'Ivoire,2038,CI,CIV,AFR,2726610,4819411,7546021,4031631,3308971,2388727,1535845,1049444,655688,12970306,2685155,4772024,7457179,4008426,3277643,2349623,1530002,1053492,677645,12896831,25867137,40870342,40870342
Côte d'Ivoire,2039,CI,CIV,AFR,2754158,4895284,7649442,4099352,3370190,2476683,1577670,1076872,688956,13289723,2712444,4847207,7559651,4075357,3346829,2431259,1574936,1085538,713055,13226974,26516697,41725787,41725787
Côte d'Ivoire,2040,CI,CIV,AFR,2781974,4969324,7751298,4168307,3430438,2564116,1625324,1101771,723048,13613004,2739957,4920617,7660574,4143611,3414427,2513621,1626189,1113481,750076,13561405,27174409,42586279,42586279
Côte d'Ivoire,2041,CI,CIV,AFR,2809347,5042051,7851398,4236893,3491277,2649498,1681099,1122863,758444,13940074,2766972,4992734,7759706,4211594,3481729,2595600,1685696,1135568,789835,13900022,27840096,43451200,43451200
Côte d'Ivoire,2042,CI,CIV,AFR,2835850,5113161,7949011,4303856,3554572,2731353,1745437,1139737,795949,14270904,2793075,5063287,7856362,4278057,3550265,2676190,1752868,1151778,833607,14242765,28513669,44319052,44319052
Côte d'Ivoire,2043,CI,CIV,AFR,2862670,5181086,8043756,4372723,3617320,2808283,1815514,1157701,834480,14606021,2819492,5130786,7950278,4346528,3616719,2754340,1822472,1170240,879872,14590171,29196192,45190221,45190221
Côte d'Ivoire,2044,CI,CIV,AFR,2890198,5245420,8135618,4446036,3676936,2881577,1887163,1180864,873135,14945711,2846604,5194715,8041319,4419589,3678389,2831488,1890534,1195443,927207,14942650,29888361,46065287,46065287
Côte d'Ivoire,2045,CI,CIV,AFR,2916698,5308128,8224826,4520218,3735089,2953538,1960804,1207501,911762,15288912,2872660,5257000,8129660,4493674,3736896,2909981,1959447,1224083,975034,15299115,30588027,46942511,46942511
Côte d'Ivoire,2046,CI,CIV,AFR,2942064,5368982,8311046,4594562,3793611,3024418,2036569,1236604,949786,15635550,2897674,5317433,8215107,4567977,3794901,2989370,2029587,1255294,1022381,15659510,31295060,47821216,47821216
Côte d'Ivoire,2047,CI,CIV,AFR,2967578,5426940,8394518,4670478,3854177,3092035,2113984,1268497,986860,15986031,2922916,5374928,8297844,4643798,3855154,3066014,2101072,1289720,1068487,16024245,32010276,48702637,48702637
Côte d'Ivoire,2048,CI,CIV,AFR,2992846,5482520,8475366,4747438,3917582,3155008,2194139,1302992,1022785,16339944,2947856,5430137,8377993,4720550,3918533,3137840,2175784,1327406,1112848,16392961,32732905,49586273,49586273
Côte d'Ivoire,2049,CI,CIV,AFR,3016999,5537597,8554596,4822757,3984378,3214729,2276264,1340163,1057409,16695700,2971780,5484843,8456623,4795655,3985425,3206088,2253344,1368410,1155148,16764070,33459770,50470989,50470989
Côte d'Ivoire,2050,CI,CIV,AFR,3041600,5591909,8633509,4896268,4052380,3273556,2357911,1382264,1090340,17052719,2996296,5538714,8535010,4869019,4053637,3272884,2331634,1414816,1195010,17137000,34189719,51358243,51358243
Cameroon,1970,CM,CMR,AFR,571457,801241,1372698,545557,419249,313704,230572,155380,112973,1777435,564065,804397,1368462,561440,450880,346687,257836,177987,139366,1934196,3711631,6452787,6452787
Cameroon,1971,CM,CMR,AFR,589772,831089,1420861,558856,429246,319662,234963,158612,116060,1817399,581762,833276,1415038,573630,459103,353443,263120,181746,143016,1974058,3791457,6627350,6627350
Cameroon,1972,CM,CMR,AFR,608578,861914,1470492,573960,439056,325990,239443,161898,119224,1859571,600087,863134,1463221,587549,467095,360589,268522,185618,146807,2016180,3875751,6809468,6809468
Cameroon,1973,CM,CMR,AFR,627652,893640,1521292,592145,447601,332605,244012,165247,122463,1904073,618876,893869,1512745,604255,474048,367947,274037,189585,150701,2060573,3964646,6998688,6998688
Cameroon,1974,CM,CMR,AFR,647022,926138,1573160,614647,453908,339288,248673,168660,125750,1950926,638103,925373,1563476,624757,479307,375161,279539,193721,154659,2107144,4058070,7194697,7194697
Cameroon,1975,CM,CMR,AFR,666571,959431,1626002,638482,461027,346040,253419,172124,129075,2000167,657591,957685,1615276,647037,485090,382129,285031,198026,158661,2155974,4156141,7397417,7397417
Cameroon,1976,CM,CMR,AFR,686336,993398,1679734,660532,468810,352320,257943,175484,132260,2047349,677347,990716,1668063,668181,491068,388319,290369,202295,162657,2202889,4250238,7598028,7598028
Cameroon,1977,CM,CMR,AFR,706956,1027634,1734590,682664,475294,358200,262227,178721,135337,2092443,697969,1024135,1722104,689287,496015,393767,295505,206506,166607,2247687,4340130,7796825,7796825
Cameroon,1978,CM,CMR,AFR,729040,1062360,1791400,707844,483638,365234,266939,182138,138588,2144381,720078,1058211,1778289,713559,503062,399954,301016,210885,170731,2299207,4443588,8013279,8013279
Cameroon,1979,CM,CMR,AFR,752840,1097586,1850426,734911,493352,373106,271893,185688,141953,2200903,743857,1092942,1836799,739783,511634,406669,306785,215383,174999,2355253,4556156,8243377,8243377
Cameroon,1980,CM,CMR,AFR,779647,1134309,1913956,768204,509703,384368,278162,189854,145864,2276155,770557,1129336,1899893,772671,527000,416369,313733,220384,179730,2429887,4706042,8519891,8519891
Cameroon,1981,CM,CMR,AFR,809441,1172658,1982099,804878,530670,397762,285407,194439,150118,2363274,800129,1167465,1967594,809139,547065,427901,321552,225714,184706,2516077,4879351,8829048,8829048
Cameroon,1982,CM,CMR,AFR,838705,1209971,2048676,826426,537052,403019,289518,197562,153005,2406582,829066,1204558,2033624,829146,552233,431674,326629,229833,188588,2558103,4964685,9046986,9046986
Cameroon,1983,CM,CMR,AFR,866380,1248219,2114599,844921,540841,404259,292657,200257,155635,2438570,856393,1242748,2099141,845674,554359,431726,330766,233586,192250,2588361,5026931,9240672,9240672
Cameroon,1984,CM,CMR,AFR,893990,1290340,2184330,875389,558978,408232,297972,203981,159366,2503918,883658,1284969,2168627,875103,570450,434672,336570,238075,196824,2651694,5155612,9508570,9508570
Cameroon,1985,CM,CMR,AFR,922087,1335171,2257258,909547,581137,414172,303877,208030,163393,2580156,911428,1329860,2241288,908461,590958,439177,342537,242715,201708,2725556,5305712,9804254,9804254
Cameroon,1986,CM,CMR,AFR,950604,1382760,2333364,944774,603217,422185,310018,212144,167431,2659769,939674,1377398,2317072,942871,612011,445249,348357,247385,206640,2802513,5462282,10112712,10112712
Cameroon,1987,CM,CMR,AFR,978899,1433957,2412856,980548,626841,430504,316512,216326,171484,2742215,967730,1428439,2396169,978010,634662,451953,354222,252163,211659,2882669,5624884,10433905,10433905
Cameroon,1988,CM,CMR,AFR,1007949,1486293,2494242,1015709,651049,438780,323223,220513,175505,2824779,996543,1480589,2477132,1012684,657965,458933,360071,257019,216749,2963421,5788200,10759573,10759573
Cameroon,1989,CM,CMR,AFR,1037908,1538600,2576508,1050726,675883,447351,330221,224678,179509,2908368,1026312,1532672,2558984,1047337,681918,466378,365974,261907,221848,3045362,5953730,11089222,11089222
Cameroon,1990,CM,CMR,AFR,1067329,1592668,2659997,1086849,702369,456948,337756,228893,183597,2996412,1055570,1586508,2642078,1083311,707592,474952,372251,266895,227035,3132036,6128448,11430520,11430520
Cameroon,1991,CM,CMR,AFR,1094974,1648784,2743758,1123625,729686,467369,345424,233167,187665,3086936,1083080,1642377,2725457,1120081,734192,484452,378585,272013,232250,3221573,6308509,11777719,11777719
Cameroon,1992,CM,CMR,AFR,1120574,1706225,2826799,1161297,757585,479052,352646,237556,191676,3179812,1108437,1699555,2807992,1157876,761486,495250,384543,277353,237498,3314006,6493818,12128604,12128604
Cameroon,1993,CM,CMR,AFR,1145130,1763751,2908881,1200644,786774,493472,358656,242058,195709,3277313,1132467,1756796,2889263,1197528,790124,508588,389510,282774,242790,3411314,6688627,12486773,12486773
Cameroon,1994,CM,CMR,AFR,1168940,1820010,2988950,1241793,816805,511537,362487,246424,199692,3378738,1155636,1812918,2968554,1239065,819674,525188,392780,287889,248022,3512618,6891356,12848862,12848862
Cameroon,1995,CM,CMR,AFR,1191243,1874719,3065962,1284695,847286,530501,366669,250593,203561,3483305,1177232,1867719,3044951,1282345,849827,543193,396260,292620,253183,3617428,7100733,13211647,13211647
Cameroon,1996,CM,CMR,AFR,1211407,1927371,3138778,1330137,878504,549058,372520,254803,207352,3592374,1196626,1920611,3117237,1328090,880827,561502,401059,297140,258318,3726936,7319310,13575324,13575324
Cameroon,1997,CM,CMR,AFR,1230234,1977236,3207470,1378884,910078,568787,378509,259205,211116,3706579,1214850,1970692,3185542,1377009,912305,581008,406262,301573,263430,3841587,7548166,13941181,13941181
Cameroon,1998,CM,CMR,AFR,1250263,2026510,3276773,1428780,941873,589754,384767,263873,214871,3823918,1234508,2019966,3254474,1426991,944145,601782,411952,306018,268554,3959442,7783360,14314599,14314599
Cameroon,1999,CM,CMR,AFR,1274332,2075943,3350275,1478407,973680,611552,391418,268792,218586,3942435,1258155,2069298,3327453,1476676,976184,623476,418233,310568,273676,4078813,8021248,14698973,14698973
Cameroon,2000,CM,CMR,AFR,1302281,2123371,3425652,1529078,1005323,633960,398618,274000,222254,4063233,1285547,2116559,3402106,1527354,1008171,645835,425150,315290,278801,4200601,8263834,15091594,15091594
Cameroon,2001,CM,CMR,AFR,1333238,2167442,3500680,1581874,1037809,657330,406703,279401,226028,4189145,1315873,2160353,3476226,1580111,1041017,669112,432919,320041,284001,4327201,8516346,15493253,15493253
Cameroon,2002,CM,CMR,AFR,1368847,2209044,3577891,1637055,1072502,682109,416352,284663,230076,4322757,1350807,2201606,3552413,1635258,1076060,693671,442091,324517,289382,4460979,8783736,15914033,15914033
Cameroon,2003,CM,CMR,AFR,1409325,2251298,3660623,1692574,1108767,707952,428396,288963,234288,4460940,1390485,2243416,3633901,1690678,1112677,719178,453410,328097,294833,4598873,9059813,16354326,16354326
Cameroon,2004,CM,CMR,AFR,1452036,2297206,3749242,1746518,1146279,734345,443554,291466,238442,4600604,1432420,2288675,3721095,1744611,1150575,745281,467601,330259,300145,4738472,9339076,16809407,16809407
Cameroon,2005,CM,CMR,AFR,1495861,2346133,3841994,1798656,1185210,761205,459605,294391,242535,4741602,1475721,2336677,3812398,1796880,1189762,771812,482982,332573,305160,4879169,9620771,17275171,17275171
Cameroon,2006,CM,CMR,AFR,1541511,2396659,3938170,1848599,1226216,788703,475411,298868,246764,4884561,1521092,2386073,3907165,1847013,1230820,798920,498579,336057,310051,5021440,9906001,17751333,17751333
Cameroon,2007,CM,CMR,AFR,1587902,2451090,4038992,1897592,1272046,817459,492734,303750,251413,5034994,1567362,2439394,4006756,1896261,1276608,827318,515663,340145,315123,5171118,10206112,18251866,18251866
Cameroon,2008,CM,CMR,AFR,1633097,2511776,4144873,1947569,1320608,847282,511598,309131,256505,5192693,1612355,2499130,4111485,1946424,1325126,856880,534263,344887,320452,5328032,10520725,18777081,18777081
Cameroon,2009,CM,CMR,AFR,1677047,2578803,4255850,1997919,1369620,877723,531573,315083,261927,5353845,1655878,2565231,4221109,1996876,1374088,887177,553985,350323,326028,5488477,10842322,19319274,19319274
Cameroon,2010,CM,CMR,AFR,1720718,2651359,4372077,2046560,1420632,908913,552540,321725,267675,5518045,1698764,2636892,4335656,2045566,1425125,918363,574743,356561,331895,5652253,11170298,19878036,19878036
Cameroon,2011,CM,CMR,AFR,1763206,2729308,4492514,2091759,1473831,941159,574537,329207,273640,5684133,1740035,2714037,4454072,2090694,1478425,950735,596576,363716,338004,5818150,11502283,20448873,20448873
Cameroon,2012,CM,CMR,AFR,1803452,2812521,4615973,2134581,1528997,975069,597664,337964,279630,5853905,1778470,2796544,4575014,2133369,1533722,984837,619524,372147,344192,5987791,11841696,21032684,21032684
Cameroon,2013,CM,CMR,AFR,1841880,2899314,4741194,2178434,1585222,1010855,621970,348753,285039,6030273,1814598,2882517,4697115,2177066,1590147,1020941,643638,382560,349914,6164266,12194539,21632850,21632850
Cameroon,2014,CM,CMR,AFR,1880377,2988998,4869375,2233251,1648969,1052760,649020,362972,289867,6236839,1850764,2971041,4821805,2232325,1654586,1063069,670323,396181,355087,6371571,12608410,22299585,22299585
Cameroon,2015,CM,CMR,AFR,1921900,3081008,5002908,2293680,1715972,1099209,678027,378604,295450,6460942,1889969,3061538,4951507,2293320,1722917,1109796,698967,411524,360762,6597286,13058228,23012646,23012646
Cameroon,2016,CM,CMR,AFR,1968489,3173482,5141971,2348645,1775633,1145923,707006,393850,301896,6672953,1933982,3152233,5086215,2347889,1783934,1156870,727734,426957,367113,6810497,13483450,23711630,23711630
Cameroon,2017,CM,CMR,AFR,2018777,3263852,5282629,2400950,1827090,1193492,735611,409752,308322,6875217,1981668,3240387,5222055,2399103,1836461,1204782,756252,443100,373590,7013288,13888505,24393181,24393181
Cameroon,2018,CM,CMR,AFR,2069010,3351081,5420091,2457492,1876022,1241582,764322,426591,315127,7081136,2029597,3324873,5354470,2454728,1886561,1253520,785215,460369,380651,7221044,14302180,25076747,25076747
Cameroon,2019,CM,CMR,AFR,2117306,3436420,5553726,2522449,1926779,1291026,794079,444601,322833,7301767,2075856,3407086,5482942,2518958,1938550,1303692,815323,478798,388592,7443913,14745680,25782341,25782341
Cameroon,2020,CM,CMR,AFR,2160208,3523752,5683960,2593271,1975481,1342082,824009,462618,329198,7526659,2117066,3490840,5607906,2588958,1988362,1355757,845992,497624,395861,7672554,15199213,26491087,26491087
Cameroon,2021,CM,CMR,AFR,2195084,3615885,5810969,2669912,2020624,1395030,854124,480308,333267,7753265,2150739,3578810,5729549,2664875,2034497,1410010,877382,516539,401549,7904852,15658117,27198628,27198628
Cameroon,2022,CM,CMR,AFR,2224504,3710589,5935093,2752411,2063217,1449892,885630,498771,337512,7987433,2179093,3668769,5847862,2746681,2077724,1466035,910217,536111,407380,8144148,16131581,27914536,27914536
Cameroon,2023,CM,CMR,AFR,2252004,3803723,6055727,2839211,2106530,1505885,919368,518847,344136,8233977,2205690,3756941,5962631,2832668,2121435,1523123,945197,557154,415386,8394963,16628940,28647293,28647293
Cameroon,2024,CM,CMR,AFR,2278394,3892894,6171288,2927805,2152960,1561601,955813,540749,353980,8492908,2231759,3841456,6073215,2920173,2167993,1580047,982703,579832,426276,8657024,17149932,29394433,29394433
Cameroon,2025,CM,CMR,AFR,2302679,3978011,6280690,3017998,2201738,1616466,994997,564330,366842,8762371,2256495,3922455,6178950,3009099,2216581,1636358,1022774,604053,439906,8928771,17691142,30150781,30150781
Cameroon,2026,CM,CMR,AFR,2326203,4060202,6386405,3109493,2251629,1669783,1037084,589207,381636,9038832,2281057,4000902,6281959,3099258,2266048,1691322,1065711,629554,455395,9207288,18246120,30914482,30914482
Cameroon,2027,CM,CMR,AFR,2350560,4140683,6491243,3199741,2304825,1720815,1082466,614728,397410,9319985,2306575,4078056,6384631,3187788,2318802,1744021,1112024,655820,472046,9490501,18810486,31686360,31686360
Cameroon,2028,CM,CMR,AFR,2376578,4218450,6595028,3286972,2363714,1771221,1129163,640705,414245,9606020,2333638,4153288,6486926,3272764,2377421,1795966,1159754,682667,489914,9778486,19384506,32466454,32466454
Cameroon,2029,CM,CMR,AFR,2404904,4292458,6697362,3371861,2428719,1821524,1176220,667221,432090,9897635,2362639,4225651,6588290,3355007,2442226,1847771,1207966,710184,508961,10072115,19969750,33255398,33255398
Cameroon,2030,CM,CMR,AFR,2434497,4359653,6794150,3458603,2499167,1869783,1224981,694404,450953,10197891,2392532,4292103,6684635,3438671,2512561,1897453,1258061,738502,529188,10374436,20572327,34051103,34051103
Cameroon,1950,CM,CMR,AFR,330069,506067,836136,401432,307405,229883,163281,104303,65831,1272135,336090,518591,854681,412277,319988,240332,176628,119758,83879,1352862,2624997,4315816,4315816
Cameroon,1951,CM,CMR,AFR,332163,513230,845393,408109,312585,234000,166540,106726,67997,1295957,337485,526252,863737,418982,325487,244551,179782,121990,86095,1376887,2672844,4381975,4381975
Cameroon,1952,CM,CMR,AFR,334951,519828,854779,415088,317833,238153,169836,109171,70192,1320273,339503,533500,873003,426053,331051,248859,182988,124274,88316,1401541,2721814,4449602,4449602
Cameroon,1953,CM,CMR,AFR,339887,524797,864684,422227,323184,242364,173172,111631,72412,1344990,343369,539450,882819,433313,336692,253258,186253,126615,90551,1426682,2771672,4519183,4519183
Cameroon,1954,CM,CMR,AFR,348885,527330,876215,429194,328674,246655,176566,114126,74659,1369874,350706,543492,894198,440414,342310,257888,189608,129039,92822,1452081,2821955,4592370,4592370
Cameroon,1955,CM,CMR,AFR,358933,531199,890132,435882,334338,251040,180031,116674,76951,1394916,359555,548240,907795,447256,347934,262745,193067,131551,95136,1477689,2872605,4670538,4670538
Cameroon,1956,CM,CMR,AFR,368142,538134,906276,442463,340216,255518,183560,119268,79288,1420313,368361,555084,923445,454054,353745,267719,196651,134180,97536,1503885,2924198,4753921,4753921
Cameroon,1957,CM,CMR,AFR,378599,546042,924641,448596,345744,259768,186961,121790,81579,1444438,378328,562788,941116,460959,359742,272788,200327,136898,100028,1530742,2975180,4840930,4840930
Cameroon,1958,CM,CMR,AFR,390185,554961,945146,454484,350888,263788,190225,124232,83806,1467423,389395,571383,960778,468078,365927,277934,204089,139693,102608,1558329,3025752,4931680,4931680
Cameroon,1959,CM,CMR,AFR,402656,565061,967717,460831,356177,267923,193547,126718,86100,1491296,401354,581001,982355,475525,372317,283178,207946,142555,105266,1586787,3078083,5028160,5028160
Cameroon,1960,CM,CMR,AFR,415919,576416,992335,464501,357619,269970,195611,128416,87742,1503859,414126,591734,1005860,483315,378756,288334,211749,145409,107995,1615558,3119417,5117608,5117608
Cameroon,1961,CM,CMR,AFR,429860,589238,1019098,465798,355285,269846,196389,129314,88744,1505376,427603,603743,1031346,491251,385359,293414,215489,148239,110776,1644528,3149904,5200355,5200355
Cameroon,1962,CM,CMR,AFR,444371,604177,1048548,471510,357473,272131,198635,131188,90563,1521500,441639,617525,1059164,499015,392466,298819,219493,151191,113649,1674633,3196133,5303841,5303841
Cameroon,1963,CM,CMR,AFR,459364,622417,1081781,479990,364150,276874,202372,134043,93198,1550627,456126,634159,1090285,505755,399899,304542,223763,154255,116603,1704817,3255444,5427511,5427511
Cameroon,1964,CM,CMR,AFR,474594,645149,1119743,486076,370877,281700,206166,136947,95875,1577641,470837,654719,1125556,510689,407152,310222,228230,157374,119606,1733273,3310914,5556209,5556209
Cameroon,1965,CM,CMR,AFR,489898,669225,1159123,493005,377692,286648,210044,139904,98580,1605873,485614,677087,1162701,516177,414141,315905,232911,160581,122679,1762394,3368267,5690086,5690086
Cameroon,1966,CM,CMR,AFR,505412,692894,1198306,502309,384848,291730,213998,142911,101333,1637129,500563,699837,1200400,523541,421070,321724,237697,163879,125827,1793738,3430867,5829580,5829580
Cameroon,1967,CM,CMR,AFR,521235,718052,1239287,512059,392507,296968,218001,145955,104145,1669635,515803,724054,1239857,531658,428083,327686,242573,167254,129052,1826306,3495941,5975087,5975087
Cameroon,1968,CM,CMR,AFR,537396,744666,1282062,522361,400764,302394,222081,149049,107014,1703663,531335,749725,1281060,540589,435314,333835,247555,170732,132383,1860408,3564071,6127193,6127193
Cameroon,1969,CM,CMR,AFR,554041,772444,1326485,533464,409661,307983,226274,152189,109959,1739530,547314,776558,1323872,550483,442886,340185,252651,174316,135824,1896345,3635875,6286232,6286232
Cameroon,2031,CM,CMR,AFR,2464119,4418681,6882800,3549910,2575002,1914628,1275883,722616,470889,10508928,2422245,4351237,6773482,3526357,2588467,1943571,1310493,767985,550648,10687521,21196449,34852730,34852730
Cameroon,2032,CM,CMR,AFR,2493723,4472421,6966144,3643484,2656033,1956658,1328373,752161,491904,10828613,2451858,4405615,6857473,3615826,2669778,1986729,1364692,798961,573381,11009367,21837980,35661603,35661603
Cameroon,2033,CM,CMR,AFR,2524640,4524966,7049606,3735253,2740614,1998713,1381271,783058,514008,11152917,2482746,4459166,6941912,3703358,2754625,2029813,1419453,831490,597351,11336090,22489007,36480529,36480529
Cameroon,2034,CM,CMR,AFR,2556215,4578345,7134560,3823164,2826948,2043650,1433520,815656,537137,11480075,2514261,4513781,7028042,3787302,2840951,2075588,1473797,865879,622525,11666042,23146117,37308723,37308723
Cameroon,2035,CM,CMR,AFR,2587801,4631645,7219446,3907364,2915115,2091038,1484903,850194,561328,11809942,2545743,4568460,7114203,3867978,2928845,2123496,1527556,902332,648991,11999198,23809140,38142789,38142789
Cameroon,2036,CM,CMR,AFR,2620370,4684949,7305319,3988882,3004752,2139681,1534929,887131,586666,12142041,2578167,4623299,7201466,3946290,3018092,2172421,1580143,941319,676829,12335094,24477135,38983916,38983916
Cameroon,2037,CM,CMR,AFR,2654042,4738978,7393020,4068700,3093194,2191527,1582932,926976,612961,12476290,2611753,4678961,7290714,4023329,3105788,2224580,1630696,983386,705864,12673643,25149933,39833668,39833668
Cameroon,2038,CM,CMR,AFR,2686775,4795916,7482691,4145840,3178764,2248872,1630389,967942,640085,12811892,2644446,4737377,7381823,4098478,3190066,2282463,1680589,1026718,735992,13014306,25826198,40690719,40690719
Cameroon,2039,CM,CMR,AFR,2718499,4855753,7574252,4219269,3262106,2312110,1677745,1009175,668101,13148506,2676113,4798321,7474434,4170796,3271728,2346363,1730367,1070470,767235,13356959,26505465,41554156,41554156
Cameroon,2040,CM,CMR,AFR,2750921,4916894,7667815,4286001,3347280,2380568,1723231,1051875,697056,13486011,2708487,4860169,7568656,4237289,3354839,2415630,1778191,1115931,799668,13701548,27187559,42424031,42424031
Cameroon,2041,CM,CMR,AFR,2782476,4979057,7761533,4344737,3436949,2454172,1765625,1096477,727293,13825253,2739973,4922808,7662781,4296582,3441946,2490298,1822729,1163536,833645,14048736,27873989,43298306,43298306
Cameroon,2042,CM,CMR,AFR,2811322,5042259,7853581,4398302,3528850,2532746,1805489,1142501,759071,14166959,2768713,4986480,7755193,4351193,3530840,2570201,1864557,1212788,869461,14399040,28565999,44174768,44174768
Cameroon,2043,CM,CMR,AFR,2838828,5105802,7944630,4450705,3619014,2614736,1845444,1188891,792344,14511134,2796068,5050488,7846556,4404992,3617858,2653553,1906394,1262583,907133,14752513,29263647,45054826,45054826
Cameroon,2044,CM,CMR,AFR,2865437,5168991,8034428,4503942,3705437,2698455,1888161,1234726,827346,14858067,2822538,5114107,7936645,4459856,3701386,2738404,1950854,1312057,946869,15109426,29967493,45938571,45938571
Cameroon,2045,CM,CMR,AFR,2890721,5232924,8123645,4557106,3788267,2783959,1933237,1279854,864310,15206733,2847701,5178443,8026144,4514792,3781739,2824826,1997418,1361069,988889,15468733,30675466,46825263,46825263
Cameroon,2046,CM,CMR,AFR,2916232,5296989,8213221,4610270,3868489,2870879,1979551,1323910,903667,15556766,2873143,5242842,8115985,4569890,3859780,2912581,2045013,1409137,1033650,15830051,31386817,47716029,47716029
Cameroon,2047,CM,CMR,AFR,2941115,5359469,8300584,4664152,3947049,2956671,2028923,1366332,945622,15908749,2898007,5305675,8203682,4625801,3936575,2998867,2095745,1455506,1081445,16193939,32102688,48606952,48606952
Cameroon,2048,CM,CMR,AFR,2964434,5419688,8384122,4720888,4022986,3039742,2083479,1408277,988596,16263968,2921367,5366255,8287622,4684433,4011511,3081897,2151965,1501306,1130630,16561742,32825710,49497461,49497461
Cameroon,2049,CM,CMR,AFR,2987414,5478025,8465439,4780476,4095316,3120733,2143585,1450100,1031986,16622196,2944447,5424938,8369385,4745570,4083674,3162465,2213956,1546990,1180517,16933172,33555368,50390181,50390181
Cameroon,2050,CM,CMR,AFR,3007628,5535744,8543372,4841345,4161162,3203559,2208577,1490340,1076837,16981820,2964755,5483027,8447782,4807604,4150147,3244511,2281071,1590976,1232274,17306583,34288403,51279560,51279560
Democratic Republic of the Congo,1970,CD,COD,AFR,1838513,2532164,4370677,1844232,1396256,947421,612453,365564,231053,5396979,1840746,2545811,4386557,1883062,1506154,1063909,730255,473295,340847,5997522,11394501,20151733,20151733
Democratic Republic of the Congo,1971,CD,COD,AFR,1896098,2617413,4513511,1877939,1438056,977060,631249,376893,237825,5539022,1897628,2630461,4528089,1911222,1544096,1092930,749232,485502,349354,6132336,11671358,20712952,20712952
Democratic Republic of the Congo,1972,CD,COD,AFR,1952516,2706871,4659387,1911721,1476146,1006521,650206,388364,244987,5677945,1953239,2719159,4672398,1939807,1577747,1121674,768415,497990,358043,6263676,11941621,21273409,21273409
Democratic Republic of the Congo,1973,CD,COD,AFR,2007116,2800438,4807554,1952666,1511742,1037418,670065,400141,252455,5824487,2007094,2811923,4819017,1976787,1607929,1151787,788492,510881,366974,6402850,12227337,21853906,21853906
Democratic Republic of the Congo,1974,CD,COD,AFR,2059792,2897681,4957473,2002113,1541910,1068922,690626,412252,260273,5976096,2059026,2908387,4967413,2021936,1633309,1182462,809247,524089,376392,6547435,12523531,22448415,22448415
Democratic Republic of the Congo,1975,CD,COD,AFR,2111148,2998105,5109253,2056855,1568636,1100579,711730,424699,268442,6130941,2109666,3007793,5117459,2073177,1654592,1213158,830456,537492,386182,6695057,12825998,23052715,23052715
Democratic Republic of the Congo,1976,CD,COD,AFR,2160812,3100710,5261522,2112863,1593030,1131618,733087,437332,276922,6284852,2158568,3108974,5267542,2127534,1671562,1243075,851786,550938,396198,6841093,13125945,23655016,23655016
Democratic Republic of the Congo,1977,CD,COD,AFR,2208907,3204049,5412956,2171356,1615519,1162302,754860,449963,285286,6439286,2205862,3210670,5416532,2184355,1686856,1272531,873396,564348,406205,6987691,13426977,24256464,24256464
Democratic Republic of the Congo,1978,CD,COD,AFR,2261206,3310631,5571837,2255426,1661426,1205184,782286,464918,295469,6664709,2257519,3315324,5572843,2268934,1726585,1313311,899925,579599,417510,7205864,13870573,25015244,25015244
Democratic Republic of the Congo,1979,CD,COD,AFR,2323560,3418822,5742382,2356738,1724826,1257916,814113,482099,307285,6942977,2319234,3421467,5740701,2371903,1784601,1362952,930374,596728,430136,7476694,14419671,25902760,25902760
Democratic Republic of the Congo,1980,CD,COD,AFR,2393606,3523172,5916778,2442699,1771496,1303926,843159,498394,317619,7177293,2388428,3523496,5911924,2457604,1825976,1405506,958583,613228,441791,7702688,14879981,26708686,26708686
Democratic Republic of the Congo,1981,CD,COD,AFR,2467901,3624668,6092569,2519621,1806330,1344369,870481,514229,327249,7382279,2461740,3622392,6084132,2533047,1855938,1442193,985357,629402,452868,7898805,15281084,27457783,27457783
Democratic Republic of the Congo,1982,CD,COD,AFR,2546741,3724726,6271467,2598934,1841616,1383285,898530,530614,337223,7590202,2539495,3720060,6259555,2610601,1887029,1477008,1012831,646207,464321,8097997,15688199,28219219,28219219
Democratic Republic of the Congo,1983,CD,COD,AFR,2631652,3824241,6455893,2681987,1881675,1419037,927505,547536,347357,7805097,2623208,3817119,6440327,2691638,1923914,1507716,1041160,663541,475887,8303856,16108953,29005175,29005175
Democratic Republic of the Congo,1984,CD,COD,AFR,2721732,3930054,6651786,2777199,1937751,1454385,959075,565952,358639,8053001,2711923,3920512,6632435,2785351,1976591,1538312,1071757,682166,488443,8542620,16595621,29879852,29879852
Democratic Republic of the Congo,1985,CD,COD,AFR,2815324,4044247,6859571,2876419,1999890,1488228,991584,585267,370541,8311929,2803968,4032256,6836224,2882923,2036189,1566865,1103159,701590,501602,8792328,17104257,30800051,30800051
Democratic Republic of the Congo,1986,CD,COD,AFR,2914194,4163031,7077225,2972945,2059035,1519995,1023779,604986,382661,8563401,2901060,4148620,7049680,2977223,2094743,1591976,1134336,721443,515105,9034826,17598227,31725132,31725132
Democratic Republic of the Congo,1987,CD,COD,AFR,3020084,4287286,7307370,3074594,2124792,1554315,1057877,626121,395927,8833626,3004777,4270534,7275311,3076840,2160019,1619895,1167196,742552,529759,9296261,18129887,32712574,32712574
Democratic Republic of the Congo,1988,CD,COD,AFR,3129005,4419143,7548148,3178491,2195923,1590792,1093834,648311,409835,9117186,3111341,4400580,7511921,3179023,2230970,1650567,1201787,764850,545596,9572793,18689979,33750052,33750052
Democratic Republic of the Congo,1989,CD,COD,AFR,3236681,4560778,7797459,3282732,2271403,1628714,1131542,671226,424341,9409958,3216758,4540942,7757700,3281881,2306670,1683482,1237929,788188,562628,9860778,19270736,34825891,34825891
Democratic Republic of the Congo,1990,CD,COD,AFR,3342559,4715888,8058447,3393677,2359403,1671632,1172564,695589,440255,9733120,3320489,4695042,8015531,3392210,2395319,1721901,1276673,813146,581200,10180449,19913569,35987541,35987541
Democratic Republic of the Congo,1991,CD,COD,AFR,3448892,4883654,8332546,3502995,2452424,1716544,1214687,721186,457362,10065198,3424522,4862081,8286603,3501172,2489313,1763149,1316139,839494,601195,10510462,20575660,37194812,37194812
Democratic Republic of the Congo,1992,CD,COD,AFR,3554599,5060094,8614693,3593442,2531499,1755538,1252869,746367,473848,10353563,3527956,5037867,8565823,3590169,2569296,1799858,1351931,865779,621193,10798226,21151789,38332302,38332302
Democratic Republic of the Congo,1993,CD,COD,AFR,3662973,5247077,8910050,3694752,2625366,1805320,1291094,773421,491732,10681685,3634337,5225424,8859761,3691690,2664806,1848617,1387057,894136,643046,11129352,21811037,39580844,39580844
Democratic Republic of the Congo,1994,CD,COD,AFR,3797880,5452592,9250472,3892176,2823568,1912276,1347273,810752,518938,11304983,3767025,5432792,9199817,3897179,2866448,1951684,1438008,931059,672328,11756706,23061689,41511985,41511985
Democratic Republic of the Congo,1995,CD,COD,AFR,3958733,5651435,9610168,4049912,2988128,2007708,1394678,845584,542906,11828916,3925103,5633711,9558814,4059920,3034944,2045781,1481071,966298,699872,12287886,24116802,43285791,43285791
Democratic Republic of the Congo,1996,CD,COD,AFR,4108056,5830957,9939013,4058579,2994605,2027872,1408511,865818,553379,11908764,4072146,5814414,9886560,4063535,3045878,2072719,1494426,990260,717546,12384364,24293128,44118709,44118709
Democratic Republic of the Congo,1997,CD,COD,AFR,4233919,6016840,10250759,4062195,2975135,2037128,1417095,884262,563596,11939411,4196842,6001220,10198062,4061461,3030741,2089989,1503789,1012953,735034,12433967,24373378,44822198,44822198
Democratic Republic of the Congo,1998,CD,COD,AFR,4352919,6216484,10569403,4137701,3005394,2072968,1437149,908652,580055,12141919,4315651,6202662,10518313,4139199,3068801,2133908,1524383,1041084,758513,12665888,24807807,45895524,45895524
Democratic Republic of the Congo,1999,CD,COD,AFR,4471901,6427037,10898938,4262469,3065618,2126174,1464210,936950,599980,12455401,4435129,6415375,10850504,4273061,3141558,2196576,1552682,1072926,785592,13022395,25477796,47227238,47227238
Democratic Republic of the Congo,2000,CD,COD,AFR,4574579,6659991,11234570,4407231,3127431,2183759,1492742,967088,621276,12799527,4539163,6649661,11188824,4421317,3210352,2261473,1581706,1105216,813334,13393398,26192925,48616317,48616317
Democratic Republic of the Congo,2001,CD,COD,AFR,4667513,6910912,11578425,4577746,3198569,2249377,1524928,999293,644707,13194620,4634304,6900886,11535190,4590745,3282576,2331633,1613316,1137960,842183,13798413,26993033,50106657,50106657
Democratic Republic of the Congo,2002,CD,COD,AFR,4780226,7151502,11931728,4762885,3271138,2318306,1559577,1031380,669307,13612593,4749831,7140949,11890780,4775926,3355967,2405037,1647971,1170109,871963,14226973,27839566,51662071,51662071
Democratic Republic of the Congo,2003,CD,COD,AFR,4916970,7377103,12294073,4947092,3334239,2383896,1596213,1060477,694239,14016156,4889822,7365116,12254938,4960051,3418905,2475190,1685915,1198469,901947,14640477,28656633,53205639,53205639
Democratic Republic of the Congo,2004,CD,COD,AFR,5065900,7604034,12669934,5136477,3406820,2452254,1639217,1086495,720519,14441782,5041681,7590196,12631877,5149188,3489497,2547222,1729805,1223649,932656,15072017,29513799,54815607,54815607
Democratic Republic of the Congo,2005,CD,COD,AFR,5220692,7843751,13064443,5334795,3501247,2527118,1688300,1112180,748899,14912539,5198969,7828055,13027024,5348016,3580911,2624754,1780104,1247587,964867,15546239,30458778,56550247,56550247
Democratic Republic of the Congo,2006,CD,COD,AFR,5388556,8091926,13480482,5538945,3608729,2604544,1740011,1138954,778896,15410079,5368646,8075186,13443832,5553149,3685130,2704405,1834629,1271285,998643,16047241,31457320,58381630,58381630
Democratic Republic of the Congo,2007,CD,COD,AFR,5569996,8347994,13917990,5747392,3725366,2681715,1793933,1166382,810010,15924798,5551202,8330794,13881996,5762136,3798457,2783329,1891404,1295890,1033413,16564629,32489427,60289422,60289422
Democratic Republic of the Congo,2008,CD,COD,AFR,5762337,8615823,14378160,5952390,3849780,2755758,1849103,1194219,842065,16443315,5743928,8598811,14342739,5967015,3919921,2858745,1949598,1321321,1068912,17085512,33528827,62249724,62249724
Democratic Republic of the Congo,2009,CD,COD,AFR,5971142,8889402,14860544,6156273,3982847,2826017,1905421,1222347,875195,16968100,5952455,8873680,14826135,6171028,4051111,2930458,2009433,1347773,1105652,17615455,34583555,64270232,64270232
Democratic Republic of the Congo,2010,CD,COD,AFR,6195018,9152203,15347221,6384059,4132496,2895910,1964888,1251101,909521,17537975,6175497,9139104,15314601,6398548,4199574,3001426,2072652,1375486,1143776,18191462,35729437,66391257,66391257
Democratic Republic of the Congo,2011,CD,COD,AFR,6429928,9418481,15848409,6635777,4304265,2968837,2028877,1281590,945300,18164646,6408758,9408909,15817667,6649457,4370520,3074591,2140229,1405415,1183343,18823555,36988201,68654269,68654269
Democratic Republic of the Congo,2012,CD,COD,AFR,6674329,9716382,16390711,6874644,4486044,3040410,2094709,1313813,981186,18790806,6650606,9710394,16361000,6886867,4552250,3145911,2209681,1437745,1222891,19455345,38246151,70997870,70997870
Democratic Republic of the Congo,2013,CD,COD,AFR,6921450,10051611,16973061,7106151,4682727,3116395,2163712,1350316,1016453,19435754,6894021,10049608,16943629,7117461,4750244,3220975,2282227,1475433,1261231,20107571,39543325,73460021,73460021
Democratic Republic of the Congo,2014,CD,COD,AFR,7165985,10416453,17582438,7342225,4886649,3202259,2235704,1392455,1050128,20109420,7133725,10418680,17552405,7353681,4956818,3305504,2357737,1519101,1298491,20791332,40900752,76035588,76035588
Democratic Republic of the Congo,2015,CD,COD,AFR,7408369,10798693,18207062,7581917,5083684,3296597,2307955,1437457,1082628,20790238,7370344,10804707,18175051,7593826,5157352,3398583,2433644,1566713,1334440,21484558,42274796,78656904,78656904
Democratic Republic of the Congo,2016,CD,COD,AFR,7649763,11203910,18853673,7838382,5295060,3406154,2383656,1484981,1116526,21524759,7605023,11212974,18817997,7852787,5373096,3506675,2512635,1618349,1371018,22234560,43759319,81430977,81430977
Democratic Republic of the Congo,2017,CD,COD,AFR,7891150,11632023,19523173,8098046,5509100,3524145,2459165,1534389,1151511,22276356,7839255,11642012,19481267,8115575,5591421,3623445,2591101,1672000,1408927,23002469,45278825,84283273,84283273
Democratic Republic of the Congo,2018,CD,COD,AFR,8136890,12070281,20207171,8346744,5700304,3642207,2528927,1584212,1187481,22989875,8077784,12078718,20156502,8366723,5786549,3741631,2664090,1726499,1448318,23733810,46723685,87087355,87087355
Democratic Republic of the Congo,2019,CD,COD,AFR,8384951,12520553,20905504,8591747,5881622,3766850,2594800,1635083,1224810,23694912,8318272,12526700,20844972,8614818,5972156,3867940,2733540,1782833,1490222,24461509,48156421,89906890,89906890
Democratic Republic of the Congo,2020,CD,COD,AFR,8635326,12986345,21621671,8838701,6092665,3909588,2660275,1685923,1257157,24444309,8560671,12988746,21549417,8866159,6186741,4012907,2802348,1840516,1529099,25237770,49682079,92853164,92853164
Democratic Republic of the Congo,2021,CD,COD,AFR,8890183,13459417,22349600,9095634,6324327,4067596,2723422,1734760,1279505,25225244,8807754,13457390,22265144,9129042,6421911,4174446,2869580,1897891,1561257,26054127,51279371,95894118,95894118
Democratic Republic of the Congo,2022,CD,COD,AFR,9145221,13941618,23086839,9383605,6543747,4235932,2784850,1784037,1299019,26031190,9054768,13935234,22990002,9424475,6645184,4347998,2935680,1956308,1592528,26902173,52933363,99010212,99010212
Democratic Republic of the Congo,2023,CD,COD,AFR,9399885,14434906,23834791,9713310,6755360,4415398,2850335,1837728,1325553,26897684,9300431,14422142,23722573,9762090,6859731,4533185,3004415,2018363,1629972,27807756,54705440,102262808,102262808
Democratic Republic of the Congo,2024,CD,COD,AFR,9653463,14929711,24583174,10072203,6968012,4597651,2924901,1896802,1362315,27821884,9545631,14908125,24453756,10128410,7075091,4721520,3080778,2084576,1675923,28766298,56588182,105625114,105625114
Democratic Republic of the Congo,2025,CD,COD,AFR,9901441,15422067,25323508,10449213,7190236,4778799,3011414,1960352,1408435,28798449,9788830,15390097,25178927,10512550,7300655,4909176,3168303,2154223,1729763,29774670,58573119,109075560,109075560
Democratic Republic of the Congo,2026,CD,COD,AFR,10144608,15911579,26056187,10846754,7419607,4962703,3107383,2026089,1459968,29822504,10030186,15868389,25898575,10916534,7534474,5099992,3265136,2225545,1788716,30830397,60652901,112607660,112607660
Democratic Republic of the Congo,2027,CD,COD,AFR,10388055,16398245,26786300,11266575,7657048,5151100,3211685,2091627,1513520,30891555,10272746,16343335,26616081,11341555,7777526,5295325,3370772,2296495,1850345,31932018,62823573,116225955,116225955
Democratic Republic of the Congo,2028,CD,COD,AFR,10632974,16887794,27520768,11699393,7907085,5339842,3326201,2156165,1569220,31997906,10517486,16821424,27338910,11777794,8034538,5490840,3487478,2366138,1914783,33071571,65069477,119929158,119929158
Democratic Republic of the Congo,2029,CD,COD,AFR,10881054,17379524,28260578,12145331,8164355,5531294,3452522,2219586,1627102,33140190,10764884,17303002,28067886,12225533,8299854,5689076,3616913,2434340,1982127,34247843,67388033,123716492,123716492
Democratic Republic of the Congo,2030,CD,COD,AFR,11131582,17869407,29000989,12603886,8413122,5742029,3591834,2282103,1687355,34320329,11012985,17784897,28797882,12684778,8557435,5906443,3760319,2501286,2052597,35462858,69783187,127582053,127582053
Democratic Republic of the Congo,1950,CD,COD,AFR,1070577,1543827,2614404,1100959,767982,528180,347494,215436,186002,3146053,1097661,1640333,2737994,1219028,897941,645663,455053,302592,277014,3797291,6943344,12295745,12295745
Democratic Republic of the Congo,1951,CD,COD,AFR,1080673,1588172,2668845,1131590,789546,542970,356084,221094,181033,3222317,1102654,1679260,2781914,1247596,918839,660584,464608,309052,272043,3872722,7095039,12545791,12545791
Democratic Republic of the Congo,1952,CD,COD,AFR,1092930,1632329,2725259,1163176,811705,558053,365308,226954,177113,3302309,1110668,1717785,2828453,1276849,940331,676023,474560,315683,268148,3951594,7253903,12807615,12807615
Democratic Republic of the Congo,1953,CD,COD,AFR,1110633,1673295,2783928,1194475,833216,572845,374875,232844,174320,3382575,1125265,1752323,2877588,1305554,961134,691333,484669,322404,265427,4030521,7413096,13074603,13074603
Democratic Republic of the Congo,1954,CD,COD,AFR,1136100,1708943,2845043,1225860,854666,587661,384757,238590,172700,3464234,1147091,1782619,2929710,1334138,981786,706595,495002,329188,264008,4110717,7574951,13349701,13349701
Democratic Republic of the Congo,1955,CD,COD,AFR,1165888,1742549,2908437,1258436,877167,603076,395112,244252,172228,3550271,1174099,1810520,2984619,1363774,1003372,722268,505752,336086,263851,4195103,7745374,13638427,13638427
Democratic Republic of the Congo,1956,CD,COD,AFR,1196596,1777269,2973865,1292142,900549,618908,405910,249788,172802,3640099,1204321,1837741,3042062,1394410,1025663,738224,516863,343041,264872,4283073,7923172,13939099,13939099
Democratic Republic of the Congo,1957,CD,COD,AFR,1228659,1812998,3041657,1327115,924824,635069,417147,255147,174407,3733709,1235776,1866641,3102417,1426246,1048637,754430,528338,350080,267160,4374891,8108600,14252673,14252673
Democratic Republic of the Congo,1958,CD,COD,AFR,1261875,1849511,3111386,1362191,948169,650809,428414,260468,176878,3826929,1268315,1896845,3165160,1457796,1070435,770133,539836,357154,270391,4465745,8292674,14569211,14569211
Democratic Republic of the Congo,1959,CD,COD,AFR,1296468,1886798,3183266,1400265,972904,667497,440127,266193,179792,3926778,1302393,1928410,3230803,1492029,1093559,786667,551859,364515,274131,4562760,8489538,14903607,14903607
Democratic Republic of the Congo,1960,CD,COD,AFR,1333517,1925086,3258603,1444266,1002341,686890,452999,272729,183139,4042364,1339058,1961499,3300557,1531942,1121586,805721,565057,372420,278304,4675030,8717394,15276558,15276558
Democratic Republic of the Congo,1961,CD,COD,AFR,1372639,1964497,3337136,1490585,1034409,707771,466437,279777,186691,4165670,1377966,1996232,3374198,1574515,1152864,826469,579059,380680,282694,4796281,8961951,15673284,15673284
Democratic Republic of the Congo,1962,CD,COD,AFR,1413947,2006164,3420111,1536471,1068084,729497,480142,287221,190245,4291660,1419150,2033758,3452908,1616960,1186159,848335,593649,389196,287104,4921403,9213063,16086084,16086084
Democratic Republic of the Congo,1963,CD,COD,AFR,1457905,2053618,3511523,1579455,1103448,752285,494330,295225,194063,4418806,1462954,2078050,3541004,1655584,1221092,871238,608806,398095,291845,5046660,9465466,16517995,16517995
Democratic Republic of the Congo,1964,CD,COD,AFR,1504240,2109219,3613459,1616670,1139364,775722,508773,303531,197970,4542030,1509152,2129890,3639042,1690077,1257430,895170,624358,407330,296960,5171325,9713355,16965855,16965855
Democratic Republic of the Congo,1965,CD,COD,AFR,1553938,2170380,3724318,1652129,1176908,800424,523827,312225,202088,4667601,1558631,2188127,3746758,1722811,1296016,920586,640522,417033,302613,5299581,9967182,17438254,17438254
Democratic Republic of the Congo,1966,CD,COD,AFR,1607711,2234830,3842541,1689977,1217480,827297,540057,321845,206989,4803645,1611964,2251714,3863678,1754435,1336197,947328,657361,427382,309179,5431882,10235527,17941738,17941738
Democratic Republic of the Congo,1967,CD,COD,AFR,1664132,2303205,3967337,1729320,1260642,856173,557281,332280,212534,4948230,1667936,2319109,3987045,1786767,1377822,975326,674776,438270,316534,5569495,10517725,18472105,18472105
Democratic Republic of the Congo,1968,CD,COD,AFR,1721883,2375388,4097271,1769021,1305575,886361,575196,343157,218420,5097730,1725306,2390352,4115658,1819890,1420957,1004516,692788,449606,324381,5712138,10809868,19022799,19022799
Democratic Republic of the Congo,1969,CD,COD,AFR,1780265,2451420,4231685,1807415,1350909,916850,593594,354290,224622,5247680,1783136,2465604,4248740,1852013,1463898,1034038,711261,461294,332514,5855018,11102698,19583123,19583123
Democratic Republic of the Congo,2031,CD,COD,AFR,11380592,18359447,29740039,13068248,8665652,5967170,3743640,2344037,1750041,35538788,11258800,18268711,29527511,13148545,8819543,6137998,3917377,2567297,2126114,36716874,72255662,131523203,131523203
Democratic Republic of the Congo,2032,CD,COD,AFR,11624446,18847666,30472112,13541495,8949336,6182626,3906114,2405864,1815009,36800444,11499789,18751527,30251316,13619914,9113977,6359273,4086364,2632852,2202560,38014940,74815384,135538810,135538810
Democratic Republic of the Congo,2033,CD,COD,AFR,11862618,19333478,31196096,14023853,9268293,6386144,4075977,2468938,1882053,38105258,11735541,19232894,30968435,14098980,9444842,6568055,4264051,2699232,2281736,39356896,77462154,139626690,139626690
Democratic Republic of the Congo,2034,CD,COD,AFR,12096799,19820554,31917353,14507658,9615106,6590194,4247316,2537936,1950842,39449052,11967492,19716912,31684404,14577769,9803870,6777648,4444231,2771431,2363274,40738223,80187275,143789026,143789026
Democratic Republic of the Congo,2035,CD,COD,AFR,12329863,20308353,32638216,14990628,9980397,6803913,4417376,2616087,2020985,40829386,12198475,20202972,32401447,15054262,10181138,6997667,4623801,2853085,2446709,42156662,82986048,148025707,148025707
Democratic Republic of the Congo,2036,CD,COD,AFR,12556183,20793480,33349663,15472163,10366349,7025055,4590122,2702101,2092412,42248202,12423236,20687604,33110840,15528397,10578476,7226187,4806551,2942995,2531791,43614397,85862599,152323103,152323103
Democratic Republic of the Congo,2037,CD,COD,AFR,12768635,21274035,34042670,15951248,10773990,7254054,4767148,2795513,2164721,43706674,12634686,21168986,33803672,15999595,10996597,7463813,4993701,3041006,2618010,45112722,88819396,156665737,156665737
Democratic Republic of the Congo,2038,CD,COD,AFR,12969624,21750782,34720406,16433425,11194398,7495197,4944589,2897923,2237242,45202774,12834791,21647727,34482518,16474160,11425924,7715073,5181147,3149129,2704655,46650088,91852862,161055774,161055774
Democratic Republic of the Congo,2039,CD,COD,AFR,13163198,22226908,35390106,16917957,11627674,7743410,5124717,3010690,2309884,46734332,13027222,22125640,35152862,16952419,11866721,7974564,5371349,3268857,2791642,48225552,94959884,165502851,165502851
Democratic Republic of the Congo,2040,CD,COD,AFR,13352422,22704648,36057070,17400920,12073381,7983920,5323222,3134870,2383021,48299334,13215616,22603798,35819414,17431300,12319051,8227018,5580052,3401336,2879246,49838003,98137337,170013815,170013815
Democratic Republic of the Congo,2041,CD,COD,AFR,13537657,23174804,36712461,17884236,12524996,8228406,5535488,3269979,2456934,49900039,13400236,23074002,36474238,17912303,12776111,8484241,5802505,3546211,2967693,51489064,101389103,174575803,174575803
Democratic Republic of the Congo,2042,CD,COD,AFR,13725200,23626815,37352015,18365999,12985493,8502702,5738743,3414285,2531841,51539063,13586953,23526759,37113712,18392571,13240919,8772822,6015294,3701841,3057275,53180722,104719785,179185515,179185515
Democratic Republic of the Congo,2043,CD,COD,AFR,13912465,24062348,37974813,18845646,13455069,8810689,5930801,3564877,2608743,53215825,13773556,23963630,37737186,18871683,13713565,9096715,6216276,3865255,3148972,54912466,108128291,183840294,183840294
Democratic Republic of the Congo,2044,CD,COD,AFR,14086428,24486759,38573187,19326680,13926305,9145380,6123385,3716740,2691275,54929765,13947637,24389437,38337074,19353625,14186251,9448027,6418155,4030957,3246811,56683826,111613591,188523850,188523850
Democratic Republic of the Congo,2045,CD,COD,AFR,14253179,24905793,39158972,19808587,14397004,9497939,6325122,3867634,2781764,56678050,14114491,24810394,38924885,19837767,14656975,9817244,6630112,4196269,3353548,58491915,115169965,193253818,193253818
Democratic Republic of the Congo,2046,CD,COD,AFR,14421022,25314754,39735776,20288085,14866630,9870467,6533949,4021009,2878866,58459006,14282035,25221860,39503895,20320688,15125672,10206138,6850335,4364621,3467788,60335242,118794248,198033915,198033915
Democratic Republic of the Congo,2047,CD,COD,AFR,14586360,25713003,40299363,20763319,15334200,10263948,6750291,4178226,2981743,60271727,14447138,25622801,40069939,20800610,15591805,10615433,7079433,4537094,3588913,62213288,122485015,202854315,202854315
Democratic Republic of the Congo,2048,CD,COD,AFR,14751807,26100112,40851919,21234979,15805003,10669857,6978109,4335895,3091298,62115141,14611817,26012818,40624635,21278113,16061475,11035841,7321674,4709948,3718057,64125108,126240249,207716793,207716793
Democratic Republic of the Congo,2049,CD,COD,AFR,14918139,26467146,41385285,21706164,16278296,11088250,7212718,4496197,3208528,63990153,14776895,26383076,41159971,21754932,16534946,11467562,7571918,4885541,3856216,66071115,130061268,212606516,212606516
Democratic Republic of the Congo,2050,CD,COD,AFR,15061571,26822731,41884302,22179026,16750297,11518694,7440758,4673448,3334316,65896539,14919559,26742174,41661733,22232119,17009242,11910685,7815985,5078711,4004691,68051433,133947972,217494003,217494003
Congo,1970,CG,COG,AFR,127058,184990,312048,127067,87242,63631,45221,29887,21969,375017,125285,184296,309581,128683,90453,67947,50149,34734,28372,400338,775355,1396989,1396989
Congo,1971,CG,COG,AFR,131667,191472,323139,131737,89418,64989,46116,30446,22506,385212,129809,190639,320448,133214,92747,69453,51258,35541,29158,411371,796583,1440159,1440159
Congo,1972,CG,COG,AFR,136517,198250,334767,136712,91615,66413,47031,31019,23040,395830,134570,197285,331855,138002,95099,71018,52388,36363,29955,422825,818655,1485274,1485274
Congo,1973,CG,COG,AFR,141446,205356,346802,141613,94236,67895,47967,31607,23559,406877,139408,204252,343660,142744,97831,72631,53542,37203,30774,434725,841602,1532069,1532069
Congo,1974,CG,COG,AFR,146343,212791,359134,146418,97293,69400,48924,32211,24086,418332,144212,211552,355764,147446,100943,74262,54725,38065,31610,447051,865383,1580280,1580280
Congo,1975,CG,COG,AFR,150529,220093,370622,150658,99849,70860,49889,32918,24568,428742,148278,219057,367335,151701,103399,75792,56083,38979,32293,458247,886989,1624935,1624935
Congo,1976,CG,COG,AFR,153838,227118,380956,154403,101843,72254,50849,33751,24977,438077,151412,226645,378057,155585,105212,77123,57596,40013,32797,468326,906403,1665418,1665418
Congo,1977,CG,COG,AFR,156911,234179,391090,158645,103727,73576,51811,34605,25400,447764,154271,234217,388488,159967,107080,78215,59095,41202,33282,478841,926605,1706181,1706181
Congo,1978,CG,COG,AFR,159973,241004,400977,163465,105562,74776,52801,35430,25817,457851,157082,241394,398476,164946,109086,79084,60571,42484,33731,489902,947753,1747207,1747207
Congo,1979,CG,COG,AFR,162960,247453,410413,168868,107478,75831,53878,36179,26188,468422,159722,248037,407759,170544,111362,79807,62065,43769,34080,501627,970049,1788218,1788218
Congo,1980,CG,COG,AFR,165478,253855,419333,174737,109621,76724,55027,36865,26551,479525,161889,254391,416280,176732,113970,80409,63566,45090,34347,514114,993639,1829256,1829256
Congo,1981,CG,COG,AFR,167650,260232,427882,180891,112097,77437,56212,37532,26971,491140,163732,260441,424173,183396,116908,80861,65022,46521,34634,527342,1018482,1870540,1870540
Congo,1982,CG,COG,AFR,169469,266592,436061,187024,114951,77904,57428,38169,27578,503054,165219,266213,431432,190236,120181,81124,66322,48020,35209,541092,1044146,1911634,1911634
Congo,1983,CG,COG,AFR,170715,272858,443573,193087,118159,78249,58569,38716,28408,515188,166265,271538,437803,197265,123747,81334,67284,49448,36206,555284,1070472,1951851,1951851
Congo,1984,CG,COG,AFR,173836,279598,453434,199659,122755,79201,59657,39181,29391,529844,169482,277088,446570,204743,128454,82476,67944,50536,37744,571897,1101741,2001739,2001739
Congo,1985,CG,COG,AFR,179118,287173,466291,206548,128834,80833,60723,39687,30375,547000,175012,283612,458624,212164,134425,84644,68432,51378,39600,590643,1137643,2062555,2062555
Congo,1986,CG,COG,AFR,184465,295078,479543,213228,135267,82740,61745,40288,31241,564509,180590,290717,471307,219073,140781,87219,68848,52224,41356,609501,1174010,2124863,2124863
Congo,1987,CG,COG,AFR,190046,302845,492891,220121,141961,84962,62686,40974,31999,582703,186458,297874,484332,225760,147444,90209,69213,53042,43060,628728,1211431,2188654,2188654
Congo,1988,CG,COG,AFR,195919,310426,506345,227133,148876,87488,63476,41753,32621,601347,192662,304991,497653,232163,154333,93572,69560,53809,44554,647991,1249338,2253336,2253336
Congo,1989,CG,COG,AFR,201190,318689,519879,234272,155981,90498,64197,42661,33027,620636,198077,312980,511057,238515,161417,97401,70041,54609,45629,667612,1288248,2319177,2319177
Congo,1990,CG,COG,AFR,205705,327335,533040,241682,163058,94024,64913,43617,33395,640689,202545,321537,524082,244999,168540,101541,70635,55388,46528,687631,1328320,2385435,2385435
Congo,1991,CG,COG,AFR,210201,335848,546049,249376,170054,98040,65659,44561,33883,661573,207004,330003,537007,251630,175683,105855,71297,56067,47513,708045,1369618,2452675,2452675
Congo,1992,CG,COG,AFR,214768,344416,559184,257349,176770,102491,66445,45518,34537,683110,211551,338601,550152,258445,182538,110273,71968,56565,48724,728513,1411623,2520958,2520958
Congo,1993,CG,COG,AFR,219490,353270,572760,265949,183950,107616,67526,46485,35349,706875,216265,347645,563910,265804,189906,115068,72896,56854,50105,750633,1457508,2594168,2594168
Congo,1994,CG,COG,AFR,224331,362556,586887,274106,191399,113164,68894,47392,36108,731063,221099,357224,578323,272715,197634,120101,74212,56977,51303,772942,1504005,2669220,2669220
Congo,1995,CG,COG,AFR,229254,371961,601215,281571,198291,118911,70365,48211,36785,754134,226021,366887,592908,279107,204649,125257,75776,56968,52294,794051,1548185,2742309,2742309
Congo,1996,CG,COG,AFR,234370,381306,615676,289259,204919,124957,72077,49009,37450,777671,231135,376489,607624,285931,211123,130744,77704,56926,53201,815629,1593300,2816595,2816595
Congo,1997,CG,COG,AFR,239084,390425,629509,293703,208349,129587,73329,49343,37703,792014,235840,385940,621780,290788,215343,135529,79588,56684,53807,831739,1623753,2875037,2875037
Congo,1998,CG,COG,AFR,243631,399836,643467,298586,212085,134518,74903,49566,37939,807597,240366,395757,636123,296484,219971,140837,81923,56499,54265,849979,1657576,2937166,2937166
Congo,1999,CG,COG,AFR,248529,409011,657540,307328,218893,141054,77580,50136,38528,833519,245216,405155,650371,305036,226448,147248,85090,56666,54741,875229,1708748,3016659,3016659
Congo,2000,CG,COG,AFR,254493,418464,672957,321871,231947,150589,82059,51352,39726,877544,251098,414663,665761,319571,238869,156503,89727,57489,55606,917765,1795309,3134030,3134030
Congo,2001,CG,COG,AFR,261437,427999,689436,335574,245430,160242,87083,52678,41023,922030,257877,424280,682157,333156,251550,166016,94676,58500,56588,960486,1882516,3254101,3254101
Congo,2002,CG,COG,AFR,268257,436691,704948,341745,251871,166153,90982,53404,41800,945955,264474,433007,697481,338731,257018,172127,98528,59098,57259,982761,1928716,3331158,3331158
Congo,2003,CG,COG,AFR,275879,446016,721895,350143,260523,173003,95688,54488,42858,976703,271874,442323,714197,346892,264520,179255,102981,60087,58134,1011869,1988572,3424653,3424653
Congo,2004,CG,COG,AFR,285044,456139,741183,361902,272167,181740,101486,56121,44155,1017571,280821,452413,733234,358817,274922,188264,108311,61665,59048,1051027,2068598,3543012,3543012
Congo,2005,CG,COG,AFR,295874,466771,762645,374401,284852,191154,108015,58074,45498,1061994,291424,462967,754391,371588,286563,197821,114273,63647,59917,1093809,2155803,3672839,3672839
Congo,2006,CG,COG,AFR,307583,478797,786380,387185,298787,201034,115151,60371,46930,1109458,302916,474850,777766,384751,299681,207597,120828,66053,60810,1139720,2249178,3813323,3813323
Congo,2007,CG,COG,AFR,319805,492344,812149,399173,312126,211071,122520,62906,48301,1156097,314929,488189,803118,397194,312371,217253,127689,68786,61669,1184962,2341059,3956329,3956329
Congo,2008,CG,COG,AFR,333440,506301,839741,408609,322623,220191,129690,65489,49381,1195983,328331,501863,830194,406970,322335,225838,134495,71690,62350,1223678,2419661,4089602,4089602
Congo,2009,CG,COG,AFR,349330,522172,871502,421382,337909,231715,138086,68901,50841,1248834,343955,517435,861390,420284,337365,236668,142476,75365,63356,1275514,2524348,4257230,4257230
Congo,2010,CG,COG,AFR,366775,539757,906532,433932,354350,244272,146923,72882,52430,1304789,361082,534665,895747,433262,353809,248565,151061,79528,64582,1330807,2635596,4437884,4437884
Congo,2011,CG,COG,AFR,383529,557996,941525,440365,364142,254240,154514,76689,53573,1343523,377459,552423,929882,439637,363597,258057,158809,83517,65662,1369279,2712802,4584216,4584216
Congo,2012,CG,COG,AFR,398041,577572,975613,444535,370372,263060,161340,80596,54647,1374550,391583,571463,963046,443492,369837,266409,165993,87507,66805,1400043,2774593,4713257,4713257
Congo,2013,CG,COG,AFR,409201,599174,1008375,447330,373694,270781,167613,84588,55700,1399706,402377,592532,994909,445745,373295,273611,172863,91537,68023,1425074,2824780,4828066,4828066
Congo,2014,CG,COG,AFR,416964,623214,1040178,451614,376985,278169,174121,88889,56905,1426683,409844,616015,1025859,449515,376839,280427,180129,95811,69421,1452142,2878825,4944861,4944861
Congo,2015,CG,COG,AFR,421171,649896,1071067,457626,380277,285532,180760,93590,58265,1456050,413798,642070,1055868,455031,380283,287288,187394,100430,70980,1481406,2937456,5064386,5064386
Congo,2016,CG,COG,AFR,422576,677471,1100047,466195,383497,293192,187393,98618,59834,1488729,414971,668968,1083939,463147,383613,294618,194474,105440,72825,1514117,3002846,5186824,5186824
Congo,2017,CG,COG,AFR,423045,703808,1126853,477533,387007,300643,194316,103883,61598,1524980,415210,694600,1109810,474077,387284,301898,201629,110823,74979,1550690,3075670,5312340,5312340
Congo,2018,CG,COG,AFR,423517,729032,1152549,490671,391059,307816,201542,109428,63517,1564033,415464,719072,1134536,486821,391460,308892,208802,116546,77417,1589938,3153971,5441062,5441062
Congo,2019,CG,COG,AFR,424189,752074,1176263,505639,394927,315277,208885,115117,65648,1605493,415949,741295,1157244,501421,395250,316302,216072,122548,80146,1631739,3237232,5570733,5570733
Congo,2020,CG,COG,AFR,425412,772696,1198108,522687,398828,322749,216521,120792,67865,1649442,417033,761063,1178096,518125,398907,323898,223707,128778,83111,1676526,3325968,5702174,5702174
Congo,2021,CG,COG,AFR,427699,790826,1218525,541628,403611,329733,224426,126400,70111,1695909,419195,778372,1197567,536684,403432,330919,231524,135085,86159,1723803,3419712,5835806,5835806
Congo,2022,CG,COG,AFR,430166,806144,1236310,562371,409528,336198,232601,131967,72826,1745491,421673,792915,1214588,557037,409081,337415,239494,141386,89620,1774033,3519524,5970424,5970424
Congo,2023,CG,COG,AFR,432672,818447,1251119,585405,416524,342252,240904,137624,76114,1798823,424322,804537,1228859,579725,415797,343611,247436,147886,93616,1828071,3626894,6106869,6106869
Congo,2024,CG,COG,AFR,435786,827705,1263491,610494,424524,348081,248851,143504,79698,1855152,427563,813217,1240780,604416,423528,349659,254920,154711,97889,1885123,3740275,6244547,6244547
Congo,2025,CG,COG,AFR,439478,833822,1273300,637870,433613,353564,256629,149455,83622,1914753,431377,818875,1250252,631312,432383,355319,262358,161529,102528,1945429,3860182,6383738,6383738
Congo,2026,CG,COG,AFR,443949,837744,1281693,665846,444594,358604,264515,155360,87864,1976783,435968,822452,1258420,658758,443160,360498,270056,168101,107558,2008131,3984914,6525029,6525029
Congo,2027,CG,COG,AFR,449614,840815,1290429,692369,457690,363555,272085,161505,92381,2039585,441675,825340,1267015,684718,456089,365611,277512,174653,112954,2071537,4111122,6668564,6668564
Congo,2028,CG,COG,AFR,456444,843934,1300378,717588,472005,368631,279226,167850,97136,2102436,448487,828424,1276911,709336,470266,370876,284579,181179,118698,2134934,4237370,6814649,6814649
Congo,2029,CG,COG,AFR,464237,847988,1312225,740639,487728,373305,286588,174336,102171,2164767,456261,832524,1288785,731774,485877,375557,291975,187793,124810,2197786,4362553,6963560,6963560
Congo,2030,CG,COG,AFR,472673,853078,1325751,761194,505098,377762,293906,181150,107541,2226651,464682,837743,1302425,751691,503153,379830,299419,194715,131344,2260152,4486803,7114987,7114987
Congo,1950,CG,COG,AFR,68994,98962,167956,77052,59396,44593,32532,19178,12417,245168,68869,99962,168831,77801,59997,45025,32854,21825,15659,253161,498329,835132,835132
Congo,1951,CG,COG,AFR,71207,101061,172268,78369,60327,45253,33057,19716,12800,249522,70964,102165,173129,79247,61117,45910,33528,22327,16198,258327,507849,853253,853253
Congo,1952,CG,COG,AFR,73614,103188,176802,79769,61283,45937,33498,20331,13189,254007,73209,104423,177632,80763,62259,46819,34200,22858,16737,263636,517643,872082,872082
Congo,1953,CG,COG,AFR,75788,105785,181573,81243,62274,46651,33910,20996,13580,258654,75268,107101,182369,82337,63434,47755,34884,23415,17281,269106,527760,891707,891707
Congo,1954,CG,COG,AFR,77743,108899,186642,82765,63301,47392,34340,21661,13954,263413,77169,110208,187377,83941,64641,48716,35587,23986,17828,274699,538112,912130,912130
Congo,1955,CG,COG,AFR,79849,112197,192046,84317,64359,48155,34800,22314,14320,268265,79218,113485,192703,85569,65883,49693,36316,24570,18377,280408,548673,933418,933418
Congo,1956,CG,COG,AFR,82035,115773,197808,85924,65470,48948,35299,22954,14679,273274,81344,117018,198362,87249,67163,50700,37069,25170,18926,286277,559551,955725,955725
Congo,1957,CG,COG,AFR,84330,119572,203902,87614,66635,49773,35841,23586,15028,278477,83575,120756,204331,89007,68494,51732,37853,25783,19487,292356,570833,979064,979064
Congo,1958,CG,COG,AFR,86743,123584,210327,89404,67854,50625,36420,24194,15394,283891,85919,124689,210608,90870,69872,52793,38660,26411,20056,298662,582553,1003497,1003497
Congo,1959,CG,COG,AFR,89292,127799,217091,91326,69128,51512,37020,24754,15807,289547,88397,128794,217191,92867,71288,53882,39491,27041,20650,305219,594766,1029055,1029055
Congo,1960,CG,COG,AFR,91923,132225,224148,93397,70445,52434,37639,25268,16284,295467,90950,133086,224036,95022,72741,54995,40343,27683,21263,312047,607514,1055693,1055693
Congo,1961,CG,COG,AFR,94605,136920,231525,95577,71829,53391,38285,25728,16815,301625,93553,137607,231160,97301,74241,56135,41217,28324,21902,319120,620745,1083431,1083431
Congo,1962,CG,COG,AFR,97364,141939,239303,97796,73295,54378,38960,26141,17397,307967,96241,142400,238641,99649,75815,57308,42120,28968,22570,326430,634397,1112348,1112348
Congo,1963,CG,COG,AFR,100268,146876,247144,100469,74836,55398,39662,26533,18025,314923,99078,147148,246226,102404,77453,58515,43047,29627,23256,334302,649225,1142600,1142600
Congo,1964,CG,COG,AFR,103371,151740,255111,103635,76419,56455,40385,26938,18635,322467,102104,151879,253983,105575,79117,59756,44000,30299,23957,342704,665171,1174269,1174269
Congo,1965,CG,COG,AFR,106736,156820,263556,106981,78034,57539,41135,27368,19224,330281,105385,156823,262208,108911,80804,61024,44970,30989,24670,351368,681649,1207412,1207412
Congo,1966,CG,COG,AFR,110384,162011,272395,110592,79692,58669,41903,27821,19802,338479,108948,161878,270826,112497,82543,62330,45964,31702,25388,360424,698903,1242116,1242116
Congo,1967,CG,COG,AFR,114270,167359,281629,114415,81421,59846,42698,28308,20354,347042,112749,167087,279836,116275,84345,63676,46975,32430,26108,369809,716851,1278312,1278312
Congo,1968,CG,COG,AFR,118363,172937,291300,118438,83238,61070,43513,28821,20895,355975,116761,172524,289285,120234,86241,65066,48008,33176,26845,379570,735545,1316130,1316130
Congo,1969,CG,COG,AFR,122638,178810,301448,122651,85174,62330,44354,29349,21432,365290,120949,178260,299209,124371,88276,66490,49069,33947,27602,389755,755045,1355699,1355699
Congo,2031,CG,COG,AFR,481192,859619,1340811,779084,524028,382831,300644,188208,113177,2287972,473191,844465,1317656,768941,521966,384753,306261,201831,138212,2321964,4609936,7268403,7268403
Congo,2032,CG,COG,AFR,489683,867552,1357235,794195,544504,388833,306882,195478,118923,2348815,481669,852616,1334285,783435,542310,390633,312640,209129,145241,2383388,4732203,7423724,7423724
Congo,2033,CG,COG,AFR,498016,876815,1374831,806359,567034,395723,312702,202806,124781,2409405,489959,862113,1352072,795039,564723,397376,318706,216362,152452,2444658,4854063,7580970,7580970
Congo,2034,CG,COG,AFR,505982,887631,1393613,815529,591572,403567,318304,209815,130878,2469665,497870,873148,1371018,803745,589113,405102,324627,223189,159964,2505740,4975405,7740041,7740041
Congo,2035,CG,COG,AFR,513615,899658,1413273,821632,618344,412454,323577,216663,137134,2529804,505451,885407,1390858,809483,615679,413914,330184,229966,167568,2566794,5096598,7900720,7900720
Congo,2036,CG,COG,AFR,520850,912548,1433398,825585,645712,423160,328438,223585,143449,2589929,512632,898522,1411154,813165,642795,424585,335296,236960,175135,2627936,5217865,8062410,8062410
Congo,2037,CG,COG,AFR,527665,926596,1454261,828710,671667,435899,333217,230225,149996,2649714,519384,912716,1432100,816172,668459,437338,340351,243748,182869,2688937,5338651,8225004,8225004
Congo,2038,CG,COG,AFR,534173,941633,1475806,831884,696353,449801,338105,236492,156734,2709369,525837,927813,1453650,819372,692806,451290,345545,250187,190758,2749958,5459327,8388788,8388788
Congo,2039,CG,COG,AFR,540346,957265,1497611,835991,718930,465060,342649,242955,163652,2769237,531974,943492,1475466,823576,715014,466639,350218,256957,198901,2811305,5580542,8553623,8553623
Congo,2040,CG,COG,AFR,546307,973206,1519513,841128,739084,481908,347016,249416,170940,2829492,537888,959487,1497375,828891,734755,483607,354534,263812,207539,2873138,5702630,8719512,8719512
Congo,2041,CG,COG,AFR,552126,988850,1540976,847685,756647,500261,351964,255392,178490,2890439,543652,975176,1518828,835689,751882,502070,359476,270151,216512,2935780,5826219,8886023,8886023
Congo,2042,CG,COG,AFR,557477,1004065,1561542,855621,771513,520103,357786,260948,186209,2952180,548986,990412,1539398,843903,766320,522025,365326,276091,225664,2999329,5951509,9052455,9052455
Congo,2043,CG,COG,AFR,562184,1018814,1580998,864872,783514,541934,364435,266152,193970,3014877,553699,1005178,1558877,853453,777935,544002,371998,281762,234803,3063953,6078830,9218712,9218712
Congo,2044,CG,COG,AFR,566394,1032866,1599260,875658,792614,565699,371974,271161,201596,3078702,557923,1019252,1577175,864532,786722,567908,379600,287292,243748,3129802,6208504,9384941,9384941
Congo,2045,CG,COG,AFR,570271,1046379,1616650,887644,798741,591613,380480,275879,209142,3143499,561815,1032775,1594590,876819,792611,593928,388228,292497,252659,3196742,6340241,9551478,9551478
Congo,2046,CG,COG,AFR,573888,1059365,1633253,900480,802790,618112,390684,280259,216728,3209053,565462,1045766,1611228,889962,796501,620502,398618,297316,261642,3264541,6473594,9718073,9718073
Congo,2047,CG,COG,AFR,577422,1071485,1648907,914454,806036,643266,402792,284575,224224,3275347,569014,1057911,1626925,904165,799725,645686,410986,302086,270518,3333166,6608513,9884345,9884345
Congo,2048,CG,COG,AFR,580731,1082667,1663398,929404,809334,667183,415980,288984,231525,3342410,572326,1069149,1641475,919271,803138,669590,424498,306981,279157,3402635,6745045,10049919,10049919
Congo,2049,CG,COG,AFR,583650,1093015,1676665,944940,813536,689068,430433,293140,239087,3410204,575266,1079579,1654845,934947,807539,691424,439338,311449,288252,3472949,6883153,10214662,10214662
Congo,2050,CG,COG,AFR,586172,1102829,1689001,960777,818738,708620,446374,297196,246900,3478605,577824,1089462,1667286,950944,813028,710880,455721,315655,297791,3544019,7022624,10378912,10378912
Cook Islands,1970,CK,COK,WPR,1975,3385,5360,1761,1019,855,647,451,304,5037,1888,3286,5174,1730,1096,770,576,385,328,4885,9922,20470,20470
Cook Islands,1971,CK,COK,WPR,1990,3479,5469,1816,1030,866,659,463,309,5143,1880,3373,5253,1773,1113,781,590,395,334,4986,10129,20850,20850
Cook Islands,1972,CK,COK,WPR,1930,3497,5427,1816,1022,857,674,466,318,5153,1809,3373,5182,1779,1107,790,592,395,339,5002,10155,20759,20759
Cook Islands,1973,CK,COK,WPR,1793,3447,5240,1757,1000,831,674,465,323,5050,1677,3289,4966,1738,1076,793,579,392,341,4919,9969,20177,20177
Cook Islands,1974,CK,COK,WPR,1654,3387,5041,1688,968,811,663,464,332,4926,1563,3190,4753,1693,1032,792,569,387,339,4812,9738,19535,19535
Cook Islands,1975,CK,COK,WPR,1538,3309,4847,1624,916,791,650,458,339,4778,1476,3082,4558,1646,967,784,560,377,343,4677,9455,18863,18863
Cook Islands,1976,CK,COK,WPR,1456,3206,4662,1578,853,773,632,449,349,4634,1421,2966,4387,1602,897,776,559,371,339,4544,9178,18216,18216
Cook Islands,1977,CK,COK,WPR,1378,3113,4491,1616,822,763,627,452,353,4633,1355,2878,4233,1620,863,768,561,370,336,4518,9151,17876,17876
Cook Islands,1978,CK,COK,WPR,1299,3034,4333,1722,835,766,635,462,362,4782,1277,2814,4091,1682,865,767,573,381,339,4607,9389,17809,17809
Cook Islands,1979,CK,COK,WPR,1236,2939,4175,1823,849,763,648,466,366,4915,1212,2746,3958,1731,863,777,584,386,342,4683,9598,17733,17733
Cook Islands,1980,CK,COK,WPR,1187,2828,4015,1915,862,761,665,472,376,5051,1157,2676,3833,1772,860,797,593,390,345,4757,9808,17651,17651
Cook Islands,1981,CK,COK,WPR,1142,2726,3868,1985,870,763,682,477,385,5162,1120,2598,3718,1813,853,807,597,403,343,4816,9978,17559,17559
Cook Islands,1982,CK,COK,WPR,1107,2635,3742,2027,866,761,697,480,383,5214,1089,2493,3582,1851,855,797,608,414,341,4866,10080,17404,17404
Cook Islands,1983,CK,COK,WPR,1078,2531,3609,2065,862,757,695,483,394,5256,1053,2375,3428,1872,867,777,618,415,340,4889,10145,17178,17178
Cook Islands,1984,CK,COK,WPR,1046,2420,3466,2084,869,754,691,475,402,5275,1023,2274,3297,1851,888,763,629,417,340,4888,10163,16925,16925
Cook Islands,1985,CK,COK,WPR,1016,2316,3332,2081,888,749,688,467,404,5277,1007,2175,3182,1815,907,740,637,425,337,4861,10138,16657,16657
Cook Islands,1986,CK,COK,WPR,1002,2218,3220,2077,928,742,688,466,407,5308,1009,2081,3090,1806,932,729,642,433,335,4877,10185,16494,16494
Cook Islands,1987,CK,COK,WPR,1023,2129,3152,2072,993,751,691,483,409,5399,1025,2006,3031,1829,973,730,651,443,344,4970,10369,16557,16557
Cook Islands,1988,CK,COK,WPR,1063,2064,3127,2060,1065,766,698,508,415,5512,1045,1952,2997,1859,1020,749,660,453,360,5101,10613,16735,16735
Cook Islands,1989,CK,COK,WPR,1108,2010,3118,2031,1143,784,702,533,416,5609,1065,1910,2975,1878,1069,768,675,461,371,5222,10831,16924,16924
Cook Islands,1990,CK,COK,WPR,1158,1976,3134,1991,1213,807,706,562,419,5698,1087,1880,2967,1880,1118,793,696,466,383,5336,11034,17123,17123
Cook Islands,1991,CK,COK,WPR,1206,1955,3161,1946,1268,826,714,580,419,5753,1112,1859,2971,1861,1164,815,707,481,386,5414,11167,17308,17308
Cook Islands,1992,CK,COK,WPR,1240,1949,3189,1901,1323,834,717,599,424,5798,1138,1850,2988,1821,1217,835,709,502,398,5482,11280,17456,17456
Cook Islands,1993,CK,COK,WPR,1250,1957,3207,1847,1369,836,716,615,427,5810,1157,1852,3009,1766,1274,856,708,522,409,5535,11345,17564,17564
Cook Islands,1994,CK,COK,WPR,1248,1985,3233,1782,1403,854,723,623,434,5819,1165,1871,3036,1700,1318,875,713,541,421,5568,11387,17656,17656
Cook Islands,1995,CK,COK,WPR,1236,2024,3260,1717,1423,881,730,629,439,5819,1163,1901,3064,1632,1347,904,713,569,433,5598,11417,17735,17735
Cook Islands,1996,CK,COK,WPR,1237,2052,3289,1657,1426,917,734,632,450,5816,1157,1927,3084,1573,1357,934,712,590,445,5611,11427,17798,17798
Cook Islands,1997,CK,COK,WPR,1211,2040,3251,1582,1393,952,737,619,460,5743,1128,1904,3032,1505,1343,952,708,594,451,5553,11296,17581,17581
Cook Islands,1998,CK,COK,WPR,1138,2001,3139,1480,1335,977,727,607,467,5593,1062,1855,2917,1420,1310,957,702,580,454,5423,11016,17067,17067
Cook Islands,1999,CK,COK,WPR,1050,1972,3022,1375,1268,998,715,590,468,5414,989,1808,2797,1330,1264,962,685,576,454,5271,10685,16500,16500
Cook Islands,2000,CK,COK,WPR,965,1940,2905,1278,1174,1015,705,575,468,5215,914,1755,2669,1244,1199,974,667,571,452,5107,10322,15897,15897
Cook Islands,2001,CK,COK,WPR,891,1886,2777,1208,1068,1027,702,554,470,5029,848,1691,2539,1185,1118,976,650,558,454,4941,9970,15294,15294
Cook Islands,2002,CK,COK,WPR,842,1844,2686,1198,1001,1046,708,547,480,4980,799,1655,2454,1168,1072,991,667,547,464,4909,9889,15028,15028
Cook Islands,2003,CK,COK,WPR,812,1818,2630,1228,978,1072,722,551,501,5052,766,1632,2398,1184,1065,1018,698,552,482,4999,10051,15077,15077
Cook Islands,2004,CK,COK,WPR,790,1774,2564,1259,956,1089,738,563,517,5122,745,1608,2353,1186,1060,1040,729,559,502,5076,10198,15113,15113
Cook Islands,2005,CK,COK,WPR,778,1722,2500,1294,935,1091,765,579,530,5194,737,1571,2308,1188,1052,1061,765,560,521,5147,10341,15146,15146
Cook Islands,2006,CK,COK,WPR,776,1663,2439,1325,917,1087,802,594,536,5261,738,1536,2274,1188,1043,1084,804,560,552,5231,10492,15199,15199
Cook Islands,2007,CK,COK,WPR,796,1619,2415,1368,924,1090,851,626,554,5413,756,1510,2266,1229,1049,1117,860,582,580,5417,10830,15507,15507
Cook Islands,2008,CK,COK,WPR,832,1598,2430,1405,960,1102,910,669,585,5631,788,1496,2284,1295,1086,1164,924,623,623,5715,11346,16063,16063
Cook Islands,2009,CK,COK,WPR,859,1601,2460,1418,999,1118,976,713,623,5847,816,1494,2310,1349,1128,1207,993,669,667,6013,11860,16634,16634
Cook Islands,2010,CK,COK,WPR,876,1623,2499,1414,1051,1126,1044,753,670,6058,830,1511,2341,1390,1184,1240,1066,714,724,6318,12376,17212,17212
Cook Islands,2011,CK,COK,WPR,883,1661,2544,1398,1101,1127,1109,790,729,6254,835,1547,2382,1408,1242,1263,1136,763,770,6582,12836,17769,17769
Cook Islands,2012,CK,COK,WPR,870,1672,2542,1374,1120,1118,1153,807,760,6332,822,1569,2391,1399,1270,1260,1180,809,810,6728,13060,18000,18000
Cook Islands,2013,CK,COK,WPR,845,1641,2486,1350,1102,1092,1180,818,774,6316,799,1556,2355,1387,1260,1235,1198,840,831,6751,13067,17916,17916
Cook Islands,2014,CK,COK,WPR,826,1608,2434,1320,1082,1062,1204,831,793,6292,781,1532,2313,1385,1247,1212,1214,870,855,6783,13075,17816,17816
Cook Islands,2015,CK,COK,WPR,805,1574,2379,1285,1068,1033,1213,849,808,6256,762,1498,2260,1383,1238,1183,1227,898,876,6805,13061,17695,17695
Cook Islands,2016,CK,COK,WPR,787,1531,2318,1250,1046,1008,1214,877,812,6207,741,1455,2196,1380,1225,1153,1235,933,897,6823,13030,17546,17546
Cook Islands,2017,CK,COK,WPR,769,1483,2252,1218,1023,982,1205,910,825,6163,727,1414,2141,1379,1215,1123,1234,971,915,6837,13000,17395,17395
Cook Islands,2018,CK,COK,WPR,753,1437,2190,1189,1005,960,1189,940,836,6119,711,1375,2086,1376,1200,1107,1225,1007,939,6854,12973,17253,17253
Cook Islands,2019,CK,COK,WPR,738,1389,2127,1158,994,935,1171,975,848,6081,699,1335,2034,1370,1186,1088,1216,1040,969,6869,12950,17110,17110
Cook Islands,2020,CK,COK,WPR,729,1360,2089,1140,987,916,1139,1013,860,6055,689,1300,1989,1366,1180,1074,1202,1070,1003,6895,12950,17029,17029
Cook Islands,2021,CK,COK,WPR,718,1344,2062,1136,985,905,1103,1044,875,6048,682,1279,1961,1363,1178,1063,1186,1101,1041,6932,12980,17003,17003
Cook Islands,2022,CK,COK,WPR,711,1349,2060,1136,977,892,1063,1068,900,6036,674,1276,1950,1352,1177,1062,1163,1122,1089,6965,13001,17011,17011
Cook Islands,2023,CK,COK,WPR,704,1362,2066,1147,972,874,1030,1088,928,6039,666,1286,1952,1331,1184,1059,1141,1134,1143,6992,13031,17044,17044
Cook Islands,2024,CK,COK,WPR,697,1374,2071,1161,962,864,994,1102,956,6039,658,1298,1956,1306,1193,1057,1119,1147,1187,7009,13048,17072,17072
Cook Islands,2025,CK,COK,WPR,689,1388,2077,1176,950,855,960,1107,990,6038,650,1307,1957,1280,1201,1055,1094,1155,1237,7022,13060,17102,17102
Cook Islands,2026,CK,COK,WPR,681,1398,2079,1195,947,853,931,1101,1024,6051,642,1316,1958,1259,1212,1061,1067,1163,1296,7058,13109,17137,17137
Cook Islands,2027,CK,COK,WPR,672,1402,2074,1209,945,850,902,1088,1063,6057,634,1320,1954,1239,1223,1067,1045,1161,1352,7087,13144,17172,17172
Cook Islands,2028,CK,COK,WPR,663,1402,2065,1225,951,854,879,1068,1106,6083,625,1320,1945,1221,1224,1068,1032,1157,1412,7114,13197,17204,17204
Cook Islands,2029,CK,COK,WPR,654,1396,2050,1238,957,857,859,1040,1151,6102,615,1319,1934,1209,1228,1072,1022,1147,1473,7151,13253,17231,17231
Cook Islands,2030,CK,COK,WPR,644,1388,2032,1251,965,864,837,1007,1196,6120,608,1314,1922,1204,1225,1078,1011,1133,1529,7180,13300,17253,17253
Cook Islands,1950,CK,COK,WPR,1274,2184,3458,1371,974,740,490,316,225,4116,1266,2033,3299,1356,920,606,451,264,202,3799,7915,14683,14683
Cook Islands,1951,CK,COK,WPR,1332,2214,3546,1438,997,740,498,318,225,4216,1283,2089,3372,1408,936,628,451,264,206,3893,8109,15027,15027
Cook Islands,1952,CK,COK,WPR,1392,2207,3599,1517,1015,742,506,322,225,4327,1321,2114,3435,1432,931,652,451,272,207,3945,8272,15309,15309
Cook Islands,1953,CK,COK,WPR,1449,2195,3644,1594,1027,749,510,327,231,4438,1372,2124,3496,1442,926,671,452,279,217,3987,8425,15573,15573
Cook Islands,1954,CK,COK,WPR,1479,2208,3687,1663,1042,767,522,329,234,4557,1413,2145,3558,1461,919,686,458,288,229,4041,8598,15845,15845
Cook Islands,1955,CK,COK,WPR,1491,2242,3733,1721,1054,794,532,332,241,4674,1445,2174,3619,1483,915,696,466,300,238,4098,8772,16129,16129
Cook Islands,1956,CK,COK,WPR,1502,2287,3789,1766,1075,818,547,332,247,4785,1467,2215,3682,1510,914,701,480,308,245,4158,8943,16413,16413
Cook Islands,1957,CK,COK,WPR,1535,2331,3866,1767,1093,830,558,333,254,4835,1502,2252,3754,1535,927,701,488,315,247,4213,9048,16675,16675
Cook Islands,1958,CK,COK,WPR,1590,2378,3968,1739,1111,831,568,345,254,4848,1562,2288,3850,1555,945,707,496,326,251,4280,9128,16941,16941
Cook Islands,1959,CK,COK,WPR,1663,2433,4096,1703,1127,832,579,353,256,4850,1643,2330,3973,1575,959,713,508,331,250,4336,9186,17259,17259
Cook Islands,1960,CK,COK,WPR,1749,2502,4251,1669,1136,832,595,361,260,4853,1741,2389,4130,1595,978,726,517,336,251,4403,9256,17631,17631
Cook Islands,1961,CK,COK,WPR,1832,2569,4401,1643,1139,837,608,371,261,4859,1831,2462,4293,1608,988,736,523,345,252,4452,9311,18014,18014
Cook Islands,1962,CK,COK,WPR,1890,2628,4518,1613,1131,840,620,375,262,4841,1872,2537,4409,1612,1000,734,526,354,264,4490,9331,18264,18264
Cook Islands,1963,CK,COK,WPR,1914,2685,4599,1579,1112,833,630,378,269,4801,1875,2620,4495,1607,1005,736,531,355,272,4506,9307,18406,18406
Cook Islands,1964,CK,COK,WPR,1936,2757,4693,1552,1085,833,635,374,276,4755,1882,2721,4603,1606,1003,741,537,349,286,4522,9277,18571,18571
Cook Islands,1965,CK,COK,WPR,1963,2841,4804,1538,1046,830,639,373,288,4714,1901,2825,4726,1607,989,742,547,336,309,4530,9244,18767,18767
Cook Islands,1966,CK,COK,WPR,1991,2937,4928,1546,1004,822,633,381,295,4681,1919,2930,4849,1615,981,746,553,326,320,4541,9222,19003,19003
Cook Islands,1967,CK,COK,WPR,1991,3042,5033,1591,991,825,632,399,297,4735,1915,3022,4937,1638,998,756,557,336,322,4607,9342,19314,19314
Cook Islands,1968,CK,COK,WPR,1974,3156,5130,1651,994,835,632,411,306,4829,1898,3114,5012,1671,1031,764,561,356,324,4707,9536,19677,19677
Cook Islands,1969,CK,COK,WPR,1967,3275,5242,1706,1005,847,636,432,309,4935,1893,3198,5091,1696,1065,770,564,375,327,4797,9732,20066,20066
Cook Islands,2031,CK,COK,WPR,636,1378,2014,1272,979,869,823,974,1236,6153,600,1303,1903,1204,1223,1083,1002,1116,1589,7217,13370,17286,17286
Cook Islands,2032,CK,COK,WPR,629,1364,1993,1290,995,871,811,939,1276,6182,592,1286,1878,1217,1217,1090,1003,1096,1640,7263,13445,17318,17318
Cook Islands,2033,CK,COK,WPR,622,1350,1972,1310,1016,872,797,912,1304,6211,587,1272,1859,1230,1203,1097,1006,1077,1685,7298,13509,17345,17345
Cook Islands,2034,CK,COK,WPR,616,1334,1950,1326,1039,868,791,881,1335,6240,581,1257,1838,1244,1191,1108,1006,1058,1735,7342,13582,17372,17372
Cook Islands,2035,CK,COK,WPR,611,1316,1927,1343,1063,862,790,854,1364,6276,574,1243,1817,1262,1170,1123,1008,1032,1780,7375,13651,17394,17394
Cook Islands,2036,CK,COK,WPR,604,1302,1906,1351,1085,862,785,829,1382,6294,572,1227,1799,1273,1154,1140,1015,1012,1822,7416,13710,17415,17415
Cook Islands,2037,CK,COK,WPR,602,1286,1888,1358,1106,869,785,808,1400,6326,568,1213,1781,1279,1142,1156,1022,990,1859,7448,13774,17438,17438
Cook Islands,2038,CK,COK,WPR,600,1272,1872,1363,1128,877,791,787,1414,6360,566,1199,1765,1283,1131,1165,1025,979,1893,7476,13836,17466,17466
Cook Islands,2039,CK,COK,WPR,600,1256,1856,1358,1148,885,800,770,1415,6376,564,1185,1749,1282,1124,1167,1031,969,1927,7500,13876,17490,17490
Cook Islands,2040,CK,COK,WPR,597,1244,1841,1353,1167,899,808,752,1422,6401,562,1173,1735,1278,1125,1167,1039,961,1959,7529,13930,17511,17511
Cook Islands,2041,CK,COK,WPR,592,1232,1824,1345,1189,916,814,742,1424,6430,560,1162,1722,1269,1132,1169,1044,958,1980,7552,13982,17529,17529
Cook Islands,2042,CK,COK,WPR,591,1221,1812,1333,1211,938,817,732,1424,6455,560,1150,1710,1257,1148,1168,1052,957,1995,7577,14032,17548,17548
Cook Islands,2043,CK,COK,WPR,590,1212,1802,1318,1236,957,818,724,1419,6472,557,1142,1699,1245,1165,1159,1064,961,2001,7595,14067,17566,17566
Cook Islands,2044,CK,COK,WPR,589,1205,1794,1306,1257,980,819,720,1409,6491,554,1135,1689,1231,1185,1145,1078,963,2014,7616,14107,17585,17585
Cook Islands,2045,CK,COK,WPR,587,1198,1785,1291,1276,1008,814,717,1405,6511,552,1128,1680,1217,1204,1130,1094,965,2016,7626,14137,17605,17605
Cook Islands,2046,CK,COK,WPR,584,1193,1777,1278,1289,1033,814,717,1399,6530,551,1123,1674,1205,1220,1115,1107,971,2023,7641,14171,17620,17620
Cook Islands,2047,CK,COK,WPR,581,1188,1769,1264,1298,1058,823,719,1389,6551,549,1120,1669,1190,1228,1102,1120,978,2024,7642,14193,17635,17635
Cook Islands,2048,CK,COK,WPR,578,1185,1763,1251,1303,1079,834,724,1381,6572,545,1115,1660,1178,1237,1096,1132,986,2028,7657,14229,17651,17651
Cook Islands,2049,CK,COK,WPR,576,1181,1757,1237,1307,1101,840,734,1370,6589,543,1113,1656,1166,1236,1093,1138,992,2036,7661,14250,17663,17663
Cook Islands,2050,CK,COK,WPR,573,1178,1751,1223,1304,1121,856,743,1357,6604,540,1111,1651,1154,1236,1095,1142,999,2042,7668,14272,17674,17674
Colombia,1970,CO,COL,AMR,1782987,3102779,4885766,2108410,1287141,887725,607317,405620,268251,5564464,1719126,3014969,4734095,2074466,1299322,912582,631050,437315,366193,5720928,11285392,20905254,20905254
Colombia,1971,CO,COL,AMR,1777496,3177345,4954841,2193523,1331115,906850,623148,416825,277122,5748583,1713653,3085312,4798965,2154263,1342313,932302,648113,449838,376202,5903031,11651614,21405413,21405413
Colombia,1972,CO,COL,AMR,1770342,3243240,5013582,2281245,1378028,925499,640438,427244,286659,5939113,1706868,3147287,4854155,2236325,1388259,951425,666828,461548,386831,6091216,12030329,21898055,21898055
Colombia,1973,CO,COL,AMR,1764623,3299435,5064058,2373941,1428168,945071,659094,437151,297069,6140494,1701526,3200019,4901545,2323004,1437733,971362,687013,472682,398425,6290219,12430713,22396318,22396318
Colombia,1974,CO,COL,AMR,1763092,3345089,5108181,2465720,1484224,966203,677989,446885,308754,6349775,1700177,3242528,4942705,2409993,1491855,992805,707510,483607,411443,6497213,12846988,22897871,22897871
Colombia,1975,CO,COL,AMR,1767557,3380349,5147906,2554349,1546731,989392,696504,456834,321716,6565526,1704624,3274891,4979515,2495192,1550945,1016326,727654,494740,425937,6710794,13276320,23403731,23403731
Colombia,1976,CO,COL,AMR,1779222,3405751,5184973,2642999,1610631,1014102,714882,466903,335893,6785410,1715853,3297899,5013752,2580238,1611566,1041521,747711,505937,441893,6928866,13714276,23913002,23913002
Colombia,1977,CO,COL,AMR,1798825,3422957,5221782,2733231,1678699,1041621,734055,477132,351312,7016050,1734542,3313298,5047840,2667004,1676517,1069636,768525,517194,459377,7158253,14174303,24443926,24443926
Colombia,1978,CO,COL,AMR,1825447,3434555,5260002,2824007,1752555,1073153,753956,488109,367473,7259253,1760084,3323438,5083522,2754618,1747456,1101838,789984,529142,477796,7400834,14660087,25003608,25003608
Colombia,1979,CO,COL,AMR,1857391,3442829,5300220,2912058,1829946,1108557,773473,500485,383558,7508077,1790957,3330427,5121384,2839613,1822162,1138016,811041,542598,496202,7649632,15157709,25579323,25579323
Colombia,1980,CO,COL,AMR,1892117,3451501,5343618,2996547,1912073,1148680,792853,514467,399267,7763887,1824760,3337907,5162667,2921217,1901879,1178965,831896,557826,514247,7906030,15669917,26176195,26176195
Colombia,1981,CO,COL,AMR,1926590,3464195,5390785,3074219,1998079,1192993,812236,529894,414519,8021940,1858364,3349520,5207884,2996106,1985787,1224202,852683,574692,531895,8165365,16187305,26785982,26785982
Colombia,1982,CO,COL,AMR,1959734,3482830,5442564,3143282,2087665,1241228,831668,546787,429136,8279766,1890570,3367134,5257704,3062557,2073434,1273497,873452,593265,548958,8425163,16704929,27405194,27405194
Colombia,1983,CO,COL,AMR,1990088,3509339,5499427,3204109,2183486,1293055,852151,564827,443330,8540958,1919955,3392574,5312529,3121255,2167336,1326713,895189,613163,565762,8689418,17230376,28042329,28042329
Colombia,1984,CO,COL,AMR,2016467,3545126,5561593,3254582,2279497,1351411,874484,583140,457728,8800842,1945382,3427242,5372624,3170010,2263158,1385491,918799,633470,583038,8953966,17754808,28689032,28689032
Colombia,1985,CO,COL,AMR,2039039,3588151,5627190,3292537,2371672,1416054,898683,600870,472273,9052089,1967034,3468918,5435952,3206365,2356915,1449502,944399,653246,600603,9211030,18263119,29326260,29326260
Colombia,1986,CO,COL,AMR,2059626,3637721,5697347,3318666,2463311,1482839,924817,618710,487420,9295763,1986764,3516867,5503631,3231653,2450715,1516307,972265,673242,619173,9463355,18759118,29960101,29960101
Colombia,1987,CO,COL,AMR,2079384,3694216,5773600,3335265,2553876,1552230,953263,637368,503670,9535672,2005839,3571504,5577343,3248770,2544478,1586615,1002896,694206,639469,9716434,19252106,30603048,30603048
Colombia,1988,CO,COL,AMR,2099316,3754111,5853427,3345918,2642625,1625094,984666,656361,520691,9775355,2025215,3629381,5654596,3261117,2637516,1661293,1036872,715574,660987,9973359,19748714,31256727,31256727
Colombia,1989,CO,COL,AMR,2120434,3815130,5935564,3353575,2728718,1701345,1019909,675157,538603,10017307,2045691,3688443,5734134,3271334,2728831,1740293,1075039,736762,683857,10236116,20253423,31923117,31923117
Colombia,1990,CO,COL,AMR,2142415,3875885,6018300,3361781,2810306,1780885,1059220,693748,557327,10263267,2066857,3747299,5814156,3282564,2816290,1823536,1117579,757727,707961,10505657,20768924,32601393,32601393
Colombia,1991,CO,COL,AMR,2163976,3934191,6098167,3371823,2882483,1862313,1101896,712282,576788,10507585,2087675,3803725,5891400,3295597,2894588,1909661,1163838,778609,733179,10775472,21283057,33272628,33272628
Colombia,1992,CO,COL,AMR,2183641,3989439,6173080,3386921,2944873,1946086,1148037,730913,596969,10753799,2106841,3857209,5964050,3313295,2963071,1998858,1213871,799550,759457,11048102,21801901,33939039,33939039
Colombia,1993,CO,COL,AMR,2200871,4041674,6242545,3411452,2999015,2034322,1197026,750329,617858,11010002,2123644,3907752,6031396,3339878,3023065,2092782,1267140,821250,786675,11330790,22340792,34614735,34614735
Colombia,1994,CO,COL,AMR,2214141,4090657,6304798,3446606,3044071,2122495,1252160,771452,639407,11276191,2136495,3954950,6091445,3376444,3073426,2188123,1325651,844708,814668,11623020,22899211,35295461,35295461
Colombia,1995,CO,COL,AMR,2221708,4137253,6358961,3490038,3078762,2208339,1313993,794817,661689,11547638,2143775,3999496,6143271,3420757,3112910,2282575,1389980,870597,843408,11920227,23467865,35970101,35970101
Colombia,1996,CO,COL,AMR,2223468,4181787,6405255,3539371,3102774,2295003,1378354,820281,685137,11820920,2145069,4042042,6187111,3470279,3141647,2377819,1457409,898885,873258,12219297,24040217,36632573,36632573
Colombia,1997,CO,COL,AMR,2220376,4223249,6443625,3595540,3118958,2382313,1445534,847949,710136,12100430,2141072,4081974,6223046,3525982,3162722,2473529,1528293,929717,904596,12524839,24625269,37291946,37291946
Colombia,1998,CO,COL,AMR,2213113,4262002,6475115,3655073,3129244,2468303,1515732,878371,736504,12383227,2132639,4119410,6252049,3584689,3177881,2567577,1602963,963655,937253,12834018,25217245,37944414,37944414
Colombia,1999,CO,COL,AMR,2203043,4297286,6500329,3714940,3135541,2551528,1588487,912177,763658,12666331,2121337,4153290,6274627,3643443,3188809,2658403,1681052,1001350,970685,13143742,25810073,38585033,38585033
Colombia,2000,CO,COL,AMR,2191430,4327374,6518804,3774292,3141699,2630256,1663767,949608,791465,12951087,2108495,4181951,6290446,3701203,3199050,2744068,1762560,1043029,1004894,13454804,26405891,39215135,39215135
Colombia,2001,CO,COL,AMR,2178374,4351701,6530075,3832373,3152340,2702617,1741745,990614,819885,13239574,2094263,4204795,6299058,3757154,3213146,2822597,1847613,1088630,1040027,13769167,27008741,39837875,39837875
Colombia,2002,CO,COL,AMR,2164079,4369409,6533488,3888842,3170021,2767410,1822719,1035178,848887,13533057,2078919,4220842,6299761,3810940,3233374,2892860,1936226,1138132,1076212,14087744,27620801,40454050,40454050
Colombia,2003,CO,COL,AMR,2147936,4380158,6528094,3942576,3195731,2822976,1907454,1082226,878923,13829886,2061843,4229773,6291616,3861175,3260309,2953222,2028801,1190570,1114015,14408092,28237978,41057687,41057687
Colombia,2004,CO,COL,AMR,2128475,4384076,6512551,3993576,3231213,2868628,1991969,1134866,910685,14130937,2041799,4231843,6273642,3907949,3295826,3002934,2122312,1247936,1154178,14731135,28862072,41648268,41648268
Colombia,2005,CO,COL,AMR,2104992,4380784,6485776,4042128,3274955,2904106,2074762,1193859,944798,14434608,2018346,4226828,6245174,3951646,3338587,3041798,2215033,1310975,1197340,15055379,29489987,42220940,42220940
Colombia,2006,CO,COL,AMR,2076928,4368757,6445685,4088627,3326115,2929730,2158653,1254901,982901,14740927,1990841,4213294,6204135,3993872,3387240,3070577,2308787,1376858,1244830,15382164,30123091,42772910,42772910
Colombia,2007,CO,COL,AMR,2045212,4348396,6393608,4131871,3384599,2946930,2242691,1317738,1025472,15049301,1960151,4191490,6151641,4034335,3441706,3090796,2402568,1445530,1297097,15712032,30761333,43306582,43306582
Colombia,2008,CO,COL,AMR,2011865,4320729,6332594,4170464,3445739,2957722,2325406,1382983,1071711,15354025,1928262,4162275,6090537,4070942,3497735,3104036,2494341,1517530,1353564,16038148,31392173,43815313,43815313
Colombia,2009,CO,COL,AMR,1979463,4287324,6266787,4205462,3508866,2966082,2406708,1451034,1121020,15659172,1897470,4127397,6024867,4104111,3554908,3113761,2583412,1593054,1413837,16363083,32022255,44313917,44313917
Colombia,2010,CO,COL,AMR,1950390,4250159,6200549,4236327,3573882,2976416,2485387,1522058,1173314,15967384,1869915,4088989,5958904,4133188,3613477,3124222,2668174,1672202,1478001,16689264,32656648,44816108,44816108
Colombia,2011,CO,COL,AMR,1925372,4207737,6133109,4260437,3637584,2991163,2558186,1595363,1229357,16272090,1846354,4045847,5892201,4155862,3670174,3138212,2745837,1754531,1546885,17011501,33283591,45308899,45308899
Colombia,2012,CO,COL,AMR,1904349,4159975,6064324,4275751,3698146,3011511,2622939,1670838,1288913,16568098,1826666,3998111,5824777,4170104,3723124,3156939,2814768,1839820,1620468,17325223,33893321,45782417,45782417
Colombia,2013,CO,COL,AMR,1886821,4108383,5995204,4282437,3755197,3039195,2678273,1749369,1350705,16855176,1810215,3947206,5757421,4175967,3772097,3181981,2873739,1928625,1697712,17630121,34485297,46237930,46237930
Colombia,2014,CO,COL,AMR,1872066,4053758,5925824,4281265,3808671,3075941,2723520,1827582,1417784,17134763,1796252,3893811,5690063,4174106,3817196,3215124,2921967,2018199,1780709,17927301,35062064,46677947,46677947
Colombia,2015,CO,COL,AMR,1860182,3999173,5859355,4274317,3860985,3122353,2759735,1905131,1490495,17413016,1784866,3840677,5625543,4166201,3861367,3256865,2960058,2107534,1869788,18221813,35634829,47119728,47119728
Colombia,2016,CO,COL,AMR,1853189,3949384,5802573,4270271,3920810,3181913,2790193,1986597,1565607,17715391,1778169,3792165,5570334,4160491,3914432,3310068,2990803,2199424,1962435,18537653,36253044,47625955,47625955
Colombia,2017,CO,COL,AMR,1853891,3908658,5762549,4291856,4012164,3266241,2821130,2073220,1647419,18112030,1779015,3752867,5531882,4181576,4001183,3385817,3020195,2294530,2061917,18945218,37057248,48351671,48351671
Colombia,2018,CO,COL,AMR,1860650,3876175,5736825,4333142,4134207,3371935,2854188,2163006,1737752,18594230,1785828,3722181,5508009,4224121,4120763,3481581,3050324,2390911,2170203,19437903,38032133,49276961,49276961
Colombia,2019,CO,COL,AMR,1868704,3847820,5716524,4359211,4252882,3480984,2885331,2251846,1832519,19062773,1793828,3695517,5489345,4251267,4238702,3580868,3077973,2485077,2284869,19918756,38981529,50187406,50187406
Colombia,2020,CO,COL,AMR,1873333,3822287,5695620,4353482,4346491,3582066,2912192,2331776,1917963,19443970,1798256,3671328,5469584,4244905,4332728,3673272,3102029,2571517,2397042,20321493,39765463,50930662,50930662
Colombia,2021,CO,COL,AMR,1872904,3802413,5675317,4323514,4417940,3674040,2936645,2397272,1990511,19739922,1797568,3652619,5450187,4213454,4406173,3758813,3125817,2645294,2501583,20651134,40391056,51516562,51516562
Colombia,2022,CO,COL,AMR,1863451,3784506,5647957,4256581,4448374,3748684,2960063,2451627,2062323,19927652,1787911,3635573,5423484,4143383,4439285,3829336,3149661,2707438,2605836,20874939,40802591,51874024,51874024
Colombia,2023,CO,COL,AMR,1845366,3766738,5612104,4160190,4439302,3809518,2990630,2504104,2152817,20056561,1769921,3618350,5388271,4041451,4431047,3885574,3178168,2764392,2727598,21028230,41084791,52085168,52085168
Colombia,2024,CO,COL,AMR,1823665,3753640,5577305,4068247,4420880,3870032,3034710,2554405,2263227,20211501,1748666,3605612,5354278,3944159,4411599,3940402,3217689,2816078,2867761,21197688,41409189,52340774,52340774
Colombia,2025,CO,COL,AMR,1799623,3742996,5542619,3985670,4394656,3929865,3088210,2595801,2379378,20373580,1725393,3595073,5320466,3857361,4383369,3994910,3266129,2858168,3014113,21374050,41747630,52610722,52610722
Colombia,2026,CO,COL,AMR,1775746,3731866,5507612,3915301,4362037,3989584,3150024,2629024,2501130,20547100,1702475,3583924,5286399,3784068,4347357,4050165,3322134,2891592,3166312,21561628,42108728,52902741,52902741
Colombia,2027,CO,COL,AMR,1753869,3717814,5471683,3857520,4323626,4047258,3219446,2655314,2627649,20730813,1681532,3569846,5251378,3724604,4303882,4104672,3384972,2917628,3323438,21759196,42490009,53213060,53213060
Colombia,2028,CO,COL,AMR,1733549,3700008,5433557,3810674,4278293,4101751,3293393,2676908,2757604,20918623,1662064,3552232,5214296,3677093,4251951,4157171,3451935,2938307,3484121,21960578,42879201,53527052,53527052
Colombia,2029,CO,COL,AMR,1714130,3678740,5392870,3773158,4225535,4151199,3369450,2696361,2889726,21105429,1643421,3531379,5174800,3639525,4191607,4205431,3520882,2956026,3647040,22160511,43265940,53833603,53833603
Colombia,2030,CO,COL,AMR,1695911,3653355,5349266,3744584,4166904,4193299,3446330,2716945,3022071,21290133,1625909,3506556,5132465,3611198,4124988,4246866,3590611,2974036,3810198,22357897,43648030,54129764,54129764
Colombia,1950,CO,COL,AMR,1063991,1523016,2587007,1148416,796675,565299,358246,224061,170088,3262785,1044104,1516507,2560611,1147337,797850,567722,381926,256034,208483,3359352,6622137,11769748,11769748
Colombia,1951,CO,COL,AMR,1106745,1569924,2676669,1169975,813887,578059,368379,227241,173288,3330829,1083117,1562553,2645670,1170416,817002,581971,389837,261804,212859,3433889,6764718,12087058,12087058
Colombia,1952,CO,COL,AMR,1150823,1621238,2772061,1191294,833151,590185,379329,230501,176900,3401360,1123336,1612921,2736257,1193068,838264,595439,398040,268032,217450,3510293,6911653,12419968,12419968
Colombia,1953,CO,COL,AMR,1198109,1675497,2873606,1212522,853329,601593,390882,233937,180976,3473239,1166278,1666276,2832554,1215341,860483,608031,406774,274508,222704,3587841,7061080,12767237,12767237
Colombia,1954,CO,COL,AMR,1243850,1736524,2980374,1235250,873604,612740,403187,238072,185293,3548146,1208874,1724738,2933612,1238817,882830,620293,416856,281123,228596,3668515,7216661,13130649,13130649
Colombia,1955,CO,COL,AMR,1286536,1805294,3091830,1260761,893768,624188,416173,243126,189667,3627683,1249882,1789096,3038978,1264873,905110,632861,428496,287811,234976,3754127,7381810,13512612,13512612
Colombia,1956,CO,COL,AMR,1330629,1877127,3207756,1288714,914014,635600,429661,249128,194030,3711147,1292090,1856376,3148466,1293246,927520,645420,441606,294591,241648,3844031,7555178,13911407,13911407
Colombia,1957,CO,COL,AMR,1376403,1952106,3328509,1319412,935002,646885,443747,256362,198506,3799914,1335769,1926648,3262417,1323927,950341,657717,456327,301635,248568,3938515,7738429,14329355,14329355
Colombia,1958,CO,COL,AMR,1422884,2030475,3453359,1352756,955463,658203,457801,264651,203011,3891885,1380075,2000126,3380201,1356745,972242,669997,471753,308828,255784,4035349,7927234,14760798,14760798
Colombia,1959,CO,COL,AMR,1469638,2112110,3581748,1390753,975726,671082,471366,273648,207445,3990020,1424701,2076727,3501428,1393920,993665,683906,486839,316077,263481,4137888,8127908,15211087,15211087
Colombia,1960,CO,COL,AMR,1516654,2197157,3713811,1434775,997068,686438,484557,283314,211915,4098067,1469596,2156606,3626202,1436832,1015764,700301,501298,323608,271806,4249609,8347676,15687688,15687688
Colombia,1961,CO,COL,AMR,1563136,2285380,3848516,1483373,1018703,703637,497225,293570,216279,4212787,1513927,2239489,3753416,1484127,1037813,718642,515063,331349,280705,4367699,8580486,16182414,16182414
Colombia,1962,CO,COL,AMR,1607957,2376820,3984777,1536047,1040443,722695,509343,304287,220459,4333274,1556665,2325261,3881926,1535320,1059597,738943,528074,339182,290190,4491306,8824580,16691282,16691282
Colombia,1963,CO,COL,AMR,1649980,2472291,4122271,1591219,1062760,743048,521028,315547,224638,4458240,1596629,2414488,4011117,1589069,1081579,760603,540422,347574,300081,4619328,9077568,17210956,17210956
Colombia,1964,CO,COL,AMR,1688662,2566774,4255436,1652620,1086817,763704,532561,327541,229110,4592353,1633166,2503886,4137052,1647546,1104983,782577,552496,357294,310011,4754907,9347260,17739754,17739754
Colombia,1965,CO,COL,AMR,1722413,2658399,4380812,1721553,1113726,784248,544357,340196,234003,4738083,1664803,2591783,4256586,1711913,1131008,804391,564785,368471,319759,4900327,9638410,18275814,18275814
Colombia,1966,CO,COL,AMR,1749244,2750976,4500220,1793119,1142821,804868,556132,353367,239449,4889756,1689659,2680332,4369991,1778834,1159085,826198,577033,381022,329273,5051445,9941201,18811407,18811407
Colombia,1967,CO,COL,AMR,1768754,2843340,4612094,1867336,1174009,825923,567663,366984,245651,5047566,1707408,2768485,4475893,1848301,1189221,848326,589049,394988,338524,5208409,10255975,19343961,19343961
Colombia,1968,CO,COL,AMR,1780723,2933623,4714346,1944884,1208155,847190,579559,380610,252597,5212995,1718038,2854469,4572507,1921001,1222336,870525,601517,409689,347592,5372660,10585655,19872503,19872503
Colombia,1969,CO,COL,AMR,1784882,3020725,4805607,2025151,1245688,867744,592675,393560,260104,5384922,1721395,2937227,4658622,1996284,1258848,891901,615410,423953,356709,5543105,10928027,20392264,20392264
Colombia,2031,CO,COL,AMR,1678256,3623596,5301852,3725002,4103607,4226945,3522421,2742074,3152651,21472700,1608973,3477469,5086442,3592153,4053633,4279948,3659532,2995919,3971562,22552747,44025447,54413737,54413737
Colombia,2032,CO,COL,AMR,1660727,3590728,5251455,3712183,4037855,4250842,3596868,2773615,3280251,21651614,1592147,3445297,5037444,3580000,3980159,4302904,3727008,3023560,4129931,22743562,44395176,54684075,54684075
Colombia,2033,CO,COL,AMR,1643381,3555661,5199042,3703148,3972125,4264288,3669032,2812942,3403689,21825224,1575395,3411083,4986478,3571550,3907309,4314711,3792502,3058375,4283997,22928444,44753668,54939194,54939194
Colombia,2034,CO,COL,AMR,1626107,3517906,5144013,3697084,3907918,4266977,3738457,2861336,3522167,21993939,1558718,3374446,4933164,3565796,3836773,4314860,3855583,3101868,4432645,23107525,45101464,55178639,55178639
Colombia,2035,CO,COL,AMR,1609576,3478460,5088036,3691684,3847299,4258373,3805652,2917989,3635725,22156722,1542763,3336381,4879144,3560305,3770798,4302699,3916878,3153396,4575632,23279708,45436430,55403609,55403609
Colombia,2036,CO,COL,AMR,1594305,3438935,5033240,3684189,3792166,4238443,3870464,2981537,3744846,22311645,1527936,3298428,4826364,3552483,3711337,4277766,3976765,3211361,4713452,23443164,45754809,55614410,55614410
Colombia,2037,CO,COL,AMR,1579344,3400755,4980099,3672551,3743864,4208183,3931155,3051373,3850102,22457228,1513435,3261784,4775219,3540435,3659747,4240767,4033910,3275123,4846575,23596557,46053785,55809100,55809100
Colombia,2038,CO,COL,AMR,1564775,3363863,4928638,3656512,3703228,4168488,3987546,3124967,3952810,22593551,1499355,3226249,4725604,3524145,3616785,4192737,4087925,3342388,4975937,23739917,46333468,55987723,55987723
Colombia,2039,CO,COL,AMR,1550537,3327797,4878334,3636731,3670510,4120493,4038590,3200396,4054660,22721380,1485569,3191464,4677033,3504317,3582431,4135381,4137339,3411398,5102916,23873782,46595162,56150514,56150514
Colombia,2040,CO,COL,AMR,1536259,3293565,4829824,3612671,3645781,4066072,4082197,3276547,4157136,22840404,1471719,3158430,4630149,3480338,3556459,4071176,4179745,3481058,5228925,23997701,46838105,56298077,56298077
Colombia,2041,CO,COL,AMR,1522126,3261074,4783200,3584149,3629303,4006542,4117337,3351949,4261769,22951049,1457983,3127019,4585002,3451981,3539126,4001781,4213693,3549889,5355574,24112044,47063093,56431283,56431283
Colombia,2042,CO,COL,AMR,1508477,3228963,4737440,3552468,3619107,3944241,4142824,3425856,4369463,23053959,1444721,3095989,4540710,3420471,3528285,3929959,4237504,3617306,5483710,24217235,47271194,56549346,56549346
Colombia,2043,CO,COL,AMR,1494918,3197395,4692313,3518561,3612472,3881768,4158046,3497700,4480512,23149059,1431575,3065425,4497000,3386885,3520972,3858619,4250242,3682834,5613672,24313224,47462283,56651603,56651603
Colombia,2044,CO,COL,AMR,1481574,3166220,4647794,3481974,3608704,3820708,4162732,3567057,4595388,23236563,1418657,3035218,4453875,3350876,3516315,3789540,4251452,3746071,5745984,24400238,47636801,56738474,56738474
Colombia,2045,CO,COL,AMR,1469129,3135743,4604872,3443712,3605558,3763104,4156363,3634405,4713557,23316699,1406649,3005668,4412317,3313439,3511916,3724973,4240495,3807630,5879979,24478432,47795131,56812317,56812317
Colombia,2046,CO,COL,AMR,1457229,3106654,4563883,3405348,3600303,3710824,4138892,3699569,4834404,23389340,1395187,2977352,4372539,3276114,3505176,3666856,4216911,3867850,6014794,24547701,47937041,56873465,56873465
Colombia,2047,CO,COL,AMR,1446146,3078354,4524500,3368276,3590918,3665206,4111280,3760867,4958066,23454613,1384504,2949827,4334331,3240072,3494203,3616533,4181387,3925420,6150508,24608123,48062736,56921552,56921552
Colombia,2048,CO,COL,AMR,1436226,3050517,4486743,3332422,3577103,3627050,4074377,3818079,5083601,23512632,1374937,2922827,4297764,3205082,3478945,3574736,4134942,3979944,6286041,24659690,48172322,56956823,56956823
Colombia,2049,CO,COL,AMR,1426640,3023204,4449844,3297308,3559497,3596611,4029287,3870172,5210821,23563696,1365670,2896329,4261999,3170773,3460087,3541443,4079239,4029951,6421242,24702735,48266431,56978269,56978269
Colombia,2050,CO,COL,AMR,1417041,2996736,4413777,3263946,3537563,3573959,3977822,3915111,5340240,23608641,1356354,2870659,4227013,3138153,3437017,3516430,4016727,4073087,6556804,24738218,48346859,56987651,56987651
Comoros,1970,KM,COM,AFR,21655,33134,54789,19075,15392,12626,9204,6331,4208,66836,21277,32249,53526,20122,15849,11427,8673,6448,4676,67195,134031,242351,242351
Comoros,1971,KM,COM,AFR,22238,34068,56306,20011,15364,13005,9407,6516,4407,68710,21831,33243,55074,21029,16069,11702,8719,6593,4859,68971,137681,249066,249066
Comoros,1972,KM,COM,AFR,22893,34984,57877,21029,15307,13421,9640,6711,4630,70738,22457,34242,56699,22065,16250,11993,8769,6729,5070,70876,141614,256187,256187
Comoros,1973,KM,COM,AFR,23624,35909,59533,22128,15220,13856,9902,6918,4881,72905,23152,35247,58399,23241,16378,12298,8816,6857,5305,72895,145800,263728,263728
Comoros,1974,KM,COM,AFR,24424,36871,61295,23235,15172,14295,10205,7147,5162,75216,23917,36276,60193,24510,16505,12602,8875,6972,5554,75018,150234,271719,271719
Comoros,1975,KM,COM,AFR,25265,37888,63153,24216,15269,14732,10545,7387,5465,77614,24722,37337,62059,25697,16785,12893,8940,7073,5814,77202,154816,280036,280036
Comoros,1976,KM,COM,AFR,26160,39000,65160,25077,15530,15153,10927,7637,5800,80124,25585,38462,64047,26803,17239,13178,9015,7160,6096,79491,159615,288810,288810
Comoros,1977,KM,COM,AFR,27121,40224,67345,25860,15910,15566,11349,7908,6145,82738,26518,39670,66188,27891,17793,13456,9112,7238,6396,81886,164624,298152,298152
Comoros,1978,KM,COM,AFR,28131,41570,69701,26546,16420,15950,11808,8190,6504,85418,27500,40967,68467,28942,18465,13719,9227,7304,6692,84349,169767,307938,307938
Comoros,1979,KM,COM,AFR,29190,43037,72227,27198,17029,16273,12291,8473,6867,88131,28530,42350,70880,29959,19238,13981,9368,7352,6990,86888,175019,318123,318123
Comoros,1980,KM,COM,AFR,30226,44640,74866,27986,17663,16447,12732,8696,7142,90666,29556,43801,73357,30928,20089,14271,9555,7381,7219,89443,180109,328328,328328
Comoros,1981,KM,COM,AFR,31201,46288,77489,28897,18251,16400,13074,8834,7332,92788,30544,45262,75806,31799,20944,14574,9790,7398,7400,91905,184693,337986,337986
Comoros,1982,KM,COM,AFR,32205,47852,80057,29670,18829,16203,13356,8953,7529,94540,31544,46689,78233,32542,21776,14820,10047,7434,7615,94234,188774,347053,347053
Comoros,1983,KM,COM,AFR,33252,49391,82643,30375,19496,15931,13619,9086,7741,96248,32560,48135,80695,33257,22665,14971,10314,7487,7854,96548,192796,356137,356137
Comoros,1984,KM,COM,AFR,34275,51023,85298,31218,20247,15649,13867,9225,7932,98138,33554,49689,83243,34034,23623,15114,10602,7545,8065,98983,197121,365664,365664
Comoros,1985,KM,COM,AFR,35243,52761,88004,32225,20967,15484,14081,9374,8096,100227,34501,51355,85856,34898,24512,15387,10913,7613,8241,101564,201791,375650,375650
Comoros,1986,KM,COM,AFR,36151,54578,90729,33403,21655,15438,14265,9537,8238,102536,35394,53119,88513,35858,25323,15794,11233,7684,8390,104282,206818,386068,386068
Comoros,1987,KM,COM,AFR,37014,56444,93458,34743,22348,15487,14415,9718,8363,105074,36234,54955,91189,36922,26119,16267,11565,7778,8513,107164,212238,396887,396887
Comoros,1988,KM,COM,AFR,37852,58337,96189,36219,23037,15649,14519,9916,8481,107821,37056,56820,93876,38085,26887,16818,11894,7891,8609,110184,218005,408070,408070
Comoros,1989,KM,COM,AFR,38676,60234,98910,37806,23725,15921,14563,10129,8594,110738,37861,58702,96563,39344,27644,17437,12224,8031,8690,113370,224108,419584,419584
Comoros,1990,KM,COM,AFR,39478,62096,101574,39354,24419,16302,14540,10370,8731,113716,38632,60562,99194,40637,28360,18110,12531,8207,8790,116635,230351,431119,431119
Comoros,1991,KM,COM,AFR,40254,63860,104114,40680,25108,16765,14437,10641,8935,116566,39358,62351,101709,41890,29014,18802,12785,8435,8963,119889,236455,442277,442277
Comoros,1992,KM,COM,AFR,40966,65671,106637,41888,25718,17322,14277,10918,9131,119254,40021,64157,104178,43059,29576,19558,12976,8653,9087,122909,242163,452990,452990
Comoros,1993,KM,COM,AFR,41575,67555,109130,43075,26237,17976,14075,11193,9298,121854,40586,66009,106595,44170,30049,20412,13096,8853,9153,125733,247587,463318,463318
Comoros,1994,KM,COM,AFR,42054,69394,111448,44279,26766,18691,13857,11449,9487,124529,41023,67819,108842,45357,30496,21307,13194,9070,9236,128660,253189,473478,473478
Comoros,1995,KM,COM,AFR,42445,71186,113631,45605,27352,19355,13736,11670,9682,127400,41367,69565,110932,46689,30968,22108,13411,9301,9317,131794,259194,483760,483760
Comoros,1996,KM,COM,AFR,42806,72909,115715,47048,28015,19962,13718,11856,9878,130477,41692,71232,112924,48160,31493,22815,13757,9536,9411,135172,265649,494288,494288
Comoros,1997,KM,COM,AFR,43156,74545,117701,48594,28749,20538,13781,11999,10083,133744,42014,72797,114811,49756,32087,23486,14162,9772,9515,138778,272522,505033,505033
Comoros,1998,KM,COM,AFR,43519,76065,119584,50236,29563,21071,13941,12093,10286,137190,42346,74251,116597,51448,32761,24108,14644,10009,9622,142592,279782,515959,515959
Comoros,1999,KM,COM,AFR,44400,77509,121909,51183,30353,21571,14225,12053,10516,139901,43052,75559,118611,52818,33348,24527,15192,10286,9843,146014,285915,526443,526443
Comoros,2000,KM,COM,AFR,45792,79252,125044,51435,30858,22155,14621,11902,10714,141685,44116,76887,121003,53934,33749,24821,15790,10572,10154,149020,290705,536758,536758
Comoros,2001,KM,COM,AFR,47130,81610,128740,51842,30936,22929,15069,11732,10828,143336,45078,78419,123497,55272,34045,25233,16398,10794,10426,152168,295504,547741,547741
Comoros,2002,KM,COM,AFR,48215,84494,132709,52518,30604,23868,15528,11571,10869,144958,45713,80178,125891,56852,34251,25748,16974,10962,10699,155486,300444,559047,559047
Comoros,2003,KM,COM,AFR,48421,86938,135359,54070,30561,24716,15976,11497,10969,147789,45777,81830,127607,58747,34765,26319,17503,11098,10940,159372,307161,570130,570130
Comoros,2004,KM,COM,AFR,48011,88228,136239,55942,31454,25696,16526,11612,11329,152559,45577,82921,128498,60424,35764,26968,18041,11322,11340,163859,316418,581154,581154
Comoros,2005,KM,COM,AFR,47749,89030,136779,57519,32829,26888,17183,11846,11872,158137,45569,83713,129282,61694,36968,27639,18571,11666,11947,168485,326622,592683,592683
Comoros,2006,KM,COM,AFR,47629,89763,137392,59200,34280,27972,17889,12094,12406,163841,45773,84484,130257,62911,38291,28247,19105,12048,12561,173163,337004,604658,604658
Comoros,2007,KM,COM,AFR,47705,90324,138029,60884,35815,28975,18689,12382,12892,169637,46235,85081,131316,64029,39741,28843,19693,12481,13129,177916,347553,616899,616899
Comoros,2008,KM,COM,AFR,48244,90510,138754,62582,37418,29897,19605,12715,13273,175490,46977,85448,132425,65074,41320,29460,20369,12975,13606,182804,358294,629470,629470
Comoros,2009,KM,COM,AFR,49117,90521,139638,64306,39068,30754,20644,13085,13538,181395,47851,85753,133604,66075,43030,30136,21154,13509,13955,187859,369254,642493,642493
Comoros,2010,KM,COM,AFR,50029,90679,140708,66062,40751,31557,21779,13491,13693,187333,48759,86124,134883,67079,44841,30879,22021,14085,14194,193099,380432,656024,656024
Comoros,2011,KM,COM,AFR,50999,90957,141956,67844,42459,32339,22973,13916,13794,193325,49720,86564,136284,68135,46695,31696,22930,14660,14385,198501,391826,670071,670071
Comoros,2012,KM,COM,AFR,51987,91342,143329,69633,44191,33147,24172,14354,13893,199390,50690,87094,137784,69277,48547,32586,23826,15224,14588,204048,403438,684553,684553
Comoros,2013,KM,COM,AFR,52917,91863,144780,71394,45950,34015,25326,14809,14019,205513,51608,87772,139380,70524,50355,33557,24658,15754,14862,209710,415223,699393,699393
Comoros,2014,KM,COM,AFR,53764,92555,146319,73113,47741,34972,26402,15277,14214,211719,52442,88669,141111,71883,52076,34621,25396,16251,15239,215466,427185,714612,714612
Comoros,2015,KM,COM,AFR,54493,93469,147962,74783,49570,36005,27382,15769,14465,217974,53162,89834,142996,73311,53710,35789,26048,16719,15705,221282,439256,730216,730216
Comoros,2016,KM,COM,AFR,55114,94592,149706,76422,51458,37099,28277,16311,14728,224295,53778,91281,145059,74754,55281,37065,26657,17201,16223,227181,451476,746232,746232
Comoros,2017,KM,COM,AFR,55705,95616,151321,77371,53485,38459,29131,17011,15108,230565,54334,92735,147069,75635,56708,38504,27243,17781,16846,232717,463282,761664,761664
Comoros,2018,KM,COM,AFR,56282,96756,153038,77322,55609,40106,29963,17889,15574,236463,54858,94166,149024,75834,57963,40122,27839,18491,17542,237791,474254,776313,776313
Comoros,2019,KM,COM,AFR,56796,98214,155010,76979,57692,41850,30741,18864,15990,242116,55330,95672,151002,75900,59116,41884,28484,19284,18184,242852,484968,790986,790986
Comoros,2020,KM,COM,AFR,57229,99864,157093,77031,59665,43560,31451,19850,16250,247807,55758,97285,153043,76227,60260,43734,29203,20104,18686,248214,496021,806166,806166
Comoros,2021,KM,COM,AFR,57574,101678,159252,77474,61527,45199,32122,20795,16331,253448,56116,99012,155128,76830,61442,45601,29989,20894,19029,253785,507233,821625,821625
Comoros,2022,KM,COM,AFR,57823,103402,161225,77912,63295,46893,32850,21748,16433,259131,56374,100667,157041,77428,62614,47456,30844,21663,19369,259374,518505,836774,836774
Comoros,2023,KM,COM,AFR,58001,104988,162989,78394,64917,48662,33707,22720,16741,265141,56561,102206,158767,78086,63789,49246,31793,22407,19853,265174,530315,852075,852075
Comoros,2024,KM,COM,AFR,58146,106419,164565,79013,66364,50475,34711,23673,17239,271475,56712,103603,160315,78917,64979,50929,32850,23084,20483,271242,542717,867605,867605
Comoros,2025,KM,COM,AFR,58264,107656,165920,79823,67621,52325,35846,24562,17823,278000,56840,104812,161652,79979,66143,52487,34015,23681,21191,277496,555496,883075,883075
Comoros,2026,KM,COM,AFR,58365,108689,167054,80824,68706,54202,37092,25388,18486,284698,56951,105830,162781,81292,67210,53937,35302,24236,21961,283938,568636,898473,898473
Comoros,2027,KM,COM,AFR,58459,109575,168034,82038,69576,56104,38443,26152,19198,291511,57057,106707,163764,82854,68068,55293,36719,24788,22778,290500,582011,913809,913809
Comoros,2028,KM,COM,AFR,58551,110354,168905,83647,70027,58018,39870,26856,19965,298383,57156,107488,164644,84630,68670,56567,38279,25363,23624,297133,595516,929073,929073
Comoros,2029,KM,COM,AFR,58651,111016,169667,85497,70250,59932,41375,27516,20757,305327,57263,108169,165432,86447,69170,57779,39964,25992,24492,303844,609171,944275,944275
Comoros,2030,KM,COM,AFR,58757,111583,170340,87281,70560,61820,42940,28153,21573,312327,57375,108762,166137,88175,69686,58947,41746,26687,25367,310608,622935,959412,959412
Comoros,1950,KM,COM,AFR,12094,18970,31064,15368,12304,9360,5902,3687,2831,49452,11703,18698,30401,15433,12434,9485,6186,4041,3323,50902,100354,161814,161814
Comoros,1951,KM,COM,AFR,12509,19175,31684,15721,12581,9614,6124,3756,2868,50664,12155,18853,31008,15668,12610,9698,6369,4098,3341,51784,102448,165143,165143
Comoros,1952,KM,COM,AFR,13003,19350,32353,16012,12787,9822,6342,3821,2889,51673,12698,18985,31683,15867,12757,9885,6562,4161,3359,52591,104264,168297,168297
Comoros,1953,KM,COM,AFR,13655,19517,33172,16244,12931,9993,6557,3895,2922,52542,13410,19104,32514,16040,12884,10054,6768,4241,3390,53377,105919,171607,171607
Comoros,1954,KM,COM,AFR,14368,19715,34083,16408,13010,10127,6759,3967,2948,53219,14188,19234,33422,16178,12981,10199,6976,4325,3422,54081,107300,174805,174805
Comoros,1955,KM,COM,AFR,15005,20065,35070,16515,13026,10217,6948,4041,2973,53720,14857,19545,34402,16289,13053,10319,7175,4410,3453,54699,108419,177885,177885
Comoros,1956,KM,COM,AFR,15559,20556,36115,16582,12985,10269,7120,4114,2990,54060,15400,20036,35436,16375,13103,10415,7370,4498,3492,55253,109313,180863,180863
Comoros,1957,KM,COM,AFR,16080,21144,37224,16689,12963,10321,7290,4192,3014,54469,15911,20618,36529,16486,13163,10499,7567,4592,3529,55836,110305,184065,184065
Comoros,1958,KM,COM,AFR,16564,21838,38402,16864,12999,10388,7459,4284,3041,55035,16379,21306,37685,16636,13254,10589,7764,4702,3575,56520,111555,187640,187640
Comoros,1959,KM,COM,AFR,17033,22491,39524,16977,13155,10478,7631,4414,3091,55746,16818,21975,38793,16820,13360,10623,7926,4823,3623,57175,112921,191246,191246
Comoros,1960,KM,COM,AFR,17489,23121,40610,16991,13434,10595,7802,4574,3163,56559,17232,22636,39868,17014,13494,10604,8053,4951,3688,57804,114363,194852,194852
Comoros,1961,KM,COM,AFR,17920,23885,41805,16943,13730,10718,7962,4747,3240,57340,17635,23400,41035,17166,13659,10585,8171,5089,3761,58431,115771,198617,198617
Comoros,1962,KM,COM,AFR,18335,24771,43106,16844,14037,10849,8109,4931,3323,58093,18034,24266,42300,17268,13855,10568,8265,5237,3833,59026,117119,202527,202527
Comoros,1963,KM,COM,AFR,18735,25786,44521,16679,14344,10988,8245,5112,3405,58773,18424,25252,43676,17301,14071,10556,8345,5388,3908,59569,118342,206546,206546
Comoros,1964,KM,COM,AFR,19122,26878,46000,16510,14633,11140,8372,5292,3497,59444,18800,26313,45113,17310,14304,10558,8407,5540,3987,60106,119550,210665,210665
Comoros,1965,KM,COM,AFR,19497,27930,47427,16493,14887,11309,8494,5473,3590,60246,19167,27293,46460,17465,14542,10580,8450,5691,4078,60806,121052,214939,214939
Comoros,1966,KM,COM,AFR,19869,28931,48800,16629,15106,11494,8610,5645,3688,61172,19528,28192,47720,17771,14788,10629,8485,5839,4166,61678,122850,219369,219369
Comoros,1967,KM,COM,AFR,20240,30019,50259,16980,15251,11702,8722,5806,3782,62243,19904,29174,49078,18164,15050,10752,8529,5987,4256,62738,124981,224321,224321
Comoros,1968,KM,COM,AFR,20652,31141,51793,17556,15328,11967,8859,5974,3887,63571,20323,30219,50542,18691,15329,10956,8584,6141,4366,64067,127638,229971,229971
Comoros,1969,KM,COM,AFR,21130,32169,53299,18247,15380,12281,9022,6152,4037,65119,20781,31244,52025,19340,15600,11179,8630,6297,4514,65560,130679,236002,236002
Comoros,2031,KM,COM,AFR,58860,112046,170906,89011,70926,63663,44553,28802,22427,319382,57483,109258,166741,89842,70227,60114,43571,27445,26244,317443,636825,974457,974457
Comoros,2032,KM,COM,AFR,58982,112417,171399,90701,71345,65413,46207,29500,23293,326459,57612,109659,167271,91476,70804,61280,45381,28274,27114,324329,650788,989461,989461
Comoros,2033,KM,COM,AFR,59153,112726,171879,92297,71855,67018,47906,30296,24176,333548,57787,109994,167781,93029,71487,62465,47130,29179,27965,331255,664803,1004456,1004456
Comoros,2034,KM,COM,AFR,59344,113008,172352,93738,72499,68451,49647,31205,25067,340607,57980,110296,168276,94440,72336,63663,48769,30173,28793,338174,678781,1019412,1019412
Comoros,2035,KM,COM,AFR,59552,113269,172821,94981,73325,69706,51419,32235,25972,347638,58191,110582,168773,95666,73419,64831,50289,31265,29617,345087,692725,1034321,1034321
Comoros,2036,KM,COM,AFR,59763,113507,173270,96031,74338,70788,53227,33366,26868,354618,58407,110839,169246,96702,74741,65906,51708,32471,30452,351980,706598,1049114,1049114
Comoros,2037,KM,COM,AFR,59939,113757,173696,96933,75564,71662,55058,34582,27749,361548,58591,111113,169704,97597,76314,66779,53033,33795,31317,358835,720383,1063780,1063780
Comoros,2038,KM,COM,AFR,60090,114055,174145,97723,77172,72130,56898,35870,28609,368402,58750,111424,170174,98397,78101,67396,54287,35251,32229,365661,734063,1078375,1078375
Comoros,2039,KM,COM,AFR,60251,114378,174629,98407,79015,72373,58733,37209,29446,375183,58918,111760,170678,99097,79919,67912,55479,36831,33197,372435,747618,1092920,1092920
Comoros,2040,KM,COM,AFR,60421,114723,175144,98985,80793,72699,60545,38599,30275,381896,59091,112121,171212,99704,81650,68448,56642,38501,34221,379166,761062,1107417,1107417
Comoros,2041,KM,COM,AFR,60620,115065,175685,99465,82517,73084,62310,40029,31129,388534,59291,112480,171771,100219,83324,69004,57798,40209,35301,385855,774389,1121845,1121845
Comoros,2042,KM,COM,AFR,60840,115394,176234,99855,84200,73517,63991,41500,32027,395090,59513,112828,172341,100639,84961,69605,58958,41904,36427,392494,787584,1136167,1136167
Comoros,2043,KM,COM,AFR,61050,115744,176794,100186,85793,74041,65535,43011,33015,401581,59726,113192,172918,100992,86520,70301,60130,43538,37602,399083,800664,1150372,1150372
Comoros,2044,KM,COM,AFR,61248,116124,177372,100481,87230,74696,66916,44569,34093,407985,59928,113581,173509,101310,87939,71168,61318,45069,38828,405632,813617,1164502,1164502
Comoros,2045,KM,COM,AFR,61437,116527,177964,100759,88480,75531,68132,46166,35258,414326,60117,113995,174112,101611,89177,72260,62476,46488,40121,412133,826459,1178543,1178543
Comoros,2046,KM,COM,AFR,61605,116963,178568,101017,89537,76551,69189,47793,36489,420576,60285,114442,174727,101890,90227,73585,63539,47815,41522,418578,839154,1192453,1192453
Comoros,2047,KM,COM,AFR,61759,117382,179141,101285,90449,77773,70046,49440,37777,426770,60438,114874,175312,102181,91138,75159,64410,49059,43038,424985,851755,1206213,1206213
Comoros,2048,KM,COM,AFR,61880,117769,179649,101597,91249,79370,70515,51102,39089,432922,60557,115275,175832,102513,91954,76937,65034,50246,44700,431384,864306,1219782,1219782
Comoros,2049,KM,COM,AFR,61919,118157,180076,101938,91948,81195,70770,52753,40418,439022,60599,115672,176271,102864,92668,78755,65557,51386,46506,437736,876758,1233111,1233111
Comoros,2050,KM,COM,AFR,61896,118537,180433,102301,92543,82953,71111,54379,41764,445051,60578,116061,176639,103238,93294,80484,66112,52505,48448,444081,889132,1246207,1246207
Cabo Verde,1970,CV,CPV,AFR,25087,41417,66504,26630,14602,11067,8936,7385,5616,74236,24538,40420,64958,26669,15918,12786,9974,8377,7844,81568,155804,287262,287262
Cabo Verde,1971,CV,CPV,AFR,25661,42041,67702,27869,14919,11065,8945,7349,5881,76028,25165,41102,66267,27932,16247,12911,10072,8343,8002,83507,159535,293505,293505
Cabo Verde,1972,CV,CPV,AFR,26125,42229,68354,28526,14843,10844,8867,7261,6102,76443,25729,41482,67211,28851,16413,12923,10159,8296,8164,84806,161249,296818,296818
Cabo Verde,1973,CV,CPV,AFR,26571,42230,68801,29034,14652,10529,8759,7154,6306,76434,26270,41716,67986,29705,16558,12879,10254,8251,8326,85973,162407,299191,299191
Cabo Verde,1974,CV,CPV,AFR,27043,42184,69227,29608,14513,10186,8647,7047,6486,76487,26804,41909,68713,30613,16776,12803,10362,8211,8484,87249,163736,301682,301682
Cabo Verde,1975,CV,CPV,AFR,27438,42611,70049,29794,14414,9867,8538,6951,6659,76223,27148,42589,69737,31205,17086,12754,10502,8187,8623,88357,164580,304375,304375
Cabo Verde,1976,CV,CPV,AFR,27634,43545,71179,29658,14283,9567,8434,6852,6817,75611,27206,43716,70922,31555,17422,12738,10656,8174,8765,89310,164921,307015,307015
Cabo Verde,1977,CV,CPV,AFR,27694,44453,72147,29723,14069,9211,8316,6753,6950,75022,27151,44688,71839,32098,17716,12689,10821,8173,8887,90384,165406,309389,309389
Cabo Verde,1978,CV,CPV,AFR,27775,45196,72971,30063,13797,8791,8170,6653,7075,74549,27151,45383,72534,32875,17979,12612,10979,8193,8993,91631,166180,311685,311685
Cabo Verde,1979,CV,CPV,AFR,27956,45698,73654,30698,13503,8299,7990,6553,7177,74220,27299,45762,73061,33875,18249,12493,11121,8234,9091,93063,167283,313995,313995
Cabo Verde,1980,CV,CPV,AFR,28407,45984,74391,31449,13538,7850,7807,6479,7284,74407,27781,45984,73765,34833,18739,12393,11227,8300,9173,94665,169072,317234,317234
Cabo Verde,1981,CV,CPV,AFR,29135,46238,75373,32216,14033,7569,7751,6523,7385,75477,28508,46140,74648,35470,19374,12250,11361,8420,9254,96129,171606,321634,321634
Cabo Verde,1982,CV,CPV,AFR,29886,46608,76494,33006,14708,7383,7782,6658,7480,77017,29190,46293,75483,35895,19972,12042,11515,8602,9301,97327,174344,326319,326319
Cabo Verde,1983,CV,CPV,AFR,30528,47117,77645,33698,15441,7233,7769,6813,7538,78492,29774,46602,76376,36209,20616,11865,11612,8820,9340,98462,176954,330971,330971
Cabo Verde,1984,CV,CPV,AFR,31037,47765,78802,34268,16201,7126,7718,6973,7572,79858,30243,47081,77324,36397,21268,11736,11650,9068,9368,99487,179345,335473,335473
Cabo Verde,1985,CV,CPV,AFR,31422,48572,79994,34731,16959,7082,7624,7146,7600,81142,30590,47742,78332,36471,21900,11670,11620,9342,9402,100405,181547,339874,339874
Cabo Verde,1986,CV,CPV,AFR,31714,49514,81228,35081,17732,7113,7488,7333,7631,82378,30863,48549,79412,36445,22523,11685,11526,9634,9447,101260,183638,344271,344271
Cabo Verde,1987,CV,CPV,AFR,31972,50523,82495,35307,18550,7224,7322,7513,7676,83592,31128,49416,80544,36307,23163,11781,11384,9939,9517,102091,185683,348718,348718
Cabo Verde,1988,CV,CPV,AFR,32224,51556,83780,35410,19423,7424,7136,7678,7728,84799,31391,50321,81712,36089,23818,11961,11199,10243,9623,102933,187732,353233,353233
Cabo Verde,1989,CV,CPV,AFR,32463,52657,85120,35493,20379,7739,6929,7815,7792,86147,31635,51316,82951,35899,24510,12261,10979,10526,9758,103933,190080,358150,358150
Cabo Verde,1990,CV,CPV,AFR,32760,54101,86861,35895,21421,8166,6607,7835,7842,87766,31947,52687,84634,36030,25245,12734,10647,10736,9905,105297,193063,364563,364563
Cabo Verde,1991,CV,CPV,AFR,33097,55823,88920,36765,22518,8745,6209,7751,7896,89884,32298,54365,86663,36628,26018,13410,10253,10864,10082,107255,197139,372721,372721
Cabo Verde,1992,CV,CPV,AFR,33389,57479,90868,37952,23704,9513,5879,7627,7968,92643,32595,55993,88588,37581,26857,14252,9931,10933,10287,109841,202484,381947,381947
Cabo Verde,1993,CV,CPV,AFR,33627,58994,92621,39394,24932,10419,5630,7459,8061,95895,32831,57492,90323,38835,27713,15207,9688,10938,10523,112904,208799,391749,391749
Cabo Verde,1994,CV,CPV,AFR,33784,60316,94100,41050,26141,11417,5461,7249,8148,99466,32988,58811,91799,40333,28538,16229,9544,10866,10780,116290,215756,401655,401655
Cabo Verde,1995,CV,CPV,AFR,33830,61439,95269,42863,27316,12465,5393,6987,8219,103243,33034,59926,92960,42027,29328,17265,9517,10719,11057,119913,223156,411382,411382
Cabo Verde,1996,CV,CPV,AFR,33777,62403,96180,44782,28452,13571,5434,6685,8288,107212,32978,60894,93872,43844,30085,18320,9623,10508,11363,123743,230955,421007,421007
Cabo Verde,1997,CV,CPV,AFR,33644,63271,96915,46733,29534,14775,5594,6368,8357,111361,32840,61792,94632,45697,30803,19435,9868,10250,11693,127746,239107,430654,430654
Cabo Verde,1998,CV,CPV,AFR,33432,64069,97501,48661,30546,16078,5876,6039,8407,115607,32620,62614,95234,47542,31490,20594,10252,9957,12041,131876,247483,440214,440214
Cabo Verde,1999,CV,CPV,AFR,33195,64751,97946,50539,31502,17451,6279,5706,8445,119922,32368,63321,95689,49362,32159,21763,10766,9647,12375,136072,255994,449627,449627
Cabo Verde,2000,CV,CPV,AFR,32786,65121,97907,52119,32461,18981,6937,5482,8641,124621,31934,63629,95563,50672,32758,22952,11480,9398,12909,140169,264790,458251,458251
Cabo Verde,2001,CV,CPV,AFR,32155,65155,97310,53396,33458,20587,7864,5373,9019,129697,31275,63558,94833,51476,33290,24087,12395,9208,13669,144125,273822,465958,465958
Cabo Verde,2002,CV,CPV,AFR,31432,65002,96434,54598,34484,22088,8925,5293,9437,134825,30545,63359,93904,52213,33836,25088,13455,9016,14453,148061,282886,473231,473231
Cabo Verde,2003,CV,CPV,AFR,30630,64672,95302,55686,35568,23488,10109,5266,9889,140006,29777,63011,92788,52865,34421,25962,14625,8845,15275,151993,291999,480089,480089
Cabo Verde,2004,CV,CPV,AFR,29807,64160,93967,56651,36726,24747,11399,5316,10348,145187,28994,62524,91518,53463,35051,26697,15864,8751,16082,155908,301095,486583,486583
Cabo Verde,2005,CV,CPV,AFR,29047,63441,92488,57534,37937,25855,12785,5473,10799,150383,28272,61862,90134,54067,35694,27279,17141,8778,16864,159823,310206,492827,492827
Cabo Verde,2006,CV,CPV,AFR,28463,62449,90912,58360,39194,26771,14250,5762,11248,155585,27725,60941,88666,54728,36333,27670,18421,8971,17601,163724,319309,498884,498884
Cabo Verde,2007,CV,CPV,AFR,28099,61139,89238,59142,40491,27481,15778,6189,11683,160764,27377,59706,87083,55484,36983,27872,19667,9355,18294,167655,328419,504733,504733
Cabo Verde,2008,CV,CPV,AFR,27884,59610,87494,59855,41805,28039,17316,6752,12107,165874,27159,58218,85377,56302,37649,27919,20837,9934,18945,171586,337460,510336,510336
Cabo Verde,2009,CV,CPV,AFR,27702,58008,85710,60447,43130,28497,18829,7441,12541,170885,26971,56590,83561,57139,38330,27848,21919,10703,19531,175470,346355,515638,515638
Cabo Verde,2010,CV,CPV,AFR,27613,56817,84430,60868,44655,28954,20120,8122,12447,175166,26876,55323,82199,57967,39484,27860,22858,11578,19676,179423,354589,521212,521212
Cabo Verde,2011,CV,CPV,AFR,27665,56156,83821,61072,46379,29503,21165,8792,11883,178794,26906,54607,81513,58603,41138,28053,23640,12531,19425,183390,362184,527521,527521
Cabo Verde,2012,CV,CPV,AFR,27592,55641,83233,61069,48066,30219,22105,9597,11437,182493,26820,54132,80952,58897,42823,28388,24320,13586,19169,187183,369676,533864,533864
Cabo Verde,2013,CV,CPV,AFR,27351,55169,82520,60909,49664,31134,22927,10507,11062,186203,26580,53747,80327,58954,44481,28912,24899,14695,18956,190897,377100,539940,539940
Cabo Verde,2014,CV,CPV,AFR,27148,54698,81846,60595,51159,32232,23642,11491,10740,189859,26383,53333,79716,58836,46130,29623,25392,15816,18853,194650,384509,546076,546076
Cabo Verde,2015,CV,CPV,AFR,26930,54349,81279,60102,52563,33491,24248,12528,10468,193400,26172,53006,79178,58518,47784,30504,25773,16934,18802,198315,391715,552166,552166
Cabo Verde,2016,CV,CPV,AFR,26638,54302,80940,59352,53856,34925,24755,13602,10306,196796,25881,52961,78842,57913,49411,31573,26027,18017,18871,201812,398608,558394,558394
Cabo Verde,2017,CV,CPV,AFR,26494,54339,80833,58364,55033,36532,25202,14697,10324,200152,25733,52976,78709,57025,50996,32849,26195,19036,19160,205261,405413,564954,564954
Cabo Verde,2018,CV,CPV,AFR,26411,54254,80665,57293,56063,38239,25641,15761,10425,203422,25645,52857,78502,55981,52488,34283,26338,19973,19554,208617,412039,571202,571202
Cabo Verde,2019,CV,CPV,AFR,26188,54139,80327,56273,56903,39984,26109,16792,10583,206644,25428,52711,78139,54907,53848,35814,26480,20859,20011,211919,418563,577030,577030
Cabo Verde,2020,CV,CPV,AFR,25922,53962,79884,55428,57512,41761,26617,17768,10772,209858,25164,52515,77679,53958,54965,37441,26646,21699,20509,215218,425076,582640,582640
Cabo Verde,2021,CV,CPV,AFR,25600,53746,79346,54821,57837,43531,27185,18640,10989,213003,24846,52275,77121,53287,55698,39156,26868,22451,20999,218459,431462,587925,587925
Cabo Verde,2022,CV,CPV,AFR,25206,53548,78754,54349,57926,45241,27890,19416,11331,216153,24462,52064,76526,52847,56074,40885,27221,23094,21594,221715,437868,593149,593149
Cabo Verde,2023,CV,CPV,AFR,24917,53244,78161,53908,57845,46867,28801,20147,11919,219487,24177,51753,75930,52486,56199,42575,27770,23665,22405,225100,444587,598682,598682
Cabo Verde,2024,CV,CPV,AFR,24749,52840,77589,53462,57614,48407,29902,20838,12698,222921,24014,51353,75367,52101,56151,44263,28501,24164,23398,228578,451499,604461,604461
Cabo Verde,2025,CV,CPV,AFR,24589,52374,76963,53143,57206,49851,31157,21450,13586,226393,23858,50894,74752,51809,55907,45949,29398,24561,24477,232101,458494,610209,610209
Cabo Verde,2026,CV,CPV,AFR,24424,51772,76196,53135,56546,51180,32575,21972,14587,229995,23696,50299,73995,51801,55376,47616,30477,24834,25659,235763,465758,615948,615948
Cabo Verde,2027,CV,CPV,AFR,24270,51253,75523,53212,55647,52394,34148,22439,15672,233512,23542,49783,73325,51858,54565,49229,31758,25020,26931,239361,472873,621716,621716
Cabo Verde,2028,CV,CPV,AFR,24134,50894,75028,53166,54667,53457,35824,22907,16810,236831,23410,49425,72835,51784,53601,50756,33193,25176,28258,242768,479599,627467,627467
Cabo Verde,2029,CV,CPV,AFR,24003,50528,74531,53095,53743,54344,37550,23406,17996,240134,23280,49058,72338,51687,52610,52157,34727,25343,29649,246173,486307,633178,633178
Cabo Verde,2030,CV,CPV,AFR,23879,50119,73998,52967,52991,54999,39305,23946,19226,243434,23158,48658,71816,51539,51755,53316,36361,25539,31092,249602,493036,638840,638840
Cabo Verde,1950,CV,CPV,AFR,16820,23974,40794,16003,10792,8335,5522,2754,1992,45398,16528,24443,40971,17590,12393,9891,7757,5405,4797,57833,103231,184999,184999
Cabo Verde,1951,CV,CPV,AFR,17115,24290,41405,15805,10821,8403,5885,3002,2006,45922,16835,24668,41503,17557,12484,9878,8002,5666,4836,58423,104345,187255,187255
Cabo Verde,1952,CV,CPV,AFR,17404,24702,42106,15499,10848,8438,6236,3265,2037,46323,17126,24997,42123,17406,12599,9843,8237,5922,4908,58915,105238,189468,189468
Cabo Verde,1953,CV,CPV,AFR,17601,25239,42840,15084,10864,8443,6578,3550,2084,46603,17327,25454,42781,17137,12715,9786,8462,6192,5010,59302,105905,191523,191523
Cabo Verde,1954,CV,CPV,AFR,17667,25947,43614,14580,10853,8427,6903,3860,2148,46771,17411,26078,43489,16769,12830,9713,8672,6469,5141,59594,106365,193466,193466
Cabo Verde,1955,CV,CPV,AFR,17688,26212,43900,14527,10981,8452,7168,4122,2210,47460,17413,26281,43694,16761,13051,9714,8845,6688,5271,60330,107790,195389,195389
Cabo Verde,1956,CV,CPV,AFR,17888,25819,43707,14980,11261,8535,7371,4341,2283,48771,17556,25848,43404,17168,13385,9799,8977,6855,5390,61574,110345,197459,197459
Cabo Verde,1957,CV,CPV,AFR,18417,25263,43680,15400,11559,8625,7552,4568,2368,50072,18045,25235,43280,17534,13757,9886,9097,7022,5541,62837,112909,199860,199860
Cabo Verde,1958,CV,CPV,AFR,19261,24738,43999,15678,11877,8718,7704,4808,2465,51250,18874,24626,43500,17752,14167,9977,9190,7192,5698,63976,115226,202736,202736
Cabo Verde,1959,CV,CPV,AFR,20342,24435,44777,15723,12213,8820,7830,5064,2575,52225,19984,24223,44207,17727,14620,10082,9266,7367,5878,64940,117165,206150,206150
Cabo Verde,1960,CV,CPV,AFR,21134,24913,46047,15520,12432,8908,7927,5338,2700,52825,20820,24617,45437,17450,14982,10177,9315,7556,6065,65545,118370,209849,209849
Cabo Verde,1961,CV,CPV,AFR,21537,26378,47915,15524,12615,9004,7946,5571,2830,53490,21236,26017,47253,17286,15303,10325,9294,7693,6228,66129,119619,214788,214788
Cabo Verde,1962,CV,CPV,AFR,21870,28344,50214,16000,12837,9164,7945,5797,3008,54751,21552,27905,49457,17507,15574,10555,9255,7794,6382,67067,121818,221484,221484
Cabo Verde,1963,CV,CPV,AFR,22071,30485,52556,16710,13000,9371,7994,6054,3247,56376,21706,29985,51691,17965,15694,10818,9258,7906,6551,68192,124568,228814,228814
Cabo Verde,1964,CV,CPV,AFR,22123,32708,54831,17581,13146,9596,8059,6298,3509,58189,21705,32157,53862,18601,15759,11106,9273,8009,6721,69469,127658,236362,236362
Cabo Verde,1965,CV,CPV,AFR,22353,34642,56995,18667,13291,9843,8146,6520,3805,60272,21896,34032,55928,19465,15777,11417,9310,8101,6900,70970,131242,244156,244156
Cabo Verde,1966,CV,CPV,AFR,22832,36203,59035,19971,13445,10104,8259,6732,4137,62648,22348,35515,57863,20573,15756,11730,9377,8181,7081,72698,135346,252238,252238
Cabo Verde,1967,CV,CPV,AFR,23331,37677,61008,21451,13624,10373,8403,6929,4495,65275,22829,36904,59733,21881,15711,12046,9478,8249,7267,74632,139907,260648,260648
Cabo Verde,1968,CV,CPV,AFR,23865,39064,62929,23095,13849,10635,8578,7117,4872,68146,23342,38207,61549,23380,15675,12335,9627,8311,7459,76787,144933,269408,269408
Cabo Verde,1969,CV,CPV,AFR,24454,40347,64801,24884,14147,10877,8787,7294,5270,71259,23905,39409,63314,25042,15684,12580,9817,8363,7662,79148,150407,278524,278524
Cabo Verde,2031,CV,CPV,AFR,23752,49644,73396,52797,52479,55381,41065,24561,20483,246766,23033,48191,71224,51351,51183,54100,38083,25791,32547,253055,499821,644431,644431
Cabo Verde,2032,CV,CPV,AFR,23614,49115,72729,52647,52112,55541,42774,25303,21737,250114,22896,47669,70565,51181,50843,54533,39824,26173,33995,256549,506663,649957,649957
Cabo Verde,2033,CV,CPV,AFR,23472,48707,72179,52388,51778,55542,44401,26225,22978,253312,22759,47266,70025,50917,50587,54726,41530,26735,35403,259898,513210,655419,655419
Cabo Verde,2034,CV,CPV,AFR,23326,48426,71752,52028,51441,55401,45939,27299,24218,256326,22613,46990,69603,50564,50307,54744,43228,27474,36778,263095,519421,660774,660774
Cabo Verde,2035,CV,CPV,AFR,23180,48157,71337,51603,51230,55083,47387,28518,25446,259267,22466,46726,69192,50147,50115,54566,44925,28372,38103,266228,525495,666035,666035
Cabo Verde,2036,CV,CPV,AFR,23033,47882,70915,51045,51314,54520,48733,29893,26655,262160,22322,46454,68776,49593,50196,54103,46600,29450,39380,269322,531482,671179,671179
Cabo Verde,2037,CV,CPV,AFR,22872,47604,70476,50563,51481,53716,49963,31415,27867,265005,22167,46178,68345,49112,50338,53352,48226,30717,40614,272359,537364,676185,676185
Cabo Verde,2038,CV,CPV,AFR,22699,47341,70040,50239,51517,52822,51050,33031,29099,267758,21995,45922,67917,48791,50341,52448,49762,32139,41848,275329,543087,681044,681044
Cabo Verde,2039,CV,CPV,AFR,22512,47077,69589,49903,51524,51988,51967,34695,30375,270452,21813,45657,67470,48457,50318,51516,51176,33657,43102,278226,548678,685740,685740
Cabo Verde,2040,CV,CPV,AFR,22317,46818,69135,49528,51469,51320,52660,36393,31702,273072,21626,45398,67024,48086,50240,50718,52343,35270,44402,281059,554131,690288,690288
Cabo Verde,2041,CV,CPV,AFR,22135,46556,68691,49084,51372,50881,53086,38094,33091,275608,21447,45143,66590,47648,50117,50194,53145,36972,45733,283809,559417,694697,694697
Cabo Verde,2042,CV,CPV,AFR,21963,46272,68235,48584,51293,50583,53301,39754,34576,278091,21278,44859,66137,47158,50015,49901,53601,38687,47139,286501,564592,698960,698960
Cabo Verde,2043,CV,CPV,AFR,21802,45968,67770,48202,51099,50318,53361,41338,36188,280506,21124,44556,65680,46783,49810,49690,53812,40376,48654,289125,569631,703079,703079
Cabo Verde,2044,CV,CPV,AFR,21672,45642,67314,47949,50803,50047,53283,42844,37918,282844,20996,44243,65239,46531,49512,49449,53852,42053,50265,291662,574506,707058,707058
Cabo Verde,2045,CV,CPV,AFR,21545,45312,66857,47704,50440,49893,53033,44270,39763,285103,20870,43919,64789,46290,49151,49295,53703,43732,51949,294120,579223,710870,710870
Cabo Verde,2046,CV,CPV,AFR,21408,44993,66401,47456,49939,50031,52538,45603,41716,287283,20737,43602,64339,46045,48651,49415,53265,45391,53736,296503,583786,714525,714525
Cabo Verde,2047,CV,CPV,AFR,21278,44669,65947,47200,49516,50242,51815,46828,43793,289394,20608,43290,63898,45791,48224,49586,52544,47000,55651,298796,588190,718032,718032
Cabo Verde,2048,CV,CPV,AFR,21140,44342,65482,46958,49244,50324,51004,47920,45966,291416,20475,42970,63445,45551,47945,49622,51674,48522,57697,301011,592427,721360,721360
Cabo Verde,2049,CV,CPV,AFR,20985,44033,65018,46704,48953,50373,50246,48851,48223,293350,20324,42666,62990,45305,47656,49629,50773,49925,59849,303137,596487,724501,724501
Cabo Verde,2050,CV,CPV,AFR,20825,43718,64543,46462,48620,50360,49646,49573,50554,295215,20169,42359,62528,45062,47318,49577,50003,51091,62125,305176,600391,727457,727457
Costa Rica,1970,CR,CRI,AMR,145833,268035,413868,182757,119999,87395,60712,42076,30446,523385,141805,260735,402540,178204,118380,88350,59602,40364,31013,515913,1039298,1855697,1855697
Costa Rica,1971,CR,CRI,AMR,144600,274357,418957,190578,124558,90011,62745,43279,31846,543017,140723,266973,407696,186045,122704,90975,61974,41661,32456,535815,1078832,1905486,1905486
Costa Rica,1972,CR,CRI,AMR,143646,279495,423141,198596,129593,92749,65021,44440,33321,563720,139811,272125,411936,194097,127510,93638,64610,42917,33989,556761,1120481,1955547,1955547
Costa Rica,1973,CR,CRI,AMR,143452,283056,426508,206843,135165,95609,67479,45596,34899,585591,139546,275770,415316,202374,132862,96350,67438,44174,35640,578838,1164429,2006247,2006247
Costa Rica,1974,CR,CRI,AMR,144136,285290,429426,215307,141326,98558,69996,46799,36569,608555,140046,278154,418200,210838,138840,99119,70310,45512,37437,602056,1210611,2058235,2058235
Costa Rica,1975,CR,CRI,AMR,145587,286636,432223,224264,147695,101610,72494,48090,38310,632463,141201,279695,420896,219655,145153,101985,73147,46982,39338,626260,1258723,2111850,2111850
Costa Rica,1976,CR,CRI,AMR,148051,287154,435205,233594,154193,104850,75019,49477,40178,657311,143286,280396,423682,228735,151693,105020,75967,48562,41368,651345,1308656,2167544,2167544
Costa Rica,1977,CR,CRI,AMR,151578,287107,438685,242761,161113,108333,77554,50939,42176,682876,146387,280468,426855,237666,158671,108291,78770,50244,43568,677210,1360086,2225630,2225630
Costa Rica,1978,CR,CRI,AMR,156075,286842,442917,251564,168421,112079,80123,52517,44290,708994,150421,280219,430640,246244,166049,111807,81562,52072,45933,703667,1412661,2286210,2286210
Costa Rica,1979,CR,CRI,AMR,161373,286850,448223,259791,176033,116093,82745,54260,46402,735324,155209,280138,435347,254285,173744,115592,84336,54097,48309,730363,1465687,2349258,2349258
Costa Rica,1980,CR,CRI,AMR,167072,287547,454619,267226,183856,120446,85417,56166,48460,761571,160387,280616,441003,261598,181682,119732,87095,56319,50689,757115,1518686,2414303,2414303
Costa Rica,1981,CR,CRI,AMR,172841,289277,462118,273699,191846,125214,88185,58287,50603,787834,165644,281965,447609,268003,189800,124283,89856,58751,53076,783769,1571603,2481334,2481334
Costa Rica,1982,CR,CRI,AMR,178649,292316,470965,279012,200027,130431,91079,60654,52875,814078,170963,284460,455423,273308,198110,129284,92649,61437,55523,810311,1624389,2550780,2550780
Costa Rica,1983,CR,CRI,AMR,184475,297046,481521,282735,208425,136138,94081,63191,55218,839788,176334,288498,464832,277103,206612,134802,95485,64307,58084,836393,1676181,2622532,2622532
Costa Rica,1984,CR,CRI,AMR,190145,303410,493555,285112,217009,142385,97146,65751,57612,865015,181580,294024,475604,279606,215243,140902,98353,67198,60722,862024,1727039,2696200,2696200
Costa Rica,1985,CR,CRI,AMR,195786,310889,506675,286567,226024,148774,100277,68275,60000,889917,186791,300564,487355,281238,224178,147294,101289,70036,63483,887518,1777435,2771463,2771463
Costa Rica,1986,CR,CRI,AMR,201220,319388,520608,287160,235358,155230,103561,70793,62459,914561,191807,308075,499882,282009,233316,153870,104373,72849,66380,912797,1827358,2847849,2847849
Costa Rica,1987,CR,CRI,AMR,205840,328938,534778,287179,244495,162062,107065,73319,65051,939171,196054,316629,512683,282120,242262,160835,107666,75636,69443,937962,1877133,2924595,2924595
Costa Rica,1988,CR,CRI,AMR,209410,339428,548838,286982,253267,169234,110804,75871,67770,963928,199306,326145,525451,281921,250846,168173,111191,78404,72694,963229,1927157,3001461,3001461
Costa Rica,1989,CR,CRI,AMR,211827,350560,562387,287188,261619,176755,114823,78479,70598,989462,201506,336305,537811,282043,259042,175882,115013,81175,76185,989340,1978802,3079001,3079001
Costa Rica,1990,CR,CRI,AMR,213116,362085,575201,288380,269524,184652,119245,81180,73572,1016553,202670,346859,549529,283038,266858,183981,119241,83972,79884,1016974,2033527,3158253,3158253
Costa Rica,1991,CR,CRI,AMR,213467,373516,586983,290943,276900,192923,124159,84005,76768,1045698,202972,357353,560325,285257,274213,192469,123951,86793,83723,1046406,2092104,3239414,3239414
Costa Rica,1992,CR,CRI,AMR,213167,384233,597400,295077,283539,201593,129578,86975,80105,1076867,202723,367204,569927,288916,280922,201357,129174,89663,87714,1077746,2154613,3321939,3321939
Costa Rica,1993,CR,CRI,AMR,212473,393975,606448,301025,288938,210675,135534,90063,83524,1109759,202164,376172,578336,294260,286485,210633,134975,92597,91879,1110829,2220588,3405372,3405372
Costa Rica,1994,CR,CRI,AMR,211538,402446,613984,308602,293262,220112,142065,93231,86970,1144242,201415,383989,585404,301107,291044,220223,141413,95593,96142,1145522,2289764,3489152,3489152
Costa Rica,1995,CR,CRI,AMR,210351,409743,620094,317264,296904,230167,148794,96475,90385,1179989,200459,390732,591191,308941,294986,230285,148216,98686,100472,1181586,2361575,3572856,3572856
Costa Rica,1996,CR,CRI,AMR,208931,415880,624811,326887,299879,240728,155646,99904,93874,1216918,199303,396400,595703,317684,298271,240734,155267,101948,104894,1218798,2435716,3656234,3656234
Costa Rica,1997,CR,CRI,AMR,207542,420549,628091,337464,302404,251271,162917,103570,97506,1255132,198143,400738,598881,327365,301042,251180,162780,105448,109506,1257321,2512453,3739421,3739421
Costa Rica,1998,CR,CRI,AMR,205998,423773,629771,348819,304697,261570,170544,107469,101198,1294297,196768,403777,600545,337833,303505,261395,170697,109195,114178,1296803,2591100,3821421,3821421
Costa Rica,1999,CR,CRI,AMR,204363,425569,629932,360511,307062,271357,178443,111607,105004,1333984,195215,405523,600738,348611,305949,271142,178931,113206,118940,1336779,2670763,3901430,3901430
Costa Rica,2000,CR,CRI,AMR,202908,425882,628790,372142,309714,280334,186526,116067,109033,1373816,193783,405929,599712,359297,308525,280148,187395,117563,123950,1376878,2750694,3979193,3979193
Costa Rica,2001,CR,CRI,AMR,201380,424896,626276,383215,312852,288245,194723,120891,113305,1413231,192245,405145,597390,369406,311392,288166,196030,122297,129037,1416328,2829559,4053222,4053222
Costa Rica,2002,CR,CRI,AMR,199128,423161,622289,393211,316718,294875,203077,126086,117829,1451796,189963,403675,593638,378472,314805,295019,204846,127442,134319,1454903,2906699,4122623,4122623
Costa Rica,2003,CR,CRI,AMR,196366,420785,617151,402059,321803,299904,211673,131707,122602,1489748,187273,401590,588863,386460,319270,300331,213891,133076,139822,1492850,2982598,4188610,4188610
Costa Rica,2004,CR,CRI,AMR,193507,418030,611537,409631,328143,303617,220540,137785,127527,1527243,184631,399079,583710,393284,324825,304359,223133,139272,145432,1530305,3057548,4252800,4252800
Costa Rica,2005,CR,CRI,AMR,190561,415188,605749,416088,335287,306428,229926,143975,132616,1564320,181945,396475,578420,399090,331041,307528,232733,145778,151232,1567402,3131722,4315887,4315887
Costa Rica,2006,CR,CRI,AMR,188136,412040,600176,421463,343151,308336,239698,150188,137819,1600655,179783,393568,573351,403902,337906,309802,242618,152485,157279,1603992,3204647,4378172,4378172
Costa Rica,2007,CR,CRI,AMR,187072,408204,595276,425452,351792,309576,249362,156683,143171,1636036,178944,389920,568864,407469,345530,311343,252408,159555,163534,1639839,3275875,4440019,4440019
Costa Rica,2008,CR,CRI,AMR,187567,403702,591269,428064,361147,310455,258732,163423,148726,1670547,179517,385642,565159,409809,353864,312420,261907,166958,169989,1674947,3345494,4501921,4501921
Costa Rica,2009,CR,CRI,AMR,188647,398999,587646,429319,370945,311426,267625,170373,154579,1704267,180551,381222,561773,410929,362620,313483,270954,174648,176808,1709442,3413709,4563127,4563127
Costa Rica,2010,CR,CRI,AMR,189399,394409,583808,429161,380961,312885,275813,177501,160891,1737212,181241,376900,558141,410780,371568,314856,279344,182560,183977,1743085,3480297,4622252,4622252
Costa Rica,2011,CR,CRI,AMR,189678,390308,579986,427787,390775,315139,283107,184820,167851,1769479,181477,373029,554506,409522,380327,316805,286897,190707,191699,1775957,3545436,4679926,4679926
Costa Rica,2012,CR,CRI,AMR,189396,386884,576280,425748,399846,318418,289306,192377,175421,1801116,181218,369788,551006,407659,388384,319580,293429,199100,200031,1808183,3609299,4736593,4736593
Costa Rica,2013,CR,CRI,AMR,188087,384545,572632,423130,407983,323066,294016,200224,183373,1831792,180015,367578,547593,405251,395594,323573,298512,207758,208827,1839515,3671307,4791535,4791535
Costa Rica,2014,CR,CRI,AMR,186269,382705,568974,420193,414947,329028,297433,208301,191377,1861279,178304,365893,544197,402494,401754,328730,302342,216598,217920,1869838,3731117,4844288,4844288
Costa Rica,2015,CR,CRI,AMR,184641,380466,565107,417228,420888,335819,299966,216860,199202,1889963,176787,363844,540631,399706,406982,334587,305333,225751,227181,1899540,3789503,4895242,4895242
Costa Rica,2016,CR,CRI,AMR,182904,378289,561193,414026,425855,343393,301680,225878,207261,1918093,175192,361871,537063,396679,411310,341133,307491,235233,237006,1928852,3846945,4945205,4945205
Costa Rica,2017,CR,CRI,AMR,180995,376917,557912,410177,429553,351787,302795,234889,215748,1944949,173400,360738,534138,392961,414489,348478,308945,244664,247315,1956852,3901801,4993842,4993842
Costa Rica,2018,CR,CRI,AMR,179065,376083,555148,405690,431968,360940,303589,243670,224462,1970319,171572,360084,531656,388639,416519,356582,309965,253846,258050,1983601,3953920,5040734,5040734
Costa Rica,2019,CR,CRI,AMR,176386,375335,551721,401023,433111,370590,304521,252028,233381,1994654,169077,359393,528470,384201,417428,365169,311013,262627,269251,2009689,4004343,5084532,5084532
Costa Rica,2020,CR,CRI,AMR,172439,374428,546867,396242,432647,380368,305970,259843,242685,2017755,165364,358523,523887,379697,416985,373939,312371,270796,280812,2034600,4052355,5123105,5123105
Costa Rica,2021,CR,CRI,AMR,167964,372913,540877,391718,430680,389735,308071,266590,251069,2037863,161084,357101,518185,375481,415303,382434,314198,277963,291654,2057033,4094896,5153957,5153957
Costa Rica,2022,CR,CRI,AMR,163483,370699,534182,388050,428198,398365,311083,271978,258857,2056531,156780,355023,511803,372078,413191,390279,316793,283963,302017,2078321,4134852,5180829,5180829
Costa Rica,2023,CR,CRI,AMR,159178,367470,526648,385737,425481,406292,315629,276237,269208,2078584,152635,351995,504630,369884,410729,397410,320726,288811,314751,2102311,4180895,5212173,5212173
Costa Rica,2024,CR,CRI,AMR,155753,362979,518732,384009,422587,413195,321614,279617,281871,2102893,149287,347795,497082,368235,407935,403539,325911,292678,329708,2128006,4230899,5246714,5246714
Costa Rica,2025,CR,CRI,AMR,153720,357432,511152,381869,419648,419076,328416,282245,295092,2126346,147265,342579,489844,366216,405079,408722,331788,295767,345293,2152865,4279211,5280199,5280199
Costa Rica,2026,CR,CRI,AMR,152611,351260,503871,379768,416442,423973,335934,284110,308783,2149010,146144,336744,482888,364251,401950,412973,338324,298032,361398,2176928,4325938,5312699,5312699
Costa Rica,2027,CR,CRI,AMR,151785,344887,496672,378451,412574,427578,344224,285436,322820,2171083,145301,330659,475960,363118,398105,416053,345626,299623,377894,2200419,4371502,5344137,5344137
Costa Rica,2028,CR,CRI,AMR,151136,338636,489772,377650,408063,429908,353239,286514,337026,2192400,144628,324668,469296,362435,393650,417975,353664,300800,394611,2223135,4415535,5374600,5374600
Costa Rica,2029,CR,CRI,AMR,150594,332508,483102,376905,403371,430971,362722,287769,351236,2212974,144067,318803,462870,361702,389070,418767,362166,302006,411369,2245080,4458054,5404011,5404011
Costa Rica,2030,CR,CRI,AMR,150043,326537,476580,376018,398804,430718,372476,289553,365266,2232835,143501,313072,456573,360811,384599,418382,370919,303548,427995,2266254,4499089,5432243,5432243
Costa Rica,1950,CR,CRI,AMR,87072,121615,208687,90046,65563,50638,34004,20567,13739,274557,83671,117956,201627,88758,62794,46877,31149,19648,14386,263612,538169,948487,948487
Costa Rica,1951,CR,CRI,AMR,90618,126056,216674,92372,67427,51793,35194,21151,14236,282173,87241,122114,209355,91111,65019,48099,32267,20119,14929,271544,553717,979749,979749
Costa Rica,1952,CR,CRI,AMR,94184,130969,225153,94833,69560,52884,36423,21787,14790,290277,90868,126737,217605,93506,67527,49273,33445,20627,15529,279907,570184,1012947,1012947
Costa Rica,1953,CR,CRI,AMR,97739,136427,234166,97423,71895,53945,37693,22488,15388,298832,94501,131888,226389,95952,70244,50433,34679,21192,16169,288669,587501,1048055,1048055
Costa Rica,1954,CR,CRI,AMR,101297,142498,243795,100108,74290,55051,39016,23275,16019,307759,98137,137644,235781,98455,73004,51664,35972,21837,16834,297766,605525,1085099,1085099
Costa Rica,1955,CR,CRI,AMR,105254,148769,254023,102899,76667,56236,40372,24136,16660,316970,102051,143719,245770,101054,75722,53024,37314,22580,17525,307219,624189,1123982,1123982
Costa Rica,1956,CR,CRI,AMR,109632,155149,264781,105880,79042,57490,41756,25069,17302,326539,106280,149989,256269,103810,78405,54482,38695,23392,18188,316972,643511,1164562,1164562
Costa Rica,1957,CR,CRI,AMR,114146,161955,276101,109100,81414,58792,43183,26070,17956,336515,110644,156679,267323,106783,81055,56023,40125,24284,18848,327118,663633,1207056,1207056
Costa Rica,1958,CR,CRI,AMR,118872,169147,288019,112563,83791,60192,44612,27124,18613,346895,115193,163763,278956,109992,83667,57705,41579,25257,19531,337731,684626,1251605,1251605
Costa Rica,1959,CR,CRI,AMR,123761,176659,300420,116294,86207,61783,45983,28220,19311,357798,119887,171157,291044,113467,86246,59596,42984,26285,20210,348788,706586,1298054,1298054
Costa Rica,1960,CR,CRI,AMR,128703,184393,313096,120383,88683,63581,47280,29354,20079,369360,124621,178788,303409,117293,88805,61711,44332,27365,20927,360433,729793,1346302,1346302
Costa Rica,1961,CR,CRI,AMR,133540,192273,325813,124893,91234,65595,48519,30530,20906,381677,129246,186600,315846,121530,91363,64069,45633,28504,21696,372795,754472,1396138,1396138
Costa Rica,1962,CR,CRI,AMR,138016,200312,338328,129837,93880,67847,49684,31722,21753,394723,133532,194583,328115,126208,93932,66685,46873,29683,22486,385867,780590,1447037,1447037
Costa Rica,1963,CR,CRI,AMR,141861,208545,350406,135299,96621,70270,50806,32943,22632,408571,137233,202755,339988,131400,96524,69478,48090,30899,23295,399686,808257,1498647,1498647
Costa Rica,1964,CR,CRI,AMR,144936,216944,361880,141345,99422,72723,51956,34197,23545,423188,140216,211078,351294,137181,99144,72295,49363,32168,24153,414304,837492,1550661,1550661
Costa Rica,1965,CR,CRI,AMR,147154,225812,372966,147564,102300,75144,53172,35471,24480,438131,142402,219742,362144,143251,101836,75058,50761,33478,25106,429490,867621,1602736,1602736
Costa Rica,1966,CR,CRI,AMR,148469,235026,383495,153875,105342,77563,54462,36782,25515,453539,143756,228652,372408,149510,104671,77784,52258,34831,26124,445178,898717,1654619,1654619
Costa Rica,1967,CR,CRI,AMR,148907,244053,392960,160598,108611,79984,55814,38147,26651,469805,144296,237389,381685,156169,107704,80470,53833,36228,27209,461613,931418,1706062,1706062
Costa Rica,1968,CR,CRI,AMR,148310,252687,400997,167698,112112,82410,57264,39523,27867,486874,143861,245761,389622,163213,110960,83114,55541,37641,28377,478846,965720,1756333,1756333
Costa Rica,1969,CR,CRI,AMR,147097,260747,407844,175108,115873,84874,58889,40840,29132,504716,142861,253603,396464,170580,114485,85732,57460,39028,29657,496942,1001658,1805968,1805968
Costa Rica,2031,CR,CRI,AMR,149451,320984,470435,374538,394724,429325,382079,292130,378959,2251755,142904,307703,450607,359385,380593,416964,379531,305671,444371,2286515,4538270,5459302,5459302
Costa Rica,2032,CR,CRI,AMR,148813,315696,464509,372314,391315,427314,390997,295695,392241,2269876,142262,302566,444828,357260,377209,414983,387493,308593,460342,2305880,4575756,5485099,5485099
Costa Rica,2033,CR,CRI,AMR,148069,310730,458799,369033,388974,424753,399023,300541,404867,2287191,141522,297732,439254,354150,374850,412474,394621,312699,475573,2324367,4611558,5509609,5509609
Costa Rica,2034,CR,CRI,AMR,147302,306748,454050,364477,387110,421863,405917,306620,417001,2302988,140762,293804,434566,349859,372999,409591,400710,317925,490230,2341314,4644302,5532923,5532923
Costa Rica,2035,CR,CRI,AMR,146526,304145,450671,358864,384834,418926,411809,313479,428903,2316815,139996,291201,431197,344554,370775,406647,405852,323823,504583,2356234,4673049,5554928,5554928
Costa Rica,2036,CR,CRI,AMR,145657,302428,448085,352631,382596,415720,416736,321017,440483,2329183,139146,289456,428602,338631,368611,403429,410080,330361,518502,2369614,4698797,5575485,5575485
Costa Rica,2037,CR,CRI,AMR,144754,300947,445701,346192,381134,411852,420403,329286,451809,2340676,138264,287949,426213,332453,367276,399499,413143,337644,531995,2382010,4722686,5594607,5594607
Costa Rica,2038,CR,CRI,AMR,143824,299536,443360,339876,380177,407343,422813,338247,463003,2351459,137361,286517,423878,326376,366392,394955,415061,345639,545154,2393577,4745036,5612274,5612274
Costa Rica,2039,CR,CRI,AMR,142752,298205,440957,333679,379280,402648,423976,347661,474303,2361547,136326,285173,421499,320417,365456,390290,415858,354088,558233,2404342,4765889,5628343,5628343
Costa Rica,2040,CR,CRI,AMR,141611,296858,438469,327635,378231,398068,423848,357333,485867,2370982,135223,283818,419041,314591,364352,385734,415492,362788,571394,2414351,4785333,5642847,5642847
Costa Rica,2041,CR,CRI,AMR,140424,295376,435800,322010,376590,393970,422603,366864,497778,2379815,134076,282345,416421,309124,362712,381631,414103,371344,584734,2423648,4803463,5655693,5655693
Costa Rica,2042,CR,CRI,AMR,139188,293816,433004,316646,374208,390534,420744,375732,510141,2388005,132893,280799,413692,303894,360381,378157,412154,379264,598368,2432218,4820223,5666916,5666916
Costa Rica,2043,CR,CRI,AMR,137986,292121,430107,311613,370769,388155,418336,383740,523007,2395620,131740,279131,410871,298973,357071,375697,409677,386366,612326,2440110,4835730,5676705,5676705
Costa Rica,2044,CR,CRI,AMR,136817,290258,427075,307570,366076,386255,415600,390664,536474,2402639,130614,277315,407929,294966,352585,373751,406832,392455,626724,2447313,4849952,5684960,5684960
Costa Rica,2045,CR,CRI,AMR,135642,288325,423967,304914,360338,383949,412816,396616,550369,2409002,129484,275428,404912,292282,347104,371441,403928,397621,641403,2453779,4862781,5691658,5691658
Costa Rica,2046,CR,CRI,AMR,134523,286250,420773,303144,353987,381680,409763,401630,564527,2414731,128409,273413,401822,290473,341016,369195,400753,401883,656225,2459545,4874276,5696869,5696869
Costa Rica,2047,CR,CRI,AMR,133420,284100,417520,301621,347448,380180,406051,405421,579080,2419801,127347,271335,398682,288915,334690,367777,396868,405007,671304,2464561,4884362,5700565,5700565
Costa Rica,2048,CR,CRI,AMR,132203,281956,414159,300170,341050,379193,401698,408002,594111,2424224,126183,269262,395445,287435,328482,366817,392381,407011,686733,2468859,4893083,5702694,5702694
Costa Rica,2049,CR,CRI,AMR,130945,279705,410650,298819,334793,378273,397166,409381,609647,2428079,124982,267092,392074,286060,322423,365816,387774,407922,702532,2472527,4900606,5703325,5703325
Costa Rica,2050,CR,CRI,AMR,129674,277384,407058,297454,328708,377215,392751,409525,625669,2431322,123770,264852,388622,284682,316513,364672,383278,407699,718667,2475511,4906833,5702525,5702525
Cuba,1970,CU,CUB,AMR,649040,1065400,1714440,767507,629407,483959,376234,300554,235637,2793298,620096,1024744,1644840,743236,615134,480066,373950,291789,212882,2717057,5510355,8869636,8869636
Cuba,1971,CU,CUB,AMR,646860,1097815,1744675,781120,636859,492909,380653,303809,245812,2841162,617033,1055844,1672877,757174,621774,488136,378416,297120,224375,2766995,5608157,9025709,9025709
Cuba,1972,CU,CUB,AMR,639984,1128906,1768890,793937,643398,500728,385887,308127,257910,2889987,609161,1085501,1694662,770896,627995,494974,382990,301819,237082,2815756,5705743,9169289,9169289
Cuba,1973,CU,CUB,AMR,626005,1159958,1785963,805739,650469,508514,391238,312216,270229,2938405,594808,1114431,1709239,783435,635276,501919,387732,305902,250047,2864311,5802716,9297924,9297924
Cuba,1974,CU,CUB,AMR,606067,1188852,1794919,817071,659270,516264,396356,316019,283151,2988131,575139,1140634,1715773,795279,644814,508892,392156,309555,263577,2914273,5902404,9413105,9413105
Cuba,1975,CU,CUB,AMR,580685,1212860,1793545,829880,669733,524110,401180,319465,296727,3041095,550495,1161635,1712130,808470,656405,515962,396203,312761,277737,2967538,6008633,9514305,9514305
Cuba,1976,CU,CUB,AMR,549526,1230566,1780092,847042,680157,532471,405787,322412,310825,3098694,520503,1176004,1696507,825903,668266,523472,400098,315297,292531,3025567,6124261,9600862,9600862
Cuba,1977,CU,CUB,AMR,514245,1239144,1753389,870278,689938,541671,410047,324714,325312,3161960,486706,1181124,1667830,849032,679726,531806,403884,317080,307834,3089362,6251322,9672546,9672546
Cuba,1978,CU,CUB,AMR,477891,1235913,1713804,899744,699118,551680,413805,326541,339917,3230805,451760,1174972,1626732,877632,690622,541206,407540,318407,323234,3158641,6389446,9729986,9729986
Cuba,1979,CU,CUB,AMR,442466,1221397,1663863,934437,707060,562236,417013,328359,354350,3303455,417532,1158409,1575941,910445,700134,551686,410989,319856,338342,3231452,6534907,9774711,9774711
Cuba,1980,CU,CUB,AMR,410373,1196535,1606908,973062,713031,573235,419654,330494,368367,3377843,386363,1132474,1518837,946065,707408,563334,414037,321830,352856,3305530,6683373,9809107,9809107
Cuba,1981,CU,CUB,AMR,383839,1162181,1546020,1016843,718440,585983,424474,333254,378016,3457010,360874,1098700,1459574,985331,713130,577222,419401,325463,365418,3385965,6842975,9848560,9848560
Cuba,1982,CU,CUB,AMR,369775,1120563,1490338,1062557,724603,599787,432578,336639,383796,3539960,347692,1059028,1406720,1025642,718688,592284,428078,330569,376596,3471857,7011817,9908874,9908874
Cuba,1983,CU,CUB,AMR,369689,1074049,1443738,1104578,731840,612771,442269,340251,390148,3621857,347823,1014892,1362715,1062442,725169,606572,438175,335701,388224,3556283,7178140,9984591,9984591
Cuba,1984,CU,CUB,AMR,377198,1023675,1400873,1141195,742289,624906,453421,343940,397106,3702857,355182,967225,1322407,1094206,734745,620003,449537,340646,400255,3639392,7342249,10065539,10065539
Cuba,1985,CU,CUB,AMR,389535,970530,1360065,1170855,758059,636351,465829,347905,404307,3783306,367178,916788,1283966,1119567,749543,632726,461909,345670,412291,3721706,7505012,10149044,10149044
Cuba,1986,CU,CUB,AMR,406372,915173,1321545,1192114,780843,647128,479334,352388,411363,3863170,383056,864330,1247386,1137132,771123,644831,475098,351201,423987,3803372,7666542,10235480,10235480
Cuba,1987,CU,CUB,AMR,422162,865949,1288111,1203070,811441,657215,493731,357233,418102,3940792,397292,817859,1215151,1145073,800023,656173,489126,357245,435219,3882859,7823651,10326910,10326910
Cuba,1988,CU,CUB,AMR,434783,829026,1263809,1202000,849142,666667,508633,362216,424538,4013196,408078,782822,1190900,1142066,835238,666598,503993,363551,446086,3957532,7970728,10425433,10425433
Cuba,1989,CU,CUB,AMR,447294,801791,1249085,1188683,892019,675310,523514,367398,430937,4077861,418391,756759,1175150,1128061,874833,675820,519359,370021,457010,4025104,8102965,10527187,10527187
Cuba,1990,CU,CUB,AMR,458371,784165,1242536,1164302,937732,682983,537982,372913,437293,4133205,427188,739710,1166898,1104091,916649,683661,534862,376633,468143,4084039,8217244,10626680,10626680
Cuba,1991,CU,CUB,AMR,463884,776179,1240063,1130692,983897,689456,551782,379089,443184,4178100,430785,731731,1162516,1071843,958443,690013,550085,383651,479093,4133128,8311228,10713812,10713812
Cuba,1992,CU,CUB,AMR,460244,778322,1238566,1090171,1028114,695335,564706,386447,448375,4213148,425997,733164,1159161,1033337,998129,695600,564549,391716,489541,4172872,8386020,10783748,10783748
Cuba,1993,CU,CUB,AMR,447832,790770,1238602,1044645,1068413,702126,576739,395189,453006,4240118,413287,744000,1157287,990211,1034097,701924,578127,401114,499456,4204929,8445047,10840934,10840934
Cuba,1994,CU,CUB,AMR,429764,810570,1240334,993646,1100815,710465,587863,405921,459424,4258134,396175,761650,1157825,942320,1064632,710711,591217,412117,509919,4230916,8489050,10887207,10887207
Cuba,1995,CU,CUB,AMR,410210,833457,1243667,939149,1123657,722092,598116,418373,468035,4269422,378358,782558,1160916,890934,1088239,723919,603967,424471,521166,4252696,8522118,10926703,10926703
Cuba,1996,CU,CUB,AMR,393557,854160,1247717,884382,1138236,739841,607352,431577,477002,4278390,363239,801609,1164848,838764,1103896,743458,615943,437584,532444,4272089,8550479,10963031,10963031
Cuba,1997,CU,CUB,AMR,382287,864662,1246949,836129,1143011,765012,615384,445466,486386,4291388,353507,811163,1164670,792637,1109812,770314,626991,451479,543902,4295135,8586523,10998129,10998129
Cuba,1998,CU,CUB,AMR,375805,863436,1239241,800337,1134882,797799,622187,459804,496311,4311320,348548,810367,1158915,757940,1103140,804334,636925,466238,555696,4324273,8635593,11033758,11033758
Cuba,1999,CU,CUB,AMR,373160,855152,1228312,776663,1112846,836550,627771,473967,506816,4334613,347010,803997,1151007,734365,1082912,843985,645400,481672,567829,4356163,8690776,11070094,11070094
Cuba,2000,CU,CUB,AMR,372365,842408,1214773,764214,1080812,877630,632045,487021,518344,4360066,347405,793819,1141224,721378,1052350,886172,652153,497086,580587,4389726,8749792,11105791,11105791
Cuba,2001,CU,CUB,AMR,371317,827572,1198889,760155,1044127,917578,634644,498138,531928,4386570,348234,781323,1129557,716747,1016122,927740,656935,511855,594721,4424120,8810690,11139127,11139127
Cuba,2002,CU,CUB,AMR,368542,812953,1181495,763074,1005251,954596,635933,507747,547212,4413813,347428,768533,1115961,719485,976807,966157,659960,526021,610348,4458778,8872591,11170051,11170051
Cuba,2003,CU,CUB,AMR,363424,799159,1162583,773832,964342,987519,638465,517735,561740,4443633,343317,755358,1098675,730221,935389,999056,663234,539463,626953,4494316,8937949,11199217,11199217
Cuba,2004,CU,CUB,AMR,356546,784526,1141072,791669,921106,1014419,645370,527931,575418,4475913,336711,740726,1077437,747605,892042,1025306,670389,551236,644289,4530867,9006780,11225294,11225294
Cuba,2005,CU,CUB,AMR,348600,768758,1117358,812517,875350,1034804,658099,536894,590099,4507763,328975,725323,1054298,767636,846670,1045070,683532,561311,662490,4566709,9074472,11246114,11246114
Cuba,2006,CU,CUB,AMR,339623,753931,1093554,831262,828318,1049620,677287,544892,605211,4536590,320101,711593,1031694,784932,800139,1058961,703268,570796,680695,4598791,9135381,11260630,11260630
Cuba,2007,CU,CUB,AMR,329972,742053,1072025,842031,785256,1055664,704517,551957,621197,4560622,310501,701373,1011874,793666,757353,1064454,730692,579863,699339,4625367,9185989,11269887,11269887
Cuba,2008,CU,CUB,AMR,321086,733345,1054431,843360,752354,1047667,739100,558695,638391,4579567,301918,693736,995654,793226,724456,1057101,764466,588796,718917,4646962,9226529,11276609,11276609
Cuba,2009,CU,CUB,AMR,315204,725983,1041187,838518,731588,1026301,777193,565323,655258,4594181,296559,686387,982946,787593,702787,1036707,802395,596946,738446,4664874,9259055,11283185,11283185
Cuba,2010,CU,CUB,AMR,313858,716496,1030354,829049,722589,997349,815271,570693,671876,4606827,295697,676746,972443,778714,690934,1008335,841525,603107,758181,4680796,9287623,11290417,11290417
Cuba,2011,CU,CUB,AMR,317360,702387,1019747,818477,720570,965402,851690,574689,689075,4619903,299632,663447,963079,768880,685527,976873,878082,608300,778330,4695992,9315895,11298710,11298710
Cuba,2012,CU,CUB,AMR,322601,686183,1008784,807902,723775,933132,886975,576986,705507,4634277,304834,648552,953386,758589,686953,942129,913540,612513,799118,4712842,9347119,11309290,11309290
Cuba,2013,CU,CUB,AMR,325982,671413,997395,794330,737534,898774,919592,579197,720325,4649752,307532,634902,942434,745327,699179,902317,948414,616724,820034,4731995,9381747,11321579,11321579
Cuba,2014,CU,CUB,AMR,326275,659249,985524,777884,759366,861349,946407,586051,733735,4664792,306993,623543,930536,729530,718910,860040,978212,625361,839123,4751176,9415968,11332026,11332026
Cuba,2015,CU,CUB,AMR,324466,649739,974205,760790,782478,821811,967437,599220,746072,4677808,304325,614392,918717,713629,740394,816882,1000549,640010,857690,4769154,9446962,11339894,11339894
Cuba,2016,CU,CUB,AMR,319969,642873,962842,744791,803215,780567,984298,617422,757320,4687613,299007,607577,906584,700190,758749,771706,1017287,660160,876882,4784974,9472587,11342012,11342012
Cuba,2017,CU,CUB,AMR,313767,636945,950712,731750,814723,743152,993502,642569,768138,4693834,292429,601366,893795,690341,767127,730170,1026257,687371,896800,4798066,9491900,11336405,11336405
Cuba,2018,CU,CUB,AMR,308878,631748,940626,721907,815644,715127,989582,674418,779857,4696535,287556,595592,883148,682536,765696,698910,1022435,720268,918086,4807931,9504466,11328244,11328244
Cuba,2019,CU,CUB,AMR,303502,628977,932479,713153,810473,698089,973496,709290,791302,4695803,282374,592212,874586,674320,759680,678482,1005520,757220,938607,4813829,9509632,11316697,11316697
Cuba,2020,CU,CUB,AMR,295511,629701,925212,702880,800416,692549,950400,745070,800295,4691610,274921,592217,867138,663878,750994,667978,980296,796423,957168,4816737,9508347,11300698,11300698
Cuba,2021,CU,CUB,AMR,286414,631823,918237,689537,789130,693226,923379,778680,797069,4671021,266604,593601,860205,651100,741421,663969,950979,832597,966842,4806908,9477929,11256372,11256372
Cuba,2022,CU,CUB,AMR,278057,632170,910227,674710,779202,698035,893887,810724,795906,4652464,259045,593364,852409,637464,732162,666571,917436,866845,976609,4797087,9449551,11212191,11212191
Cuba,2023,CU,CUB,AMR,269317,630964,900281,660974,767580,712986,861178,840978,807708,4651404,251132,591499,842631,624907,720846,679860,878851,900575,995092,4800131,9451535,11194449,11194449
Cuba,2024,CU,CUB,AMR,261347,626187,887534,649667,752916,735685,825481,865840,822570,4652159,243911,586081,829992,614448,706808,700425,837819,929307,1016091,4804898,9457057,11174587,11174587
Cuba,2025,CU,CUB,AMR,255855,616639,872494,640882,737562,759609,787886,885599,842723,4654261,238962,576199,815161,606041,692623,722718,795976,950923,1042442,4810723,9464984,11152631,11152631
Cuba,2026,CU,CUB,AMR,252539,603236,855775,634614,723288,781220,748856,901774,867459,4657211,236011,562742,798753,599830,680885,741949,752278,967308,1074808,4817058,9474269,11128799,11128799
Cuba,2027,CU,CUB,AMR,250412,588873,839285,629183,711934,793804,713808,911306,899106,4659141,234139,548790,782929,594108,672717,751363,712317,976505,1114769,4821779,9480920,11103138,11103138
Cuba,2028,CU,CUB,AMR,248368,575440,823808,624395,703701,795972,688020,909102,938124,4659314,232328,536198,768526,588727,666526,751118,682545,973660,1161507,4824083,9483397,11075736,11075736
Cuba,2029,CU,CUB,AMR,246595,562306,808901,621943,696433,792074,672837,895713,979246,4658246,230750,524004,754754,585666,659792,746341,663418,958369,1211211,4824797,9483043,11046696,11046696
Cuba,2030,CU,CUB,AMR,245107,548975,794082,622829,687048,782878,668538,875690,1019433,4656416,229423,511742,741165,585839,650203,738421,653788,935044,1261089,4824384,9480800,11016041,11016041
Cuba,1950,CU,CUB,AMR,406814,697864,1104678,541630,432922,381160,287734,174074,139613,1957133,388034,673992,1062026,532978,428251,358105,229191,135246,119036,1802807,3759940,5926645,5926645
Cuba,1951,CU,CUB,AMR,415719,708538,1124257,554744,438677,384482,299637,176092,143474,1997106,397093,683493,1080586,545169,434814,365204,242194,136960,121612,1845953,3843059,6047907,6047907
Cuba,1952,CU,CUB,AMR,424816,717866,1142682,568705,445457,387944,310484,178292,147992,2038874,406319,691776,1098095,558216,442374,371615,255126,138711,124895,1890937,3929811,6170590,6170590
Cuba,1953,CU,CUB,AMR,434810,726516,1161326,583224,453122,391475,320136,181362,152785,2082104,416273,699578,1115851,571806,450728,377416,267773,141152,128586,1937461,4019565,6296738,6296738
Cuba,1954,CU,CUB,AMR,444352,736621,1180973,597811,461400,394842,328593,186382,157086,2126114,425506,709103,1134609,585400,459426,382740,279892,145299,132060,1984817,4110931,6426523,6426523
Cuba,1955,CU,CUB,AMR,452760,749142,1201902,612077,470208,398041,335939,193582,160634,2170481,433452,721183,1154635,598608,468339,387760,291330,151468,135068,2032573,4203054,6559586,6559586
Cuba,1956,CU,CUB,AMR,461748,762255,1224003,626036,479483,401111,341981,202940,163405,2214956,441956,733883,1175839,611485,477460,392433,302000,159630,137570,2080578,4295534,6695376,6695376
Cuba,1957,CU,CUB,AMR,471916,775409,1247325,639790,489139,404040,346573,214478,165429,2259449,451584,746654,1198238,624150,486670,396725,311825,169750,139628,2128748,4388197,6833757,6833757
Cuba,1958,CU,CUB,AMR,482588,789452,1272040,653081,499284,407117,350132,227181,167142,2303937,461683,760318,1222001,636303,496125,400982,320758,181210,141511,2176889,4480826,6974868,6974868
Cuba,1959,CU,CUB,AMR,494773,804364,1299137,665210,510028,410713,353233,239456,169165,2347805,473247,774846,1248093,647257,506074,405606,328763,193005,143611,2224316,4572121,7119349,7119349
Cuba,1960,CU,CUB,AMR,509793,819863,1329656,675711,521188,414846,356001,250458,171880,2390084,487567,789972,1277539,656579,516410,410624,335767,204507,146224,2270111,4660195,7267395,7267395
Cuba,1961,CU,CUB,AMR,528063,835846,1363909,684337,532563,419422,358387,260245,175135,2430089,505056,805563,1310619,664124,526998,416038,341723,215741,149288,2313912,4744001,7418518,7418518
Cuba,1962,CU,CUB,AMR,549874,852568,1402442,691020,544227,424588,360575,268808,178899,2468117,526021,821815,1347836,669845,537883,422016,346706,226666,152758,2355874,4823991,7574265,7574265
Cuba,1963,CU,CUB,AMR,575076,870074,1445150,696683,556107,430362,362622,276123,183378,2505275,550299,838683,1388982,674707,548907,428462,350877,237116,156881,2396950,4902225,7736352,7736352
Cuba,1964,CU,CUB,AMR,600141,888489,1488630,703603,567838,436575,364413,282311,188818,2543558,574462,856157,1430619,681109,559737,435101,354515,246997,162023,2439482,4983040,7902286,7902286
Cuba,1965,CU,CUB,AMR,620986,908804,1529790,712753,579114,443198,366013,287502,195150,2583730,594549,875315,1469864,689908,570080,441891,357869,256237,168280,2484265,5067995,8067651,8067651
Cuba,1966,CU,CUB,AMR,636401,933138,1569539,722325,590036,450234,367496,291561,202327,2623979,609329,898405,1507734,699164,580013,448808,360887,264754,175564,2529190,5153169,8230450,8230450
Cuba,1967,CU,CUB,AMR,645978,962333,1608311,731890,600772,457637,368894,294440,210405,2664038,618361,926240,1544601,708463,589710,455791,363589,272523,183936,2574012,5238050,8390962,8390962
Cuba,1968,CU,CUB,AMR,649742,995700,1645442,742436,611130,465567,370535,296557,218950,2705175,621674,958124,1579798,718749,598993,463071,366364,279549,193138,2619864,5325039,8550286,8550286
Cuba,1969,CU,CUB,AMR,650006,1030886,1680892,754261,620695,474311,372916,298507,227387,2748077,621514,991772,1613286,730301,607482,471115,369752,285932,202815,2667397,5415474,8709654,8709654
Cuba,2031,CU,CUB,AMR,243698,536633,780331,625002,674085,772116,670312,852811,1058437,4652763,228163,500527,728690,587283,637729,729230,650462,908301,1308787,4821792,9474555,10983569,10983569
Cuba,2032,CU,CUB,AMR,242296,526198,768494,625405,659555,762618,675930,827366,1095512,4646386,226899,491136,718035,587089,624304,720295,653538,877331,1353731,4816288,9462674,10949207,10949207
Cuba,2033,CU,CUB,AMR,241027,515455,756482,624240,646012,751329,690941,797636,1129429,4639587,225749,481434,707183,585249,611834,709149,666851,840685,1396276,4810044,9449631,10913301,10913301
Cuba,2034,CU,CUB,AMR,239822,505744,745566,619516,634889,737057,713426,765044,1161162,4631094,224643,472662,697305,579864,601453,695309,687304,801657,1436283,4801870,9432964,10875840,10875840
Cuba,2035,CU,CUB,AMR,238552,498793,737345,610038,626265,722107,737046,730809,1192945,4619210,223479,466404,689883,570021,593121,681334,709421,761882,1474429,4790208,9409418,10836646,10836646
Cuba,2036,CU,CUB,AMR,237359,494095,731454,596716,620150,708215,758360,695438,1225510,4604389,222378,462207,684585,556610,586975,669780,728480,720456,1513130,4775431,9379820,10795857,10795857
Cuba,2037,CU,CUB,AMR,236232,490585,726817,582438,614853,697189,770865,664087,1258177,4587609,221333,459085,680418,542708,581313,661749,737857,682846,1551994,4758467,9346076,10753317,10753317
Cuba,2038,CU,CUB,AMR,234998,487296,722294,569084,610192,689215,773217,641530,1286728,4569966,220188,456135,676323,530155,575989,655673,737726,655130,1585692,4740365,9310331,10708951,10708951
Cuba,2039,CU,CUB,AMR,233675,484336,718011,556027,607845,682168,769625,628762,1306984,4551411,218962,453465,672427,517999,572973,649043,733118,637584,1610311,4721028,9272439,10662877,10662877
Cuba,2040,CU,CUB,AMR,232317,481599,713916,542772,608805,673008,760901,626112,1320366,4531964,217702,450984,668686,505780,573183,639562,725417,629126,1627400,4700468,9232432,10615034,10615034
Cuba,2041,CU,CUB,AMR,230893,479016,709909,530498,611042,660302,750686,629127,1330066,4511721,216375,448638,665013,494606,574651,627217,716479,626700,1639126,4678779,9190500,10565416,10565416
Cuba,2042,CU,CUB,AMR,229461,476506,705967,520134,611513,646049,741721,635633,1335663,4490713,215039,446337,661376,485247,574483,613920,707794,630337,1644184,4655965,9146678,10514019,10514019
Cuba,2043,CU,CUB,AMR,228037,474020,702057,509459,610429,632780,731040,650782,1334477,4468967,213713,444048,657761,475580,572674,601586,696957,643740,1641549,4632086,9101053,10460869,10460869
Cuba,2044,CU,CUB,AMR,226548,471506,698054,499811,605801,621917,717489,672834,1328713,4446565,212319,441730,654049,466840,567334,591333,683491,663960,1634241,4607199,9053764,10405863,10405863
Cuba,2045,CU,CUB,AMR,224923,468898,693821,492911,596446,613537,703287,695847,1321521,4423549,210796,439315,650111,460613,557545,583119,669892,685696,1624429,4581294,9004843,10348775,10348775
Cuba,2046,CU,CUB,AMR,223050,466296,689346,488260,583261,607637,690101,716543,1314037,4399839,209047,436895,645942,456434,544197,577090,658672,704363,1613541,4554297,8954136,10289433,10289433
Cuba,2047,CU,CUB,AMR,220872,463752,684624,484790,569119,602548,679676,728877,1310374,4375384,207004,434524,641528,453332,530359,571534,650903,713633,1606377,4526138,8901522,10227682,10227682
Cuba,2048,CU,CUB,AMR,218343,461111,679454,481534,555899,598075,672175,731597,1311082,4350362,204628,432062,636690,450399,517868,566311,645033,713712,1603667,4496990,8847352,10163491,10163491
Cuba,2049,CU,CUB,AMR,215486,458311,673797,478608,542971,595882,665518,728632,1313205,4324816,201945,429452,631397,447744,505771,563371,638587,709446,1601995,4466914,8791730,10096925,10096925
Cuba,2050,CU,CUB,AMR,212448,455341,667789,475901,529841,596948,656743,720860,1318373,4298666,199094,426678,625772,445282,493604,563627,629303,702212,1601830,4435858,8734524,10028085,10028085
Curaçao,2010,CW,CUW,AMR,5910,12162,18072,10227,7457,9709,11181,8784,7608,54966,5674,11551,17225,10588,9637,12671,14433,10978,10822,69129,124095,159380,159380
Curaçao,2011,CW,CUW,AMR,5820,12297,18117,10368,7450,9616,11363,9089,7952,55838,5580,11672,17252,10672,9686,12628,14695,11440,11339,70460,126298,161677,161677
Curaçao,2012,CW,CUW,AMR,5734,12402,18136,10802,7663,9457,11458,9283,8274,56937,5488,11788,17276,10939,9730,12444,14808,11820,11859,71600,128537,163948,163948
Curaçao,2013,CW,CUW,AMR,5663,12482,18145,11433,8010,9284,11451,9422,8595,58195,5417,11892,17309,11283,9729,12173,14776,12149,12380,72490,130685,166136,166136
Curaçao,2014,CW,CUW,AMR,5594,12510,18104,11943,8392,9118,11385,9566,8906,59310,5355,11958,17313,11551,9768,11905,14671,12487,12928,73310,132620,168025,168025
Curaçao,2015,CW,CUW,AMR,5513,12483,17996,12326,8803,8961,11265,9716,9195,60266,5278,11965,17243,11745,9862,11644,14507,12818,13481,74057,134323,169572,169572
Curaçao,2016,CW,CUW,AMR,5393,12382,17775,12585,9257,8822,11101,9888,9471,61124,5164,11896,17060,11868,10018,11393,14295,13151,14056,74781,135905,170739,170739
Curaçao,2017,CW,CUW,AMR,5168,12250,17418,12734,9754,8709,10900,10072,9727,61896,4948,11779,16727,11936,10242,11158,14044,13470,14630,75480,137376,171524,171524
Curaçao,2018,CW,CUW,AMR,5171,12383,17554,15336,13093,10028,11286,10524,10053,70320,4969,11868,16837,13341,11950,11586,14020,13875,15242,80014,150334,184722,184722
Curaçao,2019,CW,CUW,AMR,5236,12321,17557,16597,15467,10941,11466,10874,10342,75687,5038,11804,16842,14037,13205,11835,13897,14205,15840,83019,158706,193107,193107
Curaçao,2020,CW,CUW,AMR,5151,11948,17099,15179,15167,10615,11072,10935,10548,73516,4944,11485,16429,13288,13132,11511,13522,14373,16419,82245,155761,189288,189288
Curaçao,2021,CW,CUW,AMR,5207,11688,16895,14875,15867,10864,10905,11042,10751,74304,4994,11236,16230,13161,13559,11450,13249,14495,16996,82910,157214,190338,190338
Curaçao,2022,CW,CUW,AMR,5350,11378,16728,14547,16410,11149,10735,11083,10989,74913,5128,10933,16061,13046,13889,11414,12977,14542,17588,83456,158369,191163,191163
Curaçao,2023,CW,CUW,AMR,5498,11111,16609,14242,16846,11506,10584,11082,11280,75540,5262,10679,15941,12945,14148,11423,12718,14521,18236,83991,159531,192077,192077
Curaçao,2024,CW,CUW,AMR,5553,10981,16534,13947,17148,11936,10457,11037,11579,76104,5312,10559,15871,12835,14320,11498,12478,14432,18887,84450,160554,192965,192965
Curaçao,2025,CW,CUW,AMR,5572,10923,16495,13658,17311,12442,10370,10958,11893,76632,5334,10501,15835,12709,14413,11649,12256,14286,19557,84870,161502,193837,193837
Curaçao,2026,CW,CUW,AMR,5609,10888,16497,13365,17336,13029,10332,10851,12219,77132,5367,10462,15829,12539,14424,11885,12058,14108,20222,85236,162368,194695,194695
Curaçao,2027,CW,CUW,AMR,5639,10843,16482,13104,17217,13690,10340,10726,12556,77633,5397,10417,15814,12362,14363,12211,11883,13890,20885,85594,163227,195525,195525
Curaçao,2028,CW,CUW,AMR,5661,10785,16446,12879,16989,14394,10401,10591,12884,78138,5417,10361,15778,12188,14246,12599,11735,13653,21535,85956,164094,196322,196322
Curaçao,2029,CW,CUW,AMR,5678,10766,16444,12651,16673,15118,10518,10455,13197,78612,5431,10339,15770,11987,14081,13028,11616,13397,22158,86267,164879,197093,197093
Curaçao,2030,CW,CUW,AMR,5683,10787,16470,12416,16316,15827,10687,10309,13490,79045,5437,10351,15788,11769,13907,13465,11522,13128,22732,86523,165568,197829,197829
Curaçao,2031,CW,CUW,AMR,5677,10874,16551,12152,15960,16471,10911,10165,13746,79405,5431,10431,15862,11513,13753,13864,11455,12870,23245,86700,166105,198519,198519
Curaçao,2032,CW,CUW,AMR,5658,11049,16707,11843,15647,17013,11196,10026,13954,79679,5416,10595,16011,11212,13638,14193,11420,12617,23689,86769,166448,199171,199171
Curaçao,2033,CW,CUW,AMR,5632,11219,16851,11579,15348,17446,11546,9903,14136,79958,5390,10750,16140,10960,13538,14449,11435,12375,24082,86839,166797,199786,199786
Curaçao,2034,CW,CUW,AMR,5600,11289,16889,11456,15056,17745,11970,9800,14299,80326,5358,10817,16175,10838,13430,14627,11509,12142,24421,86967,167293,200349,200349
Curaçao,2035,CW,CUW,AMR,5561,11319,16880,11394,14772,17913,12471,9730,14435,80715,5321,10843,16164,10781,13305,14715,11662,11932,24713,87108,167823,200869,200869
Curaçao,2036,CW,CUW,AMR,5519,11348,16867,11358,14483,17933,13048,9709,14571,81102,5282,10870,16152,10744,13136,14728,11898,11749,24972,87227,168329,201348,201348
Curaçao,2037,CW,CUW,AMR,5472,11357,16829,11318,14224,17822,13702,9733,14692,81491,5235,10883,16118,10700,12958,14669,12221,11587,25204,87339,168830,201778,201778
Curaçao,2038,CW,CUW,AMR,5420,11357,16777,11263,14003,17600,14395,9811,14820,81892,5185,10880,16065,10645,12786,14553,12608,11448,25390,87430,169322,202164,202164
Curaçao,2039,CW,CUW,AMR,5364,11341,16705,11243,13780,17294,15109,9937,14925,82288,5133,10862,15995,10620,12591,14390,13036,11336,25548,87521,169809,202506,202506
Curaçao,2040,CW,CUW,AMR,5304,11311,16615,11265,13550,16942,15807,10115,15004,82683,5075,10833,15908,10637,12371,14217,13469,11254,25652,87600,170283,202802,202802
Curaçao,2041,CW,CUW,AMR,5244,11262,16506,11356,13288,16598,16444,10338,15056,83080,5017,10788,15805,10716,12120,14067,13868,11195,25699,87665,170745,203058,203058
Curaçao,2042,CW,CUW,AMR,5190,11196,16386,11531,12982,16282,16979,10621,15091,83486,4963,10723,15686,10877,11818,13954,14196,11167,25712,87724,171210,203276,203276
Curaçao,2043,CW,CUW,AMR,5136,11118,16254,11699,12723,15992,17399,10964,15108,83885,4911,10649,15560,11034,11568,13858,14447,11183,25680,87770,171655,203466,203466
Curaçao,2044,CW,CUW,AMR,5083,11032,16115,11773,12599,15709,17695,11375,15131,84282,4862,10567,15429,11099,11449,13752,14619,11265,25614,87798,172080,203621,203621
Curaçao,2045,CW,CUW,AMR,5032,10934,15966,11800,12545,15433,17862,11863,15178,84681,4815,10469,15284,11127,11389,13625,14714,11416,25537,87808,172489,203744,203744
Curaçao,2046,CW,CUW,AMR,4986,10834,15820,11833,12510,15145,17892,12422,15261,85063,4769,10375,15144,11155,11354,13458,14726,11656,25470,87819,172882,203847,203847
Curaçao,2047,CW,CUW,AMR,4945,10731,15676,11845,12471,14892,17785,13052,15393,85438,4729,10277,15006,11166,11310,13284,14670,11973,25399,87802,173240,203924,203924
Curaçao,2048,CW,CUW,AMR,4907,10624,15531,11843,12420,14679,17574,13729,15559,85804,4693,10170,14863,11164,11256,13117,14558,12358,25330,87783,173587,203987,203987
Curaçao,2049,CW,CUW,AMR,4876,10521,15397,11827,12403,14459,17282,14419,15772,86162,4665,10071,14736,11148,11233,12917,14403,12783,25261,87745,173907,204038,204038
Curaçao,2050,CW,CUW,AMR,4856,10410,15266,11798,12427,14231,16949,15100,16012,86517,4643,9965,14608,11120,11247,12702,14233,13215,25177,87694,174211,204084,204084
Cayman Islands,1970,KY,CYM,AMR,740,1349,2089,865,641,510,375,285,270,2946,691,1261,1952,889,698,605,474,415,464,3545,6491,10533,10533
Cayman Islands,1971,KY,CYM,AMR,762,1395,2157,955,688,552,402,299,282,3178,720,1310,2030,982,731,647,492,428,473,3753,6931,11117,11117
Cayman Islands,1972,KY,CYM,AMR,784,1434,2218,1047,754,604,442,318,291,3456,756,1358,2114,1085,775,689,516,439,489,3993,7449,11778,11778
Cayman Islands,1973,KY,CYM,AMR,802,1471,2273,1140,816,658,478,341,304,3737,788,1407,2195,1185,825,732,545,454,505,4246,7983,12443,12443
Cayman Islands,1974,KY,CYM,AMR,817,1500,2317,1227,886,719,516,366,315,4029,820,1442,2262,1284,888,774,581,468,519,4514,8543,13118,13118
Cayman Islands,1975,KY,CYM,AMR,829,1526,2355,1299,968,786,553,392,332,4330,841,1477,2318,1367,968,807,619,482,542,4785,9115,13791,13791
Cayman Islands,1976,KY,CYM,AMR,825,1560,2385,1361,1054,853,593,420,347,4628,843,1515,2358,1445,1068,844,663,493,570,5083,9711,14456,14456
Cayman Islands,1977,KY,CYM,AMR,815,1591,2406,1417,1151,915,642,447,369,4941,824,1565,2389,1508,1171,888,705,503,604,5379,10320,15116,15116
Cayman Islands,1978,KY,CYM,AMR,798,1624,2422,1469,1239,975,693,474,398,5248,783,1611,2394,1555,1287,924,748,519,642,5675,10923,15746,15746
Cayman Islands,1979,KY,CYM,AMR,775,1656,2431,1523,1323,1040,750,506,433,5575,732,1662,2394,1602,1408,968,790,537,683,5988,11563,16378,16378
Cayman Islands,1980,KY,CYM,AMR,772,1693,2465,1615,1412,1097,789,537,450,5900,710,1714,2424,1688,1518,1020,826,553,703,6308,12208,17100,17100
Cayman Islands,1981,KY,CYM,AMR,791,1722,2513,1744,1511,1143,824,563,468,6253,733,1761,2494,1793,1632,1071,852,570,726,6644,12897,17904,17904
Cayman Islands,1982,KY,CYM,AMR,819,1740,2559,1863,1618,1196,857,590,486,6610,777,1783,2560,1900,1757,1132,877,586,743,6995,13605,18729,18729
Cayman Islands,1983,KY,CYM,AMR,853,1748,2601,1975,1740,1255,902,611,504,6987,832,1785,2617,1992,1897,1200,909,609,761,7368,14355,19572,19572
Cayman Islands,1984,KY,CYM,AMR,895,1749,2644,2053,1879,1336,951,625,529,7373,886,1780,2666,2066,2054,1277,937,638,779,7751,15124,20433,20433
Cayman Islands,1985,KY,CYM,AMR,933,1763,2696,2111,2024,1437,1003,633,551,7759,923,1787,2710,2120,2209,1382,971,667,797,8146,15905,21313,21313
Cayman Islands,1986,KY,CYM,AMR,965,1777,2742,2147,2177,1556,1054,644,578,8156,945,1797,2742,2167,2365,1504,1002,695,820,8553,16709,22195,22195
Cayman Islands,1987,KY,CYM,AMR,992,1797,2789,2162,2338,1680,1105,655,605,8545,960,1802,2762,2202,2515,1650,1037,722,846,8972,17517,23075,23075
Cayman Islands,1988,KY,CYM,AMR,1007,1822,2829,2157,2502,1805,1159,687,630,8940,976,1811,2787,2214,2663,1814,1079,742,880,9392,18332,23956,23956
Cayman Islands,1989,KY,CYM,AMR,1018,1862,2880,2160,2663,1930,1217,727,651,9348,998,1831,2829,2229,2798,1989,1139,761,922,9838,19186,24888,24888
Cayman Islands,1990,KY,CYM,AMR,1048,1899,2947,2238,2819,2065,1274,764,678,9838,1037,1857,2894,2333,2921,2164,1207,792,935,10352,20190,26027,26027
Cayman Islands,1991,KY,CYM,AMR,1103,1919,3022,2381,2971,2214,1335,795,703,10399,1090,1891,2981,2489,3065,2340,1266,831,951,10942,21341,27340,27340
Cayman Islands,1992,KY,CYM,AMR,1166,1930,3096,2499,3129,2379,1407,835,726,10975,1150,1921,3071,2614,3233,2521,1336,870,956,11530,22505,28677,28677
Cayman Islands,1993,KY,CYM,AMR,1235,1948,3183,2573,3310,2542,1498,882,751,11556,1213,1961,3174,2685,3430,2712,1414,911,973,12125,23681,30038,30038
Cayman Islands,1994,KY,CYM,AMR,1301,1982,3283,2606,3496,2717,1614,928,774,12135,1273,1996,3269,2711,3640,2912,1516,948,997,12724,24859,31418,31418
Cayman Islands,1995,KY,CYM,AMR,1354,2036,3390,2588,3690,2898,1753,980,797,12706,1323,2046,3369,2692,3871,3113,1653,982,1024,13335,26041,32802,32802
Cayman Islands,1996,KY,CYM,AMR,1386,2117,3503,2522,3905,3090,1906,1032,821,13276,1360,2106,3466,2626,4111,3321,1822,1012,1056,13948,27224,34194,34194
Cayman Islands,1997,KY,CYM,AMR,1405,2213,3618,2414,4116,3307,2069,1083,851,13840,1379,2181,3560,2523,4346,3547,2009,1041,1094,14560,28400,35579,35579
Cayman Islands,1998,KY,CYM,AMR,1409,2312,3721,2294,4302,3548,2235,1132,896,14407,1381,2265,3646,2400,4555,3792,2213,1073,1133,15166,29573,36947,36947
Cayman Islands,1999,KY,CYM,AMR,1398,2417,3815,2203,4437,3797,2400,1193,948,14978,1369,2365,3734,2312,4698,4052,2419,1118,1177,15776,30754,38295,38295
Cayman Islands,2000,KY,CYM,AMR,1414,2529,3943,2274,4484,4005,2526,1260,977,15526,1381,2474,3855,2383,4725,4263,2582,1166,1218,16337,31863,39658,39658
Cayman Islands,2001,KY,CYM,AMR,1467,2618,4085,2479,4486,4180,2622,1319,1003,16089,1420,2572,3992,2587,4682,4437,2714,1215,1256,16891,32980,41054,41054
Cayman Islands,2002,KY,CYM,AMR,1519,2692,4211,2674,4491,4369,2720,1384,1038,16676,1472,2641,4113,2794,4643,4604,2849,1277,1282,17449,34125,42456,42456
Cayman Islands,2003,KY,CYM,AMR,1574,2750,4324,2843,4515,4569,2825,1457,1073,17282,1532,2697,4229,2970,4632,4776,2998,1344,1311,18031,35313,43862,43862
Cayman Islands,2004,KY,CYM,AMR,1618,2815,4433,2965,4566,4768,2950,1537,1108,17894,1598,2736,4334,3103,4667,4943,3155,1421,1339,18628,36522,45286,45286
Cayman Islands,2005,KY,CYM,AMR,1646,2879,4525,3043,4640,4977,3089,1626,1142,18517,1652,2779,4431,3188,4735,5109,3327,1519,1367,19245,37762,46727,46727
Cayman Islands,2006,KY,CYM,AMR,1671,2952,4623,3080,4732,5198,3249,1717,1182,19158,1686,2834,4520,3223,4838,5277,3515,1625,1399,19877,39035,48177,48177
Cayman Islands,2007,KY,CYM,AMR,1708,3003,4711,3073,4862,5409,3444,1807,1220,19815,1723,2885,4608,3209,4973,5447,3715,1738,1433,20515,40330,49647,49647
Cayman Islands,2008,KY,CYM,AMR,1772,3040,4812,3024,5025,5601,3661,1897,1259,20467,1761,2925,4686,3158,5134,5613,3931,1869,1459,21164,41631,51123,51123
Cayman Islands,2009,KY,CYM,AMR,1845,3073,4918,2956,5183,5790,3891,1985,1309,21114,1783,2978,4761,3083,5305,5774,4145,2004,1496,21807,42921,52602,52602
Cayman Islands,2010,KY,CYM,AMR,1904,3124,5028,2913,5283,5989,4125,2083,1371,21764,1804,3049,4853,3017,5436,5941,4345,2141,1546,22426,44190,54074,54074
Cayman Islands,2011,KY,CYM,AMR,1961,3193,5154,3037,5261,6129,4357,2196,1438,22418,1837,3115,4952,3078,5447,6042,4503,2289,1610,22969,45387,55492,55492
Cayman Islands,2012,KY,CYM,AMR,2009,3258,5267,3292,5182,6186,4580,2325,1516,23081,1873,3142,5015,3275,5364,6076,4648,2449,1684,23496,46577,56860,56860
Cayman Islands,2013,KY,CYM,AMR,2025,3326,5351,3525,5153,6223,4799,2452,1605,23757,1938,3130,5068,3464,5290,6103,4805,2615,1755,24032,47789,58212,58212
Cayman Islands,2014,KY,CYM,AMR,2014,3395,5409,3701,5179,6261,5009,2590,1712,24452,2035,3099,5134,3605,5261,6125,4962,2777,1845,24575,49027,59559,59559
Cayman Islands,2015,KY,CYM,AMR,1985,3459,5444,3807,5259,6301,5216,2729,1815,25127,2143,3075,5218,3693,5276,6142,5114,2933,1963,25121,50248,60911,60911
Cayman Islands,2016,KY,CYM,AMR,1944,3534,5478,3840,5385,6342,5416,2880,1930,25793,2243,3080,5323,3721,5333,6164,5261,3085,2097,25661,51454,62255,62255
Cayman Islands,2017,KY,CYM,AMR,1896,3616,5512,3810,5546,6404,5586,3053,2047,26446,2314,3132,5446,3677,5435,6201,5405,3232,2230,26180,52626,63581,63581
Cayman Islands,2018,KY,CYM,AMR,1860,3693,5553,3735,5712,6491,5737,3243,2158,27076,2337,3245,5582,3572,5567,6261,5526,3385,2370,26681,53757,64884,64884
Cayman Islands,2019,KY,CYM,AMR,1835,3747,5582,3634,5871,6596,5872,3449,2282,27704,2280,3410,5690,3421,5708,6343,5632,3535,2517,27156,54860,66134,66134
Cayman Islands,2020,KY,CYM,AMR,1827,3780,5607,3534,6004,6725,6005,3662,2404,28334,2127,3632,5759,3242,5832,6452,5734,3688,2663,27611,55945,67311,67311
Cayman Islands,2021,KY,CYM,AMR,1817,3798,5615,3465,5980,6808,6131,3883,2514,28781,1941,3881,5822,3063,5814,6533,5830,3860,2816,27916,56697,68136,68136
Cayman Islands,2022,KY,CYM,AMR,1796,3805,5601,3447,5792,6837,6243,4120,2627,29066,1789,4127,5916,2938,5650,6571,5915,4065,2980,28119,57185,68706,68706
Cayman Islands,2023,KY,CYM,AMR,1777,3797,5574,3481,5572,6870,6333,4359,2757,29372,1676,4334,6010,2855,5465,6597,5996,4283,3155,28351,57723,69310,69310
Cayman Islands,2024,KY,CYM,AMR,1749,3779,5528,3547,5335,6893,6421,4575,2901,29672,1616,4462,6078,2823,5252,6607,6075,4493,3352,28602,58274,69885,69885
Cayman Islands,2025,KY,CYM,AMR,1714,3760,5474,3632,5102,6892,6501,4783,3065,29975,1623,4478,6101,2856,5027,6601,6149,4693,3567,28893,58868,70445,70445
Cayman Islands,2026,KY,CYM,AMR,1683,3733,5416,3730,4869,6879,6563,4984,3250,30275,1631,4429,6060,2957,4792,6584,6222,4882,3797,29234,59509,70981,70981
Cayman Islands,2027,KY,CYM,AMR,1659,3696,5355,3831,4652,6837,6617,5162,3461,30560,1608,4353,5961,3129,4552,6558,6290,5057,4037,29623,60183,71492,71492
Cayman Islands,2028,KY,CYM,AMR,1634,3664,5298,3917,4461,6766,6665,5323,3685,30817,1583,4217,5800,3358,4318,6510,6368,5215,4290,30059,60876,71980,71980
Cayman Islands,2029,KY,CYM,AMR,1610,3636,5246,3996,4300,6664,6711,5463,3928,31062,1560,4047,5607,3627,4106,6439,6437,5351,4564,30524,61586,72438,72438
Cayman Islands,2030,KY,CYM,AMR,1582,3610,5192,4053,4185,6523,6755,5596,4183,31295,1533,3852,5385,3912,3917,6333,6500,5481,4847,30990,62285,72865,72865
Cayman Islands,1950,KY,CYM,AMR,438,687,1125,626,455,367,256,219,159,2082,437,717,1154,640,517,468,385,298,256,2564,4646,6912,6912
Cayman Islands,1951,KY,CYM,AMR,481,684,1165,646,457,368,255,223,177,2126,473,716,1189,659,525,470,386,297,287,2624,4750,7106,7106
Cayman Islands,1952,KY,CYM,AMR,532,702,1234,659,448,361,262,248,228,2206,506,719,1225,695,540,484,399,314,358,2790,4996,7454,7454
Cayman Islands,1953,KY,CYM,AMR,570,723,1293,674,461,363,265,252,246,2261,541,722,1263,713,558,492,402,322,383,2870,5131,7686,7686
Cayman Islands,1954,KY,CYM,AMR,600,763,1363,678,476,363,272,257,265,2311,568,742,1310,734,580,494,407,339,402,2956,5267,7934,7934
Cayman Islands,1955,KY,CYM,AMR,610,808,1418,678,489,365,280,254,280,2346,583,772,1355,736,596,495,416,348,428,3019,5365,8129,8129
Cayman Islands,1956,KY,CYM,AMR,611,837,1448,679,509,374,285,240,272,2359,594,790,1384,725,606,496,416,349,414,3006,5365,8204,8204
Cayman Islands,1957,KY,CYM,AMR,612,856,1468,680,535,387,294,229,259,2384,598,812,1410,721,610,493,419,349,415,3007,5391,8275,8275
Cayman Islands,1958,KY,CYM,AMR,612,876,1488,681,554,403,304,223,246,2411,592,842,1434,713,613,491,428,347,406,2998,5409,8328,8328
Cayman Islands,1959,KY,CYM,AMR,611,893,1504,680,568,416,314,215,233,2426,586,872,1458,703,612,494,436,344,397,2986,5412,8374,8374
Cayman Islands,1960,KY,CYM,AMR,616,919,1535,676,583,426,322,214,221,2442,596,908,1504,697,620,501,443,342,387,2990,5432,8473,8473
Cayman Islands,1961,KY,CYM,AMR,638,954,1592,668,598,431,331,215,221,2464,616,944,1560,692,632,505,449,346,378,3002,5466,8626,8626
Cayman Islands,1962,KY,CYM,AMR,664,993,1657,666,608,438,341,223,214,2490,640,983,1623,691,648,506,455,354,379,3033,5523,8799,8799
Cayman Islands,1963,KY,CYM,AMR,688,1037,1725,667,613,442,348,229,220,2519,666,1015,1681,688,659,515,458,356,381,3057,5576,8985,8985
Cayman Islands,1964,KY,CYM,AMR,709,1079,1788,674,616,444,356,234,219,2543,680,1057,1737,692,667,528,456,364,391,3098,5641,9172,9172
Cayman Islands,1965,KY,CYM,AMR,723,1125,1848,687,620,453,361,242,226,2589,686,1098,1784,706,674,540,455,369,405,3149,5738,9366,9366
Cayman Islands,1966,KY,CYM,AMR,729,1172,1901,709,620,456,369,255,225,2634,686,1139,1825,724,681,549,457,376,423,3210,5844,9566,9566
Cayman Islands,1967,KY,CYM,AMR,728,1222,1950,736,624,460,371,268,231,2690,684,1175,1859,754,688,556,459,382,435,3274,5964,9771,9771
Cayman Islands,1968,KY,CYM,AMR,732,1270,2002,767,622,476,369,275,242,2751,684,1202,1886,793,688,570,461,392,448,3352,6103,9981,9981
Cayman Islands,1969,KY,CYM,AMR,730,1309,2039,802,622,485,367,278,256,2810,682,1226,1908,831,683,583,463,402,459,3421,6231,10181,10181
Cayman Islands,2031,KY,CYM,AMR,1555,3581,5136,4086,4118,6354,6790,5724,4443,31515,1507,3659,5166,4195,3763,6194,6558,5598,5142,31450,62965,73263,73263
Cayman Islands,2032,KY,CYM,AMR,1527,3545,5072,4100,4102,6163,6823,5836,4710,31734,1477,3491,4968,4452,3646,6030,6606,5687,5447,31868,63602,73636,73636
Cayman Islands,2033,KY,CYM,AMR,1499,3499,4998,4092,4136,5942,6859,5925,4982,31936,1451,3350,4801,4659,3561,5843,6634,5774,5768,32239,64175,73979,73979
Cayman Islands,2034,KY,CYM,AMR,1472,3451,4923,4074,4204,5709,6884,6015,5248,32134,1425,3267,4692,4786,3529,5638,6645,5856,6095,32549,64683,74291,74291
Cayman Islands,2035,KY,CYM,AMR,1447,3386,4833,4054,4286,5478,6887,6093,5521,32319,1402,3247,4649,4800,3562,5416,6643,5927,6431,32779,65098,74585,74585
Cayman Islands,2036,KY,CYM,AMR,1428,3326,4754,4028,4387,5251,6876,6157,5805,32504,1382,3227,4609,4755,3661,5184,6627,6002,6759,32988,65492,74859,74859
Cayman Islands,2037,KY,CYM,AMR,1413,3276,4689,3994,4485,5040,6841,6215,6091,32666,1369,3179,4548,4678,3835,4945,6602,6074,7091,33225,65891,75111,75111
Cayman Islands,2038,KY,CYM,AMR,1403,3224,4627,3961,4570,4852,6774,6266,6374,32797,1359,3126,4485,4545,4061,4714,6557,6150,7407,33434,66231,75342,75342
Cayman Islands,2039,KY,CYM,AMR,1399,3171,4570,3932,4648,4694,6674,6316,6655,32919,1356,3078,4434,4370,4329,4505,6490,6224,7719,33637,66556,75559,75559
Cayman Islands,2040,KY,CYM,AMR,1404,3119,4523,3908,4704,4581,6540,6364,6932,33029,1359,3028,4387,4180,4613,4319,6389,6285,8029,33815,66844,75762,75762
Cayman Islands,2041,KY,CYM,AMR,1417,3074,4491,3878,4741,4517,6379,6403,7204,33122,1371,2983,4354,3988,4897,4167,6252,6349,8334,33987,67109,75957,75957
Cayman Islands,2042,KY,CYM,AMR,1437,3031,4468,3841,4753,4501,6192,6444,7472,33203,1390,2940,4330,3816,5155,4052,6094,6397,8629,34143,67346,76145,76145
Cayman Islands,2043,KY,CYM,AMR,1467,2994,4461,3797,4747,4538,5980,6486,7716,33264,1420,2903,4323,3683,5359,3971,5914,6426,8932,34285,67549,76334,76334
Cayman Islands,2044,KY,CYM,AMR,1508,2963,4471,3747,4731,4604,5757,6514,7967,33320,1458,2877,4335,3596,5486,3941,5714,6442,9223,34402,67722,76523,76523
Cayman Islands,2045,KY,CYM,AMR,1554,2944,4498,3687,4711,4689,5536,6525,8203,33351,1504,2856,4360,3576,5499,3973,5495,6444,9520,34507,67858,76712,76712
Cayman Islands,2046,KY,CYM,AMR,1606,2939,4545,3629,4686,4787,5313,6516,8434,33365,1555,2846,4401,3559,5454,4072,5270,6432,9800,34587,67952,76907,76907
Cayman Islands,2047,KY,CYM,AMR,1660,2942,4602,3574,4652,4885,5111,6490,8656,33368,1606,2856,4462,3509,5377,4243,5039,6414,10080,34662,68030,77097,77097
Cayman Islands,2048,KY,CYM,AMR,1713,2963,4676,3522,4621,4976,4935,6434,8874,33362,1658,2872,4530,3458,5244,4470,4813,6372,10356,34713,68075,77280,77280
Cayman Islands,2049,KY,CYM,AMR,1760,3000,4760,3471,4595,5049,4782,6346,9097,33340,1704,2911,4615,3410,5071,4732,4608,6314,10616,34751,68091,77463,77463
Cayman Islands,2050,KY,CYM,AMR,1801,3051,4852,3423,4569,5105,4674,6227,9302,33300,1743,2955,4698,3359,4882,5017,4430,6219,10870,34777,68077,77633,77633
Cyprus,1970,CY,CYP,EUR,31003,71061,102064,62442,41166,33256,28781,24496,25137,215278,29008,67676,96684,60170,43452,37698,29484,27907,28062,226773,442051,640804,640804
Cyprus,1971,CY,CYP,EUR,30100,69982,100082,63375,42201,33698,28924,24614,26392,219204,28427,66362,94789,61035,44282,37676,29827,28039,29475,230334,449538,644413,644413
Cyprus,1972,CY,CYP,EUR,29128,68623,97751,64277,43469,34049,29042,24668,27703,223208,27923,64771,92694,61950,45288,37426,30345,27943,31018,233970,457178,647620,647620
Cyprus,1973,CY,CYP,EUR,28632,67155,95787,65286,44966,34250,29109,24645,28353,226609,27717,63170,90887,62963,46426,37149,31042,27623,32222,237425,464034,650705,650705
Cyprus,1974,CY,CYP,EUR,28599,65597,94196,65385,45521,33765,28800,24331,27971,225773,27666,61587,89253,63566,47153,36742,31739,27114,33047,239361,465134,648585,648585
Cyprus,1975,CY,CYP,EUR,28436,63954,92390,65369,45907,33118,28442,24023,27606,224465,27407,60022,87429,63941,47648,36285,32383,26558,33886,240701,465166,644982,644982
Cyprus,1976,CY,CYP,EUR,28569,62277,90846,66790,47799,33461,28592,24097,27785,228524,27323,58519,85842,64615,48819,36382,32980,26214,34642,243652,472176,648868,648868
Cyprus,1977,CY,CYP,EUR,29117,60503,89620,68589,50186,34545,29020,24286,28189,234815,27553,57061,84614,65157,50382,37028,33398,26147,35255,247367,482182,656414,656414
Cyprus,1978,CY,CYP,EUR,29534,58979,88513,69960,52336,36036,29587,24453,28626,240998,27790,55845,83635,65279,51835,38027,33673,26280,35744,250838,491836,663975,663975
Cyprus,1979,CY,CYP,EUR,29904,57791,87695,70769,54303,37903,30252,24614,29112,246953,28117,54863,82980,65005,53147,39311,33843,26568,36113,253987,500940,671611,671611
Cyprus,1980,CY,CYP,EUR,30547,56718,87265,70972,56203,40040,30975,24779,29625,252594,28696,53989,82685,64399,54316,40766,33973,26925,36407,256786,509380,679327,679327
Cyprus,1981,CY,CYP,EUR,31318,55953,87271,70541,58169,42334,31730,24958,30158,257890,29388,53348,82736,63520,55374,42301,34138,27289,36644,259266,517156,687170,687170
Cyprus,1982,CY,CYP,EUR,32325,55967,88292,69489,60242,44440,32496,25233,30609,262509,30309,53263,83572,62524,56441,43802,34462,27680,36952,261861,524370,696227,696227
Cyprus,1983,CY,CYP,EUR,33658,56938,90596,68210,62262,46077,33236,25655,30886,266326,31552,53873,85425,61693,57627,45201,34984,28202,37419,265126,531452,707477,707477
Cyprus,1984,CY,CYP,EUR,34887,58230,93117,67249,64121,47473,34002,26152,31133,270130,32709,54798,87507,61124,58855,46544,35596,28837,37968,268924,539054,719678,719678
Cyprus,1985,CY,CYP,EUR,35755,59365,95120,66820,65749,48855,34849,26662,31417,274352,33534,55723,89257,60809,59999,47860,36244,29517,38507,272936,547288,731664,731664
Cyprus,1986,CY,CYP,EUR,36283,60386,96669,66959,67044,50218,35786,27162,31778,278947,34049,56681,90730,60780,61000,49105,36950,30205,39060,277100,556047,743446,743446
Cyprus,1987,CY,CYP,EUR,36499,61393,97892,67565,67968,51539,36818,27657,32228,283775,34272,57727,91999,61004,61831,50252,37735,30872,39652,281346,565121,755021,755021
Cyprus,1988,CY,CYP,EUR,36471,62461,98932,68435,68587,52807,37940,28144,32775,288688,34264,58871,93135,61402,62506,51280,38617,31507,40340,285652,574340,766412,766412
Cyprus,1989,CY,CYP,EUR,36331,63541,99872,69318,69067,54021,39128,28640,33408,293582,34147,60011,94158,61845,63097,52199,39601,32103,41135,289980,583562,777592,777592
Cyprus,1990,CY,CYP,EUR,36135,64561,100696,70005,69597,55205,40361,29160,34145,298473,33980,61055,95035,62219,63685,53060,40665,32659,42012,294300,592773,788500,788500
Cyprus,1991,CY,CYP,EUR,35870,65474,101344,70354,70378,56346,41641,29723,34964,303406,33741,61952,95693,62449,64352,53891,41799,33180,42941,298612,602018,799061,799061
Cyprus,1992,CY,CYP,EUR,35723,66537,102260,70250,71551,57514,43007,30350,35770,308442,33617,62904,96521,62575,65194,54815,43041,33682,43905,303212,611654,810431,810431
Cyprus,1993,CY,CYP,EUR,36152,68531,104683,69998,72869,58959,44624,31088,36301,313839,34031,64568,98599,63026,66218,56122,44515,34228,44759,308868,622707,825986,825986
Cyprus,1994,CY,CYP,EUR,36779,70835,107614,70357,73934,60689,46445,31934,36680,320039,34637,66512,101149,64109,67226,57771,46174,34837,45520,315637,635676,844444,844444
Cyprus,1995,CY,CYP,EUR,37027,72371,109398,71704,74620,62505,48280,32853,37181,327143,34891,67918,102809,65749,68076,59497,47856,35508,46377,323063,650206,862418,862418
Cyprus,1996,CY,CYP,EUR,36975,73266,110241,73967,74928,64355,50053,33878,37815,334996,34867,68856,103723,67887,68792,61256,49503,36289,47372,331099,666095,880058,880058
Cyprus,1997,CY,CYP,EUR,36605,73773,110378,76920,74956,66186,51698,35039,38592,343391,34558,69498,104056,70388,69441,63008,51078,37215,48524,339654,683045,897471,897471
Cyprus,1998,CY,CYP,EUR,35886,74122,110008,80230,74909,67937,53197,36363,39500,352136,33947,69990,103937,73043,70124,64715,52570,38321,49801,348574,700710,914660,914660
Cyprus,1999,CY,CYP,EUR,35025,74260,109285,83492,75073,69554,54591,37855,40524,361089,33222,70260,103482,75613,70990,66344,54015,39599,51176,357737,718826,931600,931600
Cyprus,2000,CY,CYP,EUR,34170,74114,108284,86300,75778,70970,55962,39504,41650,370164,32528,70236,102764,77850,72194,67867,55478,41034,52598,367021,737185,948237,948237
Cyprus,2001,CY,CYP,EUR,33289,74120,107409,88229,77268,72070,57402,41294,42831,379094,31805,70206,102011,79566,73886,69260,56985,42603,54004,376304,755398,964830,964830
Cyprus,2002,CY,CYP,EUR,32467,75057,107524,89374,79262,72803,58982,43110,43909,387440,31035,70654,101689,80967,76050,70571,58513,44242,55201,385544,772984,982194,982194
Cyprus,2003,CY,CYP,EUR,31846,76122,107968,90606,81374,73281,60718,44867,44994,395840,30372,71129,101501,82418,78443,71899,60062,45909,56297,395028,790868,1000350,1000350
Cyprus,2004,CY,CYP,EUR,31475,76134,107609,92509,83541,73693,62535,46552,46301,405131,29950,70950,100900,83993,80900,73298,61691,47588,57574,405044,810175,1018684,1018684
Cyprus,2005,CY,CYP,EUR,31334,75183,106517,95007,85724,74107,64359,48142,47818,415157,29741,70166,99907,85660,83371,74801,63380,49234,59027,415473,830630,1037062,1037062
Cyprus,2006,CY,CYP,EUR,31376,73518,104894,97859,87993,74594,66107,49626,49552,425731,29726,68908,98634,87288,85879,76425,65128,50804,60652,426176,851907,1055438,1055438
Cyprus,2007,CY,CYP,EUR,31479,71533,103012,100645,90505,75199,67712,51021,51492,436574,29832,67384,97216,88686,88476,78181,66940,52298,62490,437071,873645,1073873,1073873
Cyprus,2008,CY,CYP,EUR,31576,69556,101132,102901,93459,75944,69136,52376,53621,447437,29974,65835,95809,89640,91230,80072,68811,53721,64538,448012,895449,1092390,1092390
Cyprus,2009,CY,CYP,EUR,31690,67762,99452,104247,97017,76839,70362,53765,55882,458112,30141,64394,94535,89967,94171,82094,70744,55119,66781,458876,916988,1110974,1110974
Cyprus,2010,CY,CYP,EUR,31858,66238,98096,104403,101297,77878,71401,55242,58275,468496,30366,63130,93496,89561,97302,84230,72738,56543,69218,469592,938088,1129686,1129686
Cyprus,2011,CY,CYP,EUR,32299,65081,97380,102226,105809,79184,72289,56709,60434,476651,30781,62136,92917,87991,99968,86032,74527,57904,71714,478136,954787,1145086,1145086
Cyprus,2012,CY,CYP,EUR,33037,64304,97341,98039,109919,80788,73057,58147,62379,482329,31394,61433,92827,85428,101822,87444,76020,59205,74147,484066,966395,1156556,1156556
Cyprus,2013,CY,CYP,EUR,33613,63835,97448,93367,113513,82652,73727,59654,64468,487381,31846,60992,92838,82583,103200,88905,77409,60575,76628,489300,976681,1166968,1166968
Cyprus,2014,CY,CYP,EUR,33961,63681,97642,88583,116493,84858,74355,61194,66682,492165,32079,60835,92914,79685,104139,90479,78735,62024,79209,494271,986436,1176995,1176995
Cyprus,2015,CY,CYP,EUR,34277,63836,98113,83992,118687,87476,74975,62727,68967,496824,32271,60965,93236,76888,104613,92214,80008,63544,81842,499109,995933,1187280,1187280
Cyprus,2016,CY,CYP,EUR,34547,64305,98852,79863,119909,90544,75612,64189,71222,501339,32475,61351,93826,74307,104578,94134,81244,65126,84475,503864,1005203,1197881,1197881
Cyprus,2017,CY,CYP,EUR,34600,65071,99671,76405,120007,94072,76300,65537,73443,505764,32527,61973,94500,72040,103977,96249,82450,66756,87123,508595,1014359,1208523,1208523
Cyprus,2018,CY,CYP,EUR,34602,65809,100411,73651,118963,97984,77078,66766,75734,510176,32529,62582,95111,70113,102806,98489,83646,68402,89671,513127,1023303,1218831,1218831
Cyprus,2019,CY,CYP,EUR,34716,66443,101159,71525,116895,102146,77991,67865,78060,514482,32636,63099,95735,68509,101135,100761,84850,70033,92177,517465,1031947,1228836,1228836
Cyprus,2020,CY,CYP,EUR,34672,67137,101809,69794,113787,106339,79035,68801,80369,518125,32592,63681,96273,67062,98893,102900,86054,71629,94798,521336,1039461,1237537,1237537
Cyprus,2021,CY,CYP,EUR,34338,67907,102245,68309,109713,110368,80250,69603,82667,520910,32276,64323,96599,65703,96086,104744,87268,73141,97496,524438,1045348,1244188,1244188
Cyprus,2022,CY,CYP,EUR,33910,68642,102552,67380,105215,114254,81763,70362,85249,524223,31870,64930,96800,64832,93183,106382,88595,74583,100334,527909,1052132,1251488,1251488
Cyprus,2023,CY,CYP,EUR,33530,69214,102744,67027,100607,117862,83644,71092,88177,528409,31515,65383,96898,64512,90384,107777,90066,75980,103377,532096,1060505,1260138,1260138
Cyprus,2024,CY,CYP,EUR,33076,69672,102748,66981,95914,120884,85875,71787,91177,532618,31090,65718,96808,64467,87564,108762,91660,77314,106526,536293,1068911,1268467,1268467
Cyprus,2025,CY,CYP,EUR,32590,69958,102548,67233,91403,123105,88495,72471,94180,536887,30636,65885,96521,64706,84827,109263,93409,78598,109748,540551,1077438,1276508,1276508
Cyprus,2026,CY,CYP,EUR,32139,69953,102092,67789,87328,124321,91552,73163,97118,541271,30215,65828,96043,65183,82285,109217,95332,79832,112992,544841,1086112,1284246,1284246
Cyprus,2027,CY,CYP,EUR,31724,69605,101329,68621,83910,124392,95046,73893,99935,545797,29825,65501,95326,65884,80035,108583,97424,81028,116234,549188,1094985,1291644,1291644
Cyprus,2028,CY,CYP,EUR,31323,69215,100538,69415,81204,123321,98908,74694,102636,550178,29446,65132,94578,66555,78136,107376,99635,82213,119477,553392,1103570,1298685,1298685
Cyprus,2029,CY,CYP,EUR,30922,68862,99784,70091,79136,121226,103014,75619,105271,554357,29068,64804,93872,67120,76579,105671,101880,83404,122722,557376,1111733,1305389,1305389
Cyprus,2030,CY,CYP,EUR,30514,68345,98859,70840,77613,118264,107222,76709,107907,558555,28686,64317,93003,67756,75351,103556,104059,84628,126012,561362,1119917,1311784,1311784
Cyprus,1950,CY,CYP,EUR,33698,52960,86658,43043,33151,28313,22494,15918,14214,157133,31952,51195,83147,44897,36503,30466,23644,16313,15187,167010,324143,493956,493956
Cyprus,1951,CY,CYP,EUR,34483,53357,87840,43568,33658,28786,22878,16091,14335,159316,32775,51934,84709,45263,37006,30964,24087,16579,15517,169416,328732,501274,501274
Cyprus,1952,CY,CYP,EUR,35072,54072,89144,44153,34184,29199,23225,16336,14506,161603,33386,52899,86285,45689,37513,31374,24496,16944,15919,171935,333538,508971,508971
Cyprus,1953,CY,CYP,EUR,35622,54959,90581,44757,34700,29552,23580,16646,14750,163985,33919,53949,87868,46159,37988,31711,24905,17422,16403,174588,338573,517021,517021
Cyprus,1954,CY,CYP,EUR,35620,56618,92238,45298,35170,29865,23991,17009,15028,166361,33954,55566,89520,46639,38400,32007,25364,17970,16899,177279,343640,525402,525402
Cyprus,1955,CY,CYP,EUR,35453,58746,94199,45753,35555,30144,24463,17413,15323,168651,33808,57524,91332,47114,38780,32272,25892,18554,17334,179946,348597,534125,534125
Cyprus,1956,CY,CYP,EUR,35840,60709,96549,46116,35823,30386,25000,17850,15592,170767,34125,59284,93409,47599,39185,32501,26498,19131,17605,182519,353286,543250,543250
Cyprus,1957,CY,CYP,EUR,36392,62941,99333,46423,35972,30605,25597,18317,15825,172739,34632,61196,95828,48110,39651,32701,27186,19666,17670,184984,357723,552883,552883
Cyprus,1958,CY,CYP,EUR,37172,65331,102503,46742,36046,30811,26220,18794,16046,174659,35394,63197,98591,48666,40203,32878,27905,20142,17602,187396,362055,563154,563154
Cyprus,1959,CY,CYP,EUR,38183,67734,105917,47170,36113,31017,26825,19272,16315,176712,36449,65171,101620,49312,40859,33030,28602,20553,17549,189905,366617,574158,574158
Cyprus,1960,CY,CYP,EUR,39287,69923,109210,47866,36260,31230,27377,19745,16682,179160,37681,66951,104632,50123,41587,33163,29227,20930,17683,192713,371873,585725,585725
Cyprus,1961,CY,CYP,EUR,39481,71143,110624,48863,36757,31459,27809,20297,17122,182307,37970,67922,105892,50906,42252,33323,29738,21444,18291,195954,378261,594771,594771
Cyprus,1962,CY,CYP,EUR,38678,71465,110143,50135,37555,31705,28089,20922,17647,186053,37149,68186,105335,51686,42715,33585,30070,22142,19366,199564,385617,601095,601095
Cyprus,1963,CY,CYP,EUR,37641,71692,109333,51639,38318,31912,28244,21525,18303,189941,36040,68456,104496,52674,42961,33965,30203,22897,20602,203302,393243,607072,607072
Cyprus,1964,CY,CYP,EUR,36394,71965,108359,53267,38890,32041,28295,22078,19025,193596,34655,68845,103500,53784,43006,34467,30145,23691,21796,206889,400485,612338,612338
Cyprus,1965,CY,CYP,EUR,35100,72326,107426,54991,39257,32117,28308,22600,19837,197110,33162,69346,102508,54949,42897,35082,29959,24537,22876,210300,407410,617345,617345
Cyprus,1966,CY,CYP,EUR,34141,72494,106635,56777,39493,32198,28353,23124,20751,200696,32029,69588,101617,56126,42721,35771,29722,25413,23858,213611,414307,622566,622566
Cyprus,1967,CY,CYP,EUR,33443,72424,105867,58504,39675,32320,28425,23602,21761,204287,31223,69490,100713,57261,42575,36462,29492,26255,24782,216827,421114,627695,627695
Cyprus,1968,CY,CYP,EUR,32680,72241,104921,60047,39938,32524,28515,23996,22822,207842,30423,69222,99645,58314,42595,37063,29339,26988,25747,220046,427888,632452,632452
Cyprus,1969,CY,CYP,EUR,31863,71812,103675,61354,40414,32843,28638,24295,23952,211496,29676,68635,98311,59276,42880,37489,29324,27549,26823,223341,434837,636821,636821
Cyprus,2031,CY,CYP,EUR,30102,67619,97721,71688,76549,114577,111391,78021,110577,562803,28299,63638,91937,68483,74439,101123,106063,85917,129365,565390,1128193,1317850,1317850
Cyprus,2032,CY,CYP,EUR,29717,66814,96531,72466,75869,110340,115360,79600,113324,566959,27934,62878,90812,69136,73826,98463,107800,87291,132786,569302,1136261,1323605,1323605
Cyprus,2033,CY,CYP,EUR,29372,66035,95407,73039,75519,105764,118949,81490,116149,570910,27607,62145,89752,69588,73504,95674,109195,88768,136264,572993,1143903,1329063,1329063
Cyprus,2034,CY,CYP,EUR,29067,65181,94248,73495,75477,101104,121951,83723,119003,574753,27319,61348,88667,69923,73462,92864,110182,90368,139788,576587,1151340,1334251,1334251
Cyprus,2035,CY,CYP,EUR,28806,64287,93093,73784,75734,96625,124171,86335,121838,578487,27072,60509,87581,70090,73702,90135,110690,92115,143315,580047,1158534,1339205,1339205
Cyprus,2036,CY,CYP,EUR,28591,63428,92019,73782,76291,92578,125393,89367,124600,582011,26871,59698,86569,70034,74180,87604,110658,94031,146801,583308,1165319,1343910,1343910
Cyprus,2037,CY,CYP,EUR,28427,62626,91053,73434,77129,89185,125477,92812,127276,585313,26717,58945,85662,69706,74881,85365,110036,96118,150239,586345,1171658,1348377,1348377
Cyprus,2038,CY,CYP,EUR,28305,61882,90187,73047,77921,86499,124430,96613,129904,588414,26603,58243,84846,69344,75554,83474,108846,98320,153645,589183,1177597,1352623,1352623
Cyprus,2039,CY,CYP,EUR,28226,61175,89401,72694,78598,84446,122372,100646,132574,591330,26529,57579,84108,69009,76117,81924,107163,100555,157069,591837,1183167,1356675,1356675
Cyprus,2040,CY,CYP,EUR,28194,60508,88702,72178,79348,82942,119454,104778,135388,594088,26502,56945,83447,68526,76756,80704,105072,102723,160542,594323,1188411,1360553,1360553
Cyprus,2041,CY,CYP,EUR,28213,59883,88096,71457,80198,81890,115826,108872,138429,596672,26518,56359,82877,67848,77480,79796,102665,104718,164137,596644,1193316,1364280,1364280
Cyprus,2042,CY,CYP,EUR,28278,59336,87614,70649,80976,81217,111651,112771,141789,599053,26582,55842,82424,67089,78136,79185,100037,106449,167875,598771,1197824,1367860,1367860
Cyprus,2043,CY,CYP,EUR,28391,58870,87261,69872,81552,80878,107146,116300,145496,601244,26689,55399,82088,66357,78589,78869,97278,107849,171766,600708,1201952,1371301,1371301
Cyprus,2044,CY,CYP,EUR,28550,58486,87036,69020,82009,80844,102561,119265,149550,603249,26836,55042,81878,65556,78925,78831,94502,108843,175808,602465,1205714,1374621,1374621
Cyprus,2045,CY,CYP,EUR,28735,58192,86927,68132,82298,81102,98148,121461,153930,605071,27008,54765,81773,64724,79091,79073,91805,109374,179979,604046,1209117,1377817,1377817
Cyprus,2046,CY,CYP,EUR,28940,57995,86935,67272,82302,81661,94170,122688,158629,606722,27197,54584,81781,63913,79033,79556,89305,109371,184280,605458,1212180,1380891,1380891
Cyprus,2047,CY,CYP,EUR,29153,57897,87050,66471,81957,82501,90832,122806,163635,608202,27396,54491,81887,63161,78713,80253,87090,108791,188690,606698,1214900,1383832,1383832
Cyprus,2048,CY,CYP,EUR,29361,57890,87251,65728,81572,83296,88193,121818,168922,609529,27594,54484,82078,62457,78345,80924,85222,107652,193171,607771,1217300,1386636,1386636
Cyprus,2049,CY,CYP,EUR,29560,57970,87530,65026,81220,83974,86182,119851,174454,610707,27781,54561,82342,61792,78014,81491,83698,106027,197685,608707,1219414,1389291,1389291
Cyprus,2050,CY,CYP,EUR,29741,58123,87864,64356,80708,84728,84709,117049,180210,611760,27949,54703,82652,61161,77532,82130,82495,104006,202179,609503,1221263,1391785,1391785
Czechia,1970,CZ,CZE,EUR,353391,718102,1071493,868801,637823,615480,520028,569484,461128,3672744,335936,682150,1018086,833931,627286,633540,568879,649800,719990,4033426,7706170,9795744,9795744
Czechia,1971,CZ,CZE,EUR,356773,708097,1064870,865495,664919,602665,540854,544529,469766,3688228,339700,672626,1012326,829537,653024,617723,592179,624643,734013,4051119,7739347,9816549,9816549
Czechia,1972,CZ,CZE,EUR,367059,698635,1065694,850966,701544,591034,568028,511432,480480,3703484,349802,663806,1013608,815344,687926,602749,622632,589381,750456,4068488,7771972,9851275,9851275
Czechia,1973,CZ,CZE,EUR,385181,693375,1078556,832105,737050,580896,596035,476837,491384,3714307,366509,659015,1025524,797796,720978,589882,653484,552338,767427,4081905,7796212,9900291,9900291
Czechia,1974,CZ,CZE,EUR,409626,695442,1105068,811181,766803,572331,616391,449339,501591,3717636,389373,660978,1050351,778346,748434,579668,674207,523918,783232,4087805,7805441,9960863,9960863
Czechia,1975,CZ,CZE,EUR,433636,703000,1136636,788797,790606,567870,621969,437409,511428,3718079,412739,668762,1081501,756637,770741,573537,677788,512329,798468,4089500,7807579,10025715,10025715
Czechia,1976,CZ,CZE,EUR,452865,713300,1166165,765678,811513,567718,618625,435410,520077,3719021,431378,679496,1110874,734059,790764,571495,671484,511352,812832,4091986,7811007,10088044,10088044
Czechia,1977,CZ,CZE,EUR,465521,726709,1192230,744163,830441,571059,611014,436652,527445,3720774,443676,692597,1136273,713231,809023,573228,660251,513975,825510,4095218,7815992,10144499,10144499
Czechia,1978,CZ,CZE,EUR,469144,743316,1212460,728348,842854,581899,600353,438751,534017,3726222,447853,708083,1155936,697951,820767,582855,645465,517320,836885,4101243,7827465,10195871,10195871
Czechia,1979,CZ,CZE,EUR,462905,762677,1225582,719097,848752,599866,588963,441349,537984,3736011,442352,726602,1168954,688481,826316,599696,629530,521357,845273,4110653,7846664,10241203,10241203
Czechia,1980,CZ,CZE,EUR,448873,784136,1233009,711131,852993,619754,577639,448908,533221,3743646,428319,747830,1176149,680307,830021,618382,614378,531502,842660,4117250,7860896,10270060,10270060
Czechia,1981,CZ,CZE,EUR,429390,807556,1236946,701288,850018,646540,565933,465780,517857,3747416,408994,770662,1179656,670705,826617,644123,599526,552807,826032,4119810,7867226,10283835,10283835
Czechia,1982,CZ,CZE,EUR,408286,830748,1239034,692307,836279,681847,554995,487716,497723,3750867,388832,793043,1181875,661829,813271,677991,585268,580849,802712,4121920,7872787,10293691,10293691
Czechia,1983,CZ,CZE,EUR,388012,851823,1239835,687816,817696,716324,545462,509525,476381,3753204,369341,813195,1182536,657113,795914,710582,573110,608738,777135,4122592,7875796,10298164,10298164
Czechia,1984,CZ,CZE,EUR,369335,869022,1238357,690309,797047,744979,537644,524759,461786,3756524,351403,829585,1180988,659117,776188,737756,563685,627105,759991,4123842,7880366,10299715,10299715
Czechia,1985,CZ,CZE,EUR,355797,877968,1233765,698297,775086,767949,533643,528748,459408,3763131,338977,837795,1176772,666916,754160,760102,558079,630693,758704,4128654,7891785,10302326,10302326
Czechia,1986,CZ,CZE,EUR,348086,877246,1225332,708959,752538,788266,533646,525680,463541,3772630,331835,836725,1168560,677476,731203,780409,556218,625330,765526,4136162,7908792,10302680,10302680
Czechia,1987,CZ,CZE,EUR,342837,868753,1211590,722749,731582,806020,537356,519526,469866,3787099,326350,828853,1155203,690535,709989,798454,558419,615478,775317,4148192,7935291,10302082,10302082
Czechia,1988,CZ,CZE,EUR,338904,851542,1190446,739489,716694,816878,548238,511458,477198,3809955,322539,812981,1135520,705839,694992,809335,568444,602601,787027,4168238,7978193,10304152,10304152
Czechia,1989,CZ,CZE,EUR,335075,826447,1161522,758276,708410,822080,565177,502470,483269,3839682,319365,789236,1108601,723507,686023,814313,584856,588582,797417,4194698,8034380,10304496,10304496
Czechia,1990,CZ,CZE,EUR,331304,798106,1129410,779947,701095,826189,583207,492659,487224,3870321,315800,761745,1077545,744707,677968,818207,602750,574770,805522,4223924,8094245,10301192,10301192
Czechia,1991,CZ,CZE,EUR,329110,771228,1100338,802840,692960,823581,608230,482492,490916,3901019,313338,735448,1048786,767221,669076,815031,628020,560984,812890,4253222,8154241,10303362,10303362
Czechia,1992,CZ,CZE,EUR,326247,746726,1072973,825031,685760,811613,642101,473697,495239,3933441,310332,711607,1021939,788794,660578,802718,661695,548244,820567,4282596,8216037,10310956,10310956
Czechia,1993,CZ,CZE,EUR,321912,723460,1045372,846205,682816,795642,674995,466465,500532,3966655,305903,689294,995197,809094,656472,786712,693828,537473,828108,4311687,8278342,10318916,10318916
Czechia,1994,CZ,CZE,EUR,314478,701732,1016210,864003,686348,777741,702541,461447,507065,3999145,298368,668896,967264,826176,659171,768211,720390,529686,835056,4338690,8337835,10321302,10321302
Czechia,1995,CZ,CZE,EUR,300710,685769,986479,873203,694816,758477,725649,459932,514014,4026091,284954,654152,939106,834905,666836,747705,742980,525181,842426,4360033,8386124,10311702,10311702
Czechia,1996,CZ,CZE,EUR,282540,676658,959198,872932,706045,738675,746566,461853,521102,4047173,267769,645343,913112,834602,677231,726393,763833,524109,850006,4376174,8423347,10295651,10295651
Czechia,1997,CZ,CZE,EUR,264909,668868,933777,865377,720316,720304,764792,467422,527768,4065979,251301,637010,888311,827981,690275,706640,782200,527492,856395,4390983,8456962,10279044,10279044
Czechia,1998,CZ,CZE,EUR,249393,660659,910052,848896,737505,707966,776715,479426,533277,4083785,236598,628615,865213,813091,705767,693042,793576,538291,861015,4404782,8488567,10263833,10263833
Czechia,1999,CZ,CZE,EUR,237337,649546,886883,824771,756472,702001,783957,496645,537583,4101429,225108,618065,843173,790375,723519,685245,799584,555108,863837,4417668,8519097,10249147,10249147
Czechia,2000,CZ,CZE,EUR,231085,633063,864148,797930,777940,696693,790635,514858,540677,4118733,218820,602213,821033,764476,744547,677991,804707,573394,865678,4430793,8549526,10234710,10234710
Czechia,2001,CZ,CZE,EUR,229365,613791,843156,774054,801913,690737,790506,539653,543395,4140258,216806,583570,800376,740409,767707,670060,802567,598704,867038,4446485,8586743,10230276,10230276
Czechia,2002,CZ,CZE,EUR,230420,594051,824471,754069,827137,685849,780899,572317,546380,4166651,217675,564809,782484,719379,791186,662839,791109,631856,868187,4464556,8631207,10238170,10238170
Czechia,2003,CZ,CZE,EUR,232622,574084,806706,735780,851763,685159,767282,603639,549506,4193129,219606,545702,765308,700399,813780,659863,776093,663211,869547,4482893,8676022,10248038,10248038
Czechia,2004,CZ,CZE,EUR,236158,554455,790613,718568,873295,691295,751776,629894,554529,4219357,222827,526482,749309,683211,833419,663770,758807,689191,873323,4501721,8721078,10260999,10260999
Czechia,2005,CZ,CZE,EUR,241721,534978,776699,706015,886871,702575,735422,652043,563628,4246554,228356,507145,735501,671181,844910,673031,739683,711326,881231,4521362,8767916,10280113,10280113
Czechia,2006,CZ,CZE,EUR,248992,515772,764764,699391,891415,716673,719011,672208,576072,4274770,235453,488428,723881,664558,847507,685004,720100,731641,892590,4541400,8816170,10304815,10304815
Czechia,2007,CZ,CZE,EUR,258791,499274,758065,692923,889222,733902,704406,690541,590670,4301664,245022,472820,717842,657651,844372,699506,702232,750022,906469,4560252,8861916,10337829,10337829
Czechia,2008,CZ,CZE,EUR,271671,485555,757226,684948,878801,754140,695739,703530,609358,4326516,257798,459646,717444,650000,833678,716401,690526,762021,924776,4577402,8903918,10378583,10378583
Czechia,2009,CZ,CZE,EUR,284896,477066,761962,673043,860563,776823,693813,711778,631015,4347035,271013,451228,722241,639317,814994,736059,684981,768384,946538,4590273,8937308,10421510,10421510
Czechia,2010,CZ,CZE,EUR,296526,476996,773522,654483,839979,802240,692928,720165,651069,4360864,282569,451064,733633,622184,793483,759335,679987,774742,967002,4596733,8957597,10464749,10464749
Czechia,2011,CZ,CZE,EUR,302207,483774,785981,632310,818779,828467,689263,722167,675889,4366875,288126,457448,745574,601943,771900,783674,672873,774194,993367,4597951,8964826,10496379,10496379
Czechia,2012,CZ,CZE,EUR,300065,495692,795757,609766,796317,852950,684588,714525,707507,4365653,286149,468910,755059,581733,750288,806916,665411,763197,1027051,4594596,8960249,10511065,10511065
Czechia,2013,CZ,CZE,EUR,293874,511025,804899,587092,773453,874662,682452,703187,737747,4358593,280127,483901,764028,560564,729676,828132,660923,748876,1058857,4587028,8945621,10514552,10514552
Czechia,2014,CZ,CZE,EUR,287394,527172,814566,567045,751097,892152,686692,690091,764366,4351443,273634,499669,773303,540276,709634,844728,663158,732535,1087543,4577874,8929317,10517182,10517182
Czechia,2015,CZ,CZE,EUR,282677,541583,824260,550330,733916,901902,696167,676443,788954,4347712,268815,514074,782889,522132,693763,852681,671182,714536,1114644,4568938,8916650,10523798,10523798
Czechia,2016,CZ,CZE,EUR,280608,552224,832832,533937,723797,902908,707571,662725,812905,4343843,266868,524677,791545,505169,683732,852014,681119,696132,1141206,4559372,8903215,10527591,10527591
Czechia,2017,CZ,CZE,EUR,281471,559579,841050,519320,715691,897352,721523,650234,836056,4340176,267641,531951,799592,491091,674456,845643,693116,678938,1167236,4550480,8890656,10531305,10531305
Czechia,2018,CZ,CZE,EUR,283502,565620,849122,506900,707349,884271,738271,642214,857394,4336399,269508,538044,807552,479348,664994,832409,707358,666686,1190719,4541514,8877913,10534593,10534593
Czechia,2019,CZ,CZE,EUR,285558,570973,856531,497908,697494,863534,757300,639930,876575,4332741,271583,543429,815012,470830,654489,811709,723817,659880,1211863,4532588,8865329,10536871,10536871
Czechia,2020,CZ,CZE,EUR,285161,575963,861124,494235,681886,839435,778943,638949,892911,4326359,271490,548318,819808,467432,639756,787912,743623,654292,1230646,4523661,8850020,10530953,10530953
Czechia,2021,CZ,CZE,EUR,281969,579537,861506,496051,661079,815338,802245,635960,904248,4314921,268612,551909,820521,469426,621089,764556,765729,647528,1245474,4513802,8828723,10510751,10510751
Czechia,2022,CZ,CZE,EUR,277641,579738,857379,509050,642755,793087,824575,632199,910428,4312094,264410,552261,816671,481348,602056,741322,786628,640598,1255893,4507845,8819939,10493986,10493986
Czechia,2023,CZ,CZE,EUR,272557,576420,848977,530964,628971,772993,845481,631332,916996,4326737,259351,549057,808408,501183,584434,718859,805097,636869,1264726,4511168,8837905,10495295,10495295
Czechia,2024,CZ,CZE,EUR,266818,571376,838194,553167,617067,754562,863674,635923,923972,4348365,253635,544109,797744,521802,568125,698495,820280,639278,1271452,4519432,8867797,10503734,10503734
Czechia,2025,CZ,CZE,EUR,261539,565536,827075,573426,606791,740759,874765,645075,928483,4369299,248393,538433,786826,541090,553271,682562,828363,646771,1274713,4526770,8896069,10509965,10509965
Czechia,2026,CZ,CZE,EUR,257304,560265,817569,589824,597642,733670,876797,656821,932978,4387732,244200,533455,777655,556757,540214,672322,827712,656760,1277561,4531326,8919058,10514272,10514272
Czechia,2027,CZ,CZE,EUR,253838,556350,810188,602180,590999,729228,871606,670970,938284,4403267,240771,529713,770484,568441,530424,663695,820393,668853,1281051,4532857,8936124,10516793,10516793
Czechia,2028,CZ,CZE,EUR,251036,552753,803789,611786,587452,724421,858917,688146,946422,4417144,238003,526067,764070,577716,523869,654539,806075,683321,1287163,4532683,8949827,10517691,10517691
Czechia,2029,CZ,CZE,EUR,248919,548301,797220,619447,588368,717607,838874,707860,958461,4430617,235902,521687,757589,585264,521597,643823,784274,700079,1296614,4531651,8962268,10517076,10517076
Czechia,2030,CZ,CZE,EUR,247452,542504,789956,625166,596338,706644,815760,729590,970832,4444330,234439,516234,750673,590869,526306,629215,758646,719457,1305743,4530236,8974566,10515199,10515199
Czechia,1950,CZ,CZE,EUR,452114,647166,1099280,670019,579754,705610,597414,367216,316671,3236684,433670,629104,1062774,653402,603846,729235,651617,457101,422705,3517906,6754590,8916634,8916634
Czechia,1951,CZ,CZE,EUR,456219,677927,1134146,649511,606275,676952,612080,375633,320335,3240786,436026,658061,1094087,634761,628962,701169,661418,469660,431961,3527931,6768717,8996945,8996945
Czechia,1952,CZ,CZE,EUR,450995,717823,1168818,629970,640046,638214,626993,385521,323899,3244643,429868,695586,1125454,618174,660658,662622,671930,482867,441358,3537609,6782252,9076531,9076531
Czechia,1953,CZ,CZE,EUR,444316,756210,1200526,614959,672849,597002,640516,396712,327138,3249176,422625,731348,1153973,604042,693116,621785,681662,496250,451099,3547954,6797130,9151638,9151638
Czechia,1954,CZ,CZE,EUR,439147,788229,1227376,604214,693688,565367,652670,409756,329253,3254948,417252,760836,1178088,593269,713531,591104,691166,510777,460207,3560054,6815002,9220466,9220466
Czechia,1955,CZ,CZE,EUR,433563,814782,1248345,598004,698690,549878,661940,425532,332252,3266296,411810,785192,1197002,586576,717117,577083,699256,527185,470122,3577339,6843635,9288972,9288972
Czechia,1956,CZ,CZE,EUR,425812,838174,1263986,596607,694158,544492,667891,442706,336794,3282648,404609,806813,1211422,584153,710630,573508,704781,544195,482212,3599479,6882127,9357535,9357535
Czechia,1957,CZ,CZE,EUR,416368,858036,1274404,600762,683892,543858,670527,460759,340393,3300191,395680,825129,1220809,587085,698056,574791,707943,561054,493835,3622764,6922955,9418155,9418155
Czechia,1958,CZ,CZE,EUR,404115,869885,1274000,613295,671186,544274,671862,478688,344063,3323368,384167,835649,1219816,598612,682513,576690,710465,576799,506162,3651241,6974609,9468429,9468429
Czechia,1959,CZ,CZE,EUR,387368,875669,1263037,632742,657539,544984,671563,494791,349066,3350685,368518,840132,1208650,617188,665651,578716,711888,590216,520662,3684321,7035006,9506695,9506695
Czechia,1960,CZ,CZE,EUR,369247,880689,1249936,654331,643662,554371,660841,508308,355618,3377131,351545,843592,1195137,637632,649352,589564,702668,600724,537216,3717156,7094287,9539362,9539362
Czechia,1961,CZ,CZE,EUR,352800,877181,1229981,683160,629599,577633,634187,522149,363885,3410613,336217,838817,1175034,665122,632955,614555,675844,610636,555663,3754775,7165388,9570405,9570405
Czechia,1962,CZ,CZE,EUR,339314,862141,1201455,720111,616839,607034,598162,536261,371703,3450110,323330,823379,1146709,700228,617239,645942,638672,620828,572955,3795864,7245974,9594139,9594139
Czechia,1963,CZ,CZE,EUR,335615,842725,1178340,755660,605158,637864,559462,548915,380210,3487269,319578,804343,1123921,733244,603366,677971,599148,630318,590355,3834402,7321671,9623934,9623934
Czechia,1964,CZ,CZE,EUR,343703,821135,1164838,785159,595298,659210,529375,560803,390837,3520682,326823,783297,1110120,760159,592325,698417,569170,639669,609605,3869345,7390027,9664981,9664981
Czechia,1965,CZ,CZE,EUR,354109,797709,1151818,809277,589363,665232,514967,570054,403248,3552141,336383,760330,1096713,782146,585184,701869,555793,647341,629723,3902056,7454197,9702730,9702730
Czechia,1966,CZ,CZE,EUR,360940,773396,1134336,830452,587686,661887,510393,576293,416694,3583405,342777,736602,1079379,801626,582057,695338,552736,652834,650092,3934683,7518088,9731805,9731805
Czechia,1967,CZ,CZE,EUR,364408,750889,1115297,849057,590202,653230,510089,579716,430304,3612598,345831,714751,1060582,818569,583278,682929,554202,656310,670494,3965782,7578380,9754258,9754258
Czechia,1968,CZ,CZE,EUR,362463,734899,1097362,860371,600572,641502,510809,581083,442874,3637211,343893,699279,1043172,828334,592633,667116,556324,658751,689197,3992355,7629566,9770099,9770099
Czechia,1969,CZ,CZE,EUR,356593,726012,1082605,864868,618432,628414,511983,579838,453068,3656603,338548,690185,1028733,831674,609330,649931,558892,659053,705738,4014618,7671221,9782560,9782560
Czechia,2031,CZ,CZE,EUR,246688,535842,782530,628235,610827,692621,793176,752539,980626,4458024,233655,509854,743509,594032,537825,611401,732988,740459,1311772,4528477,8986501,10512538,10512538
Czechia,2032,CZ,CZE,EUR,246771,528500,775271,628045,629934,678059,772299,774761,988509,4471607,233676,502636,736312,594029,554463,593066,708913,760763,1315151,4526385,8997992,10509580,10509580
Czechia,2033,CZ,CZE,EUR,247689,520631,768320,624772,651785,664503,753104,795375,995564,4485103,234485,494819,729304,590843,574283,575561,686891,779085,1317205,4523868,9008971,10506590,10506590
Czechia,2034,CZ,CZE,EUR,249421,512788,762209,619773,673936,652811,735456,813028,1003044,4498048,236074,487011,723085,585915,594877,559356,666904,794019,1319385,4520456,9018504,10503807,10503807
Czechia,2035,CZ,CZE,EUR,251935,506054,757989,613985,694152,642741,722314,823878,1012493,4509563,238409,480314,718723,580261,614147,544609,651285,801991,1322947,4515240,9024803,10501506,10501506
Czechia,2036,CZ,CZE,EUR,255045,501072,756117,608750,710531,633790,715695,826068,1024408,4519242,241311,475345,716656,575299,629801,531646,641268,801412,1328456,4507882,9027124,10499897,10499897
Czechia,2037,CZ,CZE,EUR,258520,497696,756216,604867,722889,627329,711625,821435,1039412,4527557,244569,471946,716515,571572,641482,521943,632829,794345,1336739,4498910,9026467,10499200,10499200
Czechia,2038,CZ,CZE,EUR,262220,495820,758040,601297,732514,623938,707168,809876,1060008,4534801,248043,469995,718038,567937,650752,515465,623860,780535,1350104,4488653,9023454,10499538,10499538
Czechia,2039,CZ,CZE,EUR,266108,495446,761554,596873,740206,624976,700720,791590,1086749,4541114,251705,469490,721195,563572,658306,513251,613331,759543,1369348,4477351,9018465,10501215,10501215
Czechia,2040,CZ,CZE,EUR,270056,496498,766554,591107,745967,632999,690166,770536,1115904,4546679,255424,470367,725791,558134,663916,517988,598928,734889,1391430,4465285,9011964,10504313,10504313
Czechia,2041,CZ,CZE,EUR,273777,498851,772628,584475,749091,647484,676585,750009,1144091,4551735,258931,472487,731418,551767,667093,529502,581345,710236,1412837,4452780,9004515,10508559,10508559
Czechia,2042,CZ,CZE,EUR,277155,502416,779571,577172,748975,666553,662465,731092,1170226,4556483,262117,475768,737885,544566,667109,546119,563234,687123,1431899,4440050,8996533,10513988,10513988
Czechia,2043,CZ,CZE,EUR,280078,507038,787116,569338,745784,688347,649343,713764,1194459,4561035,264875,480059,744934,536769,663947,565906,545960,666009,1448745,4427336,8988371,10520411,10520411
Czechia,2044,CZ,CZE,EUR,282361,512661,795022,561534,740880,710439,638058,697893,1216694,4565498,267032,485312,752344,528978,659049,586465,529979,646879,1463476,4414826,8980324,10527692,10527692
Czechia,2045,CZ,CZE,EUR,283984,519128,803112,554834,735187,730609,628389,686221,1234792,4570032,268563,491369,759932,522299,653424,605702,515450,631972,1473827,4402674,8972706,10535748,10535748
Czechia,2046,CZ,CZE,EUR,284945,525964,810909,549876,730041,746961,619848,680642,1247478,4574846,269468,497778,767246,517343,648488,621329,502704,622472,1478795,4391131,8965977,10544122,10544122
Czechia,2047,CZ,CZE,EUR,285272,532821,818093,546527,726229,759311,613766,677381,1256934,4580148,269770,504221,773991,513956,644784,632995,493197,614465,1481091,4380488,8960636,10552717,10552717
Czechia,2048,CZ,CZE,EUR,284965,539444,824409,544674,722730,768942,610703,673682,1265307,4586038,269463,510459,779922,512015,641172,642252,486884,605914,1482572,4370809,8956847,10561172,10561172
Czechia,2049,CZ,CZE,EUR,284079,545619,829698,544319,718375,776649,611990,668015,1273221,4592569,268611,516280,784891,511518,636827,649798,484803,595812,1483435,4362193,8954762,10569346,10569346
Czechia,2050,CZ,CZE,EUR,282673,551195,833868,545387,712681,782438,620121,658342,1280814,4599783,267277,521532,788809,512402,631413,655414,489602,581886,1483947,4354664,8954447,10577126,10577126
Germany,1970,DE,DEU,EUR,3081759,6271143,9352902,5164826,6138272,5014106,3293572,3931450,4110413,27652639,2933434,5962892,8896326,4945745,5700731,4944409,4656451,5571000,6574372,32392708,60045347,78294583,78294583
Germany,1971,DE,DEU,EUR,2936997,6388540,9325537,5336368,5949165,5181636,3437062,3726367,4176260,27806858,2796081,6074881,8870962,5115257,5537840,4988179,4783531,5366153,6717082,32508042,60314900,78511398,78511398
Germany,1972,DE,DEU,EUR,2767226,6474849,9242075,5475339,5798651,5335116,3645812,3485552,4233070,27973540,2633338,6159848,8793186,5254188,5411271,5060667,4959794,5079423,6869423,32634766,60608306,78643556,78643556
Germany,1973,DE,DEU,EUR,2573873,6520995,9094868,5588073,5664732,5469767,3899105,3242753,4282496,28146926,2449601,6206652,8656253,5368049,5300620,5156707,5142469,4776948,7024624,32769417,60916343,78667466,78667466
Germany,1974,DE,DEU,EUR,2385154,6512804,8897958,5686268,5521550,5620154,4119981,3061008,4325962,28334923,2271740,6200191,8471931,5469371,5179650,5288000,5246349,4550848,7181510,32915728,61250651,78620534,78620534
Germany,1975,DE,DEU,EUR,2227326,6439582,8666908,5779638,5375877,5787865,4245974,2985509,4353819,28528682,2122614,6130529,8253143,5561112,5058233,5444720,5202448,4476901,7321363,33064777,61593459,78513511,78513511
Germany,1976,DE,DEU,EUR,2102349,6309230,8411579,5887567,5249513,5941439,4313000,2971286,4363666,28726471,2004710,6005650,8010360,5656295,4960019,5597195,5078799,4485793,7437702,33215803,61942274,78364216,78364216
Germany,1977,DE,DEU,EUR,2021583,6120617,8142200,6009943,5201363,6033744,4362979,2950705,4382831,28941565,1928370,5827014,7755384,5757217,4937059,5697379,4952696,4472279,7565497,33382127,62323692,78221272,78221272
Germany,1978,DE,DEU,EUR,1994445,5868727,7863172,6142140,5206953,6079266,4422943,2910951,4401002,29163255,1900931,5591330,7492261,5862623,4962363,5758885,4849326,4422130,7697536,33552863,62716118,78071549,78071549
Germany,1979,DE,DEU,EUR,2000381,5579810,7580191,6278894,5221350,6070206,4540519,2877931,4398921,29387821,1904645,5322074,7226719,5970717,4989196,5775613,4807603,4370037,7807825,33720991,63108812,77915727,77915727
Germany,1980,DE,DEU,EUR,2027191,5287962,7315153,6404680,5320228,5921003,4698774,2912856,4352819,29610360,1929686,5050038,6979724,6072658,5086674,5658977,4826109,4388287,7848760,33881465,63491825,77786703,77786703
Germany,1981,DE,DEU,EUR,2063905,5008460,7072365,6512617,5476068,5710024,4848565,3038985,4241364,29827623,1964785,4787556,6752341,6167086,5231637,5478353,4870690,4510904,7773490,34032160,63859783,77684489,77684489
Germany,1982,DE,DEU,EUR,2095056,4753870,6848926,6594395,5600902,5544818,4987169,3220484,4095780,30043548,1994452,4545825,6540277,6243076,5344547,5337222,4943504,4677918,7631413,34177680,64221228,77610430,77610430
Germany,1983,DE,DEU,EUR,2116252,4532271,6648523,6643405,5703795,5404623,5111511,3442276,3948975,30254585,2014835,4335178,6350013,6289255,5437010,5214642,5040486,4851575,7479978,34312946,64567531,77566064,77566064
Germany,1984,DE,DEU,EUR,2126608,4352043,6478651,6647789,5799184,5266965,5255489,3638520,3853660,30461607,2024164,4165123,6189287,6292379,5526010,5086957,5172977,4954238,7406463,34439024,64900631,77568572,77568572
Germany,1985,DE,DEU,EUR,2125987,4230857,6356844,6596971,5901614,5140257,5421858,3758051,3840735,30659486,2022442,4050767,6073209,6241999,5619718,4966697,5330984,4922950,7466927,34549275,65208761,77638808,77638808
Germany,1986,DE,DEU,EUR,2126946,4162788,6289734,6498959,6035057,5043612,5583178,3830421,3867223,30858450,2022222,3985593,6007815,6146228,5735381,4878202,5486920,4819129,7581495,34647355,65505805,77803357,77803357
Germany,1987,DE,DEU,EUR,2144163,4143181,6287344,6350223,6199235,5033295,5694571,3888678,3895524,31061526,2037187,3964055,6001242,6004516,5873777,4874345,5594591,4712659,7680888,34740776,65802302,78090895,78090895
Germany,1988,DE,DEU,EUR,2180251,4172892,6353143,6140539,6386294,5083620,5770403,3957263,3912857,31250976,2069995,3986645,6056640,5808362,6029186,4927846,5666794,4628331,7756255,34816774,66067750,78477530,78477530
Germany,1989,DE,DEU,EUR,2227744,4227326,6455070,5893443,6585235,5148719,5802653,4081285,3923719,31435054,2114366,4031897,6146263,5577916,6195135,4990267,5698022,4603912,7814797,34880049,66315103,78916438,78916438
Germany,1990,DE,DEU,EUR,2274077,4292309,6566386,5639864,6775297,5302147,5701820,4247078,3954257,31620463,2157380,4089011,6246391,5341506,6356685,5129471,5600146,4637716,7871437,34936961,66557424,79370196,79370196
Germany,1991,DE,DEU,EUR,2294939,4365478,6660417,5393699,6945896,5513137,5540212,4408368,4010218,31811530,2175800,4155505,6331305,5111651,6507603,5320842,5439528,4696308,7922804,34998736,66810266,79801988,79801988
Germany,1992,DE,DEU,EUR,2277255,4443349,6720604,5166949,7085430,5692025,5421569,4562474,4089243,32017690,2159756,4226669,6386425,4898762,6634500,5481383,5318492,4781935,7965246,35080318,67098008,80205030,80205030
Germany,1993,DE,DEU,EUR,2234021,4523654,6757675,4965660,7183154,5845779,5323128,4707174,4200101,32224996,2120565,4301518,6422083,4710985,6723514,5618818,5216805,4890566,8008037,35168725,67393721,80573488,80573488
Germany,1994,DE,DEU,EUR,2173724,4595491,6769215,4795914,7222356,5984666,5221355,4869704,4328270,32422265,2063320,4370126,6433446,4557533,6758387,5746126,5111020,5031462,8052674,35257202,67679467,80882126,80882126
Germany,1995,DE,DEU,EUR,2103267,4644708,6747975,4673624,7187330,6118745,5122116,5049298,4458560,32609673,1996198,4417644,6413842,4453304,6726118,5868132,5011208,5194418,8098596,35351776,67961449,81123262,81123262
Germany,1996,DE,DEU,EUR,2052007,4656978,6708985,4595053,7079053,6264139,5040225,5216938,4577177,32772585,1947610,4430868,6378478,4392816,6631759,5998536,4936759,5351703,8129247,35440820,68213405,81300865,81300865
Germany,1997,DE,DEU,EUR,2034729,4634223,6668952,4556246,6895032,6419726,5028877,5326107,4678804,32904792,1930217,4413359,6343576,4370128,6476549,6138229,4938416,5456571,8138867,35518760,68423552,81436087,81436087
Germany,1998,DE,DEU,EUR,2027840,4597778,6625618,4559076,6634140,6581758,5067484,5390264,4774638,33007360,1923040,4383189,6306229,4386046,6259256,6283470,4991570,5521283,8143542,35585167,68592527,81524383,81524383
Germany,1999,DE,DEU,EUR,2024088,4552208,6576296,4582293,6327598,6740127,5113400,5408466,4910111,33081995,1919555,4342422,6261977,4420622,6004706,6428223,5049452,5543039,8190648,35636690,68718685,81556965,81556965
Germany,2000,DE,DEU,EUR,2024073,4495491,6519564,4611442,6014552,6876303,5238986,5298493,5100702,33140478,1919745,4289119,6208864,4461831,5745666,6557692,5180404,5437078,8300097,35682768,68823246,81551677,81551677
Germany,2001,DE,DEU,EUR,2008247,4436094,6444341,4644901,5714823,6984056,5416166,5128276,5311023,33199245,1905083,4231354,6136437,4506395,5496808,6669069,5359671,5269035,8433565,35734543,68933788,81514568,81514568
Germany,2002,DE,DEU,EUR,1968728,4376305,6345033,4682021,5443938,7056939,5557472,4998788,5527782,33266940,1867834,4173203,6041037,4549703,5269061,6754723,5503635,5140186,8573109,35790417,69057357,81443427,81443427
Germany,2003,DE,DEU,EUR,1922984,4306486,6229470,4724923,5210105,7089045,5672013,4890249,5755890,33342225,1824483,4105747,5930230,4592568,5070981,6803430,5622059,5031021,8724821,35844880,69187105,81346810,81346810
Germany,2004,DE,DEU,EUR,1882073,4229934,6112007,4767079,5020189,7070559,5774671,4784057,6014967,33431522,1786322,4028655,5814977,4628205,4911333,6802026,5729337,4921248,8916017,35908166,69339688,81266673,81266673
Germany,2005,DE,DEU,EUR,1842413,4153990,5996403,4799106,4891433,6992671,5878250,4685765,6291507,33538732,1749090,3950598,5699688,4645442,4804581,6741380,5832200,4820585,9133161,35977349,69516081,81212168,81212168
Germany,2006,DE,DEU,EUR,1806451,4089172,5895623,4810333,4821984,6863119,6000421,4608356,6547738,33651951,1714364,3882535,5596899,4634401,4745687,6628913,5946847,4746477,9331025,36033350,69685301,81177817,81177817
Germany,2007,DE,DEU,EUR,1782981,4040851,5823832,4802738,4805632,6681267,6142156,4599691,6733762,33765246,1691412,3828526,5519938,4601227,4726917,6466062,6074822,4748263,9457527,36074818,69840064,81183830,81183830
Germany,2008,DE,DEU,EUR,1770603,3997528,5768131,4795571,4839233,6443967,6299147,4639409,6867581,33884908,1679154,3780649,5459803,4564887,4745918,6250974,6211910,4801497,9529458,36104644,69989552,81217482,81217482
Germany,2009,DE,DEU,EUR,1759792,3961215,5721007,4789407,4899154,6178791,6460436,4688839,6990728,34007355,1668510,3741892,5410402,4526467,4782863,6006942,6351676,4861063,9592841,36121852,70129207,81260615,81260615
Germany,2010,DE,DEU,EUR,1755374,3929544,5684918,4777488,4970759,5918434,6606695,4813809,7044060,34131245,1664156,3708953,5373109,4482209,4827217,5764315,6479190,4992305,9590578,36135814,70267059,81325090,81325090
Germany,2011,DE,DEU,EUR,1761199,3887244,5648443,4764410,5051797,5675340,6732145,4987748,7060739,34272179,1670192,3666741,5336933,4437874,4877613,5535349,6592236,5169490,9553263,36165825,70438004,81423378,81423378
Germany,2012,DE,DEU,EUR,1768993,3836086,5605079,4748752,5140523,5460523,6830467,5131111,7119750,34431126,1677974,3617695,5295669,4395430,4930956,5329664,6684080,5312789,9560774,36213693,70644819,81545565,81545565
Germany,2013,DE,DEU,EUR,1778614,3793121,5571735,4716888,5237570,5280063,6892488,5252698,7204615,34584322,1686638,3577579,5264217,4344488,4989222,5155193,6742630,5432774,9596017,36260324,70844646,81680591,81680591
Germany,2014,DE,DEU,EUR,1800862,3759104,5559966,4672645,5332166,5138426,6905770,5365864,7315981,34730852,1707085,3547512,5254597,4284791,5046509,5020430,6753644,5543317,9664716,36313407,71044259,81858825,81858825
Germany,2015,DE,DEU,EUR,1836251,3734620,5570871,4624063,5409863,5050952,6859880,5480014,7439731,34864503,1739890,3526735,5266625,4226085,5091749,4939299,6709259,5649833,9755002,36371227,71235730,82073226,82073226
Germany,2016,DE,DEU,EUR,1885823,3729222,5615045,4582904,5455352,5012296,6759904,5609435,7554804,34974695,1786965,3522693,5309658,4180155,5115256,4906637,6616233,5766877,9846869,36432027,71406722,82331423,82331423
Germany,2017,DE,DEU,EUR,1943545,3742384,5685929,4555863,5467155,5015901,6604334,5756315,7665326,35064894,1842992,3535689,5378681,4149181,5118490,4914415,6473631,5896731,9942426,36494874,71559768,82624374,82624374
Germany,2018,DE,DEU,EUR,1992769,3766877,5759646,4526426,5466888,5061046,6390164,5915652,7775002,35135178,1890746,3558603,5449349,4120080,5112875,4957671,6279294,6035538,10047063,36552521,71687699,82896696,82896696
Germany,2019,DE,DEU,EUR,2027025,3800189,5827214,4494539,5459237,5125099,6143993,6077949,7895552,35196369,1923904,3589449,5513353,4093295,5096764,5015703,6055207,6177460,10172780,36611209,71807578,83148141,83148141
Germany,2020,DE,DEU,EUR,2041829,3846027,5887856,4460619,5439116,5195363,5898574,6224105,8009847,35227624,1938313,3632857,5571170,4067535,5065763,5078987,5830147,6307600,10292318,36642350,71869974,83328988,83328988
Germany,2021,DE,DEU,EUR,2037601,3907224,5944825,4412310,5413177,5270420,5665157,6345006,8103096,35209166,1933711,3692971,5626682,4029753,5026305,5145430,5615144,6422450,10388797,36627879,71837045,83408554,83408554
Germany,2022,DE,DEU,EUR,2017004,3959943,5976947,4332009,5380234,5349332,5456170,6439892,8201715,35159352,1913081,3746881,5659962,3970279,4977799,5207165,5418193,6515982,10484153,36573571,71732923,83369843,83369843
Germany,2023,DE,DEU,EUR,1991732,3991520,5983252,4238412,5326569,5435224,5279841,6505915,8340171,35126132,1888393,3780224,5668617,3906160,4910699,5266388,5248113,6578479,10606794,36516633,71642765,83294633,83294633
Germany,2024,DE,DEU,EUR,1970477,4019223,5989700,4155249,5255451,5518358,5139432,6527990,8517345,35113825,1867770,3808811,5676581,3852791,4827560,5320600,5114003,6595170,10762238,36472362,71586187,83252474,83252474
Germany,2025,DE,DEU,EUR,1954975,4039879,5994854,4082593,5173243,5584457,5051022,6492881,8712910,35097106,1852650,3829998,5682648,3807931,4737591,5356740,5029092,6555844,10937258,36424456,71521562,83199069,83199069
Germany,2026,DE,DEU,EUR,1941959,4054353,5996312,4028761,5090054,5620145,5010526,6405591,8923674,35078751,1839928,3844711,5684639,3776836,4652613,5363299,4988154,6466103,11128165,36375170,71453921,83134876,83134876
Germany,2027,DE,DEU,EUR,1927514,4066631,5994145,3995261,5013976,5624459,5011448,6264333,9148830,35058307,1825808,3857392,5683200,3761495,4577491,5343374,4983966,6325145,11331710,36323181,71381488,83058838,83058838
Germany,2028,DE,DEU,EUR,1912022,4073267,5985289,3979304,4934999,5617986,5053805,6067289,9385990,35039373,1810639,3864628,5675267,3758922,4506115,5314845,5014708,6132886,11544398,36271874,71311247,82971793,82971793
Germany,2029,DE,DEU,EUR,1894737,4069947,5964684,3979507,4855460,5605679,5115915,5840622,9629636,35026819,1793857,3862157,5656014,3767657,4441910,5280184,5061474,5912373,11762179,36225777,71252596,82873294,82873294
Germany,2030,DE,DEU,EUR,1876023,4053662,5929685,3997343,4775892,5582025,5185174,5615142,9867222,35022798,1775783,3846980,5622763,3790383,4383510,5234528,5114359,5691891,11972758,36187429,71210227,82762675,82762675
Germany,1950,DE,DEU,EUR,2561323,6018389,8579712,5142668,3339894,4645866,4663339,3092008,2978843,23862618,2418176,5857496,8275672,5564849,5013739,6238056,5549394,4145395,3734657,30246090,54108708,70964095,70964095
Germany,1951,DE,DEU,EUR,2640653,5750533,8391186,5248897,3495056,4408228,4771342,3132200,3040955,24096678,2491612,5579105,8070717,5456992,5083698,5983783,5631251,4251421,3854318,30261463,54358141,70820042,70820042
Germany,1952,DE,DEU,EUR,2685930,5545899,8231829,5352463,3727869,4129280,4852066,3184484,3099369,24345531,2536774,5361325,7898099,5410422,5228156,5643395,5717466,4356428,3977042,30332909,54678440,70808373,70808373
Germany,1953,DE,DEU,EUR,2704814,5369513,8074327,5448492,4008733,3846983,4908085,3250768,3154458,24617519,2558575,5176587,7735162,5410175,5387580,5291179,5802916,4456972,4103622,30452444,55069963,70879443,70879443
Germany,1954,DE,DEU,EUR,2708028,5190724,7898752,5574724,4250178,3631290,4930574,3341183,3202526,24930475,2567618,4994999,7562617,5463227,5466713,5024664,5884830,4558608,4230832,30628874,55559349,71020731,71020731
Germany,1955,DE,DEU,EUR,2702989,5017493,7720482,5731864,4387751,3535337,4915121,3455662,3242636,25268371,2566656,4823667,7390323,5555289,5392356,4926064,5954102,4660848,4354799,30843458,56111829,71222628,71222628
Germany,1956,DE,DEU,EUR,2710495,4873078,7583573,5883882,4468930,3509078,4858908,3585057,3277686,25583541,2574297,4683226,7257523,5653077,5241054,4919574,5986699,4767008,4481216,31048628,56632169,71473269,71473269
Germany,1957,DE,DEU,EUR,2739255,4819499,7558754,5976774,4541978,3472662,4788408,3721904,3304269,25805995,2600804,4626924,7227728,5706740,5096185,4886603,6002243,4879494,4607888,31179153,56985148,71771634,71771634
Germany,1958,DE,DEU,EUR,2784849,4828335,7613184,6029068,4632880,3416646,4717599,3853220,3331181,25980594,2641844,4627377,7269221,5732822,4979252,4814637,6023263,4981504,4741994,31273472,57254066,72136470,72136470
Germany,1959,DE,DEU,EUR,2847923,4848116,7696039,6035036,4787275,3374214,4623269,3979858,3363953,26163605,2699475,4637093,7336568,5723789,4927891,4742340,6026033,5072439,4890232,31382724,57546329,72578945,72578945
Germany,1960,DE,DEU,EUR,2926963,4955536,7882499,5901161,4982191,3416813,4465814,4103092,3390930,26260001,2774896,4727622,7502518,5587594,4937927,4750801,5946389,5163140,5032825,31418676,57678677,73063695,73063695
Germany,1961,DE,DEU,EUR,3016602,5118546,8135148,5709219,5165028,3575771,4238115,4197336,3428834,26314303,2862507,4874671,7737178,5396565,4973875,4881635,5732751,5248262,5184632,31417720,57732023,73604346,73604346
Germany,1962,DE,DEU,EUR,3107782,5250193,8357975,5563348,5333828,3806699,3970633,4267271,3477249,26419028,2951976,4996539,7948515,5251993,5039121,5066320,5430780,5337236,5343451,31468901,57887929,74194417,74194417
Germany,1963,DE,DEU,EUR,3195111,5364612,8559723,5433144,5484745,4085494,3699594,4314495,3529451,26546923,3038365,5102934,8141299,5127999,5129172,5258943,5110220,5424132,5497808,31548274,58095197,74796217,74796217
Germany,1964,DE,DEU,EUR,3268437,5472183,8740620,5291514,5654376,4329555,3493035,4334562,3602439,26705481,3110826,5206494,8317320,4997809,5256539,5369937,4867535,5506695,5661313,31659828,58365309,75423245,75423245
Germany,1965,DE,DEU,EUR,3316268,5578659,8894927,5147765,5846240,4473477,3402700,4322549,3689593,26882324,3156459,5310433,8466892,4870950,5412309,5327358,4783567,5575622,5823538,31793344,58675668,76037469,76037469
Germany,1966,DE,DEU,EUR,3337622,5700449,9038071,5027957,6029673,4556439,3381189,4274944,3782406,27052608,3175810,5427475,8603285,4771751,5569414,5202154,4787426,5609271,5984735,31924751,58977359,76618716,76618716
Germany,1967,DE,DEU,EUR,3329726,5838123,9167849,4993048,6154098,4622534,3350986,4217410,3882917,27220993,3168336,5558855,8727191,4753199,5681082,5074317,4766734,5627274,6154912,32057518,59278511,77173553,77173553
Germany,1968,DE,DEU,EUR,3286063,5985078,9271141,5016733,6233011,4699786,3299791,4157348,3967304,27373973,3126653,5697126,8823779,4787981,5760306,4969199,4706620,5648582,6304543,32177231,59551204,77646126,77646126
Germany,1969,DE,DEU,EUR,3201529,6134147,9335676,5049300,6258186,4836583,3257702,4072677,4036898,27511346,3046071,5835341,8881412,4829032,5797438,4926679,4643858,5649525,6437524,32284056,59795402,78012485,78012485
Germany,2031,DE,DEU,EUR,1856910,4021636,5878546,4033959,4685274,5552864,5260570,5402661,10095245,35030573,1757412,3815810,5573222,3830843,4317507,5183855,5171525,5482433,12175147,36161310,71191883,82643647,82643647
Germany,2032,DE,DEU,EUR,1836995,3979660,5816655,4075368,4585342,5519194,5340800,5213144,10310737,35044585,1738325,3774504,5512829,3875426,4245261,5131088,5229339,5292874,12367698,36141686,71186271,82515755,82515755
Germany,2033,DE,DEU,EUR,1816181,3939084,5755265,4107380,4492909,5466945,5427466,5052497,10505249,35052446,1718417,3734799,5453216,3909159,4181803,5064801,5288963,5130755,12541157,36116638,71169084,82377569,82377569
Germany,2034,DE,DEU,EUR,1795930,3900675,5696605,4135322,4410632,5397128,5510827,4925416,10673307,35052632,1699101,3697496,5396597,3937939,4128899,4982375,5343382,5003423,12688514,36084532,71137164,82230377,82230377
Germany,2035,DE,DEU,EUR,1775917,3866570,5642487,4156011,4338627,5316187,5577412,4847666,10807031,35042934,1680043,3664385,5344428,3959111,4084309,4893063,5379907,4923930,12803718,36044038,71086972,82073885,82073885
Germany,2036,DE,DEU,EUR,1756432,3834495,5590927,4170397,4285207,5234086,5613923,4815160,10907410,35026183,1661429,3633324,5294753,3973690,4053302,4808603,5387059,4887087,12888579,35998320,71024503,81910193,81910193
Germany,2037,DE,DEU,EUR,1739134,3800192,5539326,4182674,4252241,5159132,5619421,4821364,10971593,35006425,1644904,3600160,5245064,3986333,4038252,4734120,5367954,4885655,12939017,35951331,70957756,81742143,81742143
Germany,2038,DE,DEU,EUR,1724878,3763950,5488828,4189385,4236797,5081272,5614142,4865844,10994457,34981897,1631316,3565130,5196446,3993619,4035998,4663390,5340259,4917624,12951064,35901954,70883851,81569127,81569127
Germany,2039,DE,DEU,EUR,1713019,3726466,5439485,4186119,4237310,5002701,5602912,4928253,10994488,34951783,1619957,3529072,5149029,3991164,4044896,4599698,5306368,4964764,12942174,35849064,70800847,81389361,81389361
Germany,2040,DE,DEU,EUR,1703122,3687829,5390951,4169893,4255408,4924121,5580456,4997187,10988816,34915881,1610437,3492015,5102452,3976003,4067771,4541827,5261565,5017712,12926948,35791826,70707707,81201103,81201103
Germany,2041,DE,DEU,EUR,1695576,3649325,5344901,4138009,4292095,4834409,5552582,5071951,10984325,34873371,1603173,3455115,5058288,3944926,4108217,4476233,5211786,5074828,12913478,35729468,70602839,81006024,81006024
Germany,2042,DE,DEU,EUR,1690448,3612160,5302608,4096242,4333438,4735309,5520357,5151550,10986489,34823385,1598248,3419544,5017792,3903776,4152652,4404266,5159975,5132702,12907647,35661018,70484403,80804806,80804806
Germany,2043,DE,DEU,EUR,1687424,3577111,5264535,4055845,4365384,4643634,5469931,5237500,10992900,34765194,1595351,3386060,4981411,3864195,4186227,4341024,5094807,5192444,12906236,35584933,70350127,80596076,80596076
Germany,2044,DE,DEU,EUR,1687048,3545032,5232080,4017595,4393380,4562147,5402244,5320247,11002085,34697698,1595004,3355410,4950414,3827003,4214990,4288397,5013701,5247159,12908479,35499729,70197427,80379918,80379918
Germany,2045,DE,DEU,EUR,1690798,3515190,5205988,3983630,4414289,4491019,5323662,5387021,11021465,34621086,1598582,3326889,4925471,3793997,4236323,4244220,4925850,5284516,12920315,35405221,70026307,80157776,80157776
Germany,2046,DE,DEU,EUR,1696796,3488230,5185026,3951692,4429000,4438455,5243825,5424776,11048450,34536198,1604294,3301084,4905378,3763037,4251170,4213683,4842791,5293136,12938120,35301937,69838135,79928542,79928542
Germany,2047,DE,DEU,EUR,1703658,3465850,5169508,3917512,4441533,4406151,5170735,5432191,11074197,34442319,1610796,3279677,4890473,3729955,4264008,4198987,4769468,5275834,12951026,35189278,69631597,79691578,79691578
Germany,2048,DE,DEU,EUR,1711301,3448599,5159900,3881363,4448417,4391163,5094600,5428910,11094416,34338869,1618020,3263216,4881236,3694982,4271389,4196959,4699771,5249931,12953794,35066826,69405695,79446826,79446826
Germany,2049,DE,DEU,EUR,1717990,3436397,5154387,3843980,4445363,4392073,5017701,5419652,11108546,34227315,1624364,3251542,4875906,3658983,4269069,4206080,4637022,5217815,12946574,34935543,69162858,79193152,79193152
Germany,2050,DE,DEU,EUR,1723028,3430296,5153324,3805444,4429403,4410495,4940749,5399515,11122645,34108251,1629136,3245641,4874777,3621992,4254084,4229172,4580029,5174972,12935625,34795874,68904125,78932228,78932228
Djibouti,1970,DJ,DJI,EMR,13352,18678,32030,13629,10071,6882,4506,2692,1655,39435,13200,18748,31948,13794,10262,7084,4764,2984,2072,40960,80395,144379,144379
Djibouti,1971,DJ,DJI,EMR,14299,20055,34354,14374,10782,7350,4822,2882,1784,41994,14127,20111,34238,14565,10990,7562,5094,3199,2222,43632,85626,154225,154225
Djibouti,1972,DJ,DJI,EMR,15350,21597,36947,15215,11578,7871,5172,3090,1931,44857,15155,21643,36798,15428,11804,8102,5462,3435,2402,46633,91490,165234,165234
Djibouti,1973,DJ,DJI,EMR,16494,23296,39790,16129,12462,8447,5559,3326,2086,48009,16271,23332,39603,16358,12711,8700,5865,3694,2599,49927,97936,177327,177327
Djibouti,1974,DJ,DJI,EMR,17798,25276,43074,17222,13480,9114,6005,3600,2273,51694,17546,25294,42840,17471,13758,9392,6333,3994,2829,53777,105471,191389,191389
Djibouti,1975,DJ,DJI,EMR,19369,27701,47070,18688,14631,9928,6549,3934,2497,56227,19081,27694,46775,18954,14946,10234,6909,4362,3104,58509,114736,208582,208582
Djibouti,1976,DJ,DJI,EMR,21236,30620,51856,20583,15919,10909,7206,4342,2768,61727,20901,30580,51481,20860,16282,11254,7605,4806,3434,64241,125968,229304,229304
Djibouti,1977,DJ,DJI,EMR,23340,33977,57317,22810,17350,12041,7963,4806,3081,68051,22959,33902,56861,23102,17776,12423,8405,5323,3818,70847,138898,253083,253083
Djibouti,1978,DJ,DJI,EMR,25557,37566,63123,25217,18850,13254,8774,5302,3422,74819,25121,37455,62576,25525,19342,13685,9258,5875,4228,77913,152732,278425,278425
Djibouti,1979,DJ,DJI,EMR,27658,41045,68703,27579,20255,14437,9557,5787,3750,81365,27164,40890,68054,27896,20814,14907,10083,6411,4626,84737,166102,302856,302856
Djibouti,1980,DJ,DJI,EMR,29427,44100,73527,29687,21425,15486,10242,6213,4040,87093,28877,43897,72774,30011,22035,15996,10808,6883,4992,90725,177818,324121,324121
Djibouti,1981,DJ,DJI,EMR,30781,46590,77371,31461,22309,16370,10801,6564,4288,91793,30185,46333,76518,31786,22966,16910,11405,7270,5298,95635,187428,341316,341316
Djibouti,1982,DJ,DJI,EMR,31800,48603,80403,32958,22960,17101,11259,6859,4497,95634,31160,48290,79450,33273,23650,17670,11889,7586,5557,99625,195259,355110,355110
Djibouti,1983,DJ,DJI,EMR,32689,50417,83106,34380,23523,17802,11687,7137,4694,99223,32014,50041,82055,34680,24241,18396,12343,7884,5795,103339,202562,367726,367726
Djibouti,1984,DJ,DJI,EMR,33719,52442,86161,36006,24222,18593,12175,7446,4922,103364,33009,51999,85008,36278,24970,19220,12859,8223,6074,107624,210988,382156,382156
Djibouti,1985,DJ,DJI,EMR,35099,54981,90080,38051,25286,19509,12798,7838,5212,108694,34344,54460,88804,38302,26062,20182,13515,8656,6418,113135,221829,400709,400709
Djibouti,1986,DJ,DJI,EMR,36910,58145,95055,40608,26820,20535,13582,8334,5573,115452,36105,57543,93648,40837,27624,21272,14345,9196,6858,120132,235584,424286,424286
Djibouti,1987,DJ,DJI,EMR,39109,61846,100955,43625,28744,21684,14521,8921,5992,123487,38235,61156,99391,43829,29577,22493,15330,9842,7365,128436,251923,452272,452272
Djibouti,1988,DJ,DJI,EMR,41467,65779,107246,46872,30869,22888,15539,9558,6442,132168,40520,64993,105513,47046,31735,23772,16404,10534,7916,137407,269575,482337,482337
Djibouti,1989,DJ,DJI,EMR,44544,70846,115390,50987,33604,24479,16853,10373,7022,143318,43512,69945,113457,51132,34520,25451,17792,11426,8614,148935,292253,521104,521104
Djibouti,1990,DJ,DJI,EMR,49056,78211,127267,56820,37514,26863,18753,11534,7845,159329,47909,77157,125066,56929,38506,27956,19801,12705,9615,165512,324841,577173,577173
Djibouti,1991,DJ,DJI,EMR,53082,84902,137984,62202,41164,28992,20533,12613,8609,174113,51829,83705,135534,62291,42252,30213,21684,13894,10554,180888,355001,628521,628521
Djibouti,1992,DJ,DJI,EMR,52217,83956,136173,61949,41119,28465,20481,12557,8604,173175,50979,82710,133689,62067,42276,29737,21663,13853,10569,180165,353340,623197,623197
Djibouti,1993,DJ,DJI,EMR,50712,82103,132815,61039,40695,27643,20249,12383,8522,170531,49506,80823,130329,61150,41893,28945,21435,13671,10467,177561,348092,611231,611231
Djibouti,1994,DJ,DJI,EMR,51163,83506,134669,62551,41951,28014,20824,12703,8773,174816,49936,82153,132089,62571,43148,29349,22052,14023,10764,181907,356723,623477,623477
Djibouti,1995,DJ,DJI,EMR,50978,84100,135078,63438,42854,28234,21137,12916,8952,177531,49742,82686,132428,63354,44041,29580,22401,14250,10966,184592,362123,629619,629619
Djibouti,1996,DJ,DJI,EMR,51333,85743,137076,65246,44541,29092,21625,13311,9240,183055,50083,84258,134341,65078,45724,30449,22940,14673,11309,190173,373228,644649,644649
Djibouti,1997,DJ,DJI,EMR,51881,87713,139594,68157,47491,30716,22315,13853,9602,192134,50615,86149,136764,67982,48676,32052,23652,15226,11713,199301,391435,667786,667786
Djibouti,1998,DJ,DJI,EMR,52553,89745,142298,71474,51159,32784,23130,14483,9987,203017,51274,88097,139371,71339,52358,34080,24464,15853,12135,210229,413246,694920,694920
Djibouti,1999,DJ,DJI,EMR,53348,91665,145013,74093,54395,34728,23871,15095,10382,212564,52049,89925,141974,73951,55612,36004,25212,16475,12566,219820,432384,719371,719371
Djibouti,2000,DJ,DJI,EMR,54342,93444,147786,76204,57302,36589,24572,15702,10780,221149,53016,91618,144634,76019,58533,37868,25931,17107,13006,228464,449613,742033,742033
Djibouti,2001,DJ,DJI,EMR,55625,95095,150720,78268,60272,38571,25327,16352,11196,229986,54265,93187,147452,78031,61514,39849,26696,17778,13466,237334,467320,765490,765490
Djibouti,2002,DJ,DJI,EMR,57162,96579,153741,80229,63184,40636,26121,17036,11627,238833,55760,94602,150362,79919,64434,41918,27497,18485,13946,246199,485032,789129,789129
Djibouti,2003,DJ,DJI,EMR,58521,97863,156384,81171,64979,42275,26724,17664,12060,244873,57074,95826,152900,80702,66228,43605,28139,19158,14423,252255,497128,806411,806411
Djibouti,2004,DJ,DJI,EMR,59363,99167,158530,81436,65831,43574,27198,18237,12478,248754,57877,97066,154943,80751,67051,44972,28671,19797,14902,256144,504898,818373,818373
Djibouti,2005,DJ,DJI,EMR,59745,100643,160388,82022,66657,44982,27813,18770,12902,253146,58236,98495,156731,81150,67835,46457,29342,20405,15410,260599,513745,830861,830861
Djibouti,2006,DJ,DJI,EMR,59792,102360,162152,83370,67944,46742,28739,19259,13358,259412,58276,100172,158448,82371,69071,48274,30306,20963,15949,266934,526346,846947,846947
Djibouti,2007,DJ,DJI,EMR,59529,104246,163775,85179,69492,48744,29900,19715,13851,266881,58015,102027,160042,84090,70566,50324,31500,21487,16527,274494,541375,865196,865196
Djibouti,2008,DJ,DJI,EMR,59019,106109,165128,87002,70883,50765,31151,20153,14367,274321,57513,103858,161371,85839,71896,52399,32797,21991,17134,282056,556377,882886,882886
Djibouti,2009,DJ,DJI,EMR,58548,107945,166493,88904,72211,52835,32508,20638,14932,282028,57045,105661,162706,87667,73146,54522,34205,22535,17794,289869,571897,901103,901103
Djibouti,2010,DJ,DJI,EMR,58195,109676,167871,90726,73401,54887,33936,21159,15540,289649,56693,107366,164059,89409,74243,56627,35700,23118,18523,297620,587269,919199,919199
Djibouti,2011,DJ,DJI,EMR,57895,111199,169094,92415,74561,56890,35419,21703,16172,297160,56394,108867,165261,91044,75302,58681,37253,23731,19284,305295,602455,936811,936811
Djibouti,2012,DJ,DJI,EMR,57691,112574,170265,93954,75754,58840,36969,22278,16834,304629,56184,110234,166418,92555,76395,60682,38885,24375,20090,312982,617611,954297,954297
Djibouti,2013,DJ,DJI,EMR,57595,113705,171300,95470,77017,60715,38594,22880,17548,312224,56081,111351,167432,94047,77552,62600,40596,25050,20949,320794,633018,971753,971753
Djibouti,2014,DJ,DJI,EMR,57573,114443,172016,97101,78363,62486,40281,23531,18293,320055,56053,112083,168136,95666,78805,64411,42381,25773,21858,328894,648949,989087,989087
Djibouti,2015,DJ,DJI,EMR,57613,114794,172407,98849,79799,64128,42028,24288,18985,328077,56081,112445,168526,97417,80163,66081,44233,26610,22744,337248,665325,1006259,1006259
Djibouti,2016,DJ,DJI,EMR,57734,114778,172512,100727,81318,65628,43832,25200,19614,336319,56189,112442,168631,99291,81613,67593,46149,27602,23549,345797,682116,1023261,1023261
Djibouti,2017,DJ,DJI,EMR,57923,114471,172394,102724,82909,66994,45689,26239,20199,344754,56360,112156,168516,101288,83139,68960,48121,28744,24323,354575,699329,1040233,1040233
Djibouti,2018,DJ,DJI,EMR,58151,114015,172166,104713,84573,68239,47582,27367,20785,353259,56572,111726,168298,103286,84758,70202,50135,29984,25115,363480,716739,1057198,1057198
Djibouti,2019,DJ,DJI,EMR,58424,113574,171998,106523,86285,69392,49479,28560,21385,361624,56827,111302,168129,105109,86434,71322,52156,31294,25922,372237,733861,1073994,1073994
Djibouti,2020,DJ,DJI,EMR,58716,113236,171952,108108,87962,70457,51332,29751,21903,369513,57101,110979,168080,106715,88087,72352,54134,32634,26688,380610,750123,1090156,1090156
Djibouti,2021,DJ,DJI,EMR,59003,113036,172039,109498,89519,71485,53102,30934,22316,376854,57369,110781,168150,108129,89634,73339,56040,33991,27380,388513,765367,1105557,1105557
Djibouti,2022,DJ,DJI,EMR,59280,113005,172285,110751,90942,72554,54821,32168,22752,383988,57628,110743,168371,109406,91059,74362,57889,35404,28092,396212,780200,1120849,1120849
Djibouti,2023,DJ,DJI,EMR,59541,113146,172687,111781,92360,73711,56495,33496,23297,391140,57871,110863,168734,110459,92482,75457,59676,36914,28911,403899,795039,1136455,1136455
Djibouti,2024,DJ,DJI,EMR,59757,113418,173175,112444,93904,74976,58113,34928,24008,398373,58077,111106,169183,111137,94040,76655,61382,38515,29871,411600,809973,1152329,1152329
Djibouti,2025,DJ,DJI,EMR,59885,113780,173665,112733,95574,76344,59643,36462,24888,405644,58215,111435,169650,111447,95725,77968,62976,40210,30970,419296,824940,1168257,1168257
Djibouti,2026,DJ,DJI,EMR,59997,114228,174225,112678,97371,77803,61055,38065,25862,412834,58346,111845,170191,111416,97547,79377,64426,41977,32183,426926,839760,1184178,1184178
Djibouti,2027,DJ,DJI,EMR,60139,114722,174861,112349,99293,79331,62341,39718,26906,419938,58510,112298,170808,111113,99495,80860,65741,43793,33455,434457,854395,1200065,1200065
Djibouti,2028,DJ,DJI,EMR,60286,115229,175515,111893,101219,80933,63524,41408,28007,426984,58676,112773,171449,110668,101444,82437,66939,45643,34808,441939,868923,1215879,1215879
Djibouti,2029,DJ,DJI,EMR,60440,115731,176171,111469,102986,82595,64628,43101,29170,433949,58845,113257,172102,110257,103245,84080,68033,47505,36235,449355,883304,1231575,1231575
Djibouti,2030,DJ,DJI,EMR,60622,116193,176815,111178,104564,84241,65680,44790,30401,440854,59038,113710,172748,109965,104859,85724,69062,49360,37748,456718,897572,1247129,1247129
Djibouti,1950,DJ,DJI,EMR,6048,8490,14538,6033,4183,2822,1794,1024,544,16400,5998,8476,14474,6029,4251,2891,1904,1152,685,16912,33312,62334,62334
Djibouti,1951,DJ,DJI,EMR,6056,8824,14880,6252,4338,2927,1866,1069,572,17024,6024,8810,14834,6251,4409,3006,1981,1202,723,17572,34596,64317,64317
Djibouti,1952,DJ,DJI,EMR,6075,9168,15243,6474,4502,3036,1940,1115,604,17671,6056,9155,15211,6477,4569,3116,2062,1255,760,18239,35910,66362,66362
Djibouti,1953,DJ,DJI,EMR,6094,9532,15626,6708,4664,3150,2020,1163,635,18340,6087,9522,15609,6712,4734,3232,2139,1306,802,18925,37265,68493,68493
Djibouti,1954,DJ,DJI,EMR,6144,9892,16036,6944,4831,3266,2101,1210,665,19017,6143,9887,16030,6951,4905,3352,2219,1358,844,19629,38646,70715,70715
Djibouti,1955,DJ,DJI,EMR,6303,10169,16472,7187,5000,3387,2181,1253,698,19706,6300,10175,16475,7190,5079,3473,2302,1413,884,20341,40047,72997,72997
Djibouti,1956,DJ,DJI,EMR,6544,10377,16921,7433,5175,3514,2263,1304,736,20425,6540,10400,16940,7442,5256,3605,2387,1467,925,21082,41507,75372,75372
Djibouti,1957,DJ,DJI,EMR,6796,10591,17387,7695,5362,3641,2351,1351,770,21170,6787,10632,17419,7707,5444,3739,2480,1525,973,21868,43038,77847,77847
Djibouti,1958,DJ,DJI,EMR,7056,10818,17874,7968,5553,3772,2440,1408,807,21948,7041,10871,17912,7979,5636,3875,2570,1579,1022,22661,44609,80395,80395
Djibouti,1959,DJ,DJI,EMR,7326,11051,18377,8249,5745,3906,2532,1463,847,22742,7305,11117,18422,8265,5834,4014,2665,1642,1069,23489,46231,83025,83025
Djibouti,1960,DJ,DJI,EMR,7622,11312,18934,8567,5954,4056,2625,1525,891,23618,7593,11392,18985,8588,6048,4165,2771,1707,1120,24399,48017,85940,85940
Djibouti,1961,DJ,DJI,EMR,7954,11623,19577,8935,6191,4223,2735,1596,938,24618,7918,11715,19633,8963,6290,4337,2887,1781,1176,25434,50052,89270,89270
Djibouti,1962,DJ,DJI,EMR,8336,11997,20333,9360,6467,4415,2863,1673,989,25767,8293,12098,20391,9392,6571,4534,3020,1869,1243,26629,52396,93122,93122
Djibouti,1963,DJ,DJI,EMR,8786,12444,21230,9866,6789,4640,3010,1764,1051,27120,8732,12555,21287,9898,6905,4766,3177,1972,1318,28036,55156,97670,97670
Djibouti,1964,DJ,DJI,EMR,9299,12999,22298,10427,7162,4896,3179,1873,1120,28657,9236,13117,22353,10474,7282,5031,3359,2087,1408,29641,58298,102945,102945
Djibouti,1965,DJ,DJI,EMR,9869,13716,23585,10958,7568,5176,3368,1994,1190,30254,9795,13830,23625,11020,7696,5319,3554,2214,1503,31306,61560,108772,108772
Djibouti,1966,DJ,DJI,EMR,10468,14554,25022,11427,7989,5470,3565,2113,1268,31832,10384,14660,25044,11506,8132,5622,3761,2350,1601,32972,64804,114874,114874
Djibouti,1967,DJ,DJI,EMR,11087,15433,26520,11891,8429,5774,3767,2239,1353,33453,10988,15534,26522,11995,8584,5936,3978,2487,1701,34681,68134,121168,121168
Djibouti,1968,DJ,DJI,EMR,11727,16346,28073,12368,8885,6089,3975,2367,1434,35118,11613,16437,28050,12490,9047,6261,4202,2628,1804,36432,71550,127668,127668
Djibouti,1969,DJ,DJI,EMR,12479,17423,29902,12946,9430,6455,4220,2517,1534,37102,12351,17509,29860,13090,9606,6645,4461,2795,1924,38521,75623,135390,135390
Djibouti,2031,DJ,DJI,EMR,60789,116649,177438,111050,105976,85797,66728,46453,31703,447707,59210,114170,173380,109827,106307,87284,70074,51185,39349,464026,911733,1262554,1262554
Djibouti,2032,DJ,DJI,EMR,60896,117112,178008,111084,107252,87221,67815,48073,33083,454528,59326,114639,173965,109839,107619,88734,71122,52958,41036,471308,925836,1277807,1277807
Djibouti,2033,DJ,DJI,EMR,60958,117552,178510,111265,108301,88623,68968,49629,34531,461317,59398,115089,174487,109994,108698,90164,72229,54662,42814,478561,939878,1292873,1292873
Djibouti,2034,DJ,DJI,EMR,60995,117950,178945,111570,108988,90141,70201,51104,36066,468070,59439,115507,174946,110271,109407,91719,73425,56273,44693,485788,953858,1307741,1307741
Djibouti,2035,DJ,DJI,EMR,60992,118301,179293,111972,109332,91794,71534,52487,37663,474782,59447,115883,175330,110641,109768,93413,74731,57771,46650,492974,967756,1322377,1322377
Djibouti,2036,DJ,DJI,EMR,60916,118630,179546,112464,109350,93578,72953,53760,39335,481440,59381,116241,175622,111092,109800,95243,76129,59139,48711,500114,981554,1336717,1336717
Djibouti,2037,DJ,DJI,EMR,60757,118927,179684,112995,109108,95480,74432,54926,41071,488012,59234,116576,175810,111587,109565,97196,77602,60383,50853,507186,995198,1350696,1350696
Djibouti,2038,DJ,DJI,EMR,60567,119186,179753,113546,108736,97387,75984,56001,42873,494527,59054,116865,175919,112101,109192,99156,79161,61517,53063,514190,1008717,1364395,1364395
Djibouti,2039,DJ,DJI,EMR,60355,119421,179776,114087,108398,99141,77591,57015,44712,500944,58854,117132,175986,112624,108847,100971,80789,62568,55338,521137,1022081,1377832,1377832
Djibouti,2040,DJ,DJI,EMR,60098,119649,179747,114586,108180,100712,79185,57985,46575,507223,58610,117384,175994,113116,108618,102598,82414,63556,57657,527959,1035182,1390928,1390928
Djibouti,2041,DJ,DJI,EMR,59841,119785,179626,115078,108124,102127,80688,58957,48466,513440,58364,117541,175905,113609,108537,104069,83961,64541,59997,534714,1048154,1403695,1403695
Djibouti,2042,DJ,DJI,EMR,59588,119788,179376,115577,108218,103408,82075,59967,50351,519596,58125,117562,175687,114115,108603,105403,85401,65559,62355,541436,1061032,1416095,1416095
Djibouti,2043,DJ,DJI,EMR,59284,119706,178990,116051,108453,104467,83436,61042,52227,525676,57836,117504,175340,114599,108807,106507,86826,66637,64708,548084,1073760,1428098,1428098
Djibouti,2044,DJ,DJI,EMR,58932,119578,178510,116485,108805,105182,84917,62190,54082,531661,57496,117399,174895,115051,109128,107254,88373,67800,67037,554643,1086304,1439706,1439706
Djibouti,2045,DJ,DJI,EMR,58564,119370,177934,116868,109252,105564,86523,63431,55892,537530,57141,117213,174354,115460,109536,107658,90054,69063,69317,561088,1098618,1450909,1450909
Djibouti,2046,DJ,DJI,EMR,58219,119086,177305,117231,109779,105633,88255,64743,57656,543297,56811,116950,173761,115851,110024,107740,91867,70418,71555,567455,1110752,1461817,1461817
Djibouti,2047,DJ,DJI,EMR,57936,118727,176663,117562,110347,105455,90100,66111,59370,548945,56539,116613,173152,116216,110554,107565,93801,71840,73727,573703,1122648,1472461,1472461
Djibouti,2048,DJ,DJI,EMR,57705,118287,175992,117851,110927,105148,91950,67544,61044,554464,56320,116197,172517,116536,111102,107253,95742,73337,75857,579827,1134291,1482795,1482795
Djibouti,2049,DJ,DJI,EMR,57528,117776,175304,118121,111497,104871,93656,69023,62686,559854,56155,115704,171859,116833,111658,106960,97539,74894,77945,585829,1145683,1492843,1492843
Djibouti,2050,DJ,DJI,EMR,57395,117206,174601,118378,112026,104718,95187,70483,64309,565101,56028,115155,171183,117114,112182,106789,99158,76455,79997,591695,1156796,1502575,1502575
Dominica,1970,DM,DMA,AMR,6075,10777,16852,5559,2565,2228,2117,1716,1518,15703,6175,10599,16774,6218,3233,2845,2650,2113,2499,19558,35261,68895,68895
Dominica,1971,DM,DMA,AMR,5851,10916,16767,5868,2693,2214,2107,1749,1554,16185,5899,10747,16646,6384,3309,2847,2612,2156,2517,19825,36010,69430,69430
Dominica,1972,DM,DMA,AMR,5609,10981,16590,6194,2868,2204,2094,1789,1595,16744,5586,10850,16436,6521,3421,2844,2573,2207,2532,20098,36842,69870,69870
Dominica,1973,DM,DMA,AMR,5391,11017,16408,6518,3054,2187,2087,1825,1637,17308,5300,10938,16238,6651,3538,2840,2541,2254,2559,20383,37691,70334,70334
Dominica,1974,DM,DMA,AMR,5200,11031,16231,6836,3237,2181,2082,1863,1682,17881,5039,11002,16041,6784,3649,2824,2519,2293,2596,20665,38546,70822,70822
Dominica,1975,DM,DMA,AMR,5066,11003,16069,7144,3410,2184,2076,1894,1732,18440,4841,10996,15837,6913,3755,2797,2510,2319,2651,20945,39385,71300,71300
Dominica,1976,DM,DMA,AMR,4972,10936,15908,7437,3567,2200,2080,1910,1785,18979,4711,10924,15635,7057,3834,2774,2513,2331,2719,21228,40207,71748,71748
Dominica,1977,DM,DMA,AMR,4872,10879,15751,7699,3714,2237,2083,1917,1840,19490,4589,10829,15418,7210,3894,2749,2523,2334,2777,21487,40977,72142,72142
Dominica,1978,DM,DMA,AMR,4745,10839,15584,7929,3861,2290,2080,1910,1904,19974,4455,10728,15183,7380,3936,2728,2536,2316,2841,21737,41711,72478,72478
Dominica,1979,DM,DMA,AMR,4582,10807,15389,8134,4009,2361,2079,1897,1982,20462,4311,10611,14922,7564,3956,2717,2548,2291,2913,21989,42451,72768,72768
Dominica,1980,DM,DMA,AMR,4377,10761,15138,8324,4160,2436,2080,1882,2075,20957,4155,10470,14625,7767,3960,2714,2559,2262,2998,22260,43217,72978,72978
Dominica,1981,DM,DMA,AMR,4156,10567,14723,8477,4339,2516,2080,1873,2162,21447,3993,10181,14174,7976,4021,2721,2552,2240,3081,22591,44038,72932,72932
Dominica,1982,DM,DMA,AMR,3996,10156,14152,8568,4543,2602,2074,1874,2246,21907,3878,9703,13581,8146,4163,2742,2548,2233,3161,22993,44900,72626,72626
Dominica,1983,DM,DMA,AMR,3929,9663,13592,8593,4752,2694,2065,1890,2316,22310,3849,9176,13025,8243,4320,2763,2542,2233,3230,23331,45641,72269,72269
Dominica,1984,DM,DMA,AMR,3931,9176,13107,8552,4961,2786,2057,1909,2394,22659,3895,8683,12578,8260,4481,2796,2524,2240,3291,23592,46251,71936,71936
Dominica,1985,DM,DMA,AMR,3969,8716,12685,8456,5154,2880,2050,1925,2465,22930,3975,8241,12216,8200,4641,2844,2492,2250,3340,23767,46697,71596,71596
Dominica,1986,DM,DMA,AMR,3996,8324,12320,8327,5315,2960,2053,1932,2530,23117,4044,7879,11923,8083,4790,2889,2455,2257,3386,23860,46977,71215,71215
Dominica,1987,DM,DMA,AMR,3986,8017,12003,8192,5401,3043,2072,1932,2572,23212,4075,7629,11704,7936,4894,2929,2439,2267,3422,23887,47099,70808,70808
Dominica,1988,DM,DMA,AMR,3957,7787,11744,8028,5431,3140,2102,1920,2621,23242,4071,7506,11577,7745,4953,2972,2431,2279,3450,23830,47072,70397,70397
Dominica,1989,DM,DMA,AMR,3922,7647,11569,7798,5447,3235,2122,1903,2675,23180,4044,7492,11536,7492,4989,3025,2417,2283,3484,23690,46870,69975,69975
Dominica,1990,DM,DMA,AMR,3864,7607,11471,7488,5432,3317,2139,1883,2739,22998,3996,7553,11549,7196,4982,3094,2381,2280,3524,23457,46455,69481,69481
Dominica,1991,DM,DMA,AMR,3818,7588,11406,7209,5455,3386,2198,1871,2764,22883,3946,7604,11550,6913,5022,3180,2356,2289,3550,23310,46193,69141,69141
Dominica,1992,DM,DMA,AMR,3813,7519,11332,7002,5579,3477,2279,1882,2728,22947,3902,7589,11491,6679,5166,3266,2378,2310,3535,23334,46281,69112,69112
Dominica,1993,DM,DMA,AMR,3811,7436,11247,6784,5713,3632,2356,1898,2700,23083,3853,7558,11411,6462,5318,3362,2417,2333,3528,23420,46503,69169,69169
Dominica,1994,DM,DMA,AMR,3804,7356,11160,6543,5802,3828,2445,1911,2689,23218,3792,7537,11329,6236,5423,3488,2455,2352,3539,23493,46711,69198,69198
Dominica,1995,DM,DMA,AMR,3801,7262,11063,6303,5858,4036,2535,1922,2692,23346,3730,7496,11226,5995,5519,3630,2505,2350,3561,23560,46906,69201,69201
Dominica,1996,DM,DMA,AMR,3782,7174,10956,6073,5897,4227,2618,1946,2712,23473,3658,7437,11095,5766,5603,3771,2551,2349,3604,23644,47117,69166,69166
Dominica,1997,DM,DMA,AMR,3711,7122,10833,5875,5897,4383,2708,1985,2741,23589,3569,7366,10935,5577,5657,3895,2592,2361,3643,23725,47314,69081,69081
Dominica,1998,DM,DMA,AMR,3602,7077,10679,5719,5826,4531,2819,2020,2790,23705,3468,7278,10746,5456,5643,4018,2647,2356,3694,23814,47519,68938,68938
Dominica,1999,DM,DMA,AMR,3451,7031,10482,5622,5669,4684,2934,2047,2857,23813,3351,7171,10522,5391,5547,4149,2712,2344,3745,23888,47701,68698,68698
Dominica,2000,DM,DMA,AMR,3245,6994,10239,5580,5444,4819,3057,2067,2930,23897,3206,7061,10267,5376,5377,4276,2785,2322,3808,23944,47841,68346,68346
Dominica,2001,DM,DMA,AMR,3048,6954,10002,5608,5230,4926,3195,2103,2989,24051,3075,6948,10023,5452,5174,4396,2873,2313,3862,24070,48121,68153,68153
Dominica,2002,DM,DMA,AMR,2938,6899,9837,5705,5074,5026,3341,2168,3010,24324,2985,6822,9807,5611,4996,4510,2977,2307,3900,24301,48625,68262,68262
Dominica,2003,DM,DMA,AMR,2876,6809,9685,5804,4947,5107,3492,2242,3020,24612,2920,6686,9606,5766,4816,4622,3086,2310,3937,24537,49149,68442,68442
Dominica,2004,DM,DMA,AMR,2838,6682,9520,5882,4831,5160,3654,2325,3044,24896,2859,6546,9405,5889,4647,4724,3198,2324,3967,24749,49645,68574,68574
Dominica,2005,DM,DMA,AMR,2814,6519,9333,5934,4744,5198,3815,2412,3081,25184,2797,6403,9200,5969,4512,4811,3310,2362,3993,24957,50141,68674,68674
Dominica,2006,DM,DMA,AMR,2764,6343,9107,5967,4699,5220,3972,2493,3132,25483,2726,6266,8992,5992,4426,4874,3427,2401,4036,25156,50639,68742,68742
Dominica,2007,DM,DMA,AMR,2684,6153,8837,5993,4689,5221,4112,2579,3200,25794,2652,6127,8779,5980,4396,4917,3544,2446,4082,25365,51159,68775,68775
Dominica,2008,DM,DMA,AMR,2612,5945,8557,6012,4702,5199,4236,2677,3283,26109,2592,5966,8558,5939,4415,4930,3658,2498,4124,25564,51673,68782,68782
Dominica,2009,DM,DMA,AMR,2547,5758,8305,6014,4729,5150,4353,2771,3377,26394,2556,5792,8348,5893,4459,4895,3771,2556,4166,25740,52134,68787,68787
Dominica,2010,DM,DMA,AMR,2486,5597,8083,5997,4765,5069,4463,2868,3473,26635,2516,5624,8140,5852,4514,4810,3892,2617,4216,25901,52536,68755,68755
Dominica,2011,DM,DMA,AMR,2438,5473,7911,6000,4841,4968,4561,2957,3476,26803,2461,5501,7962,5867,4602,4701,4021,2689,4180,26060,52863,68742,68742
Dominica,2012,DM,DMA,AMR,2415,5392,7807,6059,4958,4860,4659,3031,3391,26958,2400,5433,7833,5957,4742,4609,4154,2767,4062,26291,53249,68888,68888
Dominica,2013,DM,DMA,AMR,2375,5272,7647,6035,5058,4742,4738,3150,3372,27095,2327,5336,7663,5932,4874,4484,4272,2851,4003,26416,53511,68819,68819
Dominica,2014,DM,DMA,AMR,2351,5304,7655,6182,5209,4664,4804,3235,3177,27271,2271,5360,7631,6144,5088,4425,4409,2934,3816,26816,54087,69371,69371
Dominica,2015,DM,DMA,AMR,2328,5315,7643,6324,5376,4600,4871,3330,2998,27499,2234,5347,7581,6360,5310,4389,4543,3024,3655,27281,54780,70007,70007
Dominica,2016,DM,DMA,AMR,2293,5183,7476,6238,5511,4542,4921,3474,3016,27702,2208,5184,7392,6299,5449,4325,4632,3137,3657,27499,55201,70075,70075
Dominica,2017,DM,DMA,AMR,2287,5131,7418,6166,5676,4537,4953,3582,2963,27877,2202,5091,7293,6295,5621,4329,4720,3249,3595,27809,55686,70403,70403
Dominica,2018,DM,DMA,AMR,2284,5094,7378,6072,5847,4564,4965,3682,2942,28072,2209,5017,7226,6252,5784,4382,4781,3360,3585,28144,56216,70823,70823
Dominica,2019,DM,DMA,AMR,2313,5048,7361,6024,6009,4623,4944,3783,2934,28317,2238,4959,7197,6210,5963,4482,4805,3488,3609,28557,56874,71428,71428
Dominica,2020,DM,DMA,AMR,2342,4980,7322,5982,6143,4716,4887,3892,2944,28564,2267,4898,7165,6143,6130,4605,4776,3631,3665,28950,57514,71995,71995
Dominica,2021,DM,DMA,AMR,2361,4915,7276,5898,6240,4826,4803,3997,2999,28763,2289,4818,7107,6034,6268,4732,4699,3783,3748,29264,58027,72412,72412
Dominica,2022,DM,DMA,AMR,2384,4853,7237,5792,6314,4936,4703,4100,3074,28919,2315,4726,7041,5916,6374,4868,4608,3919,3852,29537,58456,72737,72737
Dominica,2023,DM,DMA,AMR,2395,4790,7185,5679,6362,5055,4601,4198,3195,29090,2332,4641,6973,5796,6447,5012,4510,4048,3976,29789,58879,73040,73040
Dominica,2024,DM,DMA,AMR,2405,4739,7144,5569,6393,5170,4512,4278,3353,29275,2342,4561,6903,5670,6502,5167,4410,4168,4130,30047,59322,73368,73368
Dominica,2025,DM,DMA,AMR,2407,4691,7098,5449,6402,5298,4440,4352,3504,29445,2345,4518,6863,5511,6539,5319,4334,4285,4280,30268,59713,73685,73685
Dominica,2026,DM,DMA,AMR,2404,4667,7071,5320,6367,5444,4391,4417,3661,29600,2342,4505,6847,5335,6536,5468,4285,4389,4450,30463,60063,73984,73984
Dominica,2027,DM,DMA,AMR,2397,4663,7060,5213,6251,5603,4381,4463,3812,29723,2335,4513,6848,5173,6478,5619,4271,4474,4618,30633,60356,74264,74264
Dominica,2028,DM,DMA,AMR,2389,4662,7051,5120,6107,5761,4398,4481,3962,29829,2326,4527,6853,5036,6363,5757,4310,4532,4792,30790,60619,74527,74527
Dominica,2029,DM,DMA,AMR,2370,4677,7047,5004,5982,5908,4446,4465,4123,29928,2310,4551,6861,4907,6215,5900,4385,4548,4977,30932,60860,74770,74770
Dominica,2030,DM,DMA,AMR,2349,4696,7045,4882,5872,6023,4526,4417,4289,30009,2287,4571,6858,4796,6058,6038,4480,4513,5189,31074,61083,74988,74988
Dominica,1950,DM,DMA,AMR,4404,6949,11353,3708,3323,2162,1473,1162,2020,13848,4113,6500,10613,4117,3352,2332,1613,1130,1821,14365,28213,50188,50188
Dominica,1951,DM,DMA,AMR,4195,7224,11419,3787,3230,2267,1486,1144,1917,13831,4003,6671,10674,4177,3323,2403,1640,1136,1756,14435,28266,50362,50362
Dominica,1952,DM,DMA,AMR,3977,7488,11465,3907,3097,2387,1500,1124,1820,13835,3853,6851,10704,4274,3281,2479,1662,1143,1698,14537,28372,50544,50544
Dominica,1953,DM,DMA,AMR,3786,7725,11511,4062,2950,2517,1520,1103,1746,13898,3714,7013,10727,4395,3238,2559,1692,1147,1647,14678,28576,50810,50810
Dominica,1954,DM,DMA,AMR,3764,7820,11584,4244,2817,2633,1544,1095,1669,14002,3696,7089,10785,4533,3190,2633,1722,1158,1601,14837,28839,51214,51214
Dominica,1955,DM,DMA,AMR,3927,7679,11606,4417,2724,2691,1609,1106,1578,14125,3847,7057,10904,4702,3180,2714,1832,1228,1609,15265,29390,51895,51895
Dominica,1956,DM,DMA,AMR,4192,7465,11657,4545,2683,2684,1706,1139,1481,14238,4122,7023,11145,4887,3201,2792,2011,1354,1661,15906,30144,52951,52951
Dominica,1957,DM,DMA,AMR,4549,7346,11895,4616,2687,2636,1814,1185,1393,14331,4481,7058,11539,5040,3243,2852,2185,1494,1737,16551,30882,54316,54316
Dominica,1958,DM,DMA,AMR,4967,7356,12323,4630,2717,2551,1936,1236,1313,14383,4889,7192,12081,5160,3310,2899,2348,1639,1829,17185,31568,55972,55972
Dominica,1959,DM,DMA,AMR,5388,7505,12893,4589,2775,2442,2055,1296,1235,14392,5264,7450,12714,5228,3413,2933,2494,1796,1950,17814,32206,57821,57821
Dominica,1960,DM,DMA,AMR,5699,7714,13413,4565,2838,2366,2135,1346,1207,14457,5519,7748,13267,5233,3528,2946,2571,1919,2040,18237,32694,59379,59379
Dominica,1961,DM,DMA,AMR,5858,7898,13756,4601,2884,2345,2162,1389,1219,14600,5647,7997,13644,5194,3618,2936,2583,1991,2074,18396,32996,60395,60395
Dominica,1962,DM,DMA,AMR,5930,8097,14027,4666,2916,2333,2168,1435,1247,14765,5718,8230,13948,5168,3683,2913,2587,2043,2087,18481,33246,61224,61224
Dominica,1963,DM,DMA,AMR,5945,8348,14293,4733,2925,2325,2165,1490,1283,14921,5763,8479,14242,5167,3723,2890,2597,2085,2115,18577,33498,62031,62031
Dominica,1964,DM,DMA,AMR,5933,8644,14577,4807,2909,2318,2160,1545,1315,15054,5799,8731,14530,5205,3729,2866,2612,2113,2154,18679,33733,62843,62843
Dominica,1965,DM,DMA,AMR,5934,8976,14910,4883,2872,2313,2157,1597,1344,15166,5855,9009,14864,5292,3695,2854,2635,2129,2204,18809,33975,63744,63744
Dominica,1966,DM,DMA,AMR,5960,9347,15307,4960,2809,2304,2151,1641,1378,15243,5937,9306,15243,5416,3619,2849,2662,2130,2260,18936,34179,64728,64728
Dominica,1967,DM,DMA,AMR,6007,9729,15736,5048,2733,2298,2142,1672,1406,15299,6040,9618,15658,5582,3513,2848,2684,2121,2321,19069,34368,65760,65760
Dominica,1968,DM,DMA,AMR,6071,10112,16183,5166,2647,2282,2136,1694,1437,15362,6151,9954,16105,5781,3390,2850,2692,2110,2389,19212,34574,66865,66865
Dominica,1969,DM,DMA,AMR,6141,10493,16634,5322,2567,2255,2125,1702,1479,15450,6245,10314,16559,6007,3272,2847,2678,2103,2460,19367,34817,68007,68007
Dominica,2031,DM,DMA,AMR,2318,4706,7024,4790,5761,6114,4632,4345,4455,30097,2257,4584,6841,4693,5916,6160,4596,4442,5406,31213,61310,75178,75178
Dominica,2032,DM,DMA,AMR,2283,4718,7001,4720,5644,6187,4738,4260,4619,30168,2222,4605,6827,4592,5782,6264,4723,4358,5621,31340,61508,75338,75338
Dominica,2033,DM,DMA,AMR,2246,4723,6969,4660,5535,6236,4854,4172,4781,30238,2185,4609,6794,4504,5664,6336,4865,4268,5832,31469,61707,75474,75474
Dominica,2034,DM,DMA,AMR,2207,4708,6915,4605,5429,6264,4970,4098,4942,30308,2146,4604,6750,4430,5538,6389,5019,4178,6046,31600,61908,75579,75579
Dominica,2035,DM,DMA,AMR,2167,4694,6861,4560,5311,6277,5095,4037,5102,30382,2108,4583,6691,4382,5381,6426,5171,4107,6265,31732,62114,75660,75660
Dominica,2036,DM,DMA,AMR,2128,4661,6789,4538,5183,6238,5238,4003,5245,30445,2069,4552,6621,4373,5206,6428,5319,4065,6468,31859,62304,75717,75717
Dominica,2037,DM,DMA,AMR,2090,4622,6712,4536,5079,6132,5391,4004,5371,30513,2031,4512,6543,4377,5047,6365,5466,4059,6665,31979,62492,75743,75743
Dominica,2038,DM,DMA,AMR,2051,4571,6622,4535,4991,5988,5550,4028,5471,30563,1993,4462,6455,4394,4912,6256,5605,4102,6828,32097,62660,75745,75745
Dominica,2039,DM,DMA,AMR,2012,4517,6529,4552,4876,5867,5693,4077,5553,30618,1954,4407,6361,4419,4783,6113,5747,4174,6974,32210,62828,75722,75722
Dominica,2040,DM,DMA,AMR,1975,4458,6433,4571,4757,5762,5805,4158,5605,30658,1917,4347,6264,4438,4673,5955,5884,4272,7083,32305,62963,75668,75668
Dominica,2041,DM,DMA,AMR,1940,4388,6328,4579,4664,5654,5899,4258,5644,30698,1886,4281,6167,4453,4569,5815,6004,4389,7172,32402,63100,75593,75593
Dominica,2042,DM,DMA,AMR,1908,4316,6224,4592,4596,5539,5968,4363,5669,30727,1855,4206,6061,4471,4469,5680,6105,4509,7247,32481,63208,75504,75504
Dominica,2043,DM,DMA,AMR,1882,4239,6121,4598,4540,5434,6020,4472,5688,30752,1824,4133,5957,4477,4384,5565,6179,4650,7310,32565,63317,75391,75391
Dominica,2044,DM,DMA,AMR,1857,4159,6016,4588,4485,5329,6050,4584,5729,30765,1800,4055,5855,4471,4308,5439,6234,4797,7374,32623,63388,75262,75262
Dominica,2045,DM,DMA,AMR,1831,4082,5913,4569,4442,5215,6065,4705,5780,30776,1780,3982,5762,4450,4262,5289,6271,4946,7451,32669,63445,75112,75112
Dominica,2046,DM,DMA,AMR,1812,4013,5825,4536,4420,5091,6028,4841,5837,30753,1761,3907,5668,4420,4256,5118,6272,5089,7554,32709,63462,74947,74947
Dominica,2047,DM,DMA,AMR,1795,3942,5737,4500,4415,4988,5923,4992,5911,30729,1740,3837,5577,4382,4260,4959,6216,5235,7667,32719,63448,74769,74769
Dominica,2048,DM,DMA,AMR,1778,3875,5653,4451,4421,4900,5789,5144,5996,30701,1725,3775,5500,4333,4276,4826,6108,5375,7811,32729,63430,74576,74576
Dominica,2049,DM,DMA,AMR,1767,3812,5579,4397,4436,4788,5674,5284,6080,30659,1713,3713,5426,4278,4298,4702,5966,5510,7956,32710,63369,74377,74377
Dominica,2050,DM,DMA,AMR,1758,3754,5512,4336,4452,4669,5576,5400,6173,30606,1703,3655,5358,4219,4322,4589,5818,5649,8102,32699,63305,74167,74167
Denmark,1970,DK,DNK,EUR,199620,388348,587968,402931,343660,280384,293165,266140,266219,1852499,189446,371344,560790,382442,331285,282184,301608,284623,339562,1921704,3774203,4922963,4922963
Denmark,1971,DK,DNK,EUR,193017,394244,587261,395485,360255,280328,292593,266767,271221,1866649,183134,377124,560258,376000,345477,280956,301235,284925,348730,1937323,3803972,4951486,4951486
Denmark,1972,DK,DNK,EUR,188454,399387,587841,388553,375537,281316,291714,266744,276055,1879919,178776,382121,560897,369798,358735,281091,300271,284671,357860,1952426,3832345,4981078,4981078
Denmark,1973,DK,DNK,EUR,186518,401600,588118,383629,387744,283087,290537,266312,281015,1892324,177067,384190,561257,365390,369371,282255,298722,283991,367148,1966877,3859201,5008581,5008581
Denmark,1974,DK,DNK,EUR,185936,401765,587701,380954,396681,286222,288767,265140,286200,1903964,176804,384097,560901,363136,377551,284217,296831,282496,376784,1981015,3884979,5033573,5033573
Denmark,1975,DK,DNK,EUR,185967,400878,586845,379769,403711,290558,285300,264944,291603,1915885,177126,382958,560084,362180,384325,286962,293215,282407,386300,1995389,3911274,5058203,5058203
Denmark,1976,DK,DNK,EUR,183699,400198,583897,379923,409421,295439,280447,266180,296567,1927977,175200,381967,557167,362667,389588,290433,287822,284249,394966,2009725,3937702,5078773,5078773
Denmark,1977,DK,DNK,EUR,178126,399943,578069,381128,412194,302873,277037,265750,301594,1940576,170001,381442,551443,364173,392028,296312,283963,284300,403726,2024502,3965078,5094599,5094599
Denmark,1978,DK,DNK,EUR,172424,397388,569812,383466,412236,313355,274577,264672,306540,1954846,164554,378897,543451,366507,391873,305513,280778,283421,412725,2040817,3995663,5108930,5108930
Denmark,1979,DK,DNK,EUR,167042,392321,559363,387362,409393,326189,272132,264129,310095,1969300,159398,374164,533562,370035,389167,317093,277345,283000,420561,2057201,4026501,5119418,5119418
Denmark,1980,DK,DNK,EUR,160471,386274,546745,392281,403305,341349,270673,263579,312454,1983641,153105,368593,521698,374467,383924,330237,274965,282799,426909,2073301,4056942,5125392,5125392
Denmark,1981,DK,DNK,EUR,153665,377599,531264,398239,395913,357368,270320,262649,314241,1998730,146669,360380,507049,379882,377549,344190,273668,282380,432267,2089936,4088666,5126981,5126981
Denmark,1982,DK,DNK,EUR,148076,367562,515638,403476,388901,372062,270993,261595,316029,2013056,141441,350820,492261,384521,371141,357242,273783,281361,437407,2105455,4118511,5126398,5126398
Denmark,1983,DK,DNK,EUR,142828,359907,502735,405836,383970,383499,272462,260362,317950,2024079,136529,343636,480165,386290,366458,367585,274936,279773,442315,2117357,4141436,5124332,5124332
Denmark,1984,DK,DNK,EUR,138175,353899,492074,406196,381406,391574,275279,258556,319510,2032521,132145,338151,470296,385986,363891,375411,276809,277898,446432,2126427,4158948,5121314,5121314
Denmark,1985,DK,DNK,EUR,135531,347378,482909,405483,380439,397805,279260,255362,321925,2040274,129580,332185,461765,384774,362638,381802,279446,274383,451453,2134496,4174770,5119452,5119452
Denmark,1986,DK,DNK,EUR,135341,338467,473808,404940,380980,402715,283801,251179,325447,2049062,129230,323935,453165,383863,362915,386706,282882,269179,457792,2143337,4192399,5119369,5119369
Denmark,1987,DK,DNK,EUR,136968,327591,464559,404787,382747,404790,290894,248162,327862,2059242,130520,313669,444189,383635,364323,388951,288678,265400,462536,2153523,4212765,5121510,5121510
Denmark,1988,DK,DNK,EUR,140110,317038,457148,402333,385817,404409,300996,245918,329489,2068962,133217,303564,436781,381613,366774,388802,297725,262302,466003,2163219,4232181,5126107,5126107
Denmark,1989,DK,DNK,EUR,144701,307512,452213,397392,390690,401442,313394,243918,331075,2077911,137337,294387,431724,377563,370774,386239,309148,259114,469243,2172081,4249992,5133930,5133930
Denmark,1990,DK,DNK,EUR,149777,298932,448709,391578,396742,395663,328106,242918,331855,2086862,142019,286021,428040,372830,376095,381445,322192,257019,471428,2181009,4267871,5144623,5144623
Denmark,1991,DK,DNK,EUR,154817,292688,447505,383301,403796,388994,343835,243089,332181,2095196,146755,279927,426682,365571,382736,375818,336168,256015,472644,2188952,4284148,5158325,5158325
Denmark,1992,DK,DNK,EUR,160276,289560,449836,373700,410195,382950,358387,244335,332339,2101906,151974,276800,428774,357012,388905,370267,349381,256435,472945,2194945,4296851,5175469,5175469
Denmark,1993,DK,DNK,EUR,165648,288346,453994,366480,413814,379109,369820,246389,331937,2107549,157135,275423,432558,350854,392511,366536,359952,257900,471922,2199675,4307224,5193775,5193775
Denmark,1994,DK,DNK,EUR,170199,289168,459367,360970,415381,377626,378032,249654,331153,2112816,161519,275995,437514,346413,394198,365055,368055,260124,470254,2204099,4316915,5213800,5213800
Denmark,1995,DK,DNK,EUR,174040,292401,466441,355116,415632,377801,384520,253934,330072,2117075,165186,278816,444002,341566,394962,364979,374758,263144,468272,2207681,4324756,5235197,5235197
Denmark,1996,DK,DNK,EUR,176573,297907,474480,347092,415803,379483,389771,258843,329113,2120105,167530,283726,451256,334614,395865,366430,380034,266937,466289,2210169,4330274,5256007,5256007
Denmark,1997,DK,DNK,EUR,177426,305464,482890,337248,416169,382346,392322,266280,328684,2123049,168277,290619,458896,325682,397258,369016,382772,273003,464816,2212547,4335596,5277382,5277382
Denmark,1998,DK,DNK,EUR,176983,314267,491250,327803,414057,386451,392517,276523,328836,2126187,167820,298716,466536,316833,396639,372617,383250,282181,463489,2215009,4341196,5298992,5298992
Denmark,1999,DK,DNK,EUR,175636,323529,499165,319395,409222,392195,390219,288871,329592,2129494,166534,307303,473837,308882,393691,377628,381382,293619,462149,2217351,4346845,5319854,5319854
Denmark,2000,DK,DNK,EUR,173862,332332,506194,311923,403314,398813,385230,303326,331176,2133782,164958,315497,480455,301640,389822,383703,377219,306544,461289,2220217,4353999,5340655,5340655
Denmark,2001,DK,DNK,EUR,172305,339505,511810,306767,394943,406013,379191,318605,333509,2139028,163674,322180,485854,296547,383395,390693,372097,320285,461038,2224055,4363083,5360748,5360748
Denmark,2002,DK,DNK,EUR,170694,345194,515888,304620,385294,412257,373495,332621,336512,2144799,162288,327571,489859,294311,375620,396868,366961,333207,461184,2228151,4372950,5378697,5378697
Denmark,2003,DK,DNK,EUR,169328,349371,518699,304294,378023,415543,369828,343446,340439,2151573,161113,331582,492695,293747,370095,400292,363546,343506,462189,2233375,4384948,5396355,5396355
Denmark,2004,DK,DNK,EUR,168496,351758,520254,305872,372592,416639,368379,351124,345480,2160086,160408,333967,494375,294924,366307,401659,362217,351401,464361,2240869,4400955,5415586,5415586
Denmark,2005,DK,DNK,EUR,167552,353070,520622,309645,367100,416359,368520,357204,351698,2170526,159572,335452,495024,298046,362263,402032,362230,357897,467674,2250142,4420668,5436313,5436313
Denmark,2006,DK,DNK,EUR,167021,353457,520478,315461,359804,415944,370069,362024,358704,2182006,159091,336059,495150,303053,356303,402467,363772,362931,471705,2260231,4442237,5457864,5457864
Denmark,2007,DK,DNK,EUR,167209,352249,519458,323154,351054,415705,372710,364202,367799,2194624,159273,335088,494361,309931,348462,403391,366414,365502,477578,2271278,4465902,5479722,5479722
Denmark,2008,DK,DNK,EUR,167548,350136,517684,332039,342961,413238,376652,364316,379443,2208649,159565,333246,492811,317955,340778,402449,370089,365944,486390,2283605,4492254,5502751,5502751
Denmark,2009,DK,DNK,EUR,167413,347805,515218,341446,336137,408415,382307,362250,393109,2223664,159273,331187,490460,326525,334096,399355,375231,364286,497621,2297114,4520778,5526452,5526452
Denmark,2010,DK,DNK,EUR,166802,345134,511936,350520,330502,402934,388885,357795,409244,2239880,158523,328875,487398,334849,328198,395617,381487,360625,510869,2311645,4551525,5550849,5550849
Denmark,2011,DK,DNK,EUR,164978,343316,508294,358043,327408,395452,396226,352564,427106,2256799,156783,327352,484135,341828,324498,389648,388711,356173,525936,2326794,4583593,5576016,5576016
Denmark,2012,DK,DNK,EUR,161781,342358,504139,364214,327430,387079,402906,347777,444750,2274156,153796,326504,480300,347670,323652,382589,395189,351785,541482,2342367,4616523,5600959,5600959
Denmark,2013,DK,DNK,EUR,157781,341988,499769,369044,329279,381263,406856,344903,460204,2291549,150042,326116,476158,352224,324440,377867,399065,349076,555232,2357904,4649453,5625385,5625385
Denmark,2014,DK,DNK,EUR,153870,341830,495700,372173,332975,377398,408820,344140,473548,2309054,146395,325782,472177,355189,326899,374931,401050,348335,567318,2373722,4682776,5650653,5650653
Denmark,2015,DK,DNK,EUR,151077,341123,492200,374218,338829,373641,409489,344960,485837,2326974,143670,324923,468593,357256,331247,371783,402132,348876,578733,2390027,4717001,5677796,5677796
Denmark,2016,DK,DNK,EUR,150362,339618,489980,375308,346658,368184,410086,347189,497264,2344689,142720,323436,466156,358409,337454,366709,403300,350877,589284,2406033,4750722,5706857,5706857
Denmark,2017,DK,DNK,EUR,151567,337466,489033,374750,356203,361275,411019,350558,507953,2361758,143641,321377,465018,357936,345458,359687,404904,354126,599364,2421475,4783233,5737284,5737284
Denmark,2018,DK,DNK,EUR,153552,334641,488193,373131,366804,354909,409758,355289,518242,2378133,145420,318595,464015,356520,354528,352683,404679,358504,609436,2436350,4814483,5766686,5766686
Denmark,2019,DK,DNK,EUR,155885,331316,487201,371119,377803,349618,406129,361646,528193,2394508,147513,315200,462713,354743,364089,346530,402347,364211,619538,2451458,4845966,5795878,5795878
Denmark,2020,DK,DNK,EUR,157866,328458,486324,368571,388285,345235,401769,369029,538069,2410958,149328,312112,461440,352484,373304,341052,399294,370989,629796,2466919,4877877,5825641,5825641
Denmark,2021,DK,DNK,EUR,159447,326331,485778,366674,396995,343145,395312,377141,547110,2426377,150845,309722,460567,350764,381060,337643,393894,378683,639472,2481516,4907893,5854240,5854240
Denmark,2022,DK,DNK,EUR,160810,324179,484989,365161,403992,344109,387842,384370,556042,2441516,152173,307515,459688,349283,387827,337142,387212,385551,649048,2496063,4937579,5882261,5882261
Denmark,2023,DK,DNK,EUR,162471,321416,483887,363810,409239,346883,382729,388852,565605,2457118,153781,304942,458723,347937,393301,338458,382690,389710,659083,2511179,4968297,5910913,5910913
Denmark,2024,DK,DNK,EUR,164625,318962,483587,362736,412307,351409,379455,391329,574742,2471978,155914,302684,458598,346775,396632,341547,379843,391947,668796,2525540,4997518,5939695,5939695
Denmark,2025,DK,DNK,EUR,167066,317205,484271,361243,413819,357953,376227,392518,584043,2485803,158345,300971,459316,345228,398508,346668,376735,393294,678642,2539075,5024878,5968467,5968467
Denmark,2026,DK,DNK,EUR,169322,317087,486409,359000,414093,366328,371255,393586,593804,2498066,160537,300682,461219,343183,399045,353755,371726,394672,688921,2551302,5049368,5996995,5996995
Denmark,2027,DK,DNK,EUR,171187,318985,490172,356135,412552,376256,364753,394950,603806,2508452,162322,302310,464632,340707,397630,362714,364781,396439,699459,2561730,5070182,6024988,6024988
Denmark,2028,DK,DNK,EUR,172665,322257,494922,352652,409835,387067,358769,394237,614944,2517504,163767,305344,469111,337534,395168,372683,357894,396397,711050,2570726,5088230,6052267,6052267
Denmark,2029,DK,DNK,EUR,173754,326321,500075,348637,406772,398133,353887,391231,627169,2525829,164840,309183,474023,333649,392467,383044,351947,394260,723506,2578873,5104702,6078801,6078801
Denmark,2030,DK,DNK,EUR,174435,330321,504756,344969,403274,408611,349932,387562,639892,2534240,165522,313012,478534,329922,389374,393068,346736,391407,736433,2586940,5121180,6104474,6104474
Denmark,1950,DK,DNK,EUR,216952,355784,572736,296477,311295,309064,256020,189431,182086,1544373,205733,343527,549260,289810,317989,314007,270478,205472,203573,1601329,3145702,4267694,4267694
Denmark,1951,DK,DNK,EUR,208705,371088,579793,294759,309363,309222,260045,193154,186696,1553239,198240,357347,555587,287911,316687,313972,273835,209805,208751,1610961,3164200,4299579,4299579
Denmark,1952,DK,DNK,EUR,200798,384982,585780,294283,307289,308647,264215,197226,191096,1562756,190678,369945,560623,287571,314872,313298,277443,214384,214036,1621604,3184360,4330757,4330757
Denmark,1953,DK,DNK,EUR,195781,395742,591523,294711,305097,307568,268890,201253,195290,1572809,185764,379639,565403,288386,312487,312195,281458,219003,219217,1632746,3205555,4362483,4362483
Denmark,1954,DK,DNK,EUR,193419,403172,596591,296692,302450,305721,274144,205151,199481,1583639,183363,386551,569914,290119,309802,310353,285742,223789,224367,1644172,3227811,4394320,4394320
Denmark,1955,DK,DNK,EUR,192029,408771,600800,300062,298140,304960,279285,209175,203696,1595318,181768,391906,573674,292683,305442,310039,289850,228596,230104,1656714,3252032,4426508,4426508
Denmark,1956,DK,DNK,EUR,191381,413310,604691,304111,292421,305890,283804,213471,207974,1607671,181031,395911,576942,295971,299338,311747,293306,233505,236389,1670256,3277927,4459559,4459559
Denmark,1957,DK,DNK,EUR,190997,415020,606017,310814,288412,305008,287868,217943,211829,1621874,180737,396988,577725,301737,294885,311507,296575,238364,242368,1685436,3307310,4491051,4491051
Denmark,1958,DK,DNK,EUR,189878,413990,603868,320812,285495,303380,291272,222425,215554,1638938,179787,395233,575020,311007,291155,310328,299599,243041,248378,1703508,3342446,4521329,4521329
Denmark,1959,DK,DNK,EUR,188612,410234,598846,333359,282740,302562,293846,226588,219827,1658922,178749,391017,569766,322680,287187,309787,301954,247481,254808,1723897,3382819,4551440,4551440
Denmark,1960,DK,DNK,EUR,187931,403297,591228,348464,281165,302083,295218,230491,224293,1681714,178391,384306,562697,336010,284391,309558,303130,251470,261525,1746084,3427798,4581727,4581727
Denmark,1961,DK,DNK,EUR,187897,395148,583045,364483,280913,301360,295861,234247,228794,1705658,178702,376653,555355,349965,282911,309081,303501,255025,268891,1769374,3475032,4613434,4613434
Denmark,1962,DK,DNK,EUR,188837,387582,576419,379125,281840,300414,295812,238049,233101,1728341,179860,369362,549222,362696,282873,308062,303259,258806,276310,1792006,3520347,4645994,4645994
Denmark,1963,DK,DNK,EUR,191750,382072,573822,390697,283577,299275,295279,242233,237097,1748158,182846,364014,546860,372618,283840,306452,302550,262891,283618,1811969,3560127,4680812,4680812
Denmark,1964,DK,DNK,EUR,196357,378924,575281,398924,286725,297636,293967,246954,240911,1765117,187293,361006,548299,379876,285591,304486,301028,267261,291078,1829320,3594437,4718016,4718016
Denmark,1965,DK,DNK,EUR,201500,377312,578812,405266,291150,294279,293660,251525,244620,1780500,192111,359455,551566,385673,288111,300813,300988,271443,298437,1845465,3625965,4756337,4756337
Denmark,1966,DK,DNK,EUR,207228,377044,584272,410456,296203,289474,295003,255523,248200,1794859,197397,359437,556834,390144,291395,295332,302975,274912,305683,1860441,3655300,4796403,4796403
Denmark,1967,DK,DNK,EUR,211331,377925,589256,412782,303862,286231,294611,259157,252079,1808722,201076,360698,561774,391879,297159,291414,303034,278112,313384,1874982,3683704,4834730,4834730
Denmark,1968,DK,DNK,EUR,210510,380001,590511,412358,314683,283886,293585,262335,256682,1823529,200052,363053,563105,391065,306343,288114,302092,281067,321910,1890591,3714120,4867734,4867734
Denmark,1969,DK,DNK,EUR,205864,383615,589479,409193,327949,281590,293331,264811,261348,1838222,195441,366695,562136,387947,317944,284565,301725,283471,330673,1906325,3744547,4896157,4896157
Denmark,2031,DK,DNK,EUR,174708,333701,508409,341960,400479,417315,348223,381915,653340,2543232,165812,316308,482120,326817,386863,401595,343679,386294,750135,2595383,5138615,6129146,6129146
Denmark,2032,DK,DNK,EUR,174648,336681,511329,339362,398551,424312,349394,375185,665643,2552447,165783,319218,485001,324252,385010,408717,343415,379951,762591,2603936,5156383,6152709,6152709
Denmark,2033,DK,DNK,EUR,174363,339825,514188,336616,397236,429575,352268,370599,674945,2561239,165533,322274,487807,321684,383677,414192,344790,375701,771943,2611987,5173226,6175218,6175218
Denmark,2034,DK,DNK,EUR,173883,343072,516955,334174,396190,432671,356876,367716,682071,2569698,165094,325486,490580,319434,382529,417528,347927,373049,779053,2619520,5189218,6196753,6196753
Denmark,2035,DK,DNK,EUR,173205,346198,519403,332433,394737,434222,363471,364854,688328,2578045,164458,328596,493054,317728,380993,419416,353077,370132,785404,2626750,5204795,6217243,6217243
Denmark,2036,DK,DNK,EUR,172445,348729,521174,332331,392525,434541,371858,360325,695114,2586694,163740,331080,494820,317441,378958,419972,360176,365368,792221,2634136,5220830,6236819,6236819
Denmark,2037,DK,DNK,EUR,171643,350537,522180,334233,389692,433050,381771,354358,702613,2595717,162979,332837,495816,319077,376492,418575,369120,358743,799775,2641782,5237499,6255495,6255495
Denmark,2038,DK,DNK,EUR,170791,351735,522526,337512,386242,430391,392551,348878,709476,2605050,162168,334038,496206,322114,373332,416139,379062,352182,806753,2649582,5254632,6273360,6273360
Denmark,2039,DK,DNK,EUR,169911,352346,522257,341582,382259,427386,403572,344457,715471,2614727,161330,334673,496003,325954,369456,413464,389389,346535,812780,2657578,5272305,6290573,6290573
Denmark,2040,DK,DNK,EUR,168985,352354,521339,345587,378622,423949,414010,340962,721581,2624711,160449,334721,495170,329785,365746,410401,399383,341635,818869,2665819,5290530,6307040,6307040
Denmark,2041,DK,DNK,EUR,167997,351869,519866,348969,375645,421210,422694,339642,726822,2634982,159518,334293,493811,333081,362656,407919,407889,338841,823850,2674236,5309218,6322892,6322892
Denmark,2042,DK,DNK,EUR,166948,351012,517960,351953,373076,419329,429681,341059,730275,2645373,158523,333506,492029,335993,360101,406095,415000,338754,826801,2682744,5328117,6338111,6338111
Denmark,2043,DK,DNK,EUR,165854,349879,515733,355104,370358,418062,434954,344127,733184,2655789,157493,332449,489942,339050,357546,404784,420466,340272,829116,2691234,5347023,6352693,6352693
Denmark,2044,DK,DNK,EUR,164773,348522,513295,358352,367943,417059,438082,348872,735879,2666187,156470,331174,487644,342262,355306,403654,423814,343519,831172,2699727,5365914,6366856,6366856
Denmark,2045,DK,DNK,EUR,163808,346919,510727,361480,366226,415641,439683,355534,737921,2676485,155555,329663,485218,345374,353608,402146,425726,348737,832606,2708197,5384682,6380630,6380630
Denmark,2046,DK,DNK,EUR,162985,345176,508161,364018,366141,413472,440066,363894,738983,2686574,154773,328011,482784,347863,353330,400130,426316,355846,833055,2716540,5403114,6394059,6394059
Denmark,2047,DK,DNK,EUR,162345,343331,505676,365827,368056,410678,438659,373703,739437,2696360,154166,326261,480427,349623,354968,397689,424974,364747,832702,2724703,5421063,6407171,6407171
Denmark,2048,DK,DNK,EUR,161889,341389,503278,367031,371343,407270,436100,384336,739809,2705889,153732,324419,478151,350825,358011,394549,422596,374608,832067,2732656,5438545,6419976,6419976
Denmark,2049,DK,DNK,EUR,161613,339430,501043,367646,375415,403328,433200,395183,740338,2715110,153476,322560,476036,351464,361853,390697,419992,384838,831568,2740412,5455522,6432605,6432605
Denmark,2050,DK,DNK,EUR,161550,337540,499090,367655,379430,399735,429883,405465,741797,2723965,153422,320772,474194,351515,365685,387012,417001,394741,831920,2747874,5471839,6445109,6445109
Dominican Republic,1970,DO,DOM,AMR,411173,676674,1087847,438260,267370,185612,120850,79296,56724,1148112,401213,667417,1068630,435907,271662,200368,127259,77363,58726,1171285,2319397,4475871,4475871
Dominican Republic,1971,DO,DOM,AMR,415228,692534,1107762,457285,274204,192593,123669,81314,60226,1189291,404984,684783,1089767,456493,275623,206431,131617,80009,62852,1213025,2402316,4599841,4599841
Dominican Republic,1972,DO,DOM,AMR,418875,707403,1126278,475255,281534,200422,127061,83871,64243,1232386,408504,700628,1109132,476451,280382,213122,136473,83185,67391,1257004,2489390,4724801,4724801
Dominican Republic,1973,DO,DOM,AMR,423273,720904,1144177,493131,290158,208337,130785,86383,68064,1276858,412732,714728,1127460,496698,286665,219598,141551,86446,71736,1302694,2579552,4851183,4851183
Dominican Republic,1974,DO,DOM,AMR,427896,733244,1161140,511766,299862,215727,134965,88824,71646,1322790,417139,727311,1144450,517954,294422,225263,146905,89811,75852,1350207,2672997,4978582,4978582
Dominican Republic,1975,DO,DOM,AMR,431957,744941,1176898,531214,310719,222388,139646,91197,75028,1370192,420944,738955,1159899,540120,303774,229962,152560,93277,79772,1399465,2769657,5106453,5106453
Dominican Republic,1976,DO,DOM,AMR,435738,756149,1191887,550572,323085,228538,144817,93543,78320,1418875,424431,749942,1174373,562168,315106,233932,158488,96881,83612,1450187,2869062,5235318,5235318
Dominican Republic,1977,DO,DOM,AMR,439367,766921,1206288,569431,336908,234305,150452,95915,81613,1468624,427740,760407,1188147,583568,328415,237279,164630,100653,87470,1502015,2970639,5365074,5365074
Dominican Republic,1978,DO,DOM,AMR,442674,777422,1220096,587545,352163,239843,156523,98340,84908,1519322,430684,770559,1201243,603982,343720,240177,170946,104592,91368,1554785,3074107,5495443,5495443
Dominican Republic,1979,DO,DOM,AMR,446128,787186,1233314,604719,368605,245385,162945,100880,88209,1570743,433720,779956,1213676,623195,360740,242881,177311,108656,95352,1608135,3178878,5625864,5625864
Dominican Republic,1980,DO,DOM,AMR,450206,797141,1247347,622432,385538,250673,169519,103141,89933,1621236,437415,788454,1225869,641913,379636,245746,183642,112570,97842,1661349,3282585,5755800,5755800
Dominican Republic,1981,DO,DOM,AMR,454378,807598,1261976,640959,402627,255730,176326,105206,90135,1670983,441272,796517,1237789,660049,400082,248982,190038,116386,98953,1714490,3385473,5885244,5885244
Dominican Republic,1982,DO,DOM,AMR,458428,817649,1276077,658603,419916,261357,183494,107609,90497,1721476,445041,804505,1249546,676386,421117,253013,196473,120450,100435,1767874,3489350,6014979,6014979
Dominican Republic,1983,DO,DOM,AMR,463199,827830,1291029,674887,437279,268078,190655,110444,91067,1772410,449626,812899,1262525,690578,442478,258472,202584,124797,102337,1821246,3593656,6147213,6147213
Dominican Republic,1984,DO,DOM,AMR,468515,838271,1306786,689904,455422,275663,197203,113802,91929,1823923,454856,821734,1276590,702901,464715,265252,207763,129473,104695,1874799,3698722,6282104,6282104
Dominican Republic,1985,DO,DOM,AMR,473530,848552,1322082,704067,474321,284157,202902,117709,93151,1876307,459847,830601,1290448,713965,487626,273480,211853,134476,107561,1928961,3805268,6417798,6417798
Dominican Republic,1986,DO,DOM,AMR,478622,858371,1336993,717515,493163,293948,207895,122134,94823,1929478,464896,839193,1304089,724099,510169,283649,215082,139779,110990,1983768,3913246,6554325,6554325
Dominican Republic,1987,DO,DOM,AMR,484215,867835,1352050,730345,511674,305061,212266,127046,96999,1983391,470405,847616,1318021,733562,531877,295899,217586,145327,115003,2039254,4022645,6692720,6692720
Dominican Republic,1988,DO,DOM,AMR,490157,877538,1367695,742784,529655,317513,216153,132413,99659,2038177,476204,856467,1332671,742708,552405,310320,219552,151075,119611,2095671,4133848,6834207,6834207
Dominican Republic,1989,DO,DOM,AMR,497012,887834,1384846,754542,547054,331191,219779,138154,102811,2093531,482853,866068,1348921,751362,571624,326790,221270,156932,124761,2152739,4246270,6980033,6980033
Dominican Republic,1990,DO,DOM,AMR,505004,898205,1403209,765453,563806,345777,223601,144138,106399,2149174,490592,875856,1366448,759415,589402,344799,223409,162745,130404,2210174,4359348,7129004,7129004
Dominican Republic,1991,DO,DOM,AMR,513054,908436,1421490,775654,579959,360895,227802,150437,110361,2205108,498381,885560,1383941,767054,605691,363849,226228,168600,136444,2267866,4472974,7278402,7278402
Dominican Republic,1992,DO,DOM,AMR,520331,918947,1439278,785441,595348,376253,232586,157078,114642,2261348,505371,895577,1400948,774615,620288,383604,229887,174557,142816,2325767,4587115,7427340,7427340
Dominican Republic,1993,DO,DOM,AMR,526236,930367,1456603,795407,609540,391690,238429,163701,119261,2318028,510906,906594,1417500,782639,632842,403726,234956,180281,149492,2383936,4701964,7576074,7576074
Dominican Republic,1994,DO,DOM,AMR,530251,941601,1471852,805856,622805,409286,246624,170887,126519,2381977,513900,917763,1431663,790200,640609,423104,241139,185347,158046,2438445,4820422,7723934,7723934
Dominican Republic,1995,DO,DOM,AMR,532279,952249,1484528,816402,635560,429031,257207,178356,136271,2452827,514383,928496,1442879,797264,644424,441542,248512,189551,168230,2489523,4942350,7869753,7869753
Dominican Republic,1996,DO,DOM,AMR,532533,963257,1495790,826414,647739,448764,269085,185075,146150,2523227,513284,939262,1452546,804629,647667,459599,257645,192904,178298,2540742,5063969,8012314,8012314
Dominican Republic,1997,DO,DOM,AMR,530885,974204,1505089,835812,659385,468206,282286,191162,156251,2593102,510531,949604,1460135,812126,650483,476697,268602,195512,188328,2591748,5184850,8150076,8150076
Dominican Republic,1998,DO,DOM,AMR,526996,984380,1511376,845124,670713,487097,296771,196728,166513,2662946,505871,958730,1464601,820224,653337,492451,281384,197516,198284,2643196,5306142,8282126,8282126
Dominican Republic,1999,DO,DOM,AMR,522439,993696,1516135,854661,681460,505297,312395,202006,176937,2732756,500880,966508,1467388,829104,656151,506672,295827,199201,208148,2695103,5427859,8411374,8411374
Dominican Republic,2000,DO,DOM,AMR,519285,1002310,1521595,863886,691479,522664,328857,207473,187488,2801847,497470,973229,1470699,838078,658925,519167,311403,201196,217879,2746648,5548495,8540791,8540791
Dominican Republic,2001,DO,DOM,AMR,517216,1009618,1526834,872602,701066,539281,345879,213384,198375,2870587,495220,978491,1473711,846743,662052,529962,327694,203781,227681,2797913,5668500,8669040,8669040
Dominican Republic,2002,DO,DOM,AMR,515773,1016243,1532016,881004,710368,553533,361707,218848,207444,2932904,494146,982743,1476889,856328,668866,540468,344550,206977,236103,2853292,5786196,8795101,8795101
Dominican Republic,2003,DO,DOM,AMR,515613,1021266,1536879,889754,719980,564935,376112,224311,214524,2989616,494534,985259,1479793,867189,679844,550379,361713,211347,243090,2913562,5903178,8919852,8919852
Dominican Republic,2004,DO,DOM,AMR,515448,1023911,1539359,899528,730204,575084,391155,230678,221450,3048099,494488,985692,1480180,878526,691978,558537,379629,216916,249902,2975488,6023587,9043127,9043127
Dominican Republic,2005,DO,DOM,AMR,513705,1025748,1539453,910165,740513,584554,406887,237971,227955,3108045,492735,985710,1478445,890054,704647,565723,398243,223770,256375,3038812,6146857,9164768,9164768
Dominican Republic,2006,DO,DOM,AMR,510720,1026597,1537317,921396,750488,593718,422671,246541,234045,3168859,489653,985284,1474937,901422,717328,572500,416759,232363,262683,3103055,6271914,9284168,9284168
Dominican Republic,2007,DO,DOM,AMR,507771,1026011,1533782,932905,760073,602790,438251,256331,239646,3229996,486535,983959,1470494,912385,729875,579302,434765,242763,268841,3167931,6397927,9402206,9402206
Dominican Republic,2008,DO,DOM,AMR,506677,1024270,1530947,944063,769719,612070,453400,267292,244839,3291383,485340,981810,1467150,922343,742643,586613,451936,254982,274950,3233467,6524850,9522948,9522948
Dominican Republic,2009,DO,DOM,AMR,508357,1021436,1529793,954798,779614,621355,467992,279270,249839,3352868,486998,978892,1465890,931267,755695,594389,468075,268878,281200,3299504,6652372,9648061,9648061
Dominican Republic,2010,DO,DOM,AMR,512237,1017905,1530142,965243,789111,630514,481868,291978,255109,3413823,490849,975593,1466442,939490,768265,602611,482965,283990,288029,3365350,6779173,9775755,9775755
Dominican Republic,2011,DO,DOM,AMR,517719,1013586,1531305,974798,797949,639757,495107,305144,261112,3473867,496309,971698,1468007,946682,779954,611614,496583,299952,295777,3430562,6904429,9903737,9903737
Dominican Republic,2012,DO,DOM,AMR,523566,1009517,1533083,982602,806544,649302,507502,318559,268283,3532792,502161,968158,1470319,952111,791091,621667,508695,316501,304632,3494697,7027489,10030882,10030882
Dominican Republic,2013,DO,DOM,AMR,527664,1008375,1536039,987532,815560,659489,518574,332046,276821,3590022,506386,967412,1473798,954832,802354,633047,518834,333359,314768,3557194,7147216,10157051,10157051
Dominican Republic,2014,DO,DOM,AMR,529224,1009960,1539184,990138,825470,670266,528467,346091,286135,3646567,508213,969150,1477363,955494,814161,645568,527275,350983,325520,3619001,7265568,10282115,10282115
Dominican Republic,2015,DO,DOM,AMR,529038,1012203,1541241,992011,836139,681102,537709,360688,295986,3703635,508341,971400,1479741,955742,826195,658590,534716,369242,336723,3681208,7384843,10405832,10405832
Dominican Republic,2016,DO,DOM,AMR,527997,1014831,1542828,992973,847321,691579,546622,375251,306572,3760318,507587,973906,1481493,955519,838051,671576,541661,387313,348834,3742954,7503272,10527592,10527592
Dominican Republic,2017,DO,DOM,AMR,526677,1017908,1544585,992634,858748,701658,555434,389541,317829,3815844,506523,976797,1483320,954414,849441,684375,548511,404771,361991,3803503,7619347,10647244,10647244
Dominican Republic,2018,DO,DOM,AMR,525472,1021083,1546555,991238,869795,711748,564470,403341,329853,3870445,505533,979947,1485480,952494,859715,697321,555758,421288,376484,3863060,7733505,10765531,10765531
Dominican Republic,2019,DO,DOM,AMR,523757,1024461,1548218,988781,880378,722021,573589,416521,342907,3924197,503988,983497,1487485,949783,868824,710508,563401,436736,392734,3921986,7846183,10881882,10881882
Dominican Republic,2020,DO,DOM,AMR,520925,1028475,1549400,986831,892015,732368,582614,428592,355664,3978084,501341,987738,1489079,947839,878364,723761,571734,450941,410462,3983101,7961185,10999664,10999664
Dominican Republic,2021,DO,DOM,AMR,517385,1033440,1550825,985084,904102,742560,591808,439648,368194,4031396,498039,992944,1490983,946342,888105,736699,581019,463754,428748,4044667,8076063,11117873,11117873
Dominican Republic,2022,DO,DOM,AMR,513344,1038292,1551636,982107,913400,752056,601481,450568,383004,4082616,494258,998035,1492293,943817,895085,748635,591163,475147,448418,4102265,8184881,11228821,11228821
Dominican Republic,2023,DO,DOM,AMR,508272,1041345,1549617,980770,918895,761520,611862,461002,399757,4133806,489449,1001389,1490838,942784,898325,760233,602520,484882,469970,4158714,8292520,11332972,11332972
Dominican Republic,2024,DO,DOM,AMR,502865,1041434,1544299,982136,922163,771863,622824,470496,417184,4186666,484312,1001877,1486189,944217,899533,772385,615026,493075,492619,4216855,8403521,11434005,11434005
Dominican Republic,2025,DO,DOM,AMR,498039,1038519,1536558,984179,924711,782941,633856,479536,435224,4240447,479738,999424,1479162,946170,900320,784767,628076,500436,516215,4275984,8516431,11532151,11532151
Dominican Republic,2026,DO,DOM,AMR,493522,1033842,1527364,986633,926299,794502,644524,488403,453770,4294131,475425,995258,1470683,948416,900592,796985,641142,507447,540542,4335124,8629255,11627301,11627301
Dominican Republic,2027,DO,DOM,AMR,489011,1028526,1517537,989569,926492,806290,654774,497276,472702,4347103,471077,990464,1461541,951101,899911,808765,654066,514476,565353,4393672,8740775,11719851,11719851
Dominican Republic,2028,DO,DOM,AMR,484879,1022450,1507329,992670,925529,817729,665008,506381,491898,4399215,467081,984874,1451955,954131,898334,819478,667162,521947,590435,4451487,8850702,11809986,11809986
Dominican Republic,2029,DO,DOM,AMR,481058,1015580,1496638,996060,923456,828781,675397,515526,511289,4450509,463368,978449,1441817,957672,895904,829105,680486,529806,615642,4508615,8959124,11897570,11897570
Dominican Republic,2030,DO,DOM,AMR,477398,1008023,1485421,999983,920651,839625,685367,524595,530746,4500967,459797,971309,1431106,961792,893037,838016,693329,538062,640794,4565030,9065997,11982523,11982523
Dominican Republic,1950,DO,DOM,AMR,228875,319682,548557,233317,155921,110161,76194,48169,32794,656556,222648,316562,539210,241795,156062,98488,65831,43160,32086,637422,1293978,2381740,2381740
Dominican Republic,1951,DO,DOM,AMR,238978,327237,566215,241090,160127,112674,78049,49422,33602,674964,232477,323270,555747,249413,162185,101852,67684,44323,32921,658378,1333342,2455305,2455305
Dominican Republic,1952,DO,DOM,AMR,249244,335903,585147,249243,164477,115241,79937,50708,34468,694074,242466,331194,573660,257149,168421,105385,69610,45522,33792,679879,1373953,2532758,2532758
Dominican Republic,1953,DO,DOM,AMR,259646,346230,605876,257400,169035,117873,81859,52034,35376,713577,252596,340876,593472,264660,174779,109111,71617,46761,34712,701640,1415217,2614566,2614566
Dominican Republic,1954,DO,DOM,AMR,270968,357964,628932,264917,173909,120569,83805,53400,36327,732927,263645,352086,615731,271342,181275,113066,73710,48046,35686,723125,1456052,2700717,2700717
Dominican Republic,1955,DO,DOM,AMR,283266,371129,654395,271612,179134,123345,85776,54809,37314,751990,275666,364819,640485,277078,187912,117261,75892,49387,36705,744235,1496225,2791108,2791108
Dominican Republic,1956,DO,DOM,AMR,295732,386149,681881,277763,184694,126207,87771,56255,38331,771021,287869,379474,667343,282197,194658,121693,78175,50780,37772,765275,1536296,2885526,2885526
Dominican Republic,1957,DO,DOM,AMR,308055,403022,711077,283545,190593,129162,89800,57735,39384,790219,299944,396060,696004,286870,201490,126361,80568,52227,38890,786406,1576625,2983695,2983695
Dominican Republic,1958,DO,DOM,AMR,319967,421716,741683,289134,196793,132227,91862,59244,40465,809725,311628,414561,726189,291294,208360,131244,83082,53723,40050,807753,1617478,3085349,3085349
Dominican Republic,1959,DO,DOM,AMR,331328,442017,773345,294807,203194,135452,93957,60784,41570,829764,322794,434738,757532,295791,215192,136324,85745,55284,41252,829588,1659352,3190231,3190231
Dominican Republic,1960,DO,DOM,AMR,342012,463450,805462,301102,209675,138864,96096,62350,42713,850800,333317,455966,789283,301085,221839,141577,88582,56902,42497,852482,1703282,3298021,3298021
Dominican Republic,1961,DO,DOM,AMR,351952,485518,837470,308265,216407,142438,98281,63949,43881,873221,343123,477720,820843,307464,228476,146984,91586,58586,43784,876880,1750101,3408415,3408415
Dominican Republic,1962,DO,DOM,AMR,361146,507738,868884,316530,223524,146159,100528,65584,45082,897407,352195,499623,851818,315042,235249,152529,94761,60345,45121,903047,1800454,3521164,3521164
Dominican Republic,1963,DO,DOM,AMR,369551,529724,899275,326425,230670,150091,102840,67252,46323,923601,360454,521305,881759,324349,241826,158195,98117,62173,46502,931162,1854763,3635798,3635798
Dominican Republic,1964,DO,DOM,AMR,377234,552141,929375,337682,237229,154331,105223,68949,47607,951021,367993,543440,911433,335149,247617,164009,101695,64076,47939,960485,1911506,3752313,3752313
Dominican Republic,1965,DO,DOM,AMR,384286,574965,959251,349774,242395,158604,107522,70559,48849,977703,374915,566001,940916,347429,252491,169949,105486,66061,49433,990849,1968552,3868712,3868712
Dominican Republic,1966,DO,DOM,AMR,390991,597338,988329,363741,247028,163188,109900,72193,50130,1006180,381495,588120,969615,361580,256764,176004,109505,68130,50981,1022964,2029144,3987090,3987090
Dominican Republic,1967,DO,DOM,AMR,397217,618980,1016197,380143,251931,168397,112533,73968,51549,1038521,387606,609489,997095,377634,260624,182177,113768,70308,52596,1057107,2095628,4108916,4108916
Dominican Republic,1968,DO,DOM,AMR,402401,639603,1042004,398337,256675,173901,115277,75779,53015,1072984,392713,629831,1022544,395574,264247,188405,118245,72601,54274,1093346,2166330,4230877,4230877
Dominican Republic,1969,DO,DOM,AMR,406759,659105,1065864,418066,261477,179588,118169,77632,54514,1109446,397033,649055,1046088,415116,267892,194585,122911,75033,56024,1131561,2241007,4352954,4352954
Dominican Republic,2031,DO,DOM,AMR,474046,999870,1473916,1004745,917060,849751,694746,533831,550356,4550489,456520,963581,1420101,966749,889538,845945,705355,547073,665892,4620552,9171041,12065051,12065051
Dominican Republic,2032,DO,DOM,AMR,470896,991377,1462273,1009655,913691,858336,703939,543412,569971,4599004,453441,955486,1408927,971872,886366,852190,716897,557098,690708,4675131,9274135,12145326,12145326
Dominican Republic,2033,DO,DOM,AMR,467830,982386,1450216,1013001,913157,864285,713561,553583,589145,4646732,450432,946867,1397299,975504,885937,855822,728583,568374,714773,4728993,9375725,12223234,12223234
Dominican Republic,2034,DO,DOM,AMR,464920,973368,1438288,1013415,915301,868086,724057,564291,607976,4693126,447577,938204,1385781,976288,887980,857466,740827,580744,738249,4781554,9474680,12298752,12298752
Dominican Republic,2035,DO,DOM,AMR,462337,965090,1427427,1010856,918131,871207,735279,575083,626850,4737406,445055,930236,1375291,974144,890560,858712,753310,593636,761640,4832002,9569408,12372136,12372136
Dominican Republic,2036,DO,DOM,AMR,459899,957428,1417327,1006554,921373,873411,746987,585566,645930,4779821,442663,922820,1365483,970299,893442,859466,765637,606553,785200,4880597,9660418,12443225,12443225
Dominican Republic,2037,DO,DOM,AMR,457447,949965,1407412,1001623,925097,874265,758918,595687,665261,4820851,440262,915560,1355822,965822,896772,859286,777540,619343,809033,4927796,9748647,12511883,12511883
Dominican Republic,2038,DO,DOM,AMR,454991,942956,1397947,995938,928982,874000,770532,605829,684953,4860234,437863,908719,1346582,960552,900452,858231,788411,632315,833307,4973268,9833502,12578040,12578040
Dominican Republic,2039,DO,DOM,AMR,452574,936413,1388987,989460,933159,872655,781784,616142,704774,4897974,435489,902310,1337799,954452,904642,856338,798223,645515,857839,5017009,9914983,12641774,12641774
Dominican Republic,2040,DO,DOM,AMR,450131,930352,1380483,982304,937862,870605,792827,626072,724532,4934202,433079,896367,1329446,947646,909408,854008,807330,658257,882469,5059118,9993320,12703248,12703248
Dominican Republic,2041,DO,DOM,AMR,447587,924740,1372327,974561,943387,867776,803168,635474,744523,4968889,430567,890852,1321419,940247,915005,851050,815466,670219,907532,5099519,10068408,12762152,12762152
Dominican Republic,2042,DO,DOM,AMR,445003,919314,1364317,966477,949057,865163,812022,644733,764769,5002221,428008,885512,1313520,932480,920761,848409,821951,681732,933061,5138394,10140615,12818453,12818453
Dominican Republic,2043,DO,DOM,AMR,442565,913965,1356530,957901,953190,865318,818334,654420,785114,5034277,425590,880248,1305838,924191,925032,848477,825872,693394,958854,5175820,10210097,12872473,12872473
Dominican Republic,2044,DO,DOM,AMR,440312,908805,1349117,949299,954453,868103,822600,664965,805642,5065062,423352,875159,1298511,915851,926470,850998,827860,705621,984945,5211745,10276807,12924431,12924431
Dominican Republic,2045,DO,DOM,AMR,438122,903947,1342069,941425,952796,871571,826247,676221,826304,5094564,421178,870358,1291536,908206,925003,854059,829475,718089,1011302,5246134,10340698,12974297,12974297
Dominican Republic,2046,DO,DOM,AMR,435942,899124,1335066,934158,949413,875446,829022,687942,846894,5122875,419021,865586,1284607,901102,921830,857420,830612,730413,1037679,5279056,10401931,13021610,13021610
Dominican Republic,2047,DO,DOM,AMR,433581,894241,1327822,927070,945394,879784,830508,699885,867422,5150063,416693,860750,1277443,894137,918019,861212,830839,742333,1064087,5310627,10460690,13065951,13065951
Dominican Republic,2048,DO,DOM,AMR,430829,889496,1320325,920405,940590,884269,830916,711554,888351,5176085,413993,856048,1270041,887560,913376,865334,830195,753268,1091013,5340746,10516831,13107192,13107192
Dominican Republic,2049,DO,DOM,AMR,427661,884958,1312619,914155,934957,889006,830277,722906,909607,5200908,410896,851547,1262443,881366,907853,869930,828725,763192,1118355,5369421,10570329,13145386,13145386
Dominican Republic,2050,DO,DOM,AMR,424114,880445,1304559,908353,928589,894226,828947,734047,930544,5224706,407441,847061,1254502,875600,901565,875060,826813,772423,1145317,5396778,10621484,13180541,13180541
Algeria,1970,DZ,DZA,AFR,1273895,2067129,3341024,1337788,809143,625950,412827,292749,234048,3712505,1223133,1932844,3155977,1213568,813677,620531,398451,288686,251506,3586419,7298924,13795915,13795915
Algeria,1971,DZ,DZA,AFR,1297302,2112459,3409761,1403546,818959,637748,419798,292141,232272,3804464,1246015,1983107,3229122,1266324,820155,634998,406644,289523,249277,3666921,7471385,14110271,14110271
Algeria,1972,DZ,DZA,AFR,1324596,2157321,3481917,1468671,832378,648510,428532,291588,230868,3900547,1271960,2031995,3303955,1320921,829405,648231,416629,290417,247721,3753324,7653871,14439748,14439748
Algeria,1973,DZ,DZA,AFR,1353859,2202099,3555958,1533491,851326,658613,438981,291145,229873,4003429,1299863,2080181,3380044,1377228,842890,660426,428387,291293,246804,3847028,7850457,14786469,14786469
Algeria,1974,DZ,DZA,AFR,1385458,2245553,3631011,1598270,877647,668274,450758,291150,229151,4115250,1330098,2126848,3456946,1436673,861120,671825,441636,292486,246650,3950390,8065640,15153602,15153602
Algeria,1975,DZ,DZA,AFR,1463640,2316403,3780043,1645147,914993,678980,470671,304562,239951,4254304,1394925,2184453,3579378,1498797,893212,689739,467120,307874,254225,4110967,8365271,15724692,15724692
Algeria,1976,DZ,DZA,AFR,1574827,2434921,4009748,1672428,961082,689176,497347,330747,265019,4415799,1483567,2269147,3752714,1555013,940927,713032,503728,337928,271633,4322261,8738060,16500516,16500516
Algeria,1977,DZ,DZA,AFR,1632530,2543875,4176405,1718891,1012280,697011,516822,344116,279845,4568965,1535846,2356687,3892533,1609663,989757,727788,529655,355232,284192,4496287,9065252,17134192,17134192
Algeria,1978,DZ,DZA,AFR,1651074,2623048,4274122,1788472,1070384,705281,530532,345817,281570,4722056,1562924,2431373,3994297,1671658,1039309,736008,545983,359653,289553,4642164,9364220,17632645,17632645
Algeria,1979,DZ,DZA,AFR,1674584,2700889,4375473,1861366,1134251,716092,545099,349166,283405,4889379,1594128,2505784,4099912,1737066,1095213,745710,563253,365405,295565,4802212,9691591,18166981,18166981
Algeria,1980,DZ,DZA,AFR,1706120,2777788,4483908,1936270,1201987,730396,559947,354213,285649,5068462,1631958,2580793,4212751,1804529,1155707,757777,580945,372701,302598,4974257,10042719,18739378,18739378
Algeria,1981,DZ,DZA,AFR,1750311,2849938,4600249,2012969,1272581,749507,574701,361057,288534,5259349,1680606,2652909,4333515,1873851,1219803,773419,598670,381723,310781,5158247,10417596,19351357,19351357
Algeria,1982,DZ,DZA,AFR,1805798,2916232,4722030,2091916,1345102,774694,589132,369825,292406,5463075,1737326,2723039,4460365,1945347,1286492,793858,616123,392616,320191,5354627,10817702,20000096,20000096
Algeria,1983,DZ,DZA,AFR,1863825,2983180,4847005,2173471,1418826,806755,603186,380534,297550,5680322,1794444,2797029,4591473,2019551,1354659,819907,633067,405332,330799,5563315,11243637,20682111,20682111
Algeria,1984,DZ,DZA,AFR,1918088,3054831,4972919,2257803,1493606,846038,617090,393182,304316,5912035,1848262,2876184,4724446,2097043,1423539,852047,649414,419692,342393,5784128,11696163,21393530,21393530
Algeria,1985,DZ,DZA,AFR,1964636,3134026,5098662,2344666,1569657,892708,631043,407661,312814,6158549,1895123,2962875,4857998,2177865,1493132,890743,665185,435652,355112,6017689,12176238,22132905,22132905
Algeria,1986,DZ,DZA,AFR,1998404,3220256,5218660,2432142,1646587,946164,644851,423602,322582,6415928,1929737,3056421,4986158,2260185,1563200,935910,680214,453137,369162,6261808,12677736,22882553,22882553
Algeria,1987,DZ,DZA,AFR,2016551,3309235,5325786,2512593,1718366,1002664,657200,440050,332795,6663668,1948594,3152579,5101173,2335556,1627806,984320,693147,471255,383389,6495473,13159141,23586101,23586101
Algeria,1988,DZ,DZA,AFR,2019891,3399363,5419254,2586360,1785619,1061558,668882,456939,343996,6903354,1952739,3249345,5202084,2404052,1687505,1035390,704432,489605,397339,6718323,13621677,24243018,24243018
Algeria,1989,DZ,DZA,AFR,2011478,3489584,5501062,2659410,1853892,1124478,682075,474220,356096,7150171,1944981,3345959,5290940,2472662,1747929,1090812,716140,508288,411495,6947326,14097497,24889507,24889507
Algeria,1990,DZ,DZA,AFR,1990865,3578156,5569021,2732114,1922316,1189950,697681,491081,368232,7401374,1924726,3440623,5365349,2542411,1808393,1149400,729291,526841,425990,7182326,14583700,25518074,25518074
Algeria,1991,DZ,DZA,AFR,1965146,3664686,5629832,2800585,1990576,1256790,716875,507154,380621,7652601,1899668,3532059,5431727,2609803,1868625,1210022,745001,544950,441347,7419748,15072349,26133905,26133905
Algeria,1992,DZ,DZA,AFR,1944994,3746037,5691031,2863404,2058851,1323679,740662,522027,393134,7901757,1880161,3615417,5495578,2675553,1928823,1271388,764300,562241,457635,7659940,15561697,26748303,26748303
Algeria,1993,DZ,DZA,AFR,1928354,3814781,5743135,2926989,2127566,1389655,769708,535629,405902,8155449,1863954,3684064,5548018,2745423,1989664,1332145,787834,578347,474308,7907721,16063170,27354327,27354327
Algeria,1994,DZ,DZA,AFR,1909877,3866522,5776399,2994493,2196152,1453813,804133,548001,418899,8415491,1845852,3735999,5581851,2820321,2051613,1391120,816024,593110,491073,8163261,16578752,27937006,27937006
Algeria,1995,DZ,DZA,AFR,1880786,3896257,5777043,3069263,2265204,1516327,844102,559160,431422,8685478,1817514,3766661,5584175,2902940,2115423,1448295,849490,606696,508478,8431322,17116800,28478022,28478022
Algeria,1996,DZ,DZA,AFR,1825327,3906762,5732089,3173904,2326926,1561544,885851,586690,469483,9004398,1753019,3760401,5513420,3008780,2180542,1488389,884169,630910,541932,8734722,17739120,28984634,28984634
Algeria,1997,DZ,DZA,AFR,1756105,3898824,5654929,3308904,2383510,1585966,927430,628637,536555,9371002,1665296,3716801,5382097,3133103,2250108,1510441,917629,663739,592980,9068000,18439002,29476031,29476031
Algeria,1998,DZ,DZA,AFR,1686772,3872200,5558972,3426884,2451464,1626037,977096,650261,581501,9713243,1592346,3672195,5264541,3241423,2324289,1549199,958849,681724,632434,9387918,19101161,29924668,29924668
Algeria,1999,DZ,DZA,AFR,1617740,3834219,5451959,3521192,2528841,1688849,1036273,654208,601475,10030838,1533333,3634219,5167552,3332666,2399178,1608599,1009774,687316,658204,9695737,19726575,30346083,30346083
Algeria,2000,DZ,DZA,AFR,1561196,3783423,5344619,3610354,2607239,1756633,1098732,659080,621552,10353590,1485332,3583318,5068650,3419267,2474331,1671867,1064390,693502,684412,10007769,20361359,30774621,30774621
Algeria,2001,DZ,DZA,AFR,1520137,3719633,5239770,3689808,2685225,1827661,1162045,666610,641734,10673083,1451384,3519781,4971165,3496774,2548682,1737965,1120823,701705,711020,10316969,20990052,31200985,31200985
Algeria,2002,DZ,DZA,AFR,1493827,3646538,5140365,3756429,2763757,1901137,1224196,678782,662199,10986500,1431267,3447302,4878569,3561607,2623372,1806454,1177293,713294,737233,10619253,21605753,31624696,31624696
Algeria,2003,DZ,DZA,AFR,1495591,3557578,5053169,3806824,2845618,1976506,1283482,697397,683164,11292991,1434055,3363456,4797511,3610445,2700893,1877160,1232197,729474,762045,10912214,22205205,32055883,32055883
Algeria,2004,DZ,DZA,AFR,1525606,3458978,4984584,3839870,2932944,2053548,1339284,723603,704301,11593550,1460132,3274119,4734251,3642681,2782980,1950212,1284930,751368,785632,11197803,22791353,32510186,32510186
Algeria,2005,DZ,DZA,AFR,1568705,3366289,4934994,3849877,3019865,2128796,1391185,756960,724741,11871424,1499067,3190257,4689324,3652220,2863972,2022409,1334947,779052,808355,11460955,23332379,32956690,32956690
Algeria,2006,DZ,DZA,AFR,1625395,3282041,4907436,3844646,3110496,2204249,1442303,797334,744457,12143485,1551492,3114364,4665856,3647080,2948383,2095272,1384604,812685,830280,11718304,23861789,33435080,33435080
Algeria,2007,DZ,DZA,AFR,1697910,3207302,4905212,3832319,3207842,2281729,1495901,844371,763094,12425256,1619575,3047581,4667156,3635405,3039855,2170204,1436511,852407,851823,11986205,24411461,33983827,33983827
Algeria,2008,DZ,DZA,AFR,1781745,3147436,4929181,3808019,3304072,2357842,1552617,896707,780121,12699378,1698933,2994756,4693689,3611505,3130882,2243673,1490946,897442,872896,12247344,24946722,34569592,34569592
Algeria,2009,DZ,DZA,AFR,1871191,3109238,4980429,3772545,3397282,2432893,1613686,953385,796721,12966512,1784311,2962251,4746562,3575996,3219902,2315772,1548814,947216,894834,12502534,25469046,35196037,35196037
Algeria,2010,DZ,DZA,AFR,1962489,3097083,5059572,3724134,3484850,2507901,1678987,1012863,814332,13223067,1872311,2954211,4826522,3527412,3304220,2387363,1610067,1000379,917740,12747181,25970248,35856344,35856344
Algeria,2011,DZ,DZA,AFR,2052533,3114026,5166559,3662701,3564203,2583435,1747754,1073280,834249,13465622,1959829,2973840,4933669,3466071,3381042,2458966,1674348,1055317,941952,12977696,26443318,36543541,36543541
Algeria,2012,DZ,DZA,AFR,2141327,3160658,5301985,3591682,3632179,2660599,1819212,1132699,857627,13693998,2046435,3022064,5068499,3395516,3447054,2532124,1741492,1110601,969279,13196066,26890064,37260563,37260563
Algeria,2013,DZ,DZA,AFR,2223011,3246633,5469644,3504710,3685252,2742103,1892900,1189752,886739,13901456,2126323,3104427,5230750,3313494,3498817,2609308,1811411,1164830,1000918,13398778,27300234,38000626,38000626
Algeria,2014,DZ,DZA,AFR,2294938,3366183,5661121,3407785,3721438,2829328,1968377,1243864,923826,14094618,2196972,3215932,5412904,3225661,3534578,2691398,1883899,1217223,1038775,13591534,27686152,38760168,38760168
Algeria,2015,DZ,DZA,AFR,2361207,3501566,5862773,3317275,3740058,2922082,2045066,1295633,969350,14289464,2262220,3343797,5606017,3143793,3553414,2778293,1958225,1267942,1083243,13784910,28074374,39543154,39543154
Algeria,2016,DZ,DZA,AFR,2419965,3649314,6069279,3234899,3742687,3018685,2122174,1346862,1021730,14487037,2320098,3484651,5804749,3069517,3556555,2868591,2033208,1318151,1132238,13978260,28465297,40339329,40339329
Algeria,2017,DZ,DZA,AFR,2465011,3810635,6275646,3160888,3732291,3116556,2198649,1399311,1077965,14685660,2364616,3639215,6003831,3003156,3546568,2960327,2107626,1369386,1184343,14171406,28857066,41136546,41136546
Algeria,2018,DZ,DZA,AFR,2495798,3976083,6471881,3101659,3709914,3213554,2273898,1454652,1137049,14890726,2395152,3798307,6193459,2950691,3524222,3051915,2180662,1423071,1240386,14370947,29261673,41927007,41927007
Algeria,2019,DZ,DZA,AFR,2511452,4137278,6648730,3063940,3675997,3307386,2348065,1513949,1198832,15108169,2410561,3954142,6364703,2918448,3489778,3141503,2252314,1480136,1301580,14583759,29691928,42705368,42705368
Algeria,2020,DZ,DZA,AFR,2507706,4294853,6802559,3053390,3630254,3395833,2421501,1574986,1254376,15330340,2406693,4107414,6514107,2911941,3443331,3226859,2323022,1539193,1360312,14804658,30134998,43451666,43451666
Algeria,2021,DZ,DZA,AFR,2485852,4443965,6929817,3073223,3573116,3477102,2495729,1638647,1309613,15567430,2384992,4253163,6638155,2934390,3385703,3305872,2394122,1601018,1421468,15042573,30610003,44177969,44177969
Algeria,2022,DZ,DZA,AFR,2448269,4578319,7026588,3123087,3507295,3548001,2573233,1707679,1376349,15835644,2348348,4384871,6733219,2985839,3319739,3374970,2467891,1667362,1491971,15307772,31143416,44903225,44903225
Algeria,2023,DZ,DZA,AFR,2398554,4691523,7090077,3212209,3426092,3604298,2655703,1780098,1448686,16127086,2300520,4496142,6796662,3071573,3242954,3429998,2545948,1736968,1565217,15592658,31719744,45606480,45606480
Algeria,2024,DZ,DZA,AFR,2340927,4780019,7120946,3334284,3335087,3643942,2743807,1854207,1523770,16435097,2245321,4583247,6828568,3185877,3160582,3469178,2628859,1808963,1640685,15894144,32329241,46278751,46278751
Algeria,2025,DZ,DZA,AFR,2279348,4843411,7122759,3471669,3250471,3666225,2837316,1929385,1602063,16757129,2186399,4645659,6832058,3316026,3084327,3491579,2716559,1882647,1718947,16210085,32967214,46922031,46922031
Algeria,2026,DZ,DZA,AFR,2217239,4881197,7098436,3620927,3173893,3672687,2934589,2004941,1684106,17091143,2126928,4682932,6809860,3458701,3015734,3498464,2807810,1957050,1800888,16538647,33629790,47538087,47538087
Algeria,2027,DZ,DZA,AFR,2157813,4889674,7047487,3783322,3105605,3666404,3033234,2080121,1770513,17439199,2069769,4691949,6761718,3614670,2955086,3492435,2900748,2031113,1887551,16881603,34320802,48130008,48130008
Algeria,2028,DZ,DZA,AFR,2103557,4871822,6975379,3949528,3051908,3648426,3131107,2154376,1861748,17797093,2017334,4675747,6693081,3774848,2908198,3474242,2993690,2103975,1979732,17234685,35031778,48700234,48700234
Algeria,2029,DZ,DZA,AFR,2055822,4831080,6886902,4111274,3019374,3619169,3225849,2227760,1957882,18161308,1971189,4637199,6608388,3931533,2881234,3444140,3084621,2175493,2077632,17594653,35755961,49251258,49251258
Algeria,2030,DZ,DZA,AFR,2015787,4766881,6782668,4269063,3012318,3577050,3315048,2301280,2058608,18533367,1932504,4575560,6508064,4085271,2878297,3401005,3171017,2246648,2180949,17963187,36496554,49787283,49787283
Algeria,1950,DZ,DZA,AFR,756488,1117718,1874206,915663,619490,466074,359693,217255,161233,2739408,715386,1074186,1789572,858885,594489,466403,348814,194627,153465,2616683,5356091,9019866,9019866
Algeria,1951,DZ,DZA,AFR,809363,1133439,1942802,936965,634067,472884,364570,225108,163123,2796717,767910,1089089,1856999,877584,608353,472597,355810,204248,156620,2675212,5471929,9271734,9271734
Algeria,1952,DZ,DZA,AFR,861126,1151563,2012689,955757,648127,479224,368568,234638,165562,2851876,819926,1104530,1924456,893672,622728,477204,361691,216607,160775,2732677,5584553,9521702,9521702
Algeria,1953,DZ,DZA,AFR,911407,1173578,2084985,971845,662490,485126,372105,244972,168247,2904785,871466,1121479,1992945,907762,637723,480888,366891,230389,165323,2788976,5693761,9771686,9771686
Algeria,1954,DZ,DZA,AFR,957191,1203242,2160433,981902,675249,489133,374475,253861,170072,2944692,919428,1144684,2064112,920385,652899,484492,371978,243379,169173,2842306,5786998,10011541,10011541
Algeria,1955,DZ,DZA,AFR,989457,1250004,2239461,986589,686176,491547,375825,260500,171052,2971689,952330,1186594,2138924,931661,668213,488211,377280,254609,172238,2892212,5863901,10242288,10242288
Algeria,1956,DZ,DZA,AFR,1011290,1310401,2321691,988965,698139,494314,377110,265712,171609,2995849,973091,1243762,2216853,940968,684269,491986,382825,264501,174227,2938776,5934625,10473168,10473168
Algeria,1957,DZ,DZA,AFR,1033023,1373223,2406246,989920,710965,497445,378432,269437,171535,3017734,993863,1303214,2297077,949288,700346,496197,388767,272667,174929,2982194,5999928,10703251,10703251
Algeria,1958,DZ,DZA,AFR,1054716,1437600,2492316,991769,723330,500676,379714,271810,171507,3038806,1014606,1364322,2378928,957738,715713,500914,394713,278990,175673,3023741,6062547,10933784,10933784
Algeria,1959,DZ,DZA,AFR,1075736,1503376,2579112,995982,733534,503691,380540,273332,172529,3059608,1034687,1427242,2461929,966174,729453,506076,399577,284252,178261,3063793,6123401,11164443,11164443
Algeria,1960,DZ,DZA,AFR,1095768,1570234,2666002,1003683,740210,506607,380835,274303,174719,3080357,1053832,1491810,2545642,975219,740322,511925,402988,288824,183028,3102306,6182663,11394307,11394307
Algeria,1961,DZ,DZA,AFR,1116644,1624016,2740660,1010475,747519,510892,382500,276635,182907,3110928,1071301,1538097,2609398,982834,749933,516195,401873,291043,195746,3137624,6248552,11598608,11598608
Algeria,1962,DZ,DZA,AFR,1142008,1663973,2805981,1013444,755974,516945,385092,280284,196860,3148599,1091145,1563516,2654661,987639,759732,519288,396243,290504,215609,3169015,6317614,11778260,11778260
Algeria,1963,DZ,DZA,AFR,1174631,1702509,2877140,1018159,763592,525520,387139,284032,210813,3189255,1118856,1584966,2703822,992963,769252,524201,389920,289088,233800,3199224,6388479,11969451,11969451
Algeria,1964,DZ,DZA,AFR,1212202,1738940,2951142,1029721,772363,538281,389568,288813,223820,3242566,1151564,1603193,2754757,1001561,778431,531070,383698,288012,247856,3230628,6473194,12179099,12179099
Algeria,1965,DZ,DZA,AFR,1239856,1776091,3015947,1048452,780014,553584,392378,293991,235508,3303927,1176296,1623611,2799907,1013132,785989,539636,377843,286997,257878,3261475,6565402,12381256,12381256
Algeria,1966,DZ,DZA,AFR,1251510,1827898,3079408,1084926,784918,568425,395216,296144,240436,3370065,1189052,1670596,2859648,1035828,791364,552527,376820,286674,261049,3304262,6674327,12613389,12613389
Algeria,1967,DZ,DZA,AFR,1256057,1892236,3148293,1140740,789331,582826,398456,295355,239125,3445833,1196566,1741170,2937736,1072468,796257,569429,380923,287251,258927,3365255,6811088,12897115,12897115
Algeria,1968,DZ,DZA,AFR,1257925,1955066,3212991,1203959,794847,597813,402500,294431,237685,3531235,1201489,1810718,3012207,1115584,801795,587012,385881,287635,256641,3434548,6965783,13190975,13190975
Algeria,1969,DZ,DZA,AFR,1261153,2014909,3276062,1270858,801445,612544,407233,293521,235965,3621566,1208281,1875860,3084141,1163191,807818,604420,391661,288075,254084,3509249,7130815,13491016,13491016
Algeria,2031,DZ,DZA,AFR,1984230,4683931,6668161,4418131,3033799,3522115,3396372,2375563,2163440,18909420,1901986,4495456,6397442,4231183,2902533,3345391,3250287,2318049,2289091,18336534,37245954,50311560,50311560
Algeria,2032,DZ,DZA,AFR,1961043,4587871,6548914,4552409,3084350,3457988,3466916,2451806,2271998,19285467,1879569,4402587,6282156,4362957,2954779,3280909,3319212,2391156,2401442,18710455,37995922,50826981,50826981
Algeria,2033,DZ,DZA,AFR,1946649,4484718,6431367,4665551,3173354,3378294,3523134,2532447,2383995,19656775,1865649,4303043,6168692,4474241,3040461,3205255,3374279,2468283,2517500,19080019,38736794,51336846,51336846
Algeria,2034,DZ,DZA,AFR,1941795,4380151,6321946,4754091,3295095,3288865,3563078,2618645,2499125,20018899,1860873,4202385,6063258,4561438,3154593,3124028,3413729,2550209,2636901,19440898,39459797,51845003,51845003
Algeria,2035,DZ,DZA,AFR,1944932,4279283,6224215,4817626,3432075,3205756,3586053,2710153,2617198,20368861,1863685,4105420,5969105,4624014,3284516,3048863,3436650,2636856,2759444,19790343,40159204,52352520,52352520
Algeria,2036,DZ,DZA,AFR,1955148,4186311,6141459,4855645,3580874,3130609,3593564,2805370,2738094,20704156,1873222,4016027,5889249,4661510,3426919,2981309,3444273,2727007,2884994,20126012,40830168,52860879,52860879
Algeria,2037,DZ,DZA,AFR,1971705,4104332,6076037,4864468,3742760,3063681,3588606,2901970,2861662,21023147,1888777,3936985,5825762,4670826,3582581,2921637,3439159,2818823,3013395,20446421,41469568,53371371,53371371
Algeria,2038,DZ,DZA,AFR,1992816,4036251,6029067,4847044,3908463,3011220,3572194,2997850,2987844,21324615,1908691,3871111,5779802,4654976,3742449,2875630,3422033,2910639,3144566,20750293,42074908,53883769,53883769
Algeria,2039,DZ,DZA,AFR,2016726,3984165,6000891,4806807,4069766,2979743,3544710,3090736,3116817,21608579,1931342,3820603,5751945,4616828,3898848,2849418,3393137,3000487,3278616,21037334,42645913,54398757,54398757
Algeria,2040,DZ,DZA,AFR,2043436,3947708,5991144,4743190,4227176,2973524,3504581,3178306,3249271,21876048,1956679,3785086,5741765,4555635,4052326,2847065,3351360,3085912,3416174,21308472,43184520,54917437,54917437
Algeria,2041,DZ,DZA,AFR,2072574,3926748,5999322,4660876,4375938,2995585,3451832,3258311,3385387,22127929,1984367,3764418,5748785,4476007,4198022,2871688,3297235,3164375,3557305,21564632,43692561,55440658,55440658
Algeria,2042,DZ,DZA,AFR,2101621,3920458,6022079,4565493,4510015,3046457,3390001,3327947,3525926,22365839,2012032,3757825,5769857,4383637,4329631,2924126,3234316,3232732,3702846,21807288,44173127,55965060,55965060
Algeria,2043,DZ,DZA,AFR,2129876,3927470,6057346,4463026,4623096,3135427,3312784,3383846,3672917,22591096,2038892,3764051,5802943,4284594,4440837,3009760,3160307,3287576,3854530,22037604,44628700,56488986,56488986
Algeria,2044,DZ,DZA,AFR,2156854,3946786,6103640,4359137,4711720,3256829,3225944,3424180,3827374,22805184,2064511,3782120,5846631,4184420,4528038,3123632,3080753,3327198,4012793,22256834,45062018,57012291,57012291
Algeria,2045,DZ,DZA,AFR,2181239,3976857,6158096,4258921,4775471,3393359,3145324,3448273,3988960,23010308,2087674,3810435,5898109,4087912,4590693,3253195,3007166,3350712,4177465,22467143,45477451,57533658,57533658
Algeria,2046,DZ,DZA,AFR,2201236,4016402,6217638,4166562,4813841,3541624,3072535,3457557,4156106,23208225,2106620,3847801,5954421,3998944,4628355,3395161,2941087,3359315,4347356,22670218,45878443,58050507,58050507
Algeria,2047,DZ,DZA,AFR,2216664,4062187,6278851,4085153,4823158,3702884,3007862,3454912,4326603,23400572,2121190,3891145,6012335,3920292,4637918,3550299,2882795,3355508,4520626,22867438,46268010,58559198,58559198
Algeria,2048,DZ,DZA,AFR,2226180,4111725,6337905,4017585,4806352,3867952,2957463,3441266,4498421,23589039,2130054,3938032,6068086,3854765,4622391,3709619,2838026,3339982,4695587,23060370,46649409,59055401,59055401
Algeria,2049,DZ,DZA,AFR,2228092,4162782,6390874,3965955,4766825,4028676,2927767,3416945,4669595,23775763,2131607,3986412,6118019,3804565,4584619,3865501,2812837,3312963,4870570,23251055,47026818,59535713,59535713
Algeria,2050,DZ,DZA,AFR,2223579,4214037,6437616,3929898,4704016,4185562,2922952,3380371,4838601,23961400,2127030,4035013,6162043,3769314,4523871,4018490,2811244,3273325,5043812,23440056,47401456,60001113,60001113
Ecuador,1970,EC,ECU,AMR,542122,848458,1390580,601244,391681,276023,191837,133193,106250,1700228,526403,829262,1355665,590864,384501,274610,196061,145713,133999,1725748,3425976,6172215,6172215
Ecuador,1971,EC,ECU,AMR,553535,874047,1427582,624219,405142,283674,196594,136151,107773,1753553,537431,854071,1391502,613470,397678,281958,200568,148593,136038,1778305,3531858,6350944,6350944
Ecuador,1972,EC,ECU,AMR,564571,899749,1464320,647662,419515,291457,202020,139081,109384,1809119,548131,879024,1427155,636421,411893,289379,205785,151436,138125,1833039,3642158,6533630,6533630
Ecuador,1973,EC,ECU,AMR,575109,925744,1500853,670070,436120,299515,208008,142018,111189,1866920,558398,904294,1462692,658181,428513,297031,211608,154263,140383,1889979,3756899,6720443,6720443
Ecuador,1974,EC,ECU,AMR,585034,951918,1536952,691104,455102,308126,214304,145046,113356,1927038,568118,929775,1497893,678483,447604,305231,217770,157137,143019,1949244,3876282,6911123,6911123
Ecuador,1975,EC,ECU,AMR,594722,977775,1572497,712219,475090,317375,220774,148249,115963,1989670,577588,954967,1532555,698871,467730,314094,224126,160147,146103,2011071,4000741,7105786,7105786
Ecuador,1976,EC,ECU,AMR,604504,1002702,1607206,734421,495365,327179,227456,151571,119047,2055039,587077,979226,1566303,720372,488216,323543,230728,163239,149700,2075798,4130837,7304349,7304349
Ecuador,1977,EC,ECU,AMR,614166,1026782,1640948,757688,515916,337582,234383,154976,122659,2123204,596388,1002651,1599039,742962,509044,333629,237610,166380,153846,2143471,4266675,7506665,7506665
Ecuador,1978,EC,ECU,AMR,623736,1050317,1674053,781624,536730,348735,241486,158613,126625,2193813,605533,1025518,1631051,766274,530181,344536,244694,169741,158381,2213807,4407620,7712718,7712718
Ecuador,1979,EC,ECU,AMR,633508,1073160,1706668,806128,557846,360687,248676,162701,130668,2266706,614785,1047679,1662464,790234,551635,356341,251861,173575,163017,2286663,4553369,7922490,7922490
Ecuador,1980,EC,ECU,AMR,643509,1095359,1738868,831164,579429,373275,255962,167296,134617,2341743,624192,1069155,1693347,814778,573536,368919,259101,177969,167584,2361887,4703630,8135845,8135845
Ecuador,1981,EC,ECU,AMR,653715,1117270,1770985,856343,601726,386295,263351,172363,138438,2418516,633784,1090286,1724070,839508,596095,382085,266423,182886,172023,2439020,4857536,8352602,8352602
Ecuador,1982,EC,ECU,AMR,664122,1138865,1802987,881606,624430,400135,270837,177911,142059,2496978,643536,1111073,1754609,864337,618940,396276,273816,188338,176327,2518034,5015012,8572607,8572607
Ecuador,1983,EC,ECU,AMR,674617,1160089,1834706,907152,646093,416061,278575,183821,145600,2577302,653340,1131421,1784761,889451,640572,412806,281425,194207,180641,2599102,5176404,8795873,8795873
Ecuador,1984,EC,ECU,AMR,685141,1181143,1866284,932912,666420,434249,286828,189869,149359,2659637,663111,1151524,1814635,914782,660736,431747,289574,200255,185329,2682423,5342060,9022979,9022979
Ecuador,1985,EC,ECU,AMR,695645,1202305,1897950,958429,686828,453387,295712,195944,153619,2743919,672726,1171710,1844436,939860,680961,451706,298382,206361,190737,2768007,5511926,9254311,9254311
Ecuador,1986,EC,ECU,AMR,706117,1223805,1929922,983114,708305,472806,305138,202097,158561,2830021,682213,1192166,1874379,964072,702251,472014,307775,212607,197048,2855767,5685788,9490096,9490096
Ecuador,1987,EC,ECU,AMR,716287,1245369,1961656,1006963,730728,492461,315128,208371,164287,2917938,691448,1212611,1904059,987413,724510,492595,317780,219054,204373,2945725,5863663,9729376,9729376
Ecuador,1988,EC,ECU,AMR,725806,1266913,1992719,1030010,753438,512217,325739,214705,170817,3006926,700134,1232914,1933048,1009893,747090,513279,328507,225629,212697,3037095,6044021,9969788,9969788
Ecuador,1989,EC,ECU,AMR,734602,1288602,2023204,1052024,776213,532050,336974,221032,178074,3096367,708188,1253183,1961371,1031280,769796,534020,339989,232246,221912,3129243,6225610,10210185,10210185
Ecuador,1990,EC,ECU,AMR,742643,1310312,2052955,1073060,798983,552104,348653,227405,185901,3186106,715582,1273304,1988886,1051600,792543,554928,352076,238921,231822,3221890,6407996,10449837,10449837
Ecuador,1991,EC,ECU,AMR,749836,1331944,2081780,1093218,821071,572442,360483,233813,194091,3275118,722187,1293230,2015417,1070945,814633,576062,364524,245655,242146,3313965,6589083,10686279,10686279
Ecuador,1992,EC,ECU,AMR,756193,1353134,2109327,1111848,841631,592349,372665,240207,202434,3361134,727952,1312697,2040649,1088643,835177,596691,377586,252379,252632,3403108,6764242,10914222,10914222
Ecuador,1993,EC,ECU,AMR,761856,1373496,2135352,1128993,860745,610336,386393,246737,210774,3443978,733071,1331390,2064461,1104695,854214,615254,392518,259235,263120,3489036,6933014,11132829,11132829
Ecuador,1994,EC,ECU,AMR,767197,1393009,2160206,1145761,879128,626416,401985,253718,219087,3526095,737927,1349236,2087163,1120304,872474,631798,409526,266554,273523,3574179,7100274,11347652,11347652
Ecuador,1995,EC,ECU,AMR,772310,1411618,2183928,1162954,896861,642123,418336,261282,227401,3608957,742609,1366124,2108733,1136367,890026,647984,427357,274476,283853,3660063,7269020,11561683,11561683
Ecuador,1996,EC,ECU,AMR,777075,1429280,2206355,1180933,913557,658424,434841,269346,235785,3692886,746967,1382040,2129007,1153229,906454,664800,445382,282908,294206,3746979,7439865,11775221,11775221
Ecuador,1997,EC,ECU,AMR,781515,1445863,2227378,1199391,929362,675273,451511,277908,244353,3777798,750936,1396922,2147858,1170557,921908,682209,463580,291869,304685,3834808,7612606,11987838,11987838
Ecuador,1998,EC,ECU,AMR,785731,1461213,2246944,1218264,944653,692321,468348,287064,253143,3863793,754599,1410727,2165326,1188248,936776,699854,481906,301500,315349,3923633,7787426,12199693,12199693
Ecuador,1999,EC,ECU,AMR,789333,1475554,2264887,1237906,959617,709628,485448,296836,262208,3951643,757684,1423706,2181390,1206565,951267,717784,500418,311862,326224,4014120,7965763,12412046,12412046
Ecuador,2000,EC,ECU,AMR,791934,1488944,2280878,1258493,974804,727432,503019,307093,271665,4042506,759838,1435898,2195736,1225703,965938,736183,519311,322844,337404,4107383,8149889,12626507,12626507
Ecuador,2001,EC,ECU,AMR,793641,1501327,2294968,1280261,991072,745645,521342,317658,281619,4137597,761158,1447178,2208336,1245940,981659,754905,538842,334298,348981,4204625,8342222,12845521,12845521
Ecuador,2002,EC,ECU,AMR,794719,1512923,2307642,1302965,1008686,764379,540124,328902,292113,4237169,761994,1457616,2219610,1267111,998763,774014,558690,346630,360981,4306189,8543358,13070609,13070609
Ecuador,2003,EC,ECU,AMR,795240,1523997,2319237,1325920,1027591,783854,558025,341967,303224,4340581,762394,1467509,2229903,1288575,1017162,793703,577413,361069,373537,4411459,8752040,13301184,13301184
Ecuador,2004,EC,ECU,AMR,795351,1534307,2329658,1348399,1047598,803850,574636,357010,315057,4446550,762434,1476736,2239170,1309543,1036706,813789,594660,377670,386845,4519213,8965763,13534593,13534593
Ecuador,2005,EC,ECU,AMR,795618,1543431,2339049,1370018,1068861,823931,591149,372907,327582,4554448,762680,1484886,2247566,1329599,1057589,833834,611782,395173,400969,4628946,9183394,13770012,13770012
Ecuador,2006,EC,ECU,AMR,796540,1551330,2347870,1390825,1091748,843690,608499,389121,340693,4664576,763613,1491887,2255500,1348889,1080195,853425,629753,412999,415848,4741109,9405685,14009061,14009061
Ecuador,2007,EC,ECU,AMR,798418,1558279,2356697,1410533,1115871,863248,626677,405691,354354,4776374,765473,1498000,2263473,1367230,1104100,872733,648559,431153,431518,4855293,9631667,14251835,14251835
Ecuador,2008,EC,ECU,AMR,801258,1564417,2365675,1428719,1140836,882840,645334,422617,368575,4888921,768246,1503327,2271573,1384309,1128855,892026,667836,449596,448008,4970630,9859551,14496797,14496797
Ecuador,2009,EC,ECU,AMR,805068,1569489,2374557,1445431,1166514,902324,664443,439918,383316,5001946,771922,1507666,2279588,1400131,1154218,911208,687535,468340,465241,5086673,10088619,14742766,14742766
Ecuador,2010,EC,ECU,AMR,809762,1573643,2383405,1460732,1192646,921819,684064,457706,398483,5115450,776429,1511195,2287624,1414691,1179837,930387,707667,487486,483038,5203106,10318556,14989585,14989585
Ecuador,2011,EC,ECU,AMR,815130,1577381,2392511,1474651,1219090,941736,703930,476138,413998,5229543,781568,1514403,2295971,1427863,1205554,949974,727909,507194,501203,5319697,10549240,15237728,15237728
Ecuador,2012,EC,ECU,AMR,818924,1581236,2400160,1487513,1245515,962151,724070,494907,430246,5344402,785187,1517850,2303037,1439774,1231038,970081,748234,527102,520061,5436290,10780692,15483883,15483883
Ecuador,2013,EC,ECU,AMR,818080,1585336,2403416,1499782,1271538,983145,744734,512804,448378,5460381,784361,1521629,2305990,1450910,1255930,990741,768880,545878,540863,5553202,11013583,15722989,15722989
Ecuador,2014,EC,ECU,AMR,812193,1590030,2402223,1511888,1297502,1005261,765991,529590,468763,5578995,778681,1526017,2304698,1461903,1280536,1012484,789928,563268,563971,5672090,11251085,15957994,15957994
Ecuador,2015,EC,ECU,AMR,802438,1595960,2398398,1524117,1323999,1029195,787621,546412,490488,5701832,769263,1531653,2300916,1473137,1305447,1036035,811153,580594,588392,5794758,11496590,16195902,16195902
Ecuador,2016,EC,ECU,AMR,789528,1603412,2392940,1536467,1351225,1055331,809161,564069,512935,5829188,756830,1538814,2295644,1484660,1330973,1061756,832086,598716,613627,5921818,11751006,16439585,16439585
Ecuador,2017,EC,ECU,AMR,776871,1610634,2387505,1549710,1379803,1083832,830936,582657,536254,5963192,744654,1545777,2290431,1497338,1357938,1089759,853107,617721,639950,6055813,12019005,16696944,16696944
Ecuador,2018,EC,ECU,AMR,769493,1615854,2385347,1570389,1416881,1118277,854890,602625,561236,6124298,737586,1550925,2288511,1518238,1393850,1123371,876016,637919,668122,6217516,12341814,17015672,17015672
Ecuador,2019,EC,ECU,AMR,766076,1617331,2383407,1589776,1454686,1154999,879329,623254,587312,6289356,734344,1552422,2286766,1538026,1431055,1159120,899429,658741,697835,6384206,12673562,17343740,17343740
Ecuador,2020,EC,ECU,AMR,763493,1614370,2377863,1597812,1482068,1187790,900619,640142,603849,6412280,731853,1549496,2281349,1545735,1458174,1191398,920830,677900,723062,6517099,12929379,17588595,17588595
Ecuador,2021,EC,ECU,AMR,762035,1608557,2370592,1601906,1504986,1219556,920687,654751,614356,6516242,730395,1543803,2274198,1549204,1480945,1222839,941881,696076,745757,6636702,13152944,17797737,17797737
Ecuador,2022,EC,ECU,AMR,760072,1600509,2360581,1601489,1522127,1250197,942027,673182,635000,6624022,728470,1535962,2264432,1547900,1497653,1252783,963522,715920,774192,6751970,13375992,18001000,18001000
Ecuador,2023,EC,ECU,AMR,757069,1590720,2347789,1597242,1533324,1278747,964323,694479,662617,6730732,725569,1526442,2252011,1542514,1508055,1280396,985502,737083,806403,6859953,13590685,18190484,18190484
Ecuador,2024,EC,ECU,AMR,754082,1579348,2333430,1594374,1542482,1306344,987318,716180,690957,6837655,722689,1515420,2238109,1538509,1516340,1307018,1008285,758555,839462,6968169,13805824,18377367,18377367
Ecuador,2025,EC,ECU,AMR,751093,1566191,2317284,1593973,1549511,1332878,1011398,737925,720218,6945903,719818,1502670,2222488,1537032,1522410,1332476,1032258,779969,873547,7077692,14023595,18563370,18563370
Ecuador,2026,EC,ECU,AMR,748457,1551081,2299538,1596512,1554474,1358254,1036825,759246,750667,7055978,717294,1488037,2205331,1538601,1526274,1356729,1057622,800837,908960,7189023,14245001,18749869,18749869
Ecuador,2027,EC,ECU,AMR,746013,1535918,2281931,1600043,1557673,1382242,1063362,780267,782380,7165967,714927,1473390,2188317,1541322,1528239,1379621,1084053,821331,945748,7300314,14466281,18936525,18936525
Ecuador,2028,EC,ECU,AMR,743391,1523857,2267248,1601325,1559281,1404539,1090882,801259,815147,7272433,712363,1461733,2174096,1542055,1528452,1400964,1111337,841778,983684,7408270,14680703,19122047,19122047
Ecuador,2029,EC,ECU,AMR,740846,1515142,2255988,1599599,1559181,1425202,1119410,822161,848957,7374510,709864,1453292,2163156,1540015,1526850,1420811,1139414,862166,1022721,7511977,14886487,19305626,19305626
Ecuador,2030,EC,ECU,AMR,738632,1508516,2247148,1595584,1557791,1444132,1148664,843092,883776,7473039,707675,1446861,2154536,1535865,1523918,1439029,1167985,882616,1062810,7612223,15085262,19486952,19486952
Ecuador,1950,EC,ECU,AMR,300866,422702,723568,308775,225599,177250,132709,100807,80466,1025606,292986,413592,706578,304766,224945,181130,139327,110356,102456,1062980,2088586,3518733,3518733
Ecuador,1951,EC,ECU,AMR,314546,436540,751086,316920,230763,180763,134226,101383,81701,1045756,306588,427071,733659,312599,229822,184406,141182,110842,103828,1082679,2128435,3613175,3613175
Ecuador,1952,EC,ECU,AMR,328024,451288,779312,325124,236601,184125,135832,101917,83099,1066698,319916,441560,761476,320393,235384,187524,143088,111314,105408,1103111,2169809,3710588,3710588
Ecuador,1953,EC,ECU,AMR,339932,468353,808285,333537,242986,187341,137630,102456,84585,1088535,331540,458487,790027,328329,241519,190477,145132,111833,107079,1124369,2212904,3811220,3811220
Ecuador,1954,EC,ECU,AMR,349926,487894,837820,342473,249613,190455,139795,103065,86105,1111506,341183,477921,819104,336750,247925,193290,147461,112495,108783,1146704,2258210,3915140,3915140
Ecuador,1955,EC,ECU,AMR,359373,508474,867847,352041,256339,193563,142343,103772,87611,1135669,350284,498356,848640,345795,254442,196066,150104,113335,110471,1170213,2305882,4022378,4022378
Ecuador,1956,EC,ECU,AMR,369221,529363,898584,362154,263233,196614,145300,104570,89092,1160963,359740,519095,878835,355380,261162,198755,153072,114360,112130,1194859,2355822,4133240,4133240
Ecuador,1957,EC,ECU,AMR,379576,550570,930146,372876,270360,199570,148680,105479,90511,1187476,369649,540140,909789,365560,268134,201339,156369,115593,113752,1220747,2408223,4248157,4248157
Ecuador,1958,EC,ECU,AMR,390257,572081,962338,384382,277665,202679,152310,106499,91871,1215406,379850,561455,941305,376542,275288,204067,159849,116996,115307,1248049,2463455,4367090,4367090
Ecuador,1959,EC,ECU,AMR,401282,593960,995242,396753,285083,206294,155899,107623,93127,1244779,390337,583081,973418,388422,282513,207307,163271,118507,116804,1276824,2521603,4490253,4490253
Ecuador,1960,EC,ECU,AMR,412805,616386,1029191,409833,292639,210544,159312,108899,94300,1275527,401291,605177,1006468,401075,289810,211222,166495,120140,118240,1306982,2582509,4618158,4618158
Ecuador,1961,EC,ECU,AMR,425034,639623,1064657,423410,300341,215425,162606,110318,95402,1307502,412983,627974,1040957,414305,297197,215802,169586,121883,119610,1338383,2645885,4751507,4751507
Ecuador,1962,EC,ECU,AMR,437927,663316,1101243,437920,308179,220995,165797,111844,96462,1341197,425376,651090,1076466,428585,304644,221099,172564,123713,120914,1371519,2712716,4890425,4890425
Ecuador,1963,EC,ECU,AMR,451213,685908,1137121,454740,316304,227127,168889,113562,97499,1378121,438221,672935,1111156,445306,312320,226991,175422,125688,122208,1407935,2786056,5034334,5034334
Ecuador,1964,EC,ECU,AMR,464844,707069,1171913,474026,325006,233546,171925,115609,98573,1418685,451485,693224,1144709,464540,320552,233199,178195,127942,123561,1447989,2866674,5183283,5183283
Ecuador,1965,EC,ECU,AMR,478672,728291,1206963,494379,334399,240107,174993,117988,99698,1461564,464968,713554,1178522,484810,329472,239570,180956,130473,125014,1490295,2951859,5337351,5337351
Ecuador,1966,EC,ECU,AMR,492042,750645,1242687,515084,344394,246889,178036,120702,100879,1505984,477986,734989,1212975,505422,338988,246191,183651,133283,126581,1534116,3040100,5495761,5495761
Ecuador,1967,EC,ECU,AMR,504888,774108,1278996,536107,355027,253931,181010,123759,102139,1551973,490457,757521,1247978,526345,349137,253092,186257,136368,128305,1579504,3131477,5658446,5658446
Ecuador,1968,EC,ECU,AMR,517631,798285,1315916,557425,366453,261175,184123,127000,103461,1599637,502785,780784,1283569,547521,360088,260191,188997,139596,130147,1626540,3226177,5825663,5825663
Ecuador,1969,EC,ECU,AMR,530157,823077,1353234,579072,378720,268529,187686,130174,104819,1649000,514869,804703,1319572,568968,371915,267361,192206,142743,132037,1675230,3324230,5997037,5997037
Ecuador,2031,EC,ECU,AMR,736251,1503565,2239816,1589477,1555930,1461153,1178401,864418,919349,7568728,705329,1442016,2147345,1529798,1520504,1455331,1196878,903540,1103639,7709690,15278418,19665584,19665584
Ecuador,2032,EC,ECU,AMR,733497,1498886,2232383,1582017,1554454,1476371,1208187,886193,955647,7662869,702636,1437436,2140072,1522496,1517519,1469646,1225729,925047,1145148,7805585,15468454,19840908,19840908
Ecuador,2033,EC,ECU,AMR,730248,1493748,2223996,1573565,1553768,1489952,1237457,908478,992798,7756018,699461,1432408,2131869,1514254,1515392,1482138,1254042,947143,1187446,7900415,15656433,20012290,20012290
Ecuador,2034,EC,ECU,AMR,726298,1488719,2215017,1563428,1554378,1501630,1265879,931505,1030760,7847580,695610,1427485,2123095,1504373,1514590,1492644,1281440,970061,1230492,7993600,15841180,20179297,20179297
Ecuador,2035,EC,ECU,AMR,721840,1483970,2205810,1551372,1556982,1510963,1293164,955543,1069338,7937362,691276,1422837,2114113,1492605,1515848,1500693,1307594,994104,1274069,8084913,16022275,20342202,20342202
Ecuador,2036,EC,ECU,AMR,717039,1479337,2196376,1537237,1561939,1517859,1319158,980821,1108352,8025366,686632,1418307,2104939,1478799,1519572,1506153,1332394,1019433,1317965,8174316,16199682,20500994,20500994
Ecuador,2037,EC,ECU,AMR,712053,1474452,2186505,1522918,1567376,1522631,1343633,1007108,1147986,8111652,681816,1413511,2095327,1464834,1523912,1509334,1355693,1045744,1362426,8261943,16373595,20655436,20655436
Ecuador,2038,EC,ECU,AMR,707362,1468844,2176206,1511564,1570251,1525583,1366362,1034316,1188348,8196424,677273,1407992,2085265,1453725,1525924,1510523,1377368,1072856,1407596,8347992,16544416,20805883,20805883
Ecuador,2039,EC,ECU,AMR,703183,1462580,2165763,1503430,1569940,1526713,1387445,1062494,1229407,8279429,673224,1401835,2075059,1445721,1524957,1509771,1397511,1100729,1453430,8432119,16711548,20952371,20952371
Ecuador,2040,EC,ECU,AMR,699174,1456119,2155293,1497283,1567182,1526448,1406806,1091381,1271275,8360375,669353,1395478,2064831,1439638,1521697,1507579,1416009,1129073,1500030,8514026,16874401,21094529,21094529
Ecuador,2041,EC,ECU,AMR,695373,1449123,2144496,1492734,1562192,1525607,1424267,1120739,1314042,8439581,665677,1388627,2054304,1435066,1516356,1504796,1432584,1157723,1547486,8594011,17033592,21232395,21232395
Ecuador,2042,EC,ECU,AMR,692172,1441543,2133715,1488408,1555735,1525043,1439935,1150155,1357768,8517044,662539,1381236,2043775,1430707,1509648,1502351,1447154,1186326,1595842,8672028,17189072,21366555,21366555
Ecuador,2043,EC,ECU,AMR,688996,1433747,2122743,1483583,1548193,1525182,1453977,1179092,1402631,8592658,659431,1373624,2033055,1425864,1501893,1500687,1459903,1214407,1645244,8747998,17340656,21496458,21496458
Ecuador,2044,EC,ECU,AMR,685413,1425753,2111166,1478842,1538902,1526534,1466142,1207237,1448809,8666466,655952,1365822,2021774,1421100,1492425,1500279,1470670,1241606,1695899,8821979,17488445,21621378,21621378
Ecuador,2045,EC,ECU,AMR,681694,1417410,2099104,1474356,1527616,1529783,1475986,1234317,1496382,8738440,652333,1357702,2010035,1416590,1480989,1501861,1478982,1267600,1747888,8893910,17632350,21741483,21741483
Ecuador,2046,EC,ECU,AMR,677807,1408926,2086733,1469961,1514207,1535288,1483412,1260184,1545424,8808476,648556,1349457,1998013,1412173,1467452,1505823,1484711,1292280,1801200,8963639,17772115,21856853,21856853
Ecuador,2047,EC,ECU,AMR,673400,1400840,2074240,1465299,1500550,1541210,1488738,1284620,1595914,8876331,644312,1341570,1985882,1407484,1453700,1510348,1488167,1315510,1855788,9030997,17907328,21967446,21967446
Ecuador,2048,EC,ECU,AMR,668653,1393067,2061720,1459907,1489788,1544570,1492269,1307399,1647848,8941781,639748,1333978,1973726,1402064,1442766,1512536,1489643,1337163,1911603,9095775,18037556,22073004,22073004
Ecuador,2049,EC,ECU,AMR,664043,1385397,2049440,1453859,1482182,1544778,1494004,1328635,1701249,9004707,635302,1326508,1961810,1396004,1434915,1511746,1489204,1357342,1968582,9157793,18162500,22173750,22173750
Ecuador,2050,EC,ECU,AMR,659495,1377757,2037252,1447598,1476523,1542553,1494374,1348246,1755988,9065282,630940,1319071,1950011,1389739,1428972,1508668,1487336,1375932,2026590,9217237,18282519,22269779,22269779
Egypt,1970,EG,EGY,EMR,2895114,4573576,7468690,3383012,2067948,1832257,1333744,848496,595056,10060513,2692732,4274294,6967026,3193020,2017401,1844818,1423140,988061,819313,10285753,20346266,34781986,34781986
Egypt,1971,EG,EGY,EMR,2945760,4679110,7624870,3482001,2117444,1848127,1360459,866931,608220,10283182,2737148,4370532,7107680,3292063,2072245,1861156,1456854,1012366,845551,10540235,20823417,35555969,35555969
Egypt,1972,EG,EGY,EMR,2997552,4786654,7784206,3561282,2188260,1858857,1386132,885066,621521,10501118,2783159,4468217,7251376,3373429,2148286,1873658,1489810,1036574,872309,10794066,21295184,36330768,36330768
Egypt,1973,EG,EGY,EMR,3050897,4895464,7946361,3632058,2278640,1862509,1411726,903134,634796,10722863,2831595,4566340,7397935,3448891,2241208,1880342,1522413,1061134,899624,11053612,21776475,37120776,37120776
Egypt,1974,EG,EGY,EMR,3108394,5004882,8113276,3710067,2375408,1855750,1438202,921735,648229,10949391,2885048,4664381,7549429,3534264,2336806,1878355,1554806,1086665,927389,11318285,22267676,37930374,37930374
Egypt,1975,EG,EGY,EMR,3176678,5114061,8290739,3806516,2468129,1840506,1465675,941326,662234,11184386,2949708,4761708,7711416,3633029,2430807,1869306,1586605,1113477,955817,11589041,22773427,38775584,38775584
Egypt,1976,EG,EGY,EMR,3255157,5222969,8478126,3911207,2560235,1819282,1493606,961445,676693,11422468,3024626,4858533,7883159,3734905,2529866,1856469,1617703,1141452,984917,11865312,23287780,39649050,39649050
Egypt,1977,EG,EGY,EMR,3341908,5333770,8675678,4018941,2666007,1798763,1523730,982369,691718,11681528,3107691,4957243,8064934,3836780,2640205,1844784,1648839,1170561,1014047,12155216,23836744,40577356,40577356
Egypt,1978,EG,EGY,EMR,3440596,5445335,8885931,4131235,2784081,1786577,1554864,1004369,707750,11968876,3203019,5057216,8260235,3939155,2759343,1840523,1678898,1200572,1043101,12461592,24430468,41576636,41576636
Egypt,1979,EG,EGY,EMR,3550847,5560176,9111023,4244116,2903518,1788681,1583079,1027220,725039,12271653,3310735,5161154,8471889,4040405,2878603,1849787,1705472,1231036,1072588,12777891,25049544,42632458,42632458
Egypt,1980,EG,EGY,EMR,3661733,5687363,9349096,4359529,3020755,1814921,1606007,1051304,743634,12596150,3419909,5277407,8697316,4141795,2992444,1880775,1726440,1261840,1102700,13105994,25702144,43748556,43748556
Egypt,1981,EG,EGY,EMR,3765034,5826576,9591610,4477084,3129033,1867664,1624732,1076227,763078,12937818,3522731,5405641,8928372,4244052,3094826,1935890,1742864,1292371,1131776,13441779,26379597,44899573,44899573
Egypt,1982,EG,EGY,EMR,3865079,5976193,9841272,4597420,3224988,1946187,1640895,1101391,782769,13293650,3623153,5544816,9167969,4348306,3183716,2014294,1756660,1322481,1160296,13785753,27079403,46088647,46088647
Egypt,1983,EG,EGY,EMR,3968020,6140424,10108444,4722694,3320489,2047478,1652362,1127656,803136,13673815,3725859,5699944,9425803,4455130,3270740,2110487,1765756,1352912,1190576,14145601,27819416,47353665,47353665
Egypt,1984,EG,EGY,EMR,4067829,6321321,10389150,4849407,3428275,2158255,1655795,1155951,824809,14072492,3824850,5873521,9698371,4562358,3370439,2210717,1767297,1383590,1222036,14516437,28588929,48676443,48676443
Egypt,1985,EG,EGY,EMR,4164071,6514223,10678294,4973729,3554884,2267061,1651992,1185877,847694,14481237,3922452,6060550,9983002,4667723,3484171,2310855,1762521,1413901,1254138,14893309,29374546,50035843,50035843
Egypt,1986,EG,EGY,EMR,4262537,6711341,10973878,5094574,3690561,2378611,1644117,1217223,871411,14896497,4024407,6253386,10277793,4770894,3601573,2417792,1754884,1443939,1287058,15276140,30172637,51424313,51424313
Egypt,1987,EG,EGY,EMR,4359059,6914015,11273074,5214285,3824742,2500691,1635988,1250600,896657,15322963,4123472,6452530,10576002,4874260,3716767,2534480,1748052,1474182,1321534,15669275,30992238,52841319,52841319
Egypt,1988,EG,EGY,EMR,4444008,7130665,11574673,5335276,3960438,2631489,1634504,1284692,923755,15770154,4208548,6665354,10873902,4979263,3831060,2658356,1748102,1503926,1359018,16079725,31849879,54298446,54298446
Egypt,1989,EG,EGY,EMR,4509248,7355429,11864677,5459363,4096666,2764355,1647042,1316735,952851,16237012,4271302,6886662,11157964,5088226,3944330,2782887,1761553,1530912,1398282,16506190,32743202,55765843,55765843
Egypt,1990,EG,EGY,EMR,4549820,7577567,12127387,5593621,4230266,2891678,1680723,1343496,983389,16723173,4305241,7108410,11413651,5208363,4055125,2900554,1795221,1552615,1438538,16950416,33673589,57214630,57214630
Egypt,1991,EG,EGY,EMR,4565278,7794493,12359771,5731368,4355098,3004773,1736939,1365724,1014914,17208816,4309894,7328169,11638063,5336117,4161542,3004745,1851296,1570375,1480305,17404380,34613196,58611032,58611032
Egypt,1992,EG,EGY,EMR,4570119,8005769,12575888,5874344,4474957,3102448,1815880,1385148,1047110,17699887,4302735,7541687,11844422,5472063,4266045,3094329,1929039,1585582,1521891,17868949,35568836,59989142,59989142
Egypt,1993,EG,EGY,EMR,4568101,8206820,12774921,6034130,4595897,3195990,1913613,1399141,1079935,18218706,4290098,7741845,12031943,5624975,4370796,3180345,2022189,1595574,1562740,18356619,36575325,61382200,61382200
Egypt,1994,EG,EGY,EMR,4558648,8384402,12943050,6213858,4718224,3300231,2018418,1405022,1113844,18769597,4273824,7915669,12189493,5798329,4475894,3278389,2118274,1598372,1604458,18873716,37643313,62775847,62775847
Egypt,1995,EG,EGY,EMR,4553205,8533442,13086647,6407019,4838879,3422415,2120671,1403908,1148566,19341458,4265538,8059254,12324792,5986256,4579693,3390147,2214466,1595612,1647831,19414005,38755463,64166908,64166908
Egypt,1996,EG,EGY,EMR,4555048,8659829,13214877,6606785,4959176,3555156,2226087,1399544,1185258,19932006,4268704,8178008,12446712,6181403,4682942,3506417,2317790,1590551,1692495,19971598,39903604,65565195,65565195
Egypt,1997,EG,EGY,EMR,4556102,8773581,13329683,6816957,5084220,3689911,2342358,1395528,1224298,20553272,4275914,8281800,12557714,6385683,4789361,3622281,2430927,1586520,1738284,20553056,41106328,66993728,66993728
Egypt,1998,EG,EGY,EMR,4564733,8867389,13432122,7040713,5208742,3823980,2465212,1396945,1264155,21199747,4293010,8364819,12657829,6603349,4896269,3735950,2549899,1588245,1782608,21156320,42356067,68446011,68446011
Egypt,1999,EG,EGY,EMR,4590674,8933223,13523897,7270323,5333988,3956382,2588607,1410206,1302248,21861754,4326377,8421200,12747577,6828197,5005825,3847360,2668626,1601779,1822873,21774660,43636414,69907887,69907887
Egypt,2000,EG,EGY,EMR,4627221,8977837,13605058,7495274,5468517,4085428,2706169,1441569,1335282,22532239,4368683,8456560,12825243,7052517,5126252,3956123,2780722,1633992,1859228,22408834,44941073,71371371,71371371
Egypt,2001,EG,EGY,EMR,4676359,9004565,13680924,7715404,5614136,4213531,2813945,1493972,1364229,23215217,4422501,8474334,12896835,7275268,5258540,4064622,2881866,1687635,1893349,23061280,46276497,72854261,72854261
Egypt,2002,EG,EGY,EMR,4732913,9019881,13752794,7937431,5778003,4346750,2912404,1568018,1391452,23934058,4484304,8484257,12968561,7496138,5405996,4176327,2971810,1762019,1926053,23738343,47672401,74393759,74393759
Egypt,2003,EG,EGY,EMR,4787374,9035194,13822568,8151163,5959679,4481417,3007991,1656606,1412671,24669527,4547221,8497986,13045207,7704702,5571040,4288544,3059487,1849306,1952943,24426022,49095549,75963322,75963322
Egypt,2004,EG,EGY,EMR,4840228,9059562,13899790,8335320,6153073,4612689,3112022,1747812,1425666,25386582,4610440,8523554,13133994,7883447,5752345,4398764,3158312,1937151,1972030,25102049,50488631,77522427,77522427
Egypt,2005,EG,EGY,EMR,4899925,9097749,13997674,8484324,6352267,4738819,3230773,1834918,1433069,26074170,4678810,8565078,13243888,8028271,5944459,4506011,3269224,2024610,1987002,25759577,51833747,79075310,79075310
Egypt,2006,EG,EGY,EMR,4968148,9154468,14122616,8604226,6548964,4859626,3356696,1922925,1437820,26730257,4751408,8628077,13379485,8144639,6139355,4610385,3383311,2118494,2001122,26397306,53127563,80629670,80629670
Egypt,2007,EG,EGY,EMR,5052303,9216094,14268397,8710211,6749115,4979247,3482369,2017867,1443419,27382228,4833086,8701106,13534192,8245175,6339825,4715020,3496233,2220539,2017151,27033943,54416171,82218755,82218755
Egypt,2008,EG,EGY,EMR,5154484,9281943,14436427,8795573,6959947,5096590,3607247,2116885,1453429,28029671,4925242,8783802,13709044,8324482,6552336,4819437,3607233,2327644,2038508,27669640,55699311,83844783,83844783
Egypt,2009,EG,EGY,EMR,5272053,9363120,14635173,8852265,7175159,5214625,3731028,2215882,1471796,28660755,5027544,8882683,13910227,8376744,6771483,4926658,3716420,2434771,2068835,28294911,56955666,85501064,85501064
Egypt,2010,EG,EGY,EMR,5420834,9462285,14883119,8892491,7389994,5344519,3853199,2310544,1501881,29292628,5159998,8995990,14155988,8410468,6992263,5045910,3823718,2536223,2112102,28920684,58213312,87252413,87252413
Egypt,2011,EG,EGY,EMR,5599149,9584932,15184081,8937514,7623287,5496569,3979944,2399782,1547940,29985036,5324578,9126942,14451520,8438887,7223165,5182180,3933258,2629152,2172775,29579417,59564453,89200054,89200054
Egypt,2012,EG,EGY,EMR,5796313,9729884,15526197,8970971,7853707,5659752,4108966,2481654,1608247,30683297,5511897,9274011,14785908,8459154,7449431,5330064,4044646,2712578,2249102,30244975,60928272,91240376,91240376
Egypt,2013,EG,EGY,EMR,6019224,9890511,15909735,8998578,8069560,5834448,4236999,2562935,1673061,31375581,5727889,9432864,15160753,8486327,7666774,5495589,4156597,2796286,2330251,30931824,62307405,93377890,93377890
Egypt,2014,EG,EGY,EMR,6256774,10065628,16322402,9034812,8262824,6025530,4364502,2654881,1733982,32076531,5960286,9602737,15563023,8524788,7858718,5680284,4268056,2892598,2405919,31630363,63706894,95592324,95592324
Egypt,2015,EG,EGY,EMR,6467546,10275990,16743536,9066157,8409060,6219430,4486598,2759010,1788800,32729055,6167477,9804918,15972395,8558831,8001307,5870389,4374355,2998146,2475781,32278809,65007864,97723799,97723799
Egypt,2016,EG,EGY,EMR,6597239,10523066,17120305,9117051,8532564,6417840,4607269,2870443,1844258,33389425,6295950,10042110,16338060,8614801,8118176,6066664,4479200,3106642,2550758,32936241,66325666,99784030,99784030
Egypt,2017,EG,EGY,EMR,6639406,10805502,17444908,9177157,8646983,6624086,4729565,2985053,1907770,34070614,6338198,10311851,16650049,8686355,8224487,6272183,4586249,3216520,2638020,33623814,67694428,101789386,101789386
Egypt,2018,EG,EGY,EMR,6620044,11129972,17750016,9235251,8734341,6840116,4850166,3101737,1979132,34740743,6318732,10619225,16937957,8764158,8306098,6489444,4693199,3325622,2733522,34312043,69052786,103740765,103740765
Egypt,2019,EG,EGY,EMR,6541047,11483899,18024946,9306229,8789535,7061449,4972261,3218696,2056291,35404461,6240778,10952652,17193430,8856903,8358491,6713797,4802852,3432427,2831370,34995840,70400301,105618671,105618671
Egypt,2020,EG,EGY,EMR,6423635,11846081,18269716,9403781,8831142,7283541,5105335,3331205,2132676,36087680,6125097,11294558,17419655,8968585,8393045,6940127,4923779,3534997,2927547,35688080,71775760,107465134,107465134
Egypt,2021,EG,EGY,EMR,6333696,12155415,18489111,9526434,8857711,7501714,5246649,3437768,2200906,36771182,6034759,11588339,17623098,9098171,8410847,7165059,5055090,3633758,3015871,36378796,73149978,109262178,109262178
Egypt,2022,EG,EGY,EMR,6280908,12394450,18675358,9668140,8867369,7711295,5394126,3542642,2265658,37449230,5979963,11817077,17797040,9242207,8417377,7382215,5195648,3731630,3099399,37068476,74517706,110990103,110990103
Egypt,2023,EG,EGY,EMR,6231753,12596813,18828566,9826142,8876471,7909643,5554791,3650496,2341570,38159113,5929347,12012139,17941486,9398091,8427001,7584950,5351669,3831382,3194342,37787435,75946548,112716598,112716598
Egypt,2024,EG,EGY,EMR,6201607,12753813,18955420,9998715,8894825,8084558,5733007,3764909,2439458,38915472,5897289,12165066,18062355,9565411,8448507,7760688,5527320,3935635,3313440,38551001,77466473,114484252,114484252
Egypt,2025,EG,EGY,EMR,6190890,12848139,19039029,10209683,8927511,8231403,5924071,3881391,2551784,39725843,5884110,12257656,18141766,9768453,8486236,7905880,5717684,4041212,3449361,39368826,79094669,116275465,116275465
Egypt,2026,EG,EGY,EMR,6188969,12888813,19077782,10457153,8979196,8355031,6119254,3995997,2669453,40576084,5879946,12296813,18176759,10006316,8545702,8025475,5914206,4145163,3591509,40228371,80804455,118058996,118058996
Egypt,2027,EG,EGY,EMR,6197481,12878811,19076292,10738949,9036082,8465075,6319747,4110674,2792602,41463129,5886242,12284925,18171167,10275656,8615288,8129253,6117172,4249817,3740235,41127421,82590550,119838003,119838003
Egypt,2028,EG,EGY,EMR,6214247,12811925,19026172,11063243,9097780,8555211,6532681,4224877,2920977,42394769,5900703,12216437,18117140,10583127,8694908,8212020,6332958,4355094,3894907,42073014,84467783,121611091,121611091
Egypt,2029,EG,EGY,EMR,6237432,12704775,18942207,11417107,9175495,8617691,6752523,4341478,3053966,43358260,5921754,12108441,18030195,10916897,8791316,8268008,6556587,4464029,4054698,43051535,86409795,123382198,123382198
Egypt,2030,EG,EGY,EMR,6265747,12577522,18843269,11778144,9271506,8658957,6969356,4467393,3189580,44334936,5948022,11980539,17928561,11258462,8902469,8302635,6780363,4583752,4217279,44044960,88379896,125151725,125151725
Egypt,1950,EG,EGY,EMR,1943752,2296476,4240228,2095062,1602001,1183654,815696,507448,287673,6491534,1801224,2152040,3953264,1995013,1571114,1173971,832901,555240,336793,6465032,12956566,21150058,21150058
Egypt,1951,EG,EGY,EMR,1976272,2363886,4340158,2115304,1633571,1209477,834929,517470,300605,6611356,1832156,2216119,4048275,2013157,1607158,1202025,856995,570982,356256,6606573,13217929,21606363,21606363
Egypt,1952,EG,EGY,EMR,2001189,2461130,4462319,2134024,1666015,1235732,855303,528423,314112,6733609,1856489,2307094,4163583,2029300,1643402,1230436,882918,586238,376362,6748656,13482265,22108164,22108164
Egypt,1953,EG,EGY,EMR,2026053,2581841,4607894,2148549,1700771,1263358,877476,541039,328935,6860128,1883290,2416673,4299963,2040865,1680404,1259896,910531,601760,397811,6891267,13751395,22659254,22659254
Egypt,1954,EG,EGY,EMR,2062180,2710952,4773132,2154105,1737542,1292240,901035,554974,344334,6984230,1924840,2529124,4453964,2044437,1717742,1290772,938678,618068,420197,7029894,14014124,23241217,23241217
Egypt,1955,EG,EGY,EMR,2117463,2837277,4954740,2150550,1774035,1321521,925169,569664,359619,7100558,1981867,2641599,4623466,2040812,1753992,1322839,966658,635406,443230,7162937,14263495,23841701,23841701
Egypt,1956,EG,EGY,EMR,2180446,2965690,5146136,2141733,1809931,1350742,949533,584775,374622,7211336,2041478,2760779,4802257,2033878,1789143,1355940,994390,653550,466867,7293768,14505104,24453498,24453498
Egypt,1957,EG,EGY,EMR,2236235,3104286,5340521,2133356,1847458,1380684,974455,600358,389420,7325731,2094250,2889595,4983845,2028211,1824216,1390408,1021840,672442,491162,7428279,14754010,25078378,25078378
Egypt,1958,EG,EGY,EMR,2284038,3247677,5531715,2129521,1881625,1409767,999097,616166,404179,7440355,2139283,3023310,5162593,2028171,1856136,1425190,1048755,692168,515881,7566301,15006656,25700968,25700968
Egypt,1959,EG,EGY,EMR,2327522,3389143,5716665,2143688,1913961,1440202,1024213,632591,419590,7574245,2179632,3155711,5335343,2043869,1885220,1460838,1075874,713087,540617,7719505,15293750,26345761,26345761
Egypt,1960,EG,EGY,EMR,2370550,3521147,5891697,2188381,1945694,1474376,1050733,649946,435739,7744869,2219196,3279383,5498579,2085170,1911232,1498169,1103978,735359,565443,7899351,15644220,27034499,27034499
Egypt,1961,EG,EGY,EMR,2415221,3636968,6052189,2261988,1974326,1509909,1077705,667928,452189,7944045,2260326,3387903,5648229,2152447,1933584,1536017,1132514,758889,589962,8103413,16047458,27747867,27747867
Egypt,1962,EG,EGY,EMR,2463806,3733916,6197722,2363314,2001501,1546011,1104970,686682,469029,8171507,2305027,3479319,5784346,2244545,1953955,1573884,1161263,783858,613945,8331450,16502957,28485022,28485022
Egypt,1963,EG,EGY,EMR,2517433,3819665,6337098,2486479,2023096,1582830,1132671,706302,486203,8417581,2354222,3562948,5917170,2354538,1969086,1611722,1190620,810033,638087,8574086,16991667,29245936,29245936
Egypt,1964,EG,EGY,EMR,2574695,3910851,6485546,2617291,2035100,1620967,1161135,726722,503444,8664659,2406537,3655603,6062140,2467977,1975993,1649595,1221182,836586,662971,8814304,17478963,30026648,30026648
Egypt,1965,EG,EGY,EMR,2631164,4018984,6650148,2743308,2038943,1660074,1190499,747738,520682,8901244,2457788,3761333,6219121,2579902,1976248,1686995,1253106,863007,688693,9047951,17949195,30818469,30818469
Egypt,1966,EG,EGY,EMR,2686752,4135556,6822308,2868113,2036447,1699217,1219955,768833,537389,9129954,2507945,3870286,6378231,2696630,1972564,1723491,1286041,889066,714847,9282639,18412593,31613132,31613132
Egypt,1967,EG,EGY,EMR,2742017,4248828,6990845,2999419,2030485,1738247,1248964,789539,552936,9359590,2557552,3975873,6533425,2821367,1968397,1759237,1319877,914502,741170,9524550,18884140,32408414,32408414
Egypt,1968,EG,EGY,EMR,2794481,4359095,7153576,3134350,2028826,1775888,1277770,809879,567627,9594340,2604204,4077884,6682088,2950628,1969933,1793016,1354361,939296,767399,9774633,19368973,33204629,33204629
Egypt,1969,EG,EGY,EMR,2844640,4467548,7312188,3264746,2038618,1808382,1305999,829541,581646,9828932,2648426,4177393,6825819,3076981,1983732,1822385,1388845,963689,793378,10029010,19857942,33995955,33995955
Egypt,2031,EG,EGY,EMR,6299512,12485894,18785406,12086016,9389454,8682141,7181159,4602538,3328673,45269981,5979357,11886354,17865711,11551712,9030000,8319218,7002071,4714345,4383429,45000775,90270756,126921867,126921867
Egypt,2032,EG,EGY,EMR,6343772,12442100,18785872,12324215,9530582,8692978,7386993,4745970,3471965,46152703,6020690,11838415,17859105,11780385,9174244,8326884,7217222,4855174,4553913,45907822,92060525,128705494,128705494
Egypt,2033,EG,EGY,EMR,6403891,12410640,18814531,12525977,9687952,8703462,7581979,4900852,3617902,47018124,6077156,11803179,17880335,11975453,9330175,8337655,7418293,5010322,4726928,46798826,93816950,130511810,130511810
Egypt,2034,EG,EGY,EMR,6477883,12404525,18882408,12682616,9860038,8723244,7753853,5069401,3766030,47855182,6146809,11793058,17939867,12128401,9497410,8360134,7592720,5182579,4902042,47663286,95518468,132340744,132340744
Egypt,2035,EG,EGY,EMR,6560933,12422539,18983472,12776743,10070216,8756923,7897944,5247977,3915733,48665536,6225193,11806666,18031859,12221016,9700131,8398463,7736772,5367643,5078859,48502884,97168420,134183751,134183751
Egypt,2036,EG,EGY,EMR,6650090,12454733,19104823,12817421,10316682,8809279,8019373,5430096,4067454,49460305,6309528,11834266,18143794,12260276,9937570,8458303,7855523,5558417,5258391,49328480,98788785,136037397,136037397
Egypt,2037,EG,EGY,EMR,6733917,12507808,19241725,12807653,10597287,8866830,8127797,5617029,4222703,50239299,6388812,11882269,18271081,12248579,10206411,8528207,7958773,5755312,5442622,50139904,100379203,137892015,137892015
Egypt,2038,EG,EGY,EMR,6804734,12584951,19389685,12741274,10920169,8929211,8217414,5815347,4381034,51004449,6455679,11953522,18409201,12180401,10513290,8608095,8041575,5964443,5631196,50939000,101943449,139742335,139742335
Egypt,2039,EG,EGY,EMR,6863250,12682361,19545611,12634860,11272448,9007375,8280580,6020058,4544335,51759656,6510769,12044518,18555287,12072797,10846394,8704633,8098221,6181071,5826229,51729345,103489001,141589905,141589905
Egypt,2040,EG,EGY,EMR,6907782,12793961,19701743,12508489,11631846,9103595,8323467,6222386,4716670,52506453,6552539,12149431,18701970,11945341,11187249,8815790,8134035,6398028,6032080,52512523,105018976,143422685,143422685
Egypt,2041,EG,EGY,EMR,6939530,12917120,19856650,12417624,11938337,9221484,8349187,6420577,4898799,53246008,6582195,12265361,18847556,11851537,11479876,8943199,8152333,6613258,6249681,53289884,106535892,145240099,145240099
Egypt,2042,EG,EGY,EMR,6962528,13045445,20007973,12374420,12175539,9362318,8363403,6613814,5090562,53980056,6603529,12386220,18989749,11803898,11708056,9087218,8162081,6822423,6479296,54062972,108043028,147040749,147040749
Egypt,2043,EG,EGY,EMR,6973765,13176602,20150367,12343530,12376545,9519311,8377795,6797763,5293356,54708300,6613778,12509766,19123544,11768936,11902714,9242892,8175114,7018451,6723278,54831385,109539685,148813595,148813595
Egypt,2044,EG,EGY,EMR,6969115,13309322,20278437,12337900,12532705,9690928,8401439,6961224,5508764,55432960,6609206,12634695,19243901,11759046,12055341,9409819,8199723,7189336,6983685,55596950,111029910,150552248,150552248
Egypt,2045,EG,EGY,EMR,6954794,13437140,20391934,12356315,12626776,9900295,8438438,7099500,5733188,56154512,6595569,12755037,19350606,11772834,12147818,9612043,8239811,7331277,7256138,56359921,112514433,152256979,152256979
Egypt,2046,EG,EGY,EMR,6936014,13558304,20494318,12388882,12667811,10145656,8493441,7217027,5961863,56874680,6577638,12869220,19446858,11800595,12187127,9848819,8300944,7448944,7535232,57121661,113996341,153937518,153937518
Egypt,2047,EG,EGY,EMR,6914241,13665430,20579671,12442270,12658783,10424859,8553683,7323269,6197153,57600017,6556705,12970056,19526761,11848730,12175674,10116846,8372023,7551997,7823166,57888436,115488453,155594880,155594880
Egypt,2048,EG,EGY,EMR,6887498,13747830,20635328,12519677,12593595,10745929,8618788,7413376,6444024,58335389,6531054,13047405,19578459,11920081,12107953,10422710,8452964,7635945,8124919,58664572,116999961,157213750,157213750
Egypt,2049,EG,EGY,EMR,6858041,13802082,20660123,12617301,12488702,11096079,8699064,7479989,6699826,59080961,6502854,13098170,19601024,12011145,12000978,10754638,8550198,7695213,8438188,59450360,118531321,158792464,158792464
Egypt,2050,EG,EGY,EMR,6830345,13832728,20663073,12729085,12364035,11453215,8796750,7528618,6960648,59832351,6476049,13126572,19602621,12116108,11874250,11094218,8661744,7734943,8760583,60241846,120074197,160339889,160339889
Eritrea,1970,ER,ERI,AFR,115411,158903,274314,114909,94333,64441,40492,22972,13829,350976,116864,164359,281223,117696,94272,66074,43262,26475,18452,366231,717207,1272748,1272748
Eritrea,1971,ER,ERI,AFR,118463,164596,283059,115719,96953,66380,41813,23678,14134,358677,119836,169908,289744,119414,96731,68023,44556,27232,18801,374757,733434,1306234,1306234
Eritrea,1972,ER,ERI,AFR,121519,170350,291869,116858,99551,68406,43186,24413,14466,366880,122793,175517,298310,121422,99224,70047,45886,28035,19168,383782,750662,1340838,1340838
Eritrea,1973,ER,ERI,AFR,124623,176125,300748,118667,101785,70487,44601,25178,14840,375558,125789,181156,306945,124016,101436,72105,47270,28877,19560,393264,768822,1376516,1376516
Eritrea,1974,ER,ERI,AFR,127893,181898,309791,120990,103694,72551,46037,25974,15232,384478,128938,186815,315753,127014,103561,74154,48717,29756,20004,403206,787684,1413220,1413220
Eritrea,1975,ER,ERI,AFR,131330,187725,319055,124351,104625,74532,47463,26786,15628,393385,132242,192563,324805,130777,105257,76186,50237,30670,20499,413626,807011,1450867,1450867
Eritrea,1976,ER,ERI,AFR,134923,193625,328548,128811,104618,76492,48906,27630,16047,402504,135684,198423,334107,135388,106391,78221,51828,31626,21044,424498,827002,1489656,1489656
Eritrea,1977,ER,ERI,AFR,138691,199509,338200,133488,104725,78484,50394,28514,16496,412101,139306,204284,343590,140190,107661,80286,53501,32625,21649,435912,848013,1529802,1529802
Eritrea,1978,ER,ERI,AFR,142550,205425,347975,138371,104956,80536,51936,29442,16981,422222,143030,210153,353183,145142,109066,82403,55238,33664,22300,447813,870035,1571193,1571193
Eritrea,1979,ER,ERI,AFR,146423,211495,357918,143432,105299,82681,53517,30417,17510,432856,146799,216124,362923,150222,110579,84609,57007,34734,22981,460132,892988,1613829,1613829
Eritrea,1980,ER,ERI,AFR,150317,217758,368075,148731,105823,84944,55141,31438,18082,444159,150614,222235,372849,155452,112199,86920,58791,35836,23697,472895,917054,1657982,1657982
Eritrea,1981,ER,ERI,AFR,154328,224213,378541,154220,106599,87279,56834,32514,18688,456134,154560,228500,383060,160795,113958,89295,60603,36969,24436,486056,942190,1703789,1703789
Eritrea,1982,ER,ERI,AFR,158561,230843,389404,159710,107598,89529,58569,33614,19324,468344,158733,234916,393649,166204,115951,91678,62470,38138,25213,499654,967998,1751045,1751045
Eritrea,1983,ER,ERI,AFR,163080,237625,400705,165167,109147,91401,60335,34743,19995,480788,163195,241474,404669,171653,118465,93787,64372,39347,26037,513661,994449,1799814,1799814
Eritrea,1984,ER,ERI,AFR,167739,244578,412317,170568,111152,93015,62103,35908,20703,493449,167795,248184,415979,177035,121266,95779,66249,40615,26904,527848,1021297,1849594,1849594
Eritrea,1985,ER,ERI,AFR,172341,251661,424002,175844,113976,93781,63827,37084,21447,505959,172319,255054,427373,182289,124536,97264,68075,41931,27818,541913,1047872,1899243,1899243
Eritrea,1986,ER,ERI,AFR,176855,258980,435835,181184,117745,93754,65568,38301,22237,518789,176738,262167,438905,187531,128429,98159,69881,43304,28777,556081,1074870,1949611,1949611
Eritrea,1987,ER,ERI,AFR,181232,266661,447893,186413,121522,93730,67318,39561,23070,531614,181016,269648,450664,192636,132275,99076,71670,44733,29793,570183,1101797,2000355,2000355
Eritrea,1988,ER,ERI,AFR,185570,274708,460278,191523,125220,93667,69063,40843,23949,544265,185232,277516,462748,197643,136057,100012,73470,46211,30860,584253,1128518,2051546,2051546
Eritrea,1989,ER,ERI,AFR,189821,282918,472739,196553,128719,93493,70794,42122,24855,556536,189331,285535,474866,202567,139644,100880,75277,47684,31942,597994,1154530,2102131,2102131
Eritrea,1990,ER,ERI,AFR,193909,291152,485061,201311,131694,93070,72467,43383,25797,567722,193230,293521,486751,207094,142642,101493,77042,49118,33040,610429,1178151,2149960,2149960
Eritrea,1991,ER,ERI,AFR,183181,277351,460532,191721,125394,86076,68790,41455,24897,538333,182351,279283,461634,196784,135449,94771,73094,46887,31736,578721,1117054,2039220,2039220
Eritrea,1992,ER,ERI,AFR,171993,262937,434930,181344,118172,78930,64779,39423,23912,506560,171012,264444,435456,185525,127198,87759,68841,44534,30351,544208,1050768,1921153,1921153
Eritrea,1993,ER,ERI,AFR,175608,270903,446511,188717,123507,80597,66459,40914,25133,525327,174422,272169,446591,192552,132229,89963,70559,46049,31637,562989,1088316,1981419,1981419
Eritrea,1994,ER,ERI,AFR,179729,279026,458755,195871,128743,82554,67940,42396,26355,543859,178291,280045,458336,199373,137148,92333,72195,47539,32960,581548,1125407,2042500,2042500
Eritrea,1995,ER,ERI,AFR,185964,288490,474454,210449,142344,89443,70563,44668,28325,585792,184245,289280,473525,214265,150549,99094,75017,49651,34877,623453,1209245,2157220,2157220
Eritrea,1996,ER,ERI,AFR,193998,297498,491496,222367,154418,96415,72287,46819,30127,622433,191979,297979,489958,226337,162465,105846,77157,51668,36707,660180,1282613,2264073,2264073
Eritrea,1997,ER,ERI,AFR,200842,304501,505343,221735,153560,97159,71438,47783,30815,622490,198531,304594,503125,224890,161332,106776,77109,52737,37763,660607,1283097,2291561,2291561
Eritrea,1998,ER,ERI,AFR,206318,311811,518129,222114,152599,97959,70516,48637,31548,623373,203758,311561,515319,225890,161476,108304,77325,53918,39020,665933,1289306,2322753,2322753
Eritrea,1999,ER,ERI,AFR,209845,319842,529687,223093,151231,98573,69328,49178,32040,623443,207069,319278,526347,229587,163510,110639,77799,55189,40281,677005,1300448,2356477,2356477
Eritrea,2000,ER,ERI,AFR,211965,328289,540254,226076,150872,99702,68468,49945,32705,627768,208991,327367,536358,233689,165426,113024,78316,56509,41526,688490,1316258,2392880,2392880
Eritrea,2001,ER,ERI,AFR,213043,339112,552155,235410,156353,103747,69159,51585,34186,650440,209899,337803,547702,242036,171100,117262,79720,58255,43250,711623,1362063,2461927,2461927
Eritrea,2002,ER,ERI,AFR,214034,351286,565320,247040,164254,109038,70566,53445,35922,680265,210732,349559,560291,252716,179080,122627,81728,60204,45194,741549,1421814,2547424,2547424
Eritrea,2003,ER,ERI,AFR,217877,362303,580180,261195,175214,115880,73061,55346,37935,718631,214360,360170,574530,266217,190086,129490,84714,62169,47370,780046,1498677,2653390,2653390
Eritrea,2004,ER,ERI,AFR,224081,372089,596170,274917,186694,123017,76006,57159,39965,757758,220322,369529,589851,279417,201496,136681,88055,64131,49581,819361,1577119,2763140,2763140
Eritrea,2005,ER,ERI,AFR,230638,380280,610918,281439,191593,126998,78275,57808,41411,777524,226629,377225,603854,285022,206094,140955,90712,65283,51368,839434,1616958,2831732,2831732
Eritrea,2006,ER,ERI,AFR,236724,387900,624624,284644,193325,129394,80500,57659,42691,788213,232467,384390,616857,287156,207290,143774,93309,65820,53059,850408,1638621,2880093,2880093
Eritrea,2007,ER,ERI,AFR,241594,395934,637528,287877,194876,131499,82656,57630,44067,798605,237116,392001,629117,289357,208104,146285,95846,66483,54839,860914,1659519,2926168,2926168
Eritrea,2008,ER,ERI,AFR,245824,405601,651425,296406,202037,136157,86059,58165,45996,824820,241161,401254,642415,297362,214449,151172,99455,67626,57053,887117,1711937,3005779,3005779
Eritrea,2009,ER,ERI,AFR,249027,415581,664608,305013,209039,140722,89509,58729,47967,850979,244205,410807,655012,305507,220524,155975,103119,68823,59344,913292,1764271,3083888,3083888
Eritrea,2010,ER,ERI,AFR,250821,425526,676347,311923,213761,144181,92581,59136,49811,871393,245879,420314,666193,311854,224195,159740,106488,69923,61593,933793,1805186,3147727,3147727
Eritrea,2011,ER,ERI,AFR,252076,433555,685631,320171,217908,147300,95593,59579,51668,892219,247023,427963,674986,319533,227201,163186,109829,71079,63906,954734,1846953,3207570,3207570
Eritrea,2012,ER,ERI,AFR,252848,439520,692368,327730,219775,149208,98129,59963,53365,908170,247685,433603,681288,326353,227834,165449,112780,72208,66139,970763,1878933,3252596,3252596
Eritrea,2013,ER,ERI,AFR,253428,446068,699496,334359,221631,150952,100630,60681,54900,923153,248154,439802,687956,332288,228465,167427,115711,73662,68206,985759,1908912,3296367,3296367
Eritrea,2014,ER,ERI,AFR,252726,453194,705920,338063,220929,151363,102520,61423,56131,930429,247373,446594,693967,335170,226585,167982,118136,75117,70116,993106,1923535,3323425,3323425
Eritrea,2015,ER,ERI,AFR,250796,460382,711178,340705,218527,150909,104034,62600,56821,933596,245399,453483,698882,336914,223056,167520,120262,76888,71707,996347,1929943,3340006,3340006
Eritrea,2016,ER,ERI,AFR,248517,467404,715921,345532,217438,151155,105826,64435,57263,941649,243100,460221,703321,341068,220891,167485,122625,79219,73107,1004395,1946044,3365287,3365287
Eritrea,2017,ER,ERI,AFR,246221,473324,719545,352418,217563,151998,107709,66369,57955,954012,240813,465870,706683,347456,219984,167835,125037,81633,74744,1016689,1970701,3396933,3396933
Eritrea,2018,ER,ERI,AFR,244701,477852,722553,362944,220572,154261,110044,68628,58959,975408,239293,470163,709456,357743,222038,169368,127818,84307,76680,1037954,2013362,3445374,3445374
Eritrea,2019,ER,ERI,AFR,243920,480545,724465,374593,225290,156914,112484,71014,60104,1000399,238495,472663,711158,369237,225902,171116,130677,87099,78769,1062800,2063199,3498818,3498818
Eritrea,2020,ER,ERI,AFR,244162,481317,725479,386941,231657,159794,114983,73456,61207,1028038,238694,473286,711980,381482,231523,172926,133555,89982,80909,1090377,2118415,3555868,3555868
Eritrea,2021,ER,ERI,AFR,245724,481242,726966,398299,241593,163294,117602,75932,62147,1058867,240171,473091,713262,392851,240805,175202,136518,92906,82929,1121211,2180078,3620312,3620312
Eritrea,2022,ER,ERI,AFR,248106,480890,728996,407359,253280,166812,120067,78342,63019,1088879,242414,472603,715017,401925,251908,177428,139279,95767,84831,1151138,2240017,3684032,3684032
Eritrea,2023,ER,ERI,AFR,251011,480692,731703,416402,264362,170551,122491,80815,64194,1118815,245199,472253,717452,410965,262519,179873,141873,98702,86999,1180931,2299746,3748901,3748901
Eritrea,2024,ER,ERI,AFR,254170,480382,734552,426152,275364,174635,125050,83448,65912,1150561,248303,471801,720104,420701,273152,182735,144409,101775,89671,1212443,2363004,3817651,3817651
Eritrea,2025,ER,ERI,AFR,257535,480205,737740,435911,286769,178959,127742,86202,67980,1183563,251646,471503,723149,430436,284286,185934,146867,104973,92676,1245172,2428735,3889630,3889630
Eritrea,2026,ER,ERI,AFR,260998,480647,741645,445009,298711,183491,130616,88997,70192,1217016,255096,471835,726931,439482,296095,189410,149304,108214,95835,1278340,2495356,3963932,3963932
Eritrea,2027,ER,ERI,AFR,264606,481838,746444,452700,311493,188508,133757,91747,72563,1250768,258697,472920,731617,447087,308875,193438,151839,111396,99177,1311812,2562580,4040638,4040638
Eritrea,2028,ER,ERI,AFR,268501,483979,752480,458488,325246,194026,137172,94457,75089,1284478,262568,474975,737543,452771,322711,198059,154507,114520,102683,1345251,2629729,4119757,4119757
Eritrea,2029,ER,ERI,AFR,272405,487013,759418,462312,339498,200737,140738,97165,77760,1318210,266411,477947,744358,456497,337092,203982,157179,117633,106348,1378731,2696941,4200711,4200711
Eritrea,2030,ER,ERI,AFR,276229,491166,767395,464144,354023,208738,144380,99875,80573,1351733,270162,482041,752203,458254,351770,211316,159786,120718,110175,1412019,2763752,4283355,4283355
Eritrea,1950,ER,ERI,AFR,76345,110761,187106,79113,53885,35869,23769,16018,11453,220107,74185,108347,182532,78970,55395,37788,26590,19200,14890,232833,452940,822576,822576
Eritrea,1951,ER,ERI,AFR,74172,113571,187743,81196,55434,36807,24166,16062,11493,225158,73341,110891,184232,80996,56836,38726,26973,19276,14990,237797,462955,834934,834934
Eritrea,1952,ER,ERI,AFR,72488,116315,188803,83354,57019,37777,24603,16133,11548,230434,72816,113434,186250,83081,58308,39712,27381,19362,15100,242944,473378,848449,848449
Eritrea,1953,ER,ERI,AFR,71605,118610,190215,85566,58654,38788,25088,16228,11612,235936,72940,115630,188570,85198,59828,40750,27829,19465,15212,248282,484218,863003,863003
Eritrea,1954,ER,ERI,AFR,71320,120610,191930,87796,60330,39852,25622,16350,11671,241621,73458,117730,191188,87295,61422,41829,28327,19601,15330,253804,495425,878538,878538
Eritrea,1955,ER,ERI,AFR,72293,121632,193925,90043,62053,40979,26206,16511,11716,247508,74751,119321,194072,89363,63098,42948,28887,19772,15435,259503,507011,895009,895009
Eritrea,1956,ER,ERI,AFR,74531,121649,196180,92328,63830,42166,26843,16707,11755,253629,76956,120245,197201,91425,64856,44106,29501,19975,15534,265397,519026,912409,912409
Eritrea,1957,ER,ERI,AFR,76901,121816,198717,94677,65668,43415,27536,16929,11793,260018,79281,121339,200620,93513,66709,45317,30170,20213,15645,271567,531585,930920,930920
Eritrea,1958,ER,ERI,AFR,79395,122126,201521,97108,67575,44726,28283,17183,11839,266714,81723,122594,204317,95671,68639,46573,30903,20492,15761,278039,544753,950588,950588
Eritrea,1959,ER,ERI,AFR,82044,122555,204599,99665,69537,46092,29069,17465,11902,273730,84302,123985,208287,97956,70621,47879,31683,20801,15882,284822,558552,971439,971439
Eritrea,1960,ER,ERI,AFR,84847,123110,207957,102361,71550,47527,29895,17788,11985,281106,87021,125521,212542,100394,72644,49245,32519,21138,16026,291966,573072,993568,993568
Eritrea,1961,ER,ERI,AFR,87754,123849,211603,105121,73643,49022,30759,18140,12104,288789,89837,127240,217077,102939,74732,50673,33410,21506,16203,299463,588252,1016932,1016932
Eritrea,1962,ER,ERI,AFR,90779,124910,215689,107835,75833,50576,31662,18527,12239,296672,92764,129234,221998,105500,76906,52149,34351,21896,16389,307191,603863,1041552,1041552
Eritrea,1963,ER,ERI,AFR,93883,126676,220559,110130,78078,52179,32598,18951,12389,304325,95770,131853,227623,107746,79116,53679,35344,22316,16595,314796,619121,1067295,1067295
Eritrea,1964,ER,ERI,AFR,97010,129067,226077,112137,80328,53820,33582,19419,12556,311842,98808,134913,233721,109870,81296,55276,36372,22780,16810,322404,634246,1094042,1094042
Eritrea,1965,ER,ERI,AFR,100167,132713,232880,113220,82563,55491,34622,19922,12733,318551,101887,138785,240672,111499,83428,56935,37435,23291,17044,329632,648183,1121739,1121739
Eritrea,1966,ER,ERI,AFR,103338,137589,240927,113344,84809,57198,35707,20463,12931,324452,104990,143568,248558,112485,85521,58664,38526,23845,17294,336335,660787,1150264,1150264
Eritrea,1967,ER,ERI,AFR,106432,142679,249111,113556,87073,58951,36837,21040,13125,330582,108034,148539,256573,113582,87601,60452,39659,24441,17560,343295,673877,1179554,1179554
Eritrea,1968,ER,ERI,AFR,109447,147927,257374,113876,89377,60742,38006,21651,13328,336980,111008,153671,264679,114817,89714,62295,40822,25083,17836,350567,687547,1209602,1209602
Eritrea,1969,ER,ERI,AFR,112418,153334,265752,114317,91789,62572,39223,22297,13562,343760,113931,158934,272865,116180,91922,64173,42019,25761,18133,358188,701948,1240562,1240562
Eritrea,2031,ER,ERI,AFR,279993,496501,776494,464916,366593,219207,148144,102555,83524,1384939,273852,487305,761157,458964,364508,221243,162403,123758,114158,1445034,2829973,4367625,4367625
Eritrea,2032,ER,ERI,AFR,283448,502808,786256,465394,377180,231643,152054,105185,86588,1418044,277234,493535,770769,459374,375281,233233,165103,126696,118290,1477977,2896021,4453047,4453047
Eritrea,2033,ER,ERI,AFR,286458,509958,796416,465956,387796,243623,156229,107768,89767,1451139,280183,500605,780788,459854,386080,244875,168069,129489,122558,1510925,2962064,4539275,4539275
Eritrea,2034,ER,ERI,AFR,289095,517337,806432,466281,398831,255349,160638,110374,93038,1484511,282776,507915,790691,460083,397271,256369,171356,132142,126952,1544173,3028684,4625813,4625813
Eritrea,2035,ER,ERI,AFR,291384,524786,816170,466618,409628,267308,165206,113050,96425,1518235,285032,515298,800330,460319,408206,268196,174898,134678,131497,1577794,3096029,4712526,4712526
Eritrea,2036,ER,ERI,AFR,293244,532232,825476,467474,419570,279650,169906,115864,99930,1552394,286863,522690,809553,461080,418232,280550,178650,137173,136175,1611860,3164254,4799286,4799286
Eritrea,2037,ER,ERI,AFR,294675,539483,834158,468996,427948,292687,175019,118906,103487,1587043,288266,529898,818164,462510,426640,293734,182890,139753,140926,1646453,3233496,4885821,4885821
Eritrea,2038,ER,ERI,AFR,295804,546559,842363,471404,434318,306564,180572,122179,107087,1622124,289369,536919,826288,464838,432988,307858,187659,142440,145743,1681526,3303650,4972303,4972303
Eritrea,2039,ER,ERI,AFR,296758,553259,850017,474648,438627,320833,187223,125575,110766,1657672,290289,543541,833830,468029,437253,322421,193657,145124,150649,1717133,3374805,5058644,5058644
Eritrea,2040,ER,ERI,AFR,297406,559514,856920,478956,440860,335274,195071,129022,114507,1693690,290908,549714,840622,472295,439423,337186,200989,147730,155633,1753256,3446946,5144492,5144492
Eritrea,2041,ER,ERI,AFR,297719,565273,862992,484400,441937,347737,205245,132564,118297,1730180,291207,555381,846588,477688,440434,349964,210800,150338,160681,1789905,3520085,5229664,5229664
Eritrea,2042,ER,ERI,AFR,297847,570278,868125,490780,442629,358213,217276,136237,122125,1767260,291324,560298,851622,484011,441048,360749,222590,153024,165770,1827192,3594452,5314210,5314210
Eritrea,2043,ER,ERI,AFR,297728,574537,872265,497976,443368,368692,228849,140145,125989,1805019,291200,564472,855672,491157,441687,371522,234029,155969,170845,1865209,3670228,5398164,5398164
Eritrea,2044,ER,ERI,AFR,297472,578242,875714,505390,443863,379560,240173,144281,129936,1843203,290939,568096,859035,498531,442066,382668,245313,159214,175910,1903702,3746905,5481647,5481647
Eritrea,2045,ER,ERI,AFR,297100,581295,878395,512864,444356,390192,251714,148570,134021,1881717,290557,571081,861638,505975,442436,393555,256921,162707,181002,1942596,3824313,5564343,5564343
Eritrea,2046,ER,ERI,AFR,296655,583586,880241,520336,445353,399990,263617,152997,138307,1920600,290091,573310,863401,513421,443312,403538,269039,166412,186184,1981906,3902506,5646149,5646149
Eritrea,2047,ER,ERI,AFR,296017,585265,881282,527614,446992,408269,276190,157824,142829,1959718,289431,574926,864357,520672,444840,411925,281967,170585,191500,2021489,3981207,5726855,5726855
Eritrea,2048,ER,ERI,AFR,295166,586391,881557,534713,449483,414587,289574,163075,147589,1999021,288551,575994,864545,527733,447249,418285,295813,175273,196988,2061341,4060362,5806459,5806459
Eritrea,2049,ER,ERI,AFR,294292,587212,881504,541433,452785,418904,303350,169366,152511,2038349,287649,576739,864388,534389,450498,422583,310096,181143,202550,2101259,4139608,5885492,5885492
Eritrea,2050,ER,ERI,AFR,293593,587602,881195,547712,457124,421192,317310,176769,157525,2077632,286921,577059,863980,540597,454804,424825,324586,188282,208120,2141214,4218846,5964021,5964021
Spain,1970,ES,ESP,EUR,1654050,3163020,4817070,2634268,2108745,2308908,1827370,1449847,1338701,11667839,1573951,3028651,4602602,2561686,2153636,2373183,1985567,1705632,1925404,12705108,24372947,33792617,33792617
Spain,1971,ES,ESP,EUR,1652000,3212648,4864648,2660265,2107586,2316423,1884360,1449273,1376207,11794114,1568533,3073771,4642304,2585927,2146873,2381469,2029208,1710605,1978473,12832555,24626669,34133622,34133622
Spain,1972,ES,ESP,EUR,1658499,3247558,4906057,2692747,2135179,2312865,1945662,1448053,1411389,11945895,1572062,3108758,4680820,2621311,2155824,2380486,2075609,1717587,2031580,12982397,24928292,34515170,34515170
Spain,1973,ES,ESP,EUR,1667414,3271251,4938665,2720913,2201461,2281962,2006351,1448147,1449915,12108749,1579271,3132043,4711314,2648938,2210862,2345434,2122065,1727611,2084513,13139423,25248172,34898147,34898147
Spain,1974,ES,ESP,EUR,1682117,3292592,4974709,2759980,2313055,2231693,2069716,1447106,1481284,12302834,1594181,3149265,4743446,2691474,2297424,2288789,2170063,1731813,2129349,13308912,25611746,35329897,35329897
Spain,1975,ES,ESP,EUR,1694080,3314929,5009009,2811333,2387459,2201280,2126895,1458245,1513457,12498669,1603748,3163071,4766819,2749385,2350189,2250697,2214229,1740094,2181346,13485940,25984609,35760431,35760431
Spain,1976,ES,ESP,EUR,1700283,3338700,5038983,2860399,2418525,2175375,2166777,1490520,1550876,12662472,1606218,3178764,4784982,2797318,2382263,2218780,2250185,1762692,2241382,13652620,26315092,36139064,36139064
Spain,1977,ES,ESP,EUR,1699451,3363463,5062914,2909086,2465002,2138153,2197012,1531678,1588433,12829364,1602837,3198210,4801047,2840829,2431695,2176213,2277824,1792665,2300531,13819757,26649121,36513082,36513082
Spain,1978,ES,ESP,EUR,1687087,3380060,5067147,2963155,2492793,2119361,2227416,1576330,1626265,13005320,1587892,3209713,4797605,2889699,2461546,2151089,2305036,1826530,2361478,13995378,27000698,36865443,36865443
Spain,1979,ES,ESP,EUR,1657211,3388202,5045413,3032601,2501666,2120034,2249883,1624293,1663445,13191922,1558354,3210915,4769269,2953511,2473571,2144451,2327434,1861518,2421882,14182367,27374289,37188965,37188965
Spain,1980,ES,ESP,EUR,1612506,3394335,5006841,3103588,2506802,2132346,2265589,1674112,1700926,13383363,1516847,3209987,4726834,3018932,2480584,2149902,2341152,1900035,2484029,14374634,27757997,37491666,37491666
Spain,1981,ES,ESP,EUR,1559609,3390658,4950267,3169250,2526687,2139516,2275722,1729885,1733023,13574083,1466492,3204580,4671072,3077035,2499025,2149469,2352837,1944157,2540706,14563229,28137312,37758649,37758649
Spain,1982,ES,ESP,EUR,1498568,3378166,4876734,3218890,2562747,2155544,2270099,1790339,1761365,13758984,1406181,3193588,4599769,3118432,2532886,2159276,2350257,1991379,2594436,14746666,28505650,37982149,37982149
Spain,1983,ES,ESP,EUR,1430743,3367221,4797964,3244189,2599522,2207990,2237802,1851013,1789480,13929996,1340567,3183138,4523705,3138628,2565954,2209927,2316500,2039847,2647245,14918101,28848097,38169760,38169760
Spain,1984,ES,ESP,EUR,1363022,3347673,4710695,3263754,2641509,2276691,2183390,1909387,1819888,14094619,1275453,3166423,4441876,3150047,2605942,2278267,2260092,2088958,2699429,15082735,29177354,38329925,38329925
Spain,1985,ES,ESP,EUR,1299307,3314418,4613725,3283923,2692745,2318960,2142598,1960405,1859770,14258401,1214146,3138232,4352378,3158253,2660045,2319593,2216912,2134227,2758398,15247428,29505829,38471920,38471920
Spain,1986,ES,ESP,EUR,1240033,3264177,4504210,3303307,2748788,2349539,2108520,1998713,1913604,14422471,1160142,3093357,4253499,3167734,2717905,2349875,2179400,2171357,2824360,15410631,29833102,38590808,38590808
Spain,1987,ES,ESP,EUR,1188052,3194955,4383007,3322700,2801907,2391645,2068231,2027781,1977679,14589943,1114270,3029976,4144246,3181635,2768886,2392418,2135333,2199450,2899612,15577334,30167277,38694533,38694533
Spain,1988,ES,ESP,EUR,1142741,3111624,4254365,3336260,2855277,2419915,2045374,2054203,2043853,14754882,1073878,2953538,4027416,3193193,2818361,2420684,2108586,2224591,2979648,15745063,30499945,38781722,38781722
Spain,1989,ES,ESP,EUR,1100245,3016772,4117017,3342734,2916488,2434801,2040167,2071707,2110039,14915936,1036047,2865830,3901877,3199479,2874756,2436381,2100264,2242522,3059082,15912484,30828420,38847318,38847318
Spain,1990,ES,ESP,EUR,1058777,2908542,3967319,3351117,2974597,2447368,2046533,2081843,2174352,15075810,1000286,2765226,3765512,3208312,2928028,2449589,2104440,2252252,3138623,16081244,31157054,38889889,38889889
Spain,1991,ES,ESP,EUR,1032370,2794776,3827146,3370340,3035006,2474782,2054091,2089692,2238757,15262668,976356,2658238,3634594,3226605,2983121,2476278,2107551,2262136,3216970,16272661,31535329,38997063,38997063
Spain,1992,ES,ESP,EUR,1022977,2687357,3710334,3391406,3100275,2519736,2076566,2088275,2304635,15480893,965763,2555518,3521281,3243504,3042640,2520618,2124492,2262452,3296036,16489742,31970635,39202251,39202251
Spain,1993,ES,ESP,EUR,1017901,2582816,3600717,3405913,3156482,2565225,2136377,2064017,2371360,15699374,959456,2455062,3414518,3253460,3092816,2565190,2181379,2235726,3377365,16705936,32405310,39420546,39420546
Spain,1994,ES,ESP,EUR,1008236,2484217,3492453,3410937,3206606,2617425,2216045,2018045,2440039,15909097,949194,2359384,3308578,3255896,3135791,2615872,2259853,2185094,3461094,16913600,32822697,39623725,39623725
Spain,1995,ES,ESP,EUR,993494,2397234,3390728,3397909,3254592,2684956,2265935,1990011,2511912,16105315,934686,2274822,3209508,3242021,3175565,2682984,2308459,2151177,3548819,17109025,33214340,39814573,39814573
Spain,1996,ES,ESP,EUR,977025,2322001,3299026,3366495,3304540,2758089,2301718,1971288,2584378,16286508,919824,2201876,3121700,3210649,3215902,2756966,2344132,2126233,3635357,17289239,33575747,39996473,39996473
Spain,1997,ES,ESP,EUR,960789,2259725,3220514,3316882,3357411,2826356,2356069,1942239,2656667,16455624,905688,2141180,3046868,3162279,3258450,2825895,2398989,2090385,3721034,17457032,33912656,40180050,40180050
Spain,1998,ES,ESP,EUR,948531,2208171,3156702,3249667,3404185,2898220,2398546,1930834,2728817,16610269,894236,2090648,2984884,3097269,3296275,2896105,2440772,2072293,3807786,17610500,34220769,40362357,40362357
Spain,1999,ES,ESP,EUR,946850,2160487,3107337,3165988,3441147,2985742,2426815,1937072,2792432,16749196,893305,2044539,2937844,3015521,3324862,2979654,2468477,2074019,3885320,17747853,34497049,40542232,40542232
Spain,2000,ES,ESP,EUR,959151,2116071,3075222,3066668,3478183,3074771,2454412,1954220,2852620,16880874,905861,2002607,2908468,2919192,3352100,3064336,2494998,2088328,3958138,17877092,34757966,40741651,40741651
Spain,2001,ES,ESP,EUR,981607,2078834,3060441,2954141,3517908,3154620,2493485,1970054,2916939,17007147,929183,1968001,2897184,2811230,3382581,3138845,2532487,2098891,4037642,18001676,35008823,40966450,40966450
Spain,2002,ES,ESP,EUR,1016142,2066624,3082766,2869517,3602514,3251119,2559078,1998796,2974072,17255096,963095,1957160,2920255,2728892,3442957,3220055,2595968,2122500,4109165,18219537,35474633,41477655,41477655
Spain,2003,ES,ESP,EUR,1060179,2077268,3137447,2811137,3720803,3359429,2632810,2070068,3009706,17603953,1004093,1966791,2970884,2673075,3528047,3304671,2665781,2193270,4153143,18517987,36121940,42230270,42230270
Spain,2004,ES,ESP,EUR,1102875,2088964,3191839,2753557,3823628,3464206,2710837,2168731,3023499,17944458,1043293,1977426,3020719,2616098,3600485,3382410,2737468,2293165,4173018,18802644,36747102,42959666,42959666
Spain,2005,ES,ESP,EUR,1140409,2107778,3248187,2702493,3907850,3570142,2809354,2231960,3062317,18284116,1078141,1994511,3072652,2564098,3657393,3456985,2829479,2355078,4217380,19080413,37364529,43685374,43685374
Spain,2006,ES,ESP,EUR,1177990,2138136,3316126,2657192,3963093,3677754,2914238,2277052,3116965,18606294,1113091,2023656,3136747,2523383,3700826,3535825,2929295,2399661,4274674,19363664,37969958,44422831,44422831
Spain,2007,ES,ESP,EUR,1218371,2175845,3394216,2635678,4006725,3797972,3016465,2347401,3158266,18962507,1149665,2060043,3209708,2503850,3735897,3626231,3024800,2470668,4317907,19679353,38641860,45245782,45245782
Spain,2008,ES,ESP,EUR,1257091,2218171,3475262,2612354,4008696,3903976,3116105,2403110,3216274,19260515,1184213,2099218,3283431,2481292,3739464,3706912,3116750,2524155,4378759,19947332,39207847,45966538,45966538
Spain,2009,ES,ESP,EUR,1281380,2260274,3541654,2554978,3923704,3967314,3217216,2437340,3287309,19387861,1204656,2138101,3342757,2431328,3684378,3759895,3211198,2556530,4452176,20095505,39483366,46367772,46367772
Spain,2010,ES,ESP,EUR,1288331,2300683,3589014,2486265,3781360,4012184,3312029,2468939,3362379,19423156,1209232,2175366,3384598,2371114,3586766,3800812,3301000,2585649,4530667,20176008,39599164,46572772,46572772
Spain,2011,ES,ESP,EUR,1283779,2343700,3627479,2429319,3616564,4053830,3394063,2511771,3434952,19440499,1203746,2213976,3417722,2320461,3468621,3843173,3378587,2625115,4607571,20243528,39684027,46729232,46729232
Spain,2012,ES,ESP,EUR,1264241,2384515,3648756,2380362,3429609,4067106,3459604,2564615,3501032,19402328,1185453,2249167,3434620,2275840,3330395,3867025,3441542,2678066,4677510,20270378,39672706,46756082,46756082
Spain,2013,ES,ESP,EUR,1223490,2423031,3646521,2333053,3225305,4046062,3503093,2609626,3576953,19294092,1148228,2283660,3431888,2229104,3169784,3865261,3484930,2723925,4757959,20230963,39525055,46603459,46603459
Spain,2014,ES,ESP,EUR,1179974,2456337,3636311,2299708,3043031,4011983,3540388,2657418,3656460,19208988,1108719,2312946,3421665,2194102,3014957,3853244,3520950,2770674,4843670,20197597,39406585,46464551,46464551
Spain,2015,ES,ESP,EUR,1149165,2476777,3625942,2289233,2900282,3971760,3579764,2724811,3719563,19185413,1080610,2330677,3411287,2180097,2887223,3834644,3556879,2839401,4910460,20208704,39394117,46431342,46431342
Spain,2016,ES,ESP,EUR,1121323,2493433,3614756,2293706,2788692,3919983,3623939,2798281,3777051,19201652,1055430,2345117,3400547,2181289,2783979,3806017,3596710,2917367,4971005,20256367,39458019,46473315,46473315
Spain,2017,ES,ESP,EUR,1095992,2507232,3603224,2309628,2713009,3850242,3671391,2864433,3842520,19251223,1032495,2356187,3388682,2194890,2710240,3764084,3642213,2989741,5039870,20341038,39592261,46584170,46584170
Spain,2018,ES,ESP,EUR,1074340,2509953,3584293,2346469,2676852,3770872,3717048,2934445,3913243,19358929,1012577,2357519,3370096,2226304,2669495,3714756,3688589,3065600,5113984,20478728,39837657,46792043,46792043
Spain,2019,ES,ESP,EUR,1049582,2508865,3558447,2408320,2671609,3690016,3762457,3024380,3987709,19544491,990165,2355093,3345258,2277880,2653451,3660527,3735967,3159687,5195662,20683174,40227665,47131372,47131372
Spain,2020,ES,ESP,EUR,1012445,2501618,3514063,2466064,2665809,3593690,3807550,3114043,4051519,19698675,956673,2347580,3304253,2325426,2634559,3586995,3781078,3252625,5266132,20846815,40545490,47363807,47363807
Spain,2021,ES,ESP,EUR,974960,2476654,3451614,2516674,2659094,3484710,3855170,3189823,4114639,19820110,922012,2325315,3247327,2369645,2616247,3493477,3824074,3327807,5336634,20967884,40787994,47486935,47486935
Spain,2022,ES,ESP,EUR,946343,2433852,3380195,2555741,2647766,3369329,3894250,3258205,4203572,19928863,894919,2286968,3181887,2402770,2595052,3387622,3856187,3391853,5434200,21067684,40996547,47558630,47558630
Spain,2023,ES,ESP,EUR,924877,2370397,3295274,2580710,2622715,3249327,3918931,3317327,4308122,19997132,874166,2229042,3103208,2423412,2558715,3273909,3876977,3445559,5545446,21124018,41121150,47519628,47519628
Spain,2024,ES,ESP,EUR,912816,2297769,3210585,2601887,2601872,3140001,3929522,3370643,4417307,20061232,861779,2163248,3025027,2441759,2526432,3165187,3889258,3492254,5661635,21176525,41237757,47473373,47473373
Spain,2025,ES,ESP,EUR,909340,2224440,3133780,2608376,2589024,3042953,3921180,3420348,4531624,20113505,856810,2096764,2953574,2448373,2501664,3064885,3886445,3533904,5783890,21219161,41332666,47420024,47420024
Spain,2026,ES,ESP,EUR,905544,2154230,3059774,2609451,2579804,2958032,3893734,3471602,4646818,20159441,851642,2032370,2884012,2451861,2481068,2973712,3866678,3575932,5908202,21257453,41416894,47360679,47360679
Spain,2027,ES,ESP,EUR,897081,2093265,2990346,2607246,2568345,2889543,3844029,3526097,4762309,20197569,843015,1975727,2818742,2451853,2459828,2896481,3827123,3620167,6034044,21289496,41487065,47296155,47296155
Spain,2028,ES,ESP,EUR,890156,2040713,2930869,2592454,2561333,2835392,3773509,3575415,4884624,20222727,835976,1926405,2762381,2439453,2443864,2832226,3769190,3658935,6167052,21310720,41533447,47226694,47226694
Spain,2029,ES,ESP,EUR,885200,1990890,2876090,2568591,2566134,2787575,3684317,3616399,5017846,20240862,830901,1879680,2710581,2417238,2441395,2773268,3692177,3690106,6311983,21326167,41567029,47153700,47153700
Spain,2030,ES,ESP,EUR,881866,1939628,2821494,2542181,2578768,2744006,3579476,3657791,5153932,20256154,827430,1831358,2658788,2392363,2447869,2718283,3598788,3721319,6461514,21340136,41596290,47076573,47076573
Spain,1950,ES,ESP,EUR,1362496,2428947,3791443,2668548,2049408,1751572,1429230,989495,827366,9715619,1300996,2343660,3644656,2717092,2249768,1959786,1602999,1187557,1200775,10917977,20633596,28069694,28069694
Spain,1951,ES,ESP,EUR,1329886,2429998,3759884,2668090,2109308,1743365,1457444,1004575,842646,9825428,1267092,2331590,3598682,2711307,2290670,1957724,1635981,1201484,1225917,11023083,20848511,28207080,28207080
Spain,1952,ES,ESP,EUR,1342291,2437879,3780170,2645646,2168846,1737981,1480220,1020661,858614,9911968,1276278,2335773,3612051,2675387,2333731,1958235,1664092,1217632,1251500,11100577,21012545,28404771,28404771
Spain,1953,ES,ESP,EUR,1344992,2488429,3833421,2585816,2241501,1729408,1511187,1032645,882157,9982714,1277134,2388660,3665794,2608721,2370676,1962259,1698813,1229784,1281358,11151611,21134325,28633539,28633539
Spain,1954,ES,ESP,EUR,1348492,2562215,3910707,2503255,2312450,1720588,1542583,1045311,904358,10028545,1284062,2463912,3747974,2522727,2409516,1961340,1731130,1244529,1305908,11175150,21203695,28862377,28862377
Spain,1955,ES,ESP,EUR,1377345,2592747,3970092,2452134,2353677,1718082,1569942,1074383,926561,10094779,1316590,2489523,3806113,2456228,2437778,1966253,1743738,1284693,1335703,11224393,21319172,29095374,29095374
Spain,1956,ES,ESP,EUR,1411414,2609262,4020676,2421925,2371148,1735807,1588159,1111380,942482,10170901,1350884,2505654,3856538,2407860,2449711,1977979,1752470,1333165,1360481,11281666,21452567,29329776,29329776
Spain,1957,ES,ESP,EUR,1436827,2663092,4099919,2381536,2378430,1773602,1596562,1141985,952067,10224182,1376960,2560348,3937308,2349875,2456829,1994979,1771125,1367749,1375469,11316026,21540208,29577444,29577444
Spain,1958,ES,ESP,EUR,1463550,2703258,4166808,2356501,2388692,1816810,1601024,1172333,970668,10306028,1405895,2597895,4003790,2307803,2466869,2018432,1785428,1400517,1401752,11380801,21686829,29857437,29857437
Spain,1959,ES,ESP,EUR,1496154,2727885,4224039,2357103,2387391,1861328,1604257,1200770,993727,10404576,1437620,2616400,4054020,2296805,2469547,2040425,1798320,1429358,1433421,11467876,21872452,30150510,30150510
Spain,1960,ES,ESP,EUR,1515698,2745414,4261112,2378827,2376916,1903999,1604445,1225771,1019100,10509058,1455547,2628900,4084447,2306468,2459001,2064874,1805046,1453575,1472008,11560972,22070030,30415591,30415591
Spain,1961,ES,ESP,EUR,1534781,2761934,4296715,2388181,2378047,1955582,1603303,1250280,1051516,10626909,1472551,2645472,4118023,2303268,2460939,2100812,1809055,1476390,1519757,11670221,22297130,30711863,30711863
Spain,1962,ES,ESP,EUR,1563133,2784021,4347154,2394770,2374511,2018721,1601300,1280277,1080103,10749682,1495786,2672612,4168398,2300921,2457960,2146212,1816745,1503623,1561935,11787396,22537078,31052630,31052630
Spain,1963,ES,ESP,EUR,1584816,2802643,4387459,2419833,2363322,2081430,1598811,1316597,1100410,10880403,1513923,2696444,4210367,2344363,2418425,2190068,1827549,1537514,1592412,11910331,22790734,31388554,31388554
Spain,1964,ES,ESP,EUR,1609559,2830298,4439857,2469571,2327043,2140380,1598592,1352990,1121236,11009812,1537624,2725921,4263545,2414492,2355196,2233012,1835757,1576265,1619709,12034431,23044243,31747643,31747643
Spain,1965,ES,ESP,EUR,1636225,2872194,4508419,2502011,2284690,2193092,1611407,1381353,1153326,11125879,1562522,2769841,4332363,2443336,2308633,2273895,1845790,1604545,1669157,12145356,23271235,32112015,32112015
Spain,1966,ES,ESP,EUR,1655533,2922517,4578050,2517121,2248363,2230095,1644000,1402116,1192307,11234002,1580019,2819207,4399226,2457007,2269856,2305825,1864752,1627341,1726207,12250988,23484990,32462268,32462268
Spain,1967,ES,ESP,EUR,1669115,2975448,4644563,2562035,2192058,2255685,1686200,1419957,1229201,11345136,1593014,2867687,4460701,2499046,2217125,2328307,1891391,1654928,1773030,12363827,23708963,32814224,32814224
Spain,1968,ES,ESP,EUR,1676066,3026968,4703034,2595455,2150233,2282191,1731618,1433239,1267248,11459984,1599329,2913701,4513030,2529636,2178669,2350614,1922481,1676749,1823382,12481531,23941515,33157581,33157581
Spain,1969,ES,ESP,EUR,1667991,3094850,4762841,2614570,2124975,2299925,1778490,1443970,1301085,11563015,1590257,2971556,4561813,2546728,2159522,2368054,1951684,1694684,1872166,12592838,24155853,33480512,33480512
Spain,2031,ES,ESP,EUR,879974,1892020,2771994,2507845,2596758,2707958,3462417,3702001,5286911,20263890,825366,1785500,2610866,2360941,2459052,2671396,3492506,3757533,6607377,21348805,41612695,46995541,46995541
Spain,2032,ES,ESP,EUR,879792,1852029,2731821,2461878,2617401,2679368,3341011,3737793,5422686,20260137,824945,1746875,2571820,2319223,2472280,2632660,3380076,3787204,6756156,21347599,41607736,46911380,46911380
Spain,2033,ES,ESP,EUR,880606,1823679,2704285,2398555,2642436,2654678,3223479,3763277,5558578,20241003,825469,1719113,2544582,2261373,2492967,2596554,3267702,3808771,6905675,21333042,41574045,46822907,46822907
Spain,2034,ES,ESP,EUR,881107,1806697,2687804,2326062,2663689,2634166,3116486,3774959,5692214,20207576,825733,1701680,2527413,2195661,2511363,2564490,3160279,3821896,7052437,21306126,41513702,46728914,46728914
Spain,2035,ES,ESP,EUR,882052,1799908,2681960,2252866,2670281,2621611,3021575,3768255,5825948,20160536,826461,1693263,2519724,2129253,2518031,2539924,3061199,3820120,7198866,21267393,41427929,46629612,46629612
Spain,2036,ES,ESP,EUR,883339,1794246,2677585,2182782,2671473,2612657,2938602,3743079,5960611,20109204,827520,1686056,2513576,2064929,2521576,2519511,2971154,3801636,7345900,21224706,41333910,46525082,46525082
Spain,2037,ES,ESP,EUR,884081,1785628,2669709,2121937,2669386,2601478,2871799,3696466,6097349,20058415,828095,1677029,2505124,2008355,2521628,2498454,2894934,3763686,7494604,21181661,41240076,46414916,46414916
Spain,2038,ES,ESP,EUR,885142,1779540,2664682,2069490,2654741,2594718,2819056,3629798,6234203,20002006,829002,1670532,2499534,1959092,2509299,2482662,2831558,3707648,7642954,21133213,41135219,46299435,46299435
Spain,2039,ES,ESP,EUR,886555,1775106,2661661,2019772,2631041,2599704,2772457,3545231,6371962,19940167,830234,1665738,2495972,1912427,2487158,2480333,2773395,3632880,7793353,21079546,41019713,46177346,46177346
Spain,2040,ES,ESP,EUR,887461,1772737,2660198,1968613,2604801,2612476,2729973,3445816,6511553,19873232,831007,1663013,2494020,1864164,2462367,2486913,2719136,3542056,7945781,21020417,40893649,46047876,46047876
Spain,2041,ES,ESP,EUR,887282,1772150,2659432,1921110,2570652,2630574,2694856,3334815,6649734,19801741,830797,1662029,2492826,1818362,2431024,2498191,2672888,3438588,8097222,20956275,40758016,45910270,45910270
Spain,2042,ES,ESP,EUR,885731,1772724,2658455,1881210,2524899,2651309,2667073,3219771,6781611,19725873,829299,1662195,2491494,1779787,2389403,2511510,2634723,3329092,8243128,20887643,40613516,45763466,45763466
Spain,2043,ES,ESP,EUR,882578,1774615,2657193,1852931,2461830,2676420,2643130,3108563,6903028,19645902,826309,1663638,2489947,1752070,2331659,2532266,2599157,3219658,8379924,20814734,40460636,45607779,45607779
Spain,2044,ES,ESP,EUR,878354,1776545,2654899,1836001,2389607,2697751,2623336,3007509,7008616,19562820,822332,1665147,2487479,1734666,2266054,2550735,2567608,3115080,8504097,20738240,40301060,45443430,45443430
Spain,2045,ES,ESP,EUR,872971,1778411,2651382,1829254,2316667,2704484,2611425,2918033,7096666,19476529,817244,1666664,2483908,1726275,2199752,2557484,2543511,3018662,8612180,20657864,40134393,45269679,45269679
Spain,2046,ES,ESP,EUR,866135,1779533,2645668,1823625,2246833,2705826,2603083,2839992,7167789,19387148,810788,1667523,2478311,1719093,2135538,2561120,2523535,2931086,8703492,20573864,39961012,45084984,45084984
Spain,2047,ES,ESP,EUR,857847,1778736,2636583,1815046,2186215,2703887,2592538,2777418,7220011,19295115,803004,1666615,2469619,1710089,2079057,2561256,2502914,2857056,8776295,20486667,39781782,44887980,44887980
Spain,2048,ES,ESP,EUR,847753,1776657,2624410,1808993,2133972,2689424,2586362,2728205,7252985,19199941,793524,1664548,2458072,1703614,2029875,2549022,2487538,2795592,8830107,20395748,39595689,44678170,44678170
Spain,2049,ES,ESP,EUR,835593,1773860,2609453,1804595,2084442,2665943,2591775,2684689,7269879,19101323,782117,1661812,2443929,1698843,1983288,2527001,2485534,2739154,8866720,20300540,39401863,44455244,44455244
Spain,2050,ES,ESP,EUR,821920,1769400,2591320,1802255,2033478,2639937,2604850,2645002,7274473,18999995,769315,1657510,2426825,1696137,1935103,2502331,2492371,2686492,8888984,20201418,39201413,44219565,44219565
Estonia,1970,EE,EST,EUR,49747,103867,153614,106998,102301,99105,57019,54784,49368,469575,47751,99143,146894,97198,101868,109694,83987,88191,110980,591918,1061493,1361999,1361999
Estonia,1971,EE,EST,EUR,51144,104012,155156,109264,100887,100788,59793,53631,50397,474760,49113,98761,147874,100187,100335,109237,87943,86174,113124,597000,1071760,1374794,1374794
Estonia,1972,EE,EST,EUR,52819,103818,156637,110602,99904,101728,64578,51678,51564,480054,50507,98371,148878,102088,99127,109381,93054,82981,115415,602046,1082100,1387623,1387623
Estonia,1973,EE,EST,EUR,53960,103583,157543,111654,99185,102358,69645,50323,52501,485666,51454,98116,149570,103527,98263,109524,97894,80379,117478,607065,1092731,1399849,1399849
Estonia,1974,EE,EST,EUR,54612,103100,157712,112511,99487,103014,74069,49490,53411,491982,52130,97975,150105,104526,98093,109639,101973,78520,119562,612313,1104295,1412117,1412117
Estonia,1975,EE,EST,EUR,55047,102577,157624,113717,100242,103015,78659,48471,54285,498389,52418,98184,150602,105539,98487,109493,105742,76536,121647,617444,1115833,1424044,1424044
Estonia,1976,EE,EST,EUR,55099,102949,158048,114772,100649,103069,82724,47721,55054,503989,52487,98777,151264,106419,98898,109584,108329,75556,123271,622057,1126046,1435355,1435355
Estonia,1977,EE,EST,EUR,55135,103783,158918,115406,101765,102782,86024,47370,55922,509269,52770,99653,152423,106546,100386,109257,109519,75899,124910,626517,1135786,1447120,1447120
Estonia,1978,EE,EST,EUR,55341,104710,160051,115628,104847,101246,88342,47512,56620,514195,53227,100818,154045,106156,103929,107553,109494,77103,126327,630562,1144757,1458851,1458851
Estonia,1979,EE,EST,EUR,55507,105930,161437,114761,108880,99546,89693,48000,57053,517933,53469,101972,155441,105694,107874,105771,108560,78654,127299,633852,1151785,1468656,1468656
Estonia,1980,EE,EST,EUR,55656,107540,163196,113089,112876,97597,91092,48957,57058,520669,53448,103129,156577,105102,111605,103848,107703,80778,127506,636542,1157211,1476983,1476983
Estonia,1981,EE,EST,EUR,56067,109369,165436,111487,115621,96107,92434,51176,56322,523147,53637,104412,158049,104632,114160,102271,107252,84303,126523,639141,1162288,1485768,1485768
Estonia,1982,EE,EST,EUR,56585,111357,167942,110290,116747,95280,93139,55128,55126,525710,54011,105778,159789,104479,115183,101158,107457,88809,124857,641943,1167653,1495374,1495374
Estonia,1983,EE,EST,EUR,57445,112771,170216,109646,117308,94635,93588,59252,54432,528861,54820,106825,161645,104398,115810,100379,107695,93104,123604,644990,1173851,1505714,1505714
Estonia,1984,EE,EST,EUR,58643,112954,171597,109787,117715,94687,94019,62756,54029,532993,56052,107451,163503,104379,116177,100356,107747,96728,122648,648035,1181028,1516124,1516124
Estonia,1985,EE,EST,EUR,59503,112818,172321,110302,118288,95275,93869,66381,53298,537413,57134,107991,165125,104286,116933,100844,107372,100070,121421,650926,1188339,1525782,1525782
Estonia,1986,EE,EST,EUR,60140,113130,173270,110867,118890,95622,93975,69606,53011,541971,57918,108655,166573,103950,118175,101084,107243,102440,121312,654204,1196175,1536023,1536023
Estonia,1987,EE,EST,EUR,61047,113723,174770,111383,119430,96608,93863,72345,53224,546853,58757,109404,168161,103730,119197,102150,106685,103718,122441,657921,1204774,1547706,1547706
Estonia,1988,EE,EST,EUR,61750,114774,176524,111830,119929,99277,92548,74226,53732,551542,59542,110571,170113,103717,120041,105127,104743,103826,123954,661408,1212950,1559586,1559586
Estonia,1989,EE,EST,EUR,61863,116012,177875,111829,119635,102965,90880,75163,54503,554975,59635,111879,171514,103737,119739,109011,102772,102660,125771,663690,1218665,1568047,1568047
Estonia,1990,EE,EST,EUR,61432,116774,178206,111721,118047,106785,88900,76143,55212,556808,58694,112660,171354,103973,117725,112917,100742,101448,127505,664310,1221118,1570674,1570674
Estonia,1991,EE,EST,EUR,59641,117126,176767,111083,115524,109169,87390,76922,56256,556344,56596,112763,169359,104378,114832,115183,99140,100586,129035,663154,1219498,1565627,1565627
Estonia,1992,EE,EST,EUR,55919,115979,171898,108058,110831,108511,85890,76905,57948,548143,52906,111188,164094,103869,110352,114322,97361,100064,130283,656251,1204394,1540381,1540381
Estonia,1993,EE,EST,EUR,51158,114179,165337,104973,105047,106051,84085,76592,59616,536364,48068,109056,157124,102075,105406,111913,95367,99442,131408,645611,1181975,1504436,1504436
Estonia,1994,EE,EST,EUR,46274,113482,159756,103467,100653,103721,82876,76255,60977,527949,43282,107927,151209,99915,101843,109714,94188,98628,132524,636812,1164761,1475727,1475727
Estonia,1995,EE,EST,EUR,41759,112921,154680,102303,97584,101968,82004,75341,62529,521729,39165,106891,146056,98105,99173,108238,93440,97600,133758,630314,1152043,1452775,1452775
Estonia,1996,EE,EST,EUR,38402,111222,149624,101536,95782,100695,80952,74649,64311,517925,36024,105028,141052,96893,97057,107349,92447,96929,135395,626070,1143995,1434670,1434670
Estonia,1997,EE,EST,EUR,35888,108892,144780,101294,94746,99730,80685,74024,66135,516614,33534,102616,136150,96384,95589,106386,92245,96008,137327,623939,1140553,1421490,1421490
Estonia,1998,EE,EST,EUR,33987,105965,139952,101914,94157,99012,81938,72419,67487,516927,31661,99419,131080,96838,94614,105418,93789,93908,138617,623184,1140111,1411147,1411147
Estonia,1999,EE,EST,EUR,32813,100586,133399,102792,95611,99252,84271,70613,67907,520446,30792,93896,124688,97227,94922,104468,96595,92265,139489,624966,1145412,1403498,1403498
Estonia,2000,EE,EST,EUR,32354,94983,127337,103019,97411,99009,86955,68802,68537,523733,30456,88540,118996,97162,95541,103064,99714,90570,140760,626811,1150544,1396877,1396877
Estonia,2001,EE,EST,EUR,32274,90746,123020,102896,97795,97354,88531,67315,69759,523650,30230,84871,115101,97021,95504,101162,101414,88871,142256,626228,1149878,1387995,1387995
Estonia,2002,EE,EST,EUR,32289,86149,118438,102958,98372,95728,88956,66489,71163,523666,30371,80829,111200,97024,95715,99297,101776,87666,144449,625927,1149593,1379240,1379240
Estonia,2003,EE,EST,EUR,32619,81111,113730,103346,98628,94258,89154,65967,72628,523981,30941,76246,107187,97409,95605,97596,101734,86588,146835,625767,1149748,1370660,1370660
Estonia,2004,EE,EST,EUR,33266,76109,109375,103763,98252,93080,89197,65926,73997,524215,31637,71716,103353,97775,94989,96142,101349,86199,149086,625540,1149755,1362480,1362480
Estonia,2005,EE,EST,EUR,33983,71892,105875,103592,97635,92032,89294,66185,75199,523937,32295,67842,100137,97524,93981,94764,101093,86203,151152,624717,1148654,1354662,1354662
Estonia,2006,EE,EST,EUR,34847,68745,103592,102311,96840,91224,89493,66194,76434,522496,33050,64823,97873,96395,92766,93345,100935,85895,153421,622757,1145253,1346709,1346709
Estonia,2007,EE,EST,EUR,36132,66292,102424,100466,96130,90694,89481,66529,77415,520715,34135,62581,96716,94796,91868,92220,100389,86119,155327,620719,1141434,1340574,1340574
Estonia,2008,EE,EST,EUR,37668,64680,102348,98049,95982,90549,89392,67918,77435,519325,35421,61286,96707,92422,91601,91523,99631,87779,155684,618640,1137965,1337011,1337011
Estonia,2009,EE,EST,EUR,38927,64238,103165,94722,96257,90647,89185,69952,77139,517902,36582,60912,97494,89207,91558,90981,98615,90143,155486,615990,1133892,1334552,1334552
Estonia,2010,EE,EST,EUR,39764,64574,104338,91081,96233,90949,88458,72248,76959,515928,37495,61037,98532,85764,91327,90526,97061,92764,155296,612738,1128666,1331535,1331535
Estonia,2011,EE,EST,EUR,40089,65322,105411,87183,95992,91470,87478,74002,77377,513502,37932,61514,99446,82081,90945,90336,95225,94590,155893,609070,1122572,1327429,1327429
Estonia,2012,EE,EST,EUR,39553,66538,106091,82841,96135,92043,86506,74915,78619,511059,37499,62630,100129,77935,90914,90294,93444,95154,157658,605399,1116458,1322682,1322682
Estonia,2013,EE,EST,EUR,38433,68207,106640,78166,96882,92338,85742,75594,80176,508898,36474,64321,100795,73434,91443,90031,91853,95204,159684,601649,1110547,1317982,1317982
Estonia,2014,EE,EST,EUR,37306,69997,107303,73524,97968,92318,85361,76170,81991,507332,35394,66128,101522,69131,92165,89521,90599,94933,162022,598371,1105703,1314526,1314526
Estonia,2015,EE,EST,EUR,36515,71563,108078,70163,99460,92282,84776,76900,83886,507467,34648,67811,102459,66225,92791,88998,89412,94780,164443,596649,1104116,1314657,1314657
Estonia,2016,EE,EST,EUR,36142,72926,109068,67913,100089,92192,84502,77702,85680,508078,34260,69220,103480,64273,92565,88531,88361,94780,166783,595293,1103371,1315926,1315926
Estonia,2017,EE,EST,EUR,36094,74088,110182,65891,99701,92560,85042,78491,87487,509172,34024,70235,104259,62469,91697,88292,87851,94596,169036,593941,1103113,1317549,1317549
Estonia,2018,EE,EST,EUR,36308,74958,111266,64712,98999,93785,86042,79302,89298,512138,34084,71003,105087,61638,90334,88663,87781,94337,170901,593654,1105792,1322148,1322148
Estonia,2019,EE,EST,EUR,36644,75506,112150,64479,97231,95461,87090,79831,91252,515344,34348,71594,105942,61474,88116,89436,87912,93805,172855,593598,1108942,1327039,1327039
Estonia,2020,EE,EST,EUR,36699,75805,112504,64973,94581,96742,88072,79617,93350,517335,34401,72002,106403,61738,85646,90163,88097,92612,174946,593202,1110537,1329444,1329444
Estonia,2021,EE,EST,EUR,36408,75973,112381,65869,91507,97675,89119,78989,94629,517788,34271,72177,106448,62509,83235,90746,88497,91052,176044,592083,1109871,1328701,1328701
Estonia,2022,EE,EST,EUR,35997,75714,111711,66920,87623,98723,90256,78416,95923,517861,34088,71755,105843,63522,80186,91422,88988,89563,176963,590644,1108505,1326062,1326062
Estonia,2023,EE,EST,EUR,35413,75094,110507,68316,82782,99981,91020,78021,98045,518165,33559,71079,104638,64865,76302,92389,89173,88245,178485,589459,1107624,1322765,1322765
Estonia,2024,EE,EST,EUR,34668,74458,109126,69949,77784,101275,91258,77946,100232,518444,32751,70429,103180,66412,72345,93355,88996,87221,179952,588281,1106725,1319041,1319041
Estonia,2025,EE,EST,EUR,33893,73648,107541,71456,73332,102120,91345,78001,102468,518722,31967,69596,101563,67929,68820,93830,88607,86464,181420,587070,1105792,1314900,1314900
Estonia,2026,EE,EST,EUR,33077,72839,105916,72785,69898,101881,91311,78309,104662,518846,31194,68841,100035,69242,66009,93492,88171,85839,182826,585579,1104425,1310378,1310378
Estonia,2027,EE,EST,EUR,32275,72281,104556,73838,67101,100817,91285,78751,106764,518556,30434,68282,98716,70161,63785,92514,87934,85379,183939,583712,1102268,1305538,1305538
Estonia,2028,EE,EST,EUR,31499,71815,103314,74622,64979,98895,91631,79229,108644,518000,29702,67704,97406,70814,62320,90713,88163,85134,184559,581703,1099703,1300424,1300424
Estonia,2029,EE,EST,EUR,30765,71258,102023,75094,63951,95894,92337,79754,110326,517356,29011,67023,96034,71230,61669,88104,88611,85065,184950,579629,1096985,1295047,1295047
Estonia,2030,EE,EST,EUR,30102,70399,100501,75276,63798,92467,93016,80500,111766,516823,28383,66150,94533,71483,61465,85257,89028,85172,185177,577582,1094405,1289441,1289441
Estonia,1950,EE,EST,EUR,48321,95727,144048,92972,55515,60362,48570,33134,35180,325733,42986,93314,136300,101516,78006,88851,81418,65056,81143,495990,821723,1102078,1102078
Estonia,1951,EE,EST,EUR,50045,94376,144421,95863,59378,60065,50124,33318,34971,333719,44925,91265,136190,102487,82132,87563,82598,65726,81505,502011,835730,1116336,1116336
Estonia,1952,EE,EST,EUR,51701,92988,144689,98056,64353,59324,51546,33554,34792,341625,46952,89052,136004,103126,87376,85441,83600,66472,81908,507923,849548,1130244,1130244
Estonia,1953,EE,EST,EUR,53305,91409,144714,99631,70015,58283,52870,33898,34662,349359,48789,86819,135608,103481,93155,82830,84488,67314,82362,513630,862989,1143305,1143305
Estonia,1954,EE,EST,EUR,53282,91729,145011,100600,75579,57259,54102,34463,34549,356552,49685,85827,135512,103411,98346,80515,85341,68275,82837,518725,875277,1155800,1155800
Estonia,1955,EE,EST,EUR,52652,93261,145913,100987,80656,56520,55221,35288,34461,363133,49955,86102,136057,102861,102465,78952,86133,69354,83400,523165,886298,1168276,1168276
Estonia,1956,EE,EST,EUR,52668,94164,146832,100986,85257,55969,56289,36357,34414,369272,49956,86748,136704,102041,105526,77995,86967,70553,84062,527144,896416,1179950,1179950
Estonia,1957,EE,EST,EUR,52084,95596,147680,100769,89334,55589,57309,37672,34410,375083,49389,88005,137394,101109,107360,77665,87888,71859,84751,530632,905715,1190792,1190792
Estonia,1958,EE,EST,EUR,50418,93689,144107,97377,91788,55692,59838,42171,36551,383417,47942,87807,135749,96990,109073,80011,89254,75343,85917,536588,920005,1199866,1199866
Estonia,1959,EE,EST,EUR,49062,92372,141434,93076,93202,56154,61780,46724,38803,389739,46730,88089,134819,92197,109350,83196,90041,78851,87451,541086,930825,1207082,1207082
Estonia,1960,EE,EST,EUR,49104,95691,144795,91538,95441,57373,61418,48084,39175,393029,46635,90884,137519,90451,107947,85639,89558,79964,89171,542730,935759,1218064,1218064
Estonia,1961,EE,EST,EUR,49500,98435,147935,91238,97736,60349,60216,49515,39758,398812,47048,92996,140044,89592,107015,89543,88033,81113,91154,546450,945262,1233243,1233243
Estonia,1962,EE,EST,EUR,50165,99865,150030,91287,99632,65307,58208,50911,40317,405662,47682,93906,141588,89091,106718,94482,85333,82548,92706,550878,956540,1248160,1248160
Estonia,1963,EE,EST,EUR,50568,100720,151288,91570,101166,70718,56857,51844,40987,413142,47972,94416,142388,88937,106291,99246,83079,83744,94421,555718,968860,1262540,1262540
Estonia,1964,EE,EST,EUR,50622,100939,151561,93044,102167,75898,55948,52629,42025,421711,47949,94791,142740,89201,105818,103384,81355,84794,96770,561322,983033,1277334,1277334
Estonia,1965,EE,EST,EUR,50376,101078,151454,95106,102593,81382,54894,53479,43154,430608,47665,95565,143230,89628,105399,107106,79473,85700,99412,566718,997326,1292004,1292004
Estonia,1966,EE,EST,EUR,49815,101174,150989,96718,103412,86484,54307,54262,44225,439408,47041,96665,143706,89559,105394,109773,78610,86515,101850,571701,1011109,1305808,1305808
Estonia,1967,EE,EST,EUR,49114,101578,150692,98336,104165,90987,54141,54758,45610,447997,46485,97570,144055,89866,105330,111225,78936,87430,104220,577007,1025004,1319741,1319741
Estonia,1968,EE,EST,EUR,48908,102506,151414,100768,103912,94453,54581,54905,47147,455766,46529,98386,144915,91583,104221,111449,80021,88081,106780,582135,1037901,1334226,1334226
Estonia,1969,EE,EST,EUR,49161,103339,152500,103821,103550,96918,55571,54988,48396,463244,46933,99079,146012,93984,103229,110598,81599,88537,108998,586945,1050189,1348704,1348704
Estonia,2031,EE,EST,EUR,29519,69194,98713,75335,64072,88861,93722,81452,113014,516456,27834,65142,92976,71537,61591,82346,89376,85518,185146,575514,1091970,1283666,1283666
Estonia,2032,EE,EST,EUR,29033,67928,96961,75027,64828,84754,94669,82535,114186,515999,27375,64143,91518,71066,62294,79055,89932,85987,184982,573316,1089315,1277795,1277795
Estonia,2033,EE,EST,EUR,28650,66568,95218,74409,66225,80023,95955,83348,115532,515492,27013,62883,89896,70390,63636,75196,90906,86199,184932,571259,1086751,1271864,1271864
Estonia,2034,EE,EST,EUR,28377,65094,93471,73778,67861,75128,97271,83688,117231,514957,26759,61390,88149,69744,65184,71264,91879,86064,185199,569334,1084291,1265905,1265905
Estonia,2035,EE,EST,EUR,28234,63656,91890,72974,69371,70772,98143,83895,119107,514262,26623,59977,86600,68909,66700,67762,92360,85730,185756,567217,1081479,1259966,1259966
Estonia,2036,EE,EST,EUR,28194,62258,90452,72170,70699,67421,97958,84005,121171,513424,26585,58653,85238,68160,68014,64972,92035,85348,186425,564954,1078378,1254066,1254066
Estonia,2037,EE,EST,EUR,28229,60974,89203,71618,71753,64693,96963,84124,123271,512422,26620,57440,84060,67597,68933,62768,91077,85166,187003,562544,1074966,1248225,1248225
Estonia,2038,EE,EST,EUR,28340,59813,88153,71153,72537,62627,95134,84585,125190,511226,26722,56347,83069,67024,69579,61316,89303,85432,187339,559993,1071219,1242444,1242444
Estonia,2039,EE,EST,EUR,28494,58812,87306,70599,73015,61634,92253,85376,126970,509847,26868,55400,82268,66344,69999,60672,86731,85910,187628,557284,1067131,1236710,1236710
Estonia,2040,EE,EST,EUR,28650,58004,86654,69739,73201,61504,88953,86134,128732,508263,27016,54641,81657,65475,70253,60472,83921,86358,187940,554419,1062682,1230997,1230997
Estonia,2041,EE,EST,EUR,28806,57382,86188,68542,73265,61799,85483,86911,130494,506494,27162,54053,81215,64469,70311,60606,81047,86737,188232,551402,1057896,1225300,1225300
Estonia,2042,EE,EST,EUR,28936,56935,85871,67280,72966,62565,81529,87928,132294,504562,27284,53628,80912,63470,69840,61308,77797,87320,188508,548243,1052805,1219594,1219594
Estonia,2043,EE,EST,EUR,29011,56658,85669,65925,72362,63965,76970,89250,133995,502467,27359,53369,80728,62216,69169,62653,73993,88309,188638,544978,1047445,1213847,1213847
Estonia,2044,EE,EST,EUR,29041,56545,85586,64455,71741,65597,72260,90585,135586,500224,27387,53262,80649,60720,68528,64198,70118,89291,188729,541584,1041808,1208043,1208043
Estonia,2045,EE,EST,EUR,29027,56558,85585,63019,70948,67103,68077,91492,137207,497846,27374,53273,80647,59309,67697,65712,66668,89790,188918,538094,1035940,1202180,1202180
Estonia,2046,EE,EST,EUR,28964,56675,85639,61627,70158,68425,64863,91390,138903,495366,27315,53382,80697,57988,66948,67026,63917,89496,189164,534539,1029905,1196252,1196252
Estonia,2047,EE,EST,EUR,28855,56842,85697,60343,69616,69477,62248,90501,140635,492820,27214,53542,80756,56775,66393,67942,61746,88580,189530,530966,1023786,1190245,1190245
Estonia,2048,EE,EST,EUR,28710,57028,85738,59190,69157,70263,60276,88834,142518,490238,27073,53717,80790,55684,65822,68590,60323,86869,190112,527400,1017638,1184160,1184160
Estonia,2049,EE,EST,EUR,28518,57212,85730,58189,68614,70739,59338,86158,144564,487602,26891,53892,80783,54742,65146,69013,59698,84372,190889,523860,1011462,1177982,1177982
Estonia,2050,EE,EST,EUR,28288,57353,85641,57386,67764,70934,59245,83087,146564,484980,26672,54028,80700,53980,64278,69264,59513,81651,191697,520383,1005363,1171695,1171695
Ethiopia,1970,ET,ETH,AFR,2660151,3576246,6236397,2622801,1961455,1368762,924945,579547,339276,7796786,2601322,3565328,6166650,2652539,1986883,1395242,972502,636114,465132,8108412,15905198,28308246,28308246
Ethiopia,1971,ET,ETH,AFR,2753005,3708540,6461545,2653602,2016911,1402319,947264,592701,353161,7965958,2690731,3692416,6383147,2687715,2044350,1430650,996976,651397,477852,8288940,16254898,29099594,29099594
Ethiopia,1972,ET,ETH,AFR,2839201,3851546,6690747,2681159,2071446,1436616,969704,605740,366198,8130863,2773572,3830425,6603997,2718892,2101005,1467349,1021493,666981,489996,8465716,16596579,29891328,29891328
Ethiopia,1973,ET,ETH,AFR,2918011,3997088,6915099,2722198,2121309,1472385,992681,618837,378481,8305891,2849421,3970727,6820148,2761725,2154576,1505868,1046457,682930,501612,8653168,16959059,30694316,30694316
Ethiopia,1974,ET,ETH,AFR,2986562,4136440,7123002,2782860,2164815,1508007,1015527,631544,389803,8492556,2915363,4104951,7020314,2822930,2202668,1544492,1071417,698792,512439,8852738,17345294,31488613,31488613
Ethiopia,1975,ET,ETH,AFR,3045913,4271683,7317596,2852450,2201796,1541542,1037289,643431,399829,8676337,2972673,4235304,7207977,2891141,2246034,1581431,1095730,714222,522321,9050879,17727216,32252783,32252783
Ethiopia,1976,ET,ETH,AFR,3121053,4408892,7529945,2927801,2233825,1574808,1059674,656222,410777,8863107,3046215,4367812,7414027,2963283,2287500,1618669,1120838,730914,533938,9255142,18118249,33062216,33062216
Ethiopia,1977,ET,ETH,AFR,3191564,4512135,7703699,2990770,2250147,1598798,1075848,665219,419672,9000454,3115398,4467205,7582603,3023178,2313231,1646585,1138948,743320,542998,9408260,18408714,33695018,33695018
Ethiopia,1978,ET,ETH,AFR,3259483,4597408,7856891,3054194,2260065,1620777,1089748,672556,426912,9124252,3181826,4549808,7731634,3083291,2331832,1672444,1154527,753824,550368,9546286,18670538,34259065,34259065
Ethiopia,1979,ET,ETH,AFR,3325013,4668989,7994002,3116355,2262872,1641386,1101357,678912,433109,9233991,3245008,4619663,7864671,3141317,2341514,1696254,1167694,762741,556639,9666159,18900150,34758823,34758823
Ethiopia,1980,ET,ETH,AFR,3360286,4699089,8059375,3155056,2241451,1649049,1102714,679436,435290,9262996,3277433,4648671,7926104,3174903,2324186,1705766,1169928,764420,557797,9697000,18959996,34945469,34945469
Ethiopia,1981,ET,ETH,AFR,3456629,4825728,8282357,3261661,2259275,1689614,1125861,693588,445888,9475887,3368688,4772914,8141602,3277142,2346347,1748975,1195410,780998,570131,9919003,19394890,35818844,35818844
Ethiopia,1982,ET,ETH,AFR,3599136,5019284,8618420,3423672,2310306,1754203,1165761,717764,462635,9834341,3504304,4963091,8467395,3435992,2402214,1816963,1238772,808545,590747,10293233,20127574,37213393,37213393
Ethiopia,1983,ET,ETH,AFR,3676767,5165483,8842250,3562003,2357038,1799589,1195285,733885,471462,10119262,3575327,5106314,8681641,3571417,2451886,1867086,1271957,827351,602330,10592027,20711289,38235187,38235187
Ethiopia,1984,ET,ETH,AFR,3725919,5304732,9030651,3697274,2426037,1840680,1223720,748054,476800,10412565,3617434,5242001,8859435,3704249,2523329,1913846,1304547,844240,610034,10900245,21312810,39202890,39202890
Ethiopia,1985,ET,ETH,AFR,3806867,5456801,9263668,3828975,2508542,1882663,1253755,764357,485186,10723478,3688714,5388022,9076736,3836532,2606699,1960335,1337258,861938,619317,11222079,21945557,40285965,40285965
Ethiopia,1986,ET,ETH,AFR,3918399,5622703,9541102,3953984,2595638,1924100,1285048,782749,496844,11038363,3788773,5544255,9333028,3965222,2692741,2005309,1369622,880012,629910,11542816,22581179,41455309,41455309
Ethiopia,1987,ET,ETH,AFR,4094525,5804417,9898942,4081293,2694922,1971003,1321996,806118,515009,11390341,3953284,5712368,9665652,4098245,2791457,2053376,1406072,901720,646153,11897023,23287364,42851957,42851957
Ethiopia,1988,ET,ETH,AFR,4338223,6009357,10347580,4211958,2809757,2024549,1365540,834475,540035,11786314,4183714,5900291,10084005,4239736,2907387,2104847,1446987,926865,667816,12293638,24079952,44511537,44511537
Ethiopia,1989,ET,ETH,AFR,4578134,6228293,10806427,4340411,2927939,2076600,1411155,862149,563571,12181825,4412451,6099678,10512129,4379738,3029448,2155466,1490041,952231,688642,12695566,24877391,46195954,46195954
Ethiopia,1990,ET,ETH,AFR,4796704,6469051,11265755,4470785,3045852,2123991,1458315,888352,584562,12571857,4623627,6317625,10941252,4520268,3154651,2203408,1535266,977602,708008,13099203,25671060,47878073,47878073
Ethiopia,1991,ET,ETH,AFR,5041355,6781879,11823234,4628124,3196979,2185104,1514400,921792,617897,13064296,4855126,6602813,11457939,4699297,3316054,2256307,1583802,1004805,731698,13591963,26656259,49937430,49937430
Ethiopia,1992,ET,ETH,AFR,5256877,7121400,12378277,4793010,3352737,2245792,1572258,956252,650322,13570371,5061660,6910683,11972343,4876382,3481800,2309458,1633483,1033952,755483,14090558,27660929,52011554,52011554
Ethiopia,1993,ET,ETH,AFR,5415377,7434593,12849970,4947950,3479262,2301320,1620886,984906,670166,14004490,5221704,7192117,12413821,5021741,3616765,2366603,1679490,1063620,775172,14523391,28527881,53791672,53791672
Ethiopia,1994,ET,ETH,AFR,5580294,7749437,13329731,5112693,3599366,2372885,1666438,1013946,690414,14455742,5386987,7478491,12865478,5172321,3744500,2440713,1722543,1093655,795521,14969253,29424995,55620211,55620211
Ethiopia,1995,ET,ETH,AFR,5737149,8062649,13799798,5299462,3715306,2451280,1712922,1042836,706468,14928274,5547807,7768205,13316012,5328639,3866122,2527611,1770665,1125111,814308,15432456,30360730,57476536,57476536
Ethiopia,1996,ET,ETH,AFR,5881757,8385142,14266899,5498517,3827108,2531728,1759254,1072484,723093,15412184,5697886,8071471,13769357,5486164,3980024,2619031,1822236,1157950,833810,15899215,31311399,59347649,59347649
Ethiopia,1997,ET,ETH,AFR,6034580,8717680,14752260,5685751,3933314,2615719,1803335,1104096,748579,15890794,5848158,8390076,14238234,5638945,4085284,2709471,1869190,1190907,858394,16352191,32242985,61233480,61233480
Ethiopia,1998,ET,ETH,AFR,6189836,9059719,15249555,5868125,4034983,2703591,1845640,1137798,777285,16367422,5995638,8722591,14718229,5790334,4184469,2802257,1913635,1225160,885438,16801293,33168715,63136493,63136493
Ethiopia,1999,ET,ETH,AFR,6337255,9408769,15746024,6067064,4135773,2793900,1887229,1173478,802035,16859479,6136108,9062858,15198966,5956411,4283755,2901176,1959222,1261910,910638,17273112,34132591,65077579,65077579
Ethiopia,2000,ET,ETH,AFR,6480867,9744509,16225376,6283396,4241621,2888109,1925762,1211929,829171,17379988,6269538,9390994,15660532,6142092,4384966,3001621,2000608,1300030,936655,17765972,35145960,67031867,67031867
Ethiopia,2001,ET,ETH,AFR,6619433,10067493,16686926,6519533,4359531,2989385,1961153,1253218,860313,17943133,6396008,9705910,16101918,6348446,4492107,3105277,2036953,1339198,964969,18286950,36230083,69018932,69018932
Ethiopia,2002,ET,ETH,AFR,6755390,10379549,17134939,6784739,4487513,3097291,1996470,1295540,889847,18551400,6523088,10008688,16531776,6581702,4607197,3217667,2074788,1379795,993951,18855100,37406500,71073215,71073215
Ethiopia,2003,ET,ETH,AFR,6887123,10683190,17570313,7065326,4623919,3205536,2041448,1335137,919007,19190373,6646017,10304289,16950306,6831926,4728535,3330506,2123040,1419012,1024832,19457851,38648224,73168838,73168838
Ethiopia,2004,ET,ETH,AFR,7013240,10991409,18004649,7346267,4770026,3309283,2100749,1372198,949425,19847948,6761031,10605001,17366032,7087745,4856683,3437492,2186387,1456151,1057939,20082397,39930345,75301026,75301026
Ethiopia,2005,ET,ETH,AFR,7140153,11299376,18439529,7628157,4924985,3410879,2167784,1408732,980942,20521479,6874227,10905158,17779385,7352730,4991708,3540507,2257192,1494161,1093256,20729554,41251033,77469940,77469940
Ethiopia,2006,ET,ETH,AFR,7263573,11600447,18864020,7929514,5088957,3512236,2240114,1445425,1012867,21229113,6982688,11199526,18182214,7641207,5134123,3642502,2332794,1534462,1130627,21415715,42644828,79691050,79691050
Ethiopia,2007,ET,ETH,AFR,7378474,11910542,19289016,8253857,5260506,3613080,2318924,1483458,1045089,21974914,7083659,11503213,18586872,7953081,5282695,3745524,2416799,1576960,1170331,22145390,44120304,81996185,81996185
Ethiopia,2008,ET,ETH,AFR,7487735,12222917,19710652,8594726,5436269,3712188,2403502,1522140,1078714,22747539,7181080,11808741,18989821,8283031,5434917,3848143,2508399,1621063,1213541,22909094,45656633,84357105,84357105
Ethiopia,2009,ET,ETH,AFR,7581518,12527156,20108674,8945379,5627994,3813618,2493160,1561592,1116871,23558614,7264673,12106908,19371581,8625870,5603079,3952793,2606266,1666513,1262197,23716718,47275332,86755585,86755585
Ethiopia,2010,ET,ETH,AFR,7659486,12831485,20490971,9294438,5853410,3926526,2589744,1601529,1159870,24425517,7334578,12402702,19737280,8971589,5804266,4067590,2711861,1712615,1316096,24584017,49009534,89237791,89237791
Ethiopia,2011,ET,ETH,AFR,7733802,13129307,20863109,9640901,6113147,4055350,2694570,1641107,1207415,25352490,7402063,12689723,20091786,9316846,6039277,4195769,2826208,1758133,1374310,25510543,50863033,91817929,91817929
Ethiopia,2012,ET,ETH,AFR,7798135,13418368,21216503,9979074,6401718,4196188,2807304,1681404,1258295,26323983,7460189,12968878,20429067,9654441,6303839,4333530,2949005,1804687,1436223,26481725,52805708,94451280,94451280
Ethiopia,2013,ET,ETH,AFR,7850850,13698196,21549046,10305362,6703481,4344818,2920782,1730291,1308244,27312978,7507475,13239262,20746737,9982101,6583743,4477251,3072769,1860692,1499043,27475599,54788577,97084366,97084366
Ethiopia,2014,ET,ETH,AFR,7915653,13956276,21871929,10633556,7007597,4503314,3030684,1792188,1357088,28324427,7567658,13486579,21054237,10312783,6869905,4628342,3192561,1931039,1561546,28496176,56820603,99746766,99746766
Ethiopia,2015,ET,ETH,AFR,8006217,14195693,22201910,10959824,7317400,4672487,3139531,1862284,1407030,29358556,7654728,13714290,21369018,10641527,7166308,4787472,3310785,2009938,1626388,29542418,58900974,102471895,102471895
Ethiopia,2016,ET,ETH,AFR,8121328,14424766,22546094,11278354,7647596,4852206,3248689,1937319,1458285,30422449,7766490,13931844,21698334,10964867,7487454,4955341,3429131,2094106,1695452,30626351,61048800,105293228,105293228
Ethiopia,2017,ET,ETH,AFR,8265220,14634138,22899358,11602211,7992859,5038492,3357116,2016914,1511897,31519489,7905632,14128088,22033720,11293592,7827926,5127353,3545832,2183676,1767005,31745384,63264873,108197950,108197950
Ethiopia,2018,ET,ETH,AFR,8444840,14824636,23269476,11917637,8340493,5225111,3462454,2100393,1567408,32613496,8078807,14305214,22384021,11611341,8174667,5298551,3658949,2278087,1840847,32862442,65475938,111129438,111129438
Ethiopia,2019,ET,ETH,AFR,8659025,15009123,23668148,12217922,8687626,5422257,3567685,2187252,1624541,33707283,8284382,14478222,22762604,11912569,8523248,5480154,3771682,2377274,1917627,33982554,67689837,114120594,114120594
Ethiopia,2020,ET,ETH,AFR,8884102,15200216,24084318,12519722,9026713,5644414,3679078,2275770,1676529,34822226,8498812,14660265,23159077,12211677,8866422,5685843,3889638,2480045,1991659,35125284,69947510,117190911,117190911
Ethiopia,2021,ET,ETH,AFR,9097090,15407604,24504694,12813895,9354120,5889747,3798649,2364983,1717322,35938716,8700815,14860794,23561609,12502396,9200802,5915766,4015184,2586200,2057666,36278014,72216730,120283026,120283026
Ethiopia,2022,ET,ETH,AFR,9294147,15630960,24925107,13095583,9665489,6156073,3925480,2458072,1754376,37055073,8887683,15076646,23964329,12781681,9520186,6168374,4146613,2697633,2120934,37435421,74490494,123379924,123379924
Ethiopia,2023,ET,ETH,AFR,9470402,15879820,25350222,13371273,9969075,6437841,4061788,2554050,1801460,38195487,9055300,15314704,24370004,13052697,9831611,6437285,4284728,2811090,2193948,38611359,76806846,126527060,126527060
Ethiopia,2024,ET,ETH,AFR,9608335,16174359,25782694,13628338,10277117,6723704,4209539,2650664,1865632,39354994,9187733,15595191,24782924,13301997,10146986,6712799,4430948,2923205,2283165,39799100,79154094,129719719,129719719
Ethiopia,2025,ET,ETH,AFR,9712189,16500832,26213021,13867724,10584794,7016097,4368814,2749410,1943773,40530612,9289685,15906803,25196488,13532213,10461162,6998477,4585540,3035724,2385316,40998432,81529044,132938555,132938555
Ethiopia,2026,ET,ETH,AFR,9801233,16835931,26637164,14096731,10884299,7326290,4537337,2849104,2029474,41723235,9378467,16227741,25606208,13750714,10767710,7305050,4746858,3148020,2495178,42213530,83936765,136180141,136180141
Ethiopia,2027,ET,ETH,AFR,9881959,17181438,27063397,14306451,11189089,7649212,4710734,2947398,2119212,42922096,9459083,16559315,26018398,13948381,11079385,7628527,4911005,3258197,2610371,43435866,86357962,139439745,139439745
Ethiopia,2028,ET,ETH,AFR,9957851,17540023,27497874,14499182,11494648,7981885,4887615,3044164,2212793,44120287,9534979,16904416,26439395,14128857,11389718,7965625,5077411,3366123,2730577,44658311,88778598,142715864,142715864
Ethiopia,2029,ET,ETH,AFR,10032604,17894102,27926706,14687367,11792398,8320388,5077254,3141988,2309964,45329359,9609323,17246008,26855331,14305735,11690378,8310332,5256118,3474355,2855632,45892550,91221909,146003944,146003944
Ethiopia,2030,ET,ETH,AFR,10104360,18225465,28329825,14882036,12089241,8648648,5289665,3245738,2410325,46565653,9679564,17565692,27245256,14491720,11986490,8647323,5457173,3587689,2985253,47155648,93721301,149296378,149296378
Ethiopia,1950,ET,ETH,AFR,1624455,2297025,3921480,1686207,1217654,877386,548217,318232,218976,4866672,1590368,2263977,3854345,1656494,1215169,869901,604093,408094,313702,5067453,9934125,17709951,17709951
Ethiopia,1951,ET,ETH,AFR,1635676,2360242,3995918,1725647,1245859,895401,572704,321488,222585,4983684,1609796,2327310,3937106,1696668,1244588,889196,620673,412596,320712,5184433,10168117,18101144,18101144
Ethiopia,1952,ET,ETH,AFR,1646426,2424447,4070873,1766283,1274567,913888,598048,324093,226178,5103057,1627516,2391501,4019017,1738331,1274095,909262,637675,417258,327227,5303848,10406905,18496797,18496797
Ethiopia,1953,ET,ETH,AFR,1663398,2482659,4146057,1807082,1302906,932475,622922,327280,229778,5222443,1648630,2451455,4100085,1780282,1302905,929697,654691,422395,333362,5423332,10645775,18891916,18891916
Ethiopia,1954,ET,ETH,AFR,1688227,2534835,4223062,1847863,1331286,951237,645769,333084,233369,5342608,1675903,2506475,4182378,1822281,1331692,950619,671226,428908,339383,5544109,10886717,19292149,19292149
Ethiopia,1955,ET,ETH,AFR,1717403,2585363,4302766,1889451,1360433,970528,666269,342227,236896,5465804,1705428,2561560,4266988,1865022,1361276,972251,687250,437020,345357,5668176,11133980,19703738,19703738
Ethiopia,1956,ET,ETH,AFR,1750589,2634745,4385334,1932395,1390424,990394,684411,354441,240544,5592609,1736148,2617874,4354022,1909122,1391557,994582,702694,446649,351367,5795971,11388580,20127942,20127942
Ethiopia,1957,ET,ETH,AFR,1768039,2678601,4446640,1975650,1420048,1009330,698317,368136,242454,5713935,1750678,2668617,4419295,1953923,1421479,1016599,716211,456358,354979,5919549,11633484,20499416,20499416
Ethiopia,1958,ET,ETH,AFR,1772797,2715049,4487846,2019017,1448050,1026949,708745,382611,242572,5827944,1752211,2711600,4463811,1998982,1449945,1037726,728095,465911,356300,6036959,11864903,20816567,20816567
Ethiopia,1959,ET,ETH,AFR,1805392,2753096,4558488,2068331,1478534,1047224,721040,399706,244650,5959485,1781881,2755499,4537380,2049643,1481034,1060830,742022,477880,360448,6171857,12131342,21227211,21227211
Ethiopia,1960,ET,ETH,AFR,1866013,2792067,4658080,2125529,1513087,1071013,736201,418615,248716,6113161,1839923,2799617,4639540,2107952,1516566,1086635,758612,491949,367212,6328926,12442087,21739710,21739710
Ethiopia,1961,ET,ETH,AFR,1937272,2826139,4763411,2186712,1549965,1096319,752199,438097,252709,6276001,1908283,2838225,4746508,2170187,1554912,1113613,776354,506561,374133,6495760,12771761,22281675,22281675
Ethiopia,1962,ET,ETH,AFR,2018503,2858112,4876615,2249291,1589449,1122970,769018,458245,256388,6445361,1986199,2874126,4860325,2233886,1596269,1141617,795222,521666,381199,6669859,13115220,22852158,22852158
Ethiopia,1963,ET,ETH,AFR,2100661,2903806,5004467,2306454,1630796,1150723,786612,478254,260630,6613469,2064727,2921495,4986222,2293869,1639768,1170460,815078,537026,388623,6844824,13458293,23448979,23448979
Ethiopia,1964,ET,ETH,AFR,2177545,2971410,5148955,2357802,1673057,1179361,804779,496968,266772,6778739,2137939,2989325,5127264,2349073,1684353,1200163,835767,552210,397171,7018737,13797476,24073696,24073696
Ethiopia,1965,ET,ETH,AFR,2253645,3052953,5306598,2407433,1716548,1208944,823502,514026,275114,6945567,2210268,3068926,5279194,2404217,1730143,1230841,857162,567004,406785,7196152,14141719,24727506,24727506
Ethiopia,1966,ET,ETH,AFR,2324359,3141143,5465502,2454511,1760701,1238843,842120,528730,284794,7109699,2277038,3152296,5429334,2458969,1776653,1261788,878684,580667,416341,7373102,14482801,25377645,25377645
Ethiopia,1967,ET,ETH,AFR,2397760,3236547,5634307,2500182,1806393,1269790,861278,541638,296644,7275925,2346847,3242468,5589315,2511973,1824880,1293505,900899,593794,427003,7552054,14827979,26051596,26051596
Ethiopia,1968,ET,ETH,AFR,2481574,3341640,5823214,2544343,1855152,1302401,881805,554143,310789,7448633,2427999,3341932,5769931,2562825,1876136,1326634,924319,607385,439577,7736876,15185509,26778653,26778653
Ethiopia,1969,ET,ETH,AFR,2568855,3454550,6023405,2585480,1906625,1335392,903007,566627,325194,7622325,2513004,3449181,5962185,2609949,1929942,1360510,948205,621420,452446,7922472,15544797,27530388,27530388
Ethiopia,2031,ET,ETH,AFR,10165005,18531110,28696115,15092822,12379327,8966131,5524976,3358875,2513821,47835952,9738647,17860682,27599329,14695088,12273499,8974679,5681557,3709251,3119549,48453623,96289575,152585021,152585021
Ethiopia,2032,ET,ETH,AFR,10217739,18812316,29030055,15319016,12661611,9272814,5782632,3480245,2621703,49138021,9790585,18132970,27923555,14912541,12552921,9290827,5929450,3837459,3259799,49782997,98921018,155874633,155874633
Ethiopia,2033,ET,ETH,AFR,10260929,19066640,29327569,15568925,12936706,9571170,6054016,3608909,2733726,50473452,9833551,18380699,28214250,15151594,12824366,9599425,6192832,3971289,3405480,51144986,101618438,159160258,159160258
Ethiopia,2034,ET,ETH,AFR,10295847,19281694,29577541,15863145,13192501,9872691,6328091,3746084,2849396,51851908,9868256,18591816,28460072,15432972,13074449,9911927,6462283,4111776,3555895,52549302,104401210,162438815,162438815
Ethiopia,2035,ET,ETH,AFR,10328797,19462120,29790917,16189786,13431785,10174315,6608223,3892574,2968410,53265093,9901124,18769669,28670793,15746240,13306503,10224034,6741855,4259623,3710440,53988695,107253788,165715492,165715492
Ethiopia,2036,ET,ETH,AFR,10362109,19618551,29980660,16525846,13661697,10468743,6905416,4046936,3089334,54697972,9934223,18924196,28858419,16069471,13527538,10529319,7041959,4413589,3867482,55449358,110147330,168986410,168986410
Ethiopia,2037,ET,ETH,AFR,10394260,19758845,30153105,16872081,13872842,10768381,7214507,4205455,3211321,56144587,9965678,19063384,29029062,16403244,13728040,10839768,7358406,4570138,4026254,56925850,113070437,172252603,172252603
Ethiopia,2038,ET,ETH,AFR,10427886,19884753,30312639,17231016,14067455,11068851,7532582,4366791,3333994,57600689,9998183,19188737,29186920,16750373,13911569,11149026,7687984,4728699,4186273,58413924,116014613,175514171,175514171
Ethiopia,2039,ET,ETH,AFR,10468694,20001165,30469859,17585369,14257645,11361935,7856232,4539646,3459357,59060184,10037495,19304097,29341592,17093975,14091541,11448938,8025061,4898904,4349583,59908002,118968186,178779627,178779627
Ethiopia,2040,ET,ETH,AFR,10515824,20112497,30628321,17917316,14454224,11654310,8170562,4733549,3591195,60521156,10082898,19413356,29496254,17415829,14280555,11744542,8355035,5090574,4520312,61406847,121928003,182052579,182052579
Ethiopia,2041,ET,ETH,AFR,10571248,20213092,30784340,18223928,14666588,11940330,8475224,4948820,3732311,61987201,10136272,19511558,29647830,17713158,14486776,12031355,8676119,5304757,4701155,62913320,124900521,185332694,185332694
Ethiopia,2042,ET,ETH,AFR,10631380,20304543,30935923,18506468,14894018,12218978,8770215,5184868,3882637,63457184,10193865,19600785,29794650,17987921,14706951,12310854,8986783,5541572,4891739,64425820,127883004,188613575,188613575
Ethiopia,2043,ET,ETH,AFR,10699981,20387874,31087855,18762570,15144625,12490772,9057618,5433556,4040966,64930107,10259214,19681910,29941124,18238263,14948474,12582583,9290412,5793275,5090667,65943674,130873781,191902756,191902756
Ethiopia,2044,ET,ETH,AFR,10770581,20470057,31240638,18980152,15438538,12744003,9348157,5684731,4207929,66403510,10326501,19761409,30087910,18452257,15231873,12833398,9598015,6050882,5298208,67464633,133868143,195196696,195196696
Ethiopia,2045,ET,ETH,AFR,10836426,20556386,31392812,19163665,15764086,12981346,9639049,5941643,4384226,67874015,10388952,19844902,30233854,18633170,15546774,13066532,9905476,6318298,5514718,68984968,136858983,198485649,198485649
Ethiopia,2046,ET,ETH,AFR,10895037,20651115,31546152,19323402,16098726,13209683,9923565,6214307,4567643,69337326,10444161,19936292,30380453,18790729,15871389,13288803,10206637,6605356,5738022,70500936,139838262,201764870,201764870
Ethiopia,2047,ET,ETH,AFR,10949222,20749249,31698471,19467116,16443205,13419930,10213349,6497539,4754297,70795436,10495096,20029976,30525072,18932853,16206258,13490846,10513039,6907727,5964172,72014895,142810331,205033875,205033875
Ethiopia,2048,ET,ETH,AFR,10997830,20857065,31854895,19596492,16799943,13614130,10504006,6788395,4942751,72245717,10540521,20132203,30672724,19061041,16554149,13676070,10818325,7222176,6192143,73523904,145769621,208297232,208297232
Ethiopia,2049,ET,ETH,AFR,11044031,20973770,32017801,19716343,17152094,13804055,10787856,7084396,5142148,73686892,10583509,20242862,30826371,19179129,16898374,13857704,11114669,7543838,6432693,75026407,148713299,211557468,211557468
Ethiopia,2050,ET,ETH,AFR,11091527,21091900,32183427,19831059,17482324,14000309,11071297,7372699,5363802,75121490,10627755,20354489,30982244,19290984,17220956,14048245,11406982,7859433,6698555,76525155,151646645,214812309,214812309
Finland,1970,FI,FIN,EUR,177385,401091,578476,447962,310094,286415,234676,210537,156994,1646678,170348,385108,555456,425337,299804,285392,280086,270491,264899,1826009,3472687,4606621,4606621
Finland,1971,FI,FIN,EUR,170222,394502,564724,443399,324466,284736,239588,208615,161543,1662347,163352,379123,542475,421672,313138,282477,282302,269876,273408,1842873,3505220,4612424,4612424
Finland,1972,FI,FIN,EUR,164113,389718,553831,440408,344501,284406,245479,205876,167070,1687740,157178,374810,531988,418849,330480,281213,284428,268217,283083,1866270,3554010,4639831,4639831
Finland,1973,FI,FIN,EUR,157936,386499,544435,434111,363814,285350,251564,203377,172951,1711167,150758,371749,522507,413019,347208,281142,286357,266790,293534,1888050,3599217,4666166,4666166
Finland,1974,FI,FIN,EUR,154416,381963,536379,426386,381078,287014,259263,199014,178826,1731581,147326,367167,514493,406354,361893,281773,290910,262809,304377,1908116,3639697,4690576,4690576
Finland,1975,FI,FIN,EUR,154638,374788,529426,418971,397647,286063,265402,195744,184673,1748500,147547,360058,507605,400311,376113,280276,293563,260086,315492,1925841,3674341,4711368,4711368
Finland,1976,FI,FIN,EUR,156581,366342,522923,412006,407334,288078,268458,195346,190040,1761262,148924,351914,500838,394732,384677,282088,291618,261064,326300,1940479,3701741,4725518,4725518
Finland,1977,FI,FIN,EUR,158961,357681,516642,405688,416372,290942,271080,195006,195249,1774337,151135,343343,494478,388795,392048,284363,289378,261321,337373,1953278,3727615,4738739,4738739
Finland,1978,FI,FIN,EUR,161836,347936,509772,400603,427782,292574,271579,196131,199756,1788425,154224,333500,487724,383357,402074,285069,285790,262248,347935,1966473,3754898,4752400,4752400
Finland,1979,FI,FIN,EUR,163881,338395,502276,396235,434340,298161,270699,198544,203501,1801480,156377,324242,480619,378729,408995,289655,281781,263635,357396,1980191,3781671,4764568,4764568
Finland,1980,FI,FIN,EUR,163787,332210,495997,391699,436517,307419,270529,202094,206534,1814792,156468,318151,474619,374123,411936,297642,279107,265320,365885,1994013,3808805,4779418,4779418
Finland,1981,FI,FIN,EUR,162901,328355,491256,387613,433483,322848,270020,207334,208593,1829891,155846,313916,469762,370475,409424,311376,276852,268002,372833,2008962,3838853,4799865,4799865
Finland,1982,FI,FIN,EUR,163008,325067,488075,384683,428052,340919,269764,212914,210756,1847088,155869,310493,466362,367926,404396,327456,275544,270258,379757,2025337,3872425,4826861,4826861
Finland,1983,FI,FIN,EUR,164480,322088,486568,382627,420709,357852,270713,218668,212881,1863450,157135,307518,464653,366243,397731,342632,275328,272293,386838,2041065,3904515,4855733,4855733
Finland,1984,FI,FIN,EUR,165927,320459,486386,378729,413009,373096,272461,225807,213701,1876803,158447,306118,464565,362796,391307,355803,275835,276858,391383,2053982,3930785,4881748,4881748
Finland,1985,FI,FIN,EUR,166232,320349,486581,372303,406710,388859,272027,231739,215286,1886924,158800,306163,464963,356901,386456,369406,274411,279812,396719,2063705,3950629,4902175,4902175
Finland,1986,FI,FIN,EUR,165199,321470,486669,364660,402085,399417,274756,235331,218916,1895165,157957,306967,464924,350012,382945,378759,276472,278535,404681,2071404,3966569,4918172,4918172
Finland,1987,FI,FIN,EUR,162597,324409,487006,355915,397780,409884,277950,238310,222552,1902391,155622,309668,465290,341837,379691,388323,279048,276738,411854,2077491,3979882,4932176,4932176
Finland,1988,FI,FIN,EUR,159808,329119,488927,346093,394117,422364,279750,239380,226514,1908218,153156,314398,467554,332245,376891,400523,280071,273432,418702,2081864,3990082,4946561,4946561
Finland,1989,FI,FIN,EUR,158442,332839,491281,337396,391972,430089,285589,239381,231373,1915800,151785,318069,469854,323898,374864,408853,284941,269878,425102,2087536,4003336,4964475,4964475
Finland,1990,FI,FIN,EUR,158913,333471,492384,332102,389767,433492,295158,239980,236612,1927111,152020,318833,470853,318733,372647,413071,293165,267692,430887,2096195,4023306,4986545,4986545
Finland,1991,FI,FIN,EUR,161021,332078,493099,329334,387508,431190,310638,240485,242385,1941540,154080,317715,471795,315429,370774,411560,307161,265864,436629,2107417,4048957,5013854,5013854
Finland,1992,FI,FIN,EUR,164065,330017,494082,326913,385601,425746,328366,241277,248190,1956093,157173,315665,472838,312631,369205,406977,323369,264941,441981,2119104,4075197,5042121,5042121
Finland,1993,FI,FIN,EUR,166209,329104,495313,324302,384012,418088,344827,243103,254124,1968456,159375,314796,474171,309994,367903,400398,338531,265074,446770,2128670,4097126,5066605,5066605
Finland,1994,FI,FIN,EUR,166782,329462,496244,322782,380576,410237,359547,245718,260850,1979710,160272,314945,475217,308790,364623,393976,351720,265923,452280,2137312,4117022,5088490,5088490
Finland,1995,FI,FIN,EUR,166230,330247,496477,322704,374506,404147,374651,246373,267858,1990239,160041,315462,475503,308950,358875,389310,365262,264915,458415,2145727,4135966,5107943,5107943
Finland,1996,FI,FIN,EUR,164393,331127,495520,324106,367245,399965,384925,249864,274567,2000672,158115,316507,474622,309991,352318,386128,374740,267321,463407,2153905,4154577,5124718,5124718
Finland,1997,FI,FIN,EUR,161304,331357,492661,327411,359027,396313,395219,253584,280665,2012219,155135,317131,472266,313005,344599,383135,384604,270142,467307,2162792,4175011,5139943,5139943
Finland,1998,FI,FIN,EUR,157343,330595,487938,332522,349765,393451,407500,255839,285589,2024666,151476,316795,468271,318069,335469,380590,397012,271368,470161,2172669,4197335,5153544,5153544
Finland,1999,FI,FIN,EUR,153582,329630,483212,336515,341331,391513,415093,261659,290241,2036352,147635,316187,463822,321810,327312,378378,405490,276302,472822,2182114,4218466,5165491,5165491
Finland,2000,FI,FIN,EUR,150303,329263,479566,337168,335793,388655,418124,270885,296008,2046633,144088,315974,460062,322495,321757,375455,409694,284328,476223,2189952,4236585,5176209,5176209
Finland,2001,FI,FIN,EUR,147650,329102,476752,335686,332298,385195,415651,285563,302333,2056726,141383,315790,457173,321243,317881,372516,407901,297813,479990,2197344,4254070,5188002,5188002
Finland,2002,FI,FIN,EUR,145716,328676,474392,333551,329355,382349,410364,302327,308934,2066880,139276,315595,454871,319062,314856,369933,403049,313473,484070,2204443,4271323,5200596,5200596
Finland,2003,FI,FIN,EUR,144954,326536,471490,332462,326762,380412,403005,317983,316807,2077431,138211,313822,452033,318049,312115,368123,396468,328191,489092,2212038,4289469,5212989,5212989
Finland,2004,FI,FIN,EUR,145106,323174,468280,332765,325817,377041,395706,331925,325948,2089202,138310,310714,449024,318272,311098,364857,390214,341048,496136,2221625,4310827,5228141,5228141
Finland,2005,FI,FIN,EUR,145443,319392,464835,333943,326862,371594,390282,345959,333726,2102366,138878,306996,445874,319223,311848,359508,385848,354214,502350,2232991,4335357,5246071,5246071
Finland,2006,FI,FIN,EUR,146372,315006,461378,335408,329615,365438,386710,355505,343995,2116671,140168,302478,442646,320691,313772,353502,383102,363510,510981,2245558,4362229,5266251,5266251
Finland,2007,FI,FIN,EUR,148036,310273,458309,336391,334646,358537,383830,365183,353361,2131948,141844,297718,439562,321855,317980,346485,380697,373219,518633,2258869,4390817,5288689,5288689
Finland,2008,FI,FIN,EUR,149868,306055,455923,336613,342069,350674,381869,376648,360418,2148291,143454,293491,436945,322262,324524,338162,378673,385338,523235,2272194,4420485,5313350,5313350
Finland,2009,FI,FIN,EUR,151504,302990,454494,336496,348439,343723,380943,383925,370338,2163864,145061,290184,435245,322333,330137,331045,377020,393765,530909,2285209,4449073,5338815,5338815
Finland,2010,FI,FIN,EUR,153227,300510,453737,336787,351276,339864,379300,387236,383538,2178001,146651,287620,434271,322659,332717,326690,374798,398227,542174,2297265,4475266,5363271,5363271
Finland,2011,FI,FIN,EUR,154566,299345,453911,337246,352098,337975,377012,385520,401709,2191560,147742,286684,434426,322971,333424,323867,372498,396929,558580,2308269,4499829,5388166,5388166
Finland,2012,FI,FIN,EUR,155085,299780,454865,337326,352469,336716,375182,381272,421745,2204710,148453,286875,435328,323201,333401,321994,370591,392652,577113,2318952,4523662,5413859,5413859
Finland,2013,FI,FIN,EUR,155095,301475,456570,335673,353822,336074,374293,375321,441724,2216907,148459,288189,436648,321738,334553,320588,369472,386788,595604,2328743,4545650,5438872,5438872
Finland,2014,FI,FIN,EUR,154197,303797,457994,332705,356053,336839,372085,369563,460870,2228115,147381,290451,437832,318810,336769,320718,366897,381208,613094,2337496,4565611,5461440,5461440
Finland,2015,FI,FIN,EUR,152036,306191,458227,329307,358305,339173,367754,365528,478374,2238441,145230,292868,438098,315196,338884,322252,362075,377411,628877,2344695,4583136,5479461,5479461
Finland,2016,FI,FIN,EUR,148816,308749,457565,326177,361004,342898,362343,363229,493678,2249329,142154,295399,437553,310846,340907,324652,356320,375202,642850,2350777,4600106,5495219,5495219
Finland,2017,FI,FIN,EUR,144757,311300,456057,322602,363212,348394,355753,361505,508190,2259656,138282,297981,436263,306137,342259,328966,349308,373043,656450,2356163,4615819,5508140,5508140
Finland,2018,FI,FIN,EUR,139766,313383,453149,318419,363669,355386,348029,360306,522240,2268049,133351,299859,433210,301744,342228,335360,340827,371063,669831,2361053,4629102,5515461,5515461
Finland,2019,FI,FIN,EUR,133982,314280,448262,315260,363820,361593,341507,360086,535231,2277497,127847,300559,428406,298309,342004,341120,333619,369511,682814,2367377,4644874,5521537,5521537
Finland,2020,FI,FIN,EUR,128557,314172,442729,312796,364710,365370,338182,359278,547953,2288289,122924,300334,423258,295818,342508,344392,329410,367437,695625,2375190,4663479,5529468,5529468
Finland,2021,FI,FIN,EUR,124607,312149,436756,311800,365049,366971,336780,357827,559838,2298265,119036,298336,417372,295580,342838,345721,326772,365258,707429,2383598,4681863,5535992,5535992
Finland,2022,FI,FIN,EUR,122076,307831,429907,312481,364260,367517,335834,356684,571119,2307895,116291,294490,410781,296947,342805,345802,324825,363306,718470,2392155,4700050,5540745,5540745
Finland,2023,FI,FIN,EUR,120856,302083,422939,314227,361660,368952,335244,356223,581530,2317836,115228,288845,404073,299179,341100,346887,323200,362072,728180,2400618,4718454,5545475,5545475
Finland,2024,FI,FIN,EUR,121066,294651,415717,316356,358063,371466,336067,354543,591345,2327840,115469,281550,397019,302167,338022,349129,323156,359452,737384,2409310,4737150,5549886,5549886
Finland,2025,FI,FIN,EUR,121893,286323,408216,318602,354194,374273,338631,350889,601340,2337929,116045,273750,389795,305309,334548,351660,324831,354762,746943,2418053,4755982,5553985,5553985
Finland,2026,FI,FIN,EUR,122343,278565,400908,321096,349552,376953,342586,346187,611119,2347493,116422,266280,382702,308336,330736,354138,327582,349293,756328,2426413,4773906,5557511,5557511
Finland,2027,FI,FIN,EUR,122595,271517,394112,323384,344482,378623,348417,340504,620789,2356199,116648,259287,375935,310993,326858,355885,332318,342782,765381,2434217,4790416,5560463,5560463
Finland,2028,FI,FIN,EUR,122846,264904,387750,325091,340074,378718,356045,333919,630326,2364173,116875,252960,369835,312638,323582,356475,339149,334985,774289,2441118,4805291,5562880,5562880
Finland,2029,FI,FIN,EUR,123026,258958,381984,325535,337082,378227,362636,328343,639376,2371199,117037,247311,364348,312989,321372,356581,345042,328269,782821,2447074,4818273,5564606,5564606
Finland,2030,FI,FIN,EUR,123067,253953,377020,324766,334880,377977,366236,325641,647458,2376958,117067,242503,359570,312209,320013,356936,348070,324301,790399,2451928,4828886,5565475,5565475
Finland,1950,FI,FIN,EUR,255709,352723,608432,324154,269983,273264,207683,131667,99610,1306361,244838,339614,584452,317227,304124,305116,242618,173627,166337,1509049,2815410,4008289,4008289
Finland,1951,FI,FIN,EUR,253066,368952,622018,321658,273901,270003,212580,133818,100593,1312553,242536,354911,597447,313632,304987,303475,248162,176220,168997,1515473,2828026,4047489,4047489
Finland,1952,FI,FIN,EUR,246415,387361,633776,319766,278948,265639,219299,136129,102692,1322473,236137,372295,608432,311775,306309,300828,255273,178919,172998,1526102,2848575,4090778,4090778
Finland,1953,FI,FIN,EUR,239557,404769,644326,320179,285207,262035,225755,139201,104867,1337244,229428,389053,618481,311585,308232,298652,261734,182518,176999,1539720,2876964,4139773,4139773
Finland,1954,FI,FIN,EUR,232464,420054,652518,321499,293707,256355,231818,143400,106893,1353672,223013,403484,626497,312108,312884,293782,267508,187715,180673,1554670,2908342,4187364,4187364
Finland,1955,FI,FIN,EUR,227335,435791,663126,320416,300905,251995,237847,148025,108721,1367909,218441,418160,636601,310451,315844,290420,273681,193376,184002,1567774,2935683,4235413,4235413
Finland,1956,FI,FIN,EUR,224765,445771,670536,322826,304574,250961,242833,152786,110901,1384881,215841,427832,643673,312352,314033,291145,279116,198730,187827,1583203,2968084,4282280,4282280
Finland,1957,FI,FIN,EUR,222163,455442,677605,325510,307009,249492,247011,157725,113196,1399943,213302,437141,650443,314622,311339,290735,283990,204206,191698,1596590,2996533,4324579,4324579
Finland,1958,FI,FIN,EUR,217911,467698,685609,326399,306691,249579,250049,162946,115184,1410848,209256,448998,658254,315071,306567,290676,288312,210109,194822,1605557,3016405,4360274,4360274
Finland,1959,FI,FIN,EUR,214120,474707,688827,331979,304931,251497,251526,168629,117636,1426198,205372,456162,661534,320180,301113,291239,291044,216525,198577,1618678,3044876,4395235,4395235
Finland,1960,FI,FIN,EUR,210618,476339,686957,341762,303801,254948,251672,173738,120697,1446618,201846,457996,659842,329765,296785,292171,292140,222532,203362,1636755,3083373,4430173,4430173
Finland,1961,FI,FIN,EUR,206452,470947,677399,358072,302081,260332,249661,178818,123830,1472794,198334,452733,651067,345733,292728,294112,291170,228261,208268,1660272,3133066,4461529,4461529
Finland,1962,FI,FIN,EUR,203287,462213,665500,376923,300524,266085,246112,184778,126291,1500713,195807,444208,640015,363665,290185,295752,288788,234957,212589,1685936,3186649,4492172,4492172
Finland,1963,FI,FIN,EUR,202593,451573,654166,394089,300317,272006,242652,190211,129314,1528589,195226,433969,629195,380224,289199,297299,286644,241071,217921,1712358,3240947,4524297,4524297
Finland,1964,FI,FIN,EUR,202184,440666,642850,407637,299961,279606,237189,195342,133296,1553031,194737,423622,618359,392622,288123,301510,281858,246675,224524,1735312,3288343,4549553,4549553
Finland,1965,FI,FIN,EUR,200286,431245,631531,420527,296243,285661,232824,200359,136979,1572593,192829,414666,607495,403427,284402,303725,278369,252597,230449,1752969,3325562,4564583,4564583
Finland,1966,FI,FIN,EUR,197992,424108,622100,428418,297276,288691,231619,204369,140771,1591144,190402,408019,598421,410110,285703,301196,278958,257775,236376,1770118,3361262,4581787,4581787
Finland,1967,FI,FIN,EUR,195890,418171,614061,437444,300844,290950,230282,207654,144744,1611918,188142,402584,590726,418164,289405,298451,278652,262552,243185,1790409,3402327,4607108,4607108
Finland,1968,FI,FIN,EUR,192453,412944,605397,449060,302568,290650,230422,209951,148404,1631055,184863,397457,582320,428223,291423,294101,278854,266828,249583,1809012,3440067,4627785,4627785
Finland,1969,FI,FIN,EUR,185770,407888,593658,452120,305279,288547,232043,210851,152561,1641401,178501,391954,570455,429572,294610,289177,279409,269443,256676,1818887,3460288,4624397,4624397
Finland,2031,FI,FIN,EUR,123131,250239,373370,322349,334011,377616,367632,324695,654663,2380966,117118,238770,355888,309842,320241,357064,349197,321822,797139,2455305,4836271,5565535,5565535
Finland,2032,FI,FIN,EUR,123242,247959,371201,318038,334658,376812,368239,324126,661266,2383139,117213,236244,353457,305991,321539,356987,349298,320058,803205,2457078,4840217,5564876,5564876
Finland,2033,FI,FIN,EUR,123354,246992,370346,312309,336426,374292,369766,323925,666928,2383646,117312,235411,352723,300354,323779,355308,350423,318645,808278,2456787,4840433,5563499,5563499
Finland,2034,FI,FIN,EUR,123547,247384,370931,304896,338580,370774,372344,325032,670751,2382377,117497,235816,353313,293074,326772,352256,352698,318754,811275,2454829,4837206,5561441,5561441
Finland,2035,FI,FIN,EUR,123865,248256,372121,296591,340842,366989,375211,327764,672773,2380170,117798,236423,354221,285286,329916,348811,355254,320524,812350,2452141,4832311,5558658,5558658
Finland,2036,FI,FIN,EUR,124268,248773,373041,288858,343350,362440,377953,331803,673549,2377953,118179,236855,355034,277829,332947,345035,357763,323346,812267,2449187,4827140,5555219,5555219
Finland,2037,FI,FIN,EUR,124767,249137,373904,281835,345652,357461,379707,337623,673330,2375608,118651,237178,355829,270854,335604,341195,359548,328099,810661,2445961,4821569,5551302,5551302
Finland,2038,FI,FIN,EUR,125298,249498,374796,275251,347380,353137,379913,345141,672191,2373013,119151,237506,356657,264535,337260,337948,360191,334888,807546,2442368,4815381,5546832,5546832
Finland,2039,FI,FIN,EUR,125765,249873,375638,269329,347846,350218,379529,351657,671646,2370225,119586,237850,357436,258902,337623,335773,360347,340765,805061,2438471,4808696,5541771,5541771
Finland,2040,FI,FIN,EUR,126160,250238,376398,264352,347108,348083,379377,355316,673103,2367339,119962,238184,358146,254106,336853,334435,360750,343842,804344,2434330,4801669,5536212,5536212
Finland,2041,FI,FIN,EUR,126434,250709,377143,260661,344730,347263,379102,356859,675665,2364280,120222,238620,358842,250383,334499,334681,360917,345056,804366,2429902,4794182,5530170,5530170
Finland,2042,FI,FIN,EUR,126506,251319,377825,258394,340468,347948,378374,357634,678346,2361164,120294,239188,359482,247868,330673,335998,360873,345260,804653,2425325,4786489,5523795,5523795
Finland,2043,FI,FIN,EUR,126364,251962,378326,257438,334791,349743,375954,359295,680878,2358099,120163,239788,359951,247039,325060,338249,359243,346476,804624,2420691,4778790,5517065,5517065
Finland,2044,FI,FIN,EUR,126029,252625,378654,257838,327439,351919,372559,361966,683306,2355027,119845,240411,360256,247448,317803,341249,356251,348816,804452,2416019,4771046,5509954,5509954
Finland,2045,FI,FIN,EUR,125461,253340,378801,258714,319199,354210,368909,364923,686032,2351987,119305,241090,360395,248061,310043,344404,352873,351436,804522,2411339,4763326,5502517,5502517
Finland,2046,FI,FIN,EUR,124692,254017,378709,259238,311530,356740,364501,367760,689278,2349047,118571,241732,360303,248495,302611,347445,349166,354016,805029,2406762,4755809,5494829,5494829
Finland,2047,FI,FIN,EUR,123704,254589,378293,259608,304568,359061,359673,369655,693667,2346232,117627,242276,359903,248819,295657,350113,345398,355891,806519,2402397,4748629,5486833,5486833
Finland,2048,FI,FIN,EUR,122487,254979,377466,259976,298040,360811,355493,370072,699199,2343591,116468,242649,359117,249152,289365,351781,342218,356642,809082,2398240,4741831,5478418,5478418
Finland,2049,FI,FIN,EUR,121147,255113,376260,260357,292175,361307,352702,369911,704729,2341181,115195,242769,357964,249505,283752,352159,340110,356920,811945,2394391,4735572,5469791,5469791
Finland,2050,FI,FIN,EUR,119738,254942,374680,260726,287245,360605,350681,369954,709748,2338959,113856,242600,356456,249841,278973,351410,338833,357430,814339,2390826,4729785,5460917,5460917
Fiji,1970,FJ,FJI,WPR,43658,79416,123074,53262,35307,24266,16455,10114,6509,145913,41225,76566,117791,52975,35394,22668,15080,8914,5833,140864,286777,527634,527634
Fiji,1971,FJ,FJI,WPR,43471,80427,123898,55305,36103,24959,16670,10453,6575,150065,41034,77605,118639,54820,36311,23551,15388,9273,6052,145395,295460,538000,538000
Fiji,1972,FJ,FJI,WPR,43270,81055,124325,57417,36970,25644,16920,10761,6683,154395,40820,78291,119111,56698,37286,24457,15714,9641,6288,150084,304479,547918,547918
Fiji,1973,FJ,FJI,WPR,43014,81350,124364,59566,37893,26304,17205,11031,6799,158798,40548,78665,119213,58616,38280,25370,16071,10005,6516,154858,313656,557244,557244
Fiji,1974,FJ,FJI,WPR,42756,81442,124198,61664,38913,26965,17533,11270,6950,163295,40263,78854,119117,60550,39287,26292,16460,10360,6741,159690,322985,566296,566296
Fiji,1975,FJ,FJI,WPR,42785,81409,124194,63877,39822,27622,17915,11482,7141,167859,40257,78912,119169,62657,40116,27218,16897,10707,6986,164581,332440,575804,575804
Fiji,1976,FJ,FJI,WPR,43319,81398,124717,66185,40723,28317,18342,11676,7333,172576,40732,78920,119652,64893,40917,28173,17399,11046,7230,169658,342234,586607,586607
Fiji,1977,FJ,FJI,WPR,44458,81293,125751,68434,41901,29142,18908,11887,7560,177832,41804,78870,120674,67067,41972,29183,17983,11344,7485,175034,352866,599289,599289
Fiji,1978,FJ,FJI,WPR,46138,81052,127190,70657,43350,30047,19598,12111,7833,183596,43410,78702,122112,69200,43325,30163,18660,11608,7757,180713,364309,613611,613611
Fiji,1979,FJ,FJI,WPR,48105,80936,129041,72640,45089,30901,20340,12333,8114,189417,45274,78573,123847,71132,44995,31052,19436,11867,8071,186553,375970,628859,628859
Fiji,1980,FJ,FJI,WPR,50038,81178,131216,74268,47039,31742,21125,12571,8411,195156,47108,78785,125893,72745,46842,31929,20298,12100,8400,192314,387470,644582,644582
Fiji,1981,FJ,FJI,WPR,51746,81937,133683,75586,49116,32644,21931,12823,8684,200784,48723,79475,128198,74068,48749,32898,21210,12319,8714,197958,398742,660630,660630
Fiji,1982,FJ,FJI,WPR,53250,83182,136432,76558,51316,33609,22741,13119,8943,206286,50144,80618,130762,75056,50739,33937,22161,12565,9025,203483,409769,676967,676967
Fiji,1983,FJ,FJI,WPR,54552,84856,139408,77215,53623,34636,23565,13461,9198,211698,51371,82159,133530,75747,52835,35011,23146,12865,9348,208952,420650,693593,693593
Fiji,1984,FJ,FJI,WPR,55657,86867,142524,77695,55949,35755,24413,13864,9468,217144,52400,84011,136411,76277,55002,36113,24161,13233,9698,214484,431628,710561,710561
Fiji,1985,FJ,FJI,WPR,56528,89133,145661,77994,58366,36774,25293,14331,9783,222541,53209,86181,139390,76614,57300,37037,25196,13646,10076,219869,442410,727461,727461
Fiji,1986,FJ,FJI,WPR,57002,91372,148374,78000,60465,37735,26243,14854,10271,227568,53675,88679,142354,76567,59264,37797,26222,14006,10508,224364,451932,742658,742658
Fiji,1987,FJ,FJI,WPR,57136,93554,150690,77620,62180,38766,27005,15282,10579,231432,53766,90969,144735,76104,60853,38646,27109,14372,10828,227912,459344,754778,754778
Fiji,1988,FJ,FJI,WPR,57060,95760,152820,76954,63757,39828,27475,15600,10579,234193,53596,92839,146435,75356,62306,39641,27787,14829,11009,230928,465121,764370,764370
Fiji,1989,FJ,FJI,WPR,56796,97871,154667,76242,64947,41048,27873,15927,10567,236604,53291,94600,147891,74543,63381,40809,28326,15327,11157,233543,470147,772704,772704
Fiji,1990,FJ,FJI,WPR,56494,99649,156143,75824,65770,42426,28262,16263,10569,239114,52975,96023,148998,74003,64088,42093,28829,15882,11282,236177,475291,780430,780430
Fiji,1991,FJ,FJI,WPR,56074,100530,156604,75581,65985,43768,28612,16516,10547,241009,52583,96601,149184,73570,64160,43238,29310,16388,11371,238037,479046,784832,784832
Fiji,1992,FJ,FJI,WPR,55463,100784,156247,75604,65667,45096,28965,16702,10516,242550,52021,96610,148631,73354,63679,44302,29792,16852,11449,239428,481978,786859,786859
Fiji,1993,FJ,FJI,WPR,54740,100821,155561,76101,65138,46483,29418,16921,10528,244589,51351,96428,147779,73609,62986,45412,30347,17354,11558,241266,485855,789198,789198
Fiji,1994,FJ,FJI,WPR,53896,100464,154360,76879,64430,47817,29957,17138,10552,246773,50566,95904,146470,74128,62113,46502,30909,17856,11691,243199,489972,790803,790803
Fiji,1995,FJ,FJI,WPR,52998,99857,152855,77957,63632,49238,30395,17353,10602,249177,49728,95178,144906,74931,61132,47728,31307,18358,11853,245309,494486,792246,792246
Fiji,1996,FJ,FJI,WPR,52282,99407,151689,79527,63122,50754,30869,17660,10715,252647,49054,94599,143653,76283,60439,49088,31709,18954,12077,248550,501197,796538,796538
Fiji,1997,FJ,FJI,WPR,51804,99117,150921,81546,62930,52202,31771,18188,11013,257650,48592,94144,142736,78183,60110,50424,32399,19676,12480,253272,510922,804572,804572
Fiji,1998,FJ,FJI,WPR,51412,98748,150160,83736,62793,53553,32973,18837,11466,263358,48205,93602,141807,80317,59857,51699,33323,20406,13011,258613,521971,813947,813947
Fiji,1999,FJ,FJI,WPR,51103,98302,149405,85908,62787,54679,34320,19474,11940,269108,47900,92991,140891,82435,59707,52783,34452,21057,13580,264014,533122,823422,823422
Fiji,2000,FJ,FJI,WPR,50850,97825,148675,87708,63115,55520,35770,20106,12412,274631,47646,92369,140015,84178,59872,53600,35675,21681,14182,269188,543819,832509,832509
Fiji,2001,FJ,FJI,WPR,50652,97470,148122,88911,63875,56145,37236,20796,12879,279842,47447,91885,139332,85317,60458,54215,36879,22358,14787,274014,553856,841320,841320
Fiji,2002,FJ,FJI,WPR,50631,97065,147696,89698,65020,56531,38707,21530,13333,284819,47416,91374,138790,86027,61428,54586,38087,23063,15398,278589,563408,849891,849891
Fiji,2003,FJ,FJI,WPR,50825,96490,147315,90199,66456,56734,40189,22313,13799,289690,47587,90724,138311,86421,62699,54759,39308,23774,16034,282995,572685,858306,858306
Fiji,2004,FJ,FJI,WPR,51124,95879,147003,90376,68094,56889,41635,23171,14332,294497,47861,90059,137920,86467,64187,54870,40545,24482,16724,287275,581772,866694,866694
Fiji,2005,FJ,FJI,WPR,51401,95267,146668,90346,69908,57023,43164,23926,14889,299256,48123,89409,137532,86277,65879,54938,41920,25015,17450,291479,590735,874923,874923
Fiji,2006,FJ,FJI,WPR,51710,94643,146353,90181,71840,57185,44680,24595,15477,303958,48423,88772,137195,85926,67709,55000,43312,25426,18198,295571,599529,883083,883083
Fiji,2007,FJ,FJI,WPR,52004,94052,146056,89806,73820,57190,46036,25440,16112,308404,48705,88180,136885,85359,69603,54873,44530,25986,18959,299310,607714,890648,890648
Fiji,2008,FJ,FJI,WPR,52246,93442,145688,89174,75619,56843,47189,26315,16586,311726,49016,87702,136718,84728,71439,54426,45643,26736,19619,302591,614317,896731,896731
Fiji,2009,FJ,FJI,WPR,52413,92823,145236,88308,77119,56386,48043,27184,16881,313921,49319,87381,136700,84085,73109,53922,46559,27653,20195,305523,619444,901383,901383
Fiji,2010,FJ,FJI,WPR,52400,92235,144635,87356,78259,56181,48642,28162,17209,315809,49417,87134,136551,83374,74429,53683,47207,28672,20813,308178,623987,905169,905169
Fiji,2011,FJ,FJI,WPR,52083,91802,143885,86487,78847,56354,49054,29184,17595,317521,49190,87072,136262,82753,75206,53839,47647,29707,21533,310685,628206,908355,908355
Fiji,2012,FJ,FJI,WPR,51486,91657,143143,85535,79073,56850,49250,30243,18037,318988,48658,87307,135965,82051,75622,54360,47836,30761,22325,312955,631943,911059,911059
Fiji,2013,FJ,FJI,WPR,50849,91731,142580,84376,79071,57589,49270,31333,18494,320133,48060,87751,135811,81154,75812,55174,47816,31840,23130,314926,635059,913453,913453
Fiji,2014,FJ,FJI,WPR,50280,91843,142123,83144,78803,58497,49212,32385,18970,321011,47518,88208,135726,80188,75737,56203,47701,32927,23942,316698,637709,915560,915560
Fiji,2015,FJ,FJI,WPR,49804,91841,141645,81871,78374,59558,49077,33466,19303,321649,47060,88546,135606,79191,75491,57436,47512,34099,24578,318307,639956,917200,917200
Fiji,2016,FJ,FJI,WPR,49393,91654,141047,80576,77846,60748,48928,34516,19565,322179,46654,88669,135323,78193,75147,58809,47289,35256,25124,319818,641997,918371,918371
Fiji,2017,FJ,FJI,WPR,48899,91263,140162,79373,77171,62053,48644,35483,20040,322764,46181,88564,134745,77307,74677,60308,46895,36307,25852,321346,644110,919019,919019
Fiji,2018,FJ,FJI,WPR,48236,90743,138979,78353,76309,63428,48174,36375,20659,323298,45558,88312,133870,76621,74043,61889,46299,37261,26734,322847,646145,918996,918996
Fiji,2019,FJ,FJI,WPR,47457,90160,137617,77514,75296,64750,47743,37085,21363,323751,44836,87948,132784,76137,73276,63424,45752,38015,27708,324312,648063,918465,918465
Fiji,2020,FJ,FJI,WPR,46721,89980,136701,77087,74576,65972,47673,37674,22192,325174,44118,87823,131941,76016,72747,64837,45608,38606,28795,326609,651783,920422,920422
Fiji,2021,FJ,FJI,WPR,46075,90033,136108,77172,74290,66889,48053,38152,23021,327577,43450,87769,131219,76337,72584,65920,45965,39041,29859,329706,657283,924610,924610
Fiji,2022,FJ,FJI,WPR,45552,90040,135592,77769,74123,67574,48737,38451,23899,330553,42876,87531,130407,77078,72494,66730,46724,39260,30939,333225,663778,929766,929766
Fiji,2023,FJ,FJI,WPR,45161,90128,135289,78806,73947,68196,49666,38647,24944,334206,42409,87239,129648,78150,72362,67406,47839,39352,32130,337239,671445,936375,936375
Fiji,2024,FJ,FJI,WPR,44790,90145,134935,79964,73708,68657,50785,38806,26017,337937,42005,86869,128874,79292,72198,67876,49199,39407,33352,341324,679261,943072,943072
Fiji,2025,FJ,FJI,WPR,44486,90135,134621,81115,73432,69070,52098,38929,27081,341725,41699,86480,128179,80388,72033,68242,50789,39444,34559,345455,687180,949992,949992
Fiji,2026,FJ,FJI,WPR,44272,90110,134382,82198,73151,69494,53577,39053,28092,345565,41493,86091,127584,81368,71896,68577,52560,39511,35725,349637,695202,957162,957162
Fiji,2027,FJ,FJI,WPR,44091,90032,134123,83221,73002,69876,55207,39056,29125,349487,41334,85681,127015,82247,71896,68855,54488,39464,36921,353871,703358,964494,964494
Fiji,2028,FJ,FJI,WPR,43948,89797,133745,84248,73067,70154,56949,38914,30190,353522,41219,85159,126378,83078,72106,69042,56527,39274,38162,358189,711711,971841,971841
Fiji,2029,FJ,FJI,WPR,43857,89380,133237,85286,73330,70320,58696,38815,31182,357629,41149,84509,125658,83871,72506,69137,58542,39154,39336,362546,720175,979073,979073
Fiji,2030,FJ,FJI,WPR,43792,88845,132637,86313,73710,70466,60214,38956,32093,361752,41102,83795,124897,84599,73015,69241,60288,39316,40427,366886,728638,986172,986172
Fiji,1950,FJ,FJI,WPR,28409,41214,69623,28802,20269,14159,9692,9285,11731,93938,27178,39846,67024,27181,18646,11690,7627,5851,6724,77719,171657,308308,308308
Fiji,1951,FJ,FJI,WPR,29042,42277,71319,29674,20606,14692,9664,8829,10406,93871,27721,41062,68783,28165,19015,12179,7747,5733,6027,78866,172737,312840,312840
Fiji,1952,FJ,FJI,WPR,29887,43482,73369,30560,21002,15212,9708,8446,9330,94258,28413,42404,70817,29209,19415,12681,7897,5656,5461,80319,174577,318772,318772
Fiji,1953,FJ,FJI,WPR,30915,44815,75730,31461,21474,15707,9824,8126,8452,95044,29274,43828,73102,30304,19874,13201,8075,5622,5011,82087,177131,325965,325965
Fiji,1954,FJ,FJI,WPR,32036,46308,78344,32394,22016,16170,10014,7864,7734,96192,30280,45309,75589,31440,20390,13731,8285,5625,4664,84135,180327,334262,334262
Fiji,1955,FJ,FJI,WPR,33491,47732,81223,33354,22630,16606,10289,7660,7193,97732,31652,46642,78294,32618,20968,14259,8535,5665,4398,86443,184175,343693,343693
Fiji,1956,FJ,FJI,WPR,35197,49117,84314,34351,23309,17027,10640,7506,6816,99649,33266,47901,81167,33830,21615,14773,8828,5725,4208,88979,188628,354110,354110
Fiji,1957,FJ,FJI,WPR,36779,50772,87551,35371,24039,17425,11064,7387,6579,101865,34762,49417,84179,35050,22317,15267,9161,5801,4097,91693,193558,365288,365288
Fiji,1958,FJ,FJI,WPR,38220,52658,90878,36388,24821,17794,11536,7339,6455,104333,36119,51219,87338,36212,23080,15738,9537,5913,4044,94524,198857,377075,377075
Fiji,1959,FJ,FJI,WPR,39517,54758,94275,37394,25665,18144,12047,7355,6382,106987,37337,53264,90601,37301,23933,16178,9956,6056,4034,97458,204445,389315,389315
Fiji,1960,FJ,FJI,WPR,40595,57061,97656,38423,26542,18496,12586,7408,6328,109783,38350,55469,93819,38415,24877,16591,10419,6214,4059,100575,210358,401841,401841
Fiji,1961,FJ,FJI,WPR,41429,59464,100893,39570,27448,18879,13128,7487,6281,112793,39136,57699,96835,39676,25894,17008,10920,6387,4127,104012,216805,414534,414534
Fiji,1962,FJ,FJI,WPR,42178,61958,104136,40841,28370,19310,13643,7613,6251,116028,39834,59956,99790,41055,26975,17459,11439,6586,4228,107742,223770,427695,427695
Fiji,1963,FJ,FJI,WPR,42886,64532,107418,42228,29306,19812,14131,7795,6224,119496,40495,62256,102751,42518,28113,17963,11961,6805,4352,111712,231208,441385,441385
Fiji,1964,FJ,FJI,WPR,43434,67074,110508,43749,30274,20371,14591,8026,6210,123221,41011,64572,105583,44032,29299,18519,12492,7051,4504,115897,239118,455214,455214
Fiji,1965,FJ,FJI,WPR,43852,69682,113534,45162,31244,20991,15022,8320,6249,126988,41406,67029,108435,45383,30505,19121,13020,7327,4694,120050,247038,469010,469010
Fiji,1966,FJ,FJI,WPR,44174,72073,116247,46448,32168,21647,15449,8683,6447,130842,41714,69403,111117,46604,31654,19731,13558,7649,4958,124154,254996,482358,482358
Fiji,1967,FJ,FJI,WPR,44226,74225,118451,47889,33030,22286,15795,9057,6551,134608,41775,71535,113310,47953,32734,20372,14031,7968,5201,128259,262867,494632,494632
Fiji,1968,FJ,FJI,WPR,44032,76322,120354,49499,33841,22917,16040,9410,6495,138202,41591,73529,115120,49449,33715,21065,14413,8259,5401,132302,270504,505979,505979
Fiji,1969,FJ,FJI,WPR,43835,78064,121899,51289,34580,23579,16251,9761,6487,141947,41400,75217,116617,51142,34566,21831,14764,8571,5613,136487,278434,516952,516952
Fiji,2031,FJ,FJI,WPR,43755,88275,132030,87133,74292,70721,61301,39422,32930,365799,41083,83094,124177,85081,73713,69473,61560,39855,41443,371125,736924,993129,993129
Fiji,2032,FJ,FJI,WPR,43744,87748,131492,87618,75211,70901,62136,40166,33675,369707,41082,82480,123562,85199,74711,69664,62531,40732,42354,375191,744898,999949,999949
Fiji,2033,FJ,FJI,WPR,43727,87312,131039,87870,76385,70873,62847,41112,34348,373435,41074,81991,123065,85077,75926,69687,63316,41886,43191,379083,752518,1006621,1006621
Fiji,2034,FJ,FJI,WPR,43701,86922,130623,88018,77651,70760,63398,42212,35000,377039,41056,81589,122645,84847,77187,69648,63888,43250,44002,382822,759861,1013135,1013135
Fiji,2035,FJ,FJI,WPR,43688,86612,130300,88103,78879,70580,63882,43453,35606,380503,41049,81291,122340,84555,78363,69582,64344,44798,44765,386407,766910,1019549,1019549
Fiji,2036,FJ,FJI,WPR,43686,86387,130073,88131,80001,70362,64354,44808,36146,383802,41051,81098,122149,84224,79392,69508,64736,46486,45464,389810,773612,1025842,1025842
Fiji,2037,FJ,FJI,WPR,43680,86211,129891,88077,81036,70244,64763,46262,36597,386979,41050,80958,122008,83840,80290,69544,65059,48289,46096,393118,780097,1031992,1031992
Fiji,2038,FJ,FJI,WPR,43679,86062,129741,87847,82058,70324,65063,47786,36972,390050,41056,80842,121898,83331,81133,69776,65282,50168,46630,396320,786370,1038011,1038011
Fiji,2039,FJ,FJI,WPR,43669,85946,129615,87432,83093,70601,65256,49298,37325,393005,41052,80757,121809,82691,81929,70192,65415,52020,47175,399422,792427,1043850,1043850
Fiji,2040,FJ,FJI,WPR,43599,85871,129470,86905,84117,70990,65428,50608,37815,395863,40993,80712,121705,81989,82666,70716,65560,53625,47884,402440,798303,1049476,1049476
Fiji,2041,FJ,FJI,WPR,43480,85836,129316,86342,84934,71583,65700,51550,38516,398625,40884,80699,121583,81297,83158,71427,65822,54809,48867,405380,804005,1054902,1054902
Fiji,2042,FJ,FJI,WPR,43317,85823,129140,85823,85418,72499,65893,52289,39375,401297,40736,80705,121441,80693,83288,72435,66041,55723,50054,408234,809531,1060105,1060105
Fiji,2043,FJ,FJI,WPR,43095,85811,128906,85388,85678,73665,65889,52931,40332,403883,40531,80710,121241,80211,83177,73656,66095,56482,51407,411028,814911,1065062,1065062
Fiji,2044,FJ,FJI,WPR,42851,85775,128626,85005,85831,74928,65807,53449,41400,406420,40302,80691,120993,79818,82959,74920,66099,57054,52920,413770,820190,1069814,1069814
Fiji,2045,FJ,FJI,WPR,42611,85700,128311,84697,85923,76142,65662,53920,42554,408898,40077,80632,120709,79527,82686,76101,66068,57527,54555,416464,825362,1074382,1074382
Fiji,2046,FJ,FJI,WPR,42362,85583,127945,84481,85955,77257,65493,54389,43750,411325,39846,80534,120380,79341,82367,77134,66037,57956,56264,419099,830424,1078746,1078746
Fiji,2047,FJ,FJI,WPR,42111,85413,127524,84308,85905,78284,65422,54809,44955,413683,39609,80387,119996,79207,81995,78039,66117,58321,58002,421681,835364,1082892,1082892
Fiji,2048,FJ,FJI,WPR,41879,85197,127076,84159,85687,79303,65543,55133,46160,415985,39392,80194,119586,79098,81500,78889,66385,58601,59739,424212,840197,1086848,1086848
Fiji,2049,FJ,FJI,WPR,41650,84947,126597,84050,85283,80326,65849,55361,47339,418208,39177,79966,119143,79021,80873,79692,66830,58793,61462,426671,844879,1090614,1090614
Fiji,2050,FJ,FJI,WPR,41411,84642,126053,83981,84767,81346,66263,55568,48464,420389,38950,79689,118639,78978,80184,80436,67381,58991,63120,429090,849479,1094174,1094174
France,1970,FR,FRA,EUR,2096110,4232313,6328423,4235833,3110523,3396562,2579072,2511873,2497267,18331130,2005700,4069100,6074800,4084897,2908617,3283242,2656163,2823323,4032991,19789233,38120363,50523586,50523586
France,1971,FR,FRA,EUR,2106357,4253986,6360343,4289223,3176609,3379452,2728543,2400321,2554872,18529020,2013803,4084906,6098709,4144650,2968537,3259113,2805241,2705710,4099382,19982633,38511653,50970698,50970698
France,1972,FR,FRA,EUR,2128970,4266910,6395880,4282425,3303694,3357985,2889325,2276206,2607968,18717603,2033642,4092034,6125676,4147490,3089353,3232674,2966033,2572534,4163126,20171210,38888813,51410363,51410363
France,1973,FR,FRA,EUR,2147921,4272930,6420851,4262616,3444916,3329694,3034715,2166710,2658965,18897616,2049698,4092563,6142261,4138033,3225239,3202373,3110281,2451451,4225966,20353343,39250959,51814075,51814075
France,1974,FR,FRA,EUR,2145253,4277330,6422583,4243133,3587337,3297583,3157080,2077903,2709009,19072045,2045368,4092189,6137557,4126493,3365022,3170583,3231506,2349519,4288237,20531360,39603405,52163552,52163552
France,1975,FR,FRA,EUR,2110487,4285527,6396014,4227398,3736146,3247913,3211297,2061035,2755996,19239785,2011965,4095399,6107364,4116300,3515429,3121566,3280588,2324435,4348540,20706858,39946643,52450030,52450030
France,1976,FR,FRA,EUR,2044114,4303188,6347302,4220047,3893824,3175665,3208369,2108974,2794457,19401336,1948992,4107757,6056749,4113257,3678599,3049730,3268381,2370188,4399722,20879877,40281213,52685266,52685266
France,1977,FR,FRA,EUR,1969603,4327737,6297340,4219410,4037993,3113540,3208000,2149527,2836033,19564503,1877927,4126659,6004586,4116236,3831839,2987106,3259111,2408597,4456132,21059021,40623524,52925442,52925442
France,1978,FR,FRA,EUR,1907376,4340064,6247440,4228484,4150937,3084664,3206233,2178031,2882356,19730705,1818686,4133384,5952070,4128390,3957641,2956082,3249159,2433680,4520133,21245085,40975790,53175309,53175309
France,1979,FR,FRA,EUR,1868463,4325481,6193944,4248776,4246536,3074613,3200202,2209129,2921874,19901130,1781508,4115425,5896933,4150330,4068140,2944837,3234877,2459576,4579007,21436767,41337897,53428781,53428781
France,1980,FR,FRA,EUR,1870215,4286507,6156722,4267451,4337271,3074091,3186966,2283078,2921904,20070761,1782767,4077131,5859898,4166844,4177222,2943140,3215128,2534528,4589600,21626462,41697223,53713830,53713830
France,1981,FR,FRA,EUR,1903123,4231096,6134219,4282968,4374640,3133246,3164129,2411805,2868479,20235267,1813508,4024636,5838144,4178100,4237472,2999451,3187435,2675827,4530833,21809118,42044385,54016749,54016749
France,1982,FR,FRA,EUR,1934976,4181322,6116298,4291490,4352201,3255856,3140168,2549687,2805157,20394559,1843338,3977836,5821174,4182692,4241119,3118319,3159403,2828285,4457791,21987609,42382168,54319646,54319646
France,1983,FR,FRA,EUR,1947967,4141677,6089644,4294423,4316352,3394881,3112086,2674182,2754533,20546457,1855867,3940797,5796664,4182368,4232091,3253660,3128830,2965773,4396889,22159611,42706068,54592379,54592379
France,1984,FR,FRA,EUR,1947782,4103733,6051515,4297172,4281020,3536398,3082633,2778957,2722778,20698958,1856469,3905252,5761721,4182791,4220685,3393830,3097744,3082492,4356252,22333794,43032752,54845980,54845980
France,1985,FR,FRA,EUR,1937257,4072793,6010050,4304683,4250238,3684544,3039232,2826980,2752147,20857824,1847045,3877252,5724297,4187688,4210306,3545486,3050830,3132542,4389086,22515938,43373762,55108106,55108106
France,1986,FR,FRA,EUR,1919792,4040370,5960162,4322499,4228033,3840600,2976428,2828326,2830088,21025974,1831064,3847908,5678972,4202074,4206225,3710201,2981853,3125826,4480351,22706530,43732504,55371639,55371639
France,1987,FR,FRA,EUR,1903274,3997421,5900695,4347844,4212107,3982631,2924636,2833324,2905279,21205821,1816699,3808429,5625128,4222894,4206712,3865311,2922123,3121920,4570936,22909896,44115717,55641541,55641541
France,1988,FR,FRA,EUR,1898597,3946655,5845252,4360285,4205622,4094491,2905260,2837765,2977894,21381317,1813398,3762221,5575619,4230166,4215012,3993609,2893682,3116958,4659865,23109292,44490609,55911478,55911478
France,1989,FR,FRA,EUR,1902169,3904155,5806324,4344575,4210564,4189116,2903330,2838924,3048805,21535314,1817361,3723995,5541356,4211314,4231713,4105973,2884995,3107449,4745505,23286949,44822263,56169948,56169948
France,1990,FR,FRA,EUR,1899851,3889152,5789003,4302930,4213960,4278310,2909668,2834601,3121023,21660492,1815107,3711053,5526160,4170650,4241536,4216127,2885599,3092198,4831140,23437250,45097742,56412897,56412897
France,1991,FR,FRA,EUR,1891596,3897336,5788932,4242538,4214123,4314644,2973048,2822372,3196636,21763361,1806511,3719188,5525699,4113690,4244766,4277032,2943176,3068672,4919891,23567227,45330588,56645215,56645215
France,1992,FR,FRA,EUR,1878540,3905531,5784071,4186124,4207135,4292927,3097358,2809180,3271346,21864070,1792804,3727385,5520189,4060750,4240160,4281079,3062625,3043957,5007146,23695717,45559787,56864048,56864048
France,1993,FR,FRA,EUR,1856323,3906831,5763154,4139001,4195430,4258746,3236707,2792301,3344361,21966546,1770580,3729061,5499641,4016639,4229965,4272581,3197829,3016415,5090965,23824394,45790940,57053732,57053732
France,1994,FR,FRA,EUR,1827788,3904132,5731920,4092558,4184855,4225752,3377057,2774469,3417552,22072243,1742645,3726967,5469612,3973174,4220217,4261985,3337196,2988398,5175316,23956286,46028529,57230065,57230065
France,1995,FR,FRA,EUR,1806014,3887610,5693624,4053258,4179161,4198091,3522380,2745016,3494280,22192186,1721678,3711060,5432738,3937143,4214346,4252257,3487915,2945318,5264828,24101807,46293993,57420354,57420354
France,1996,FR,FRA,EUR,1792038,3861210,5653248,4014828,4185077,4179048,3674497,2698078,3570397,22321925,1708338,3685348,5393686,3901461,4218389,4247913,3651940,2881335,5353283,24254321,46576246,57623178,57623178
France,1997,FR,FRA,EUR,1783481,3834193,5617674,3968978,4200997,4167211,3813465,2660591,3643570,22454812,1699524,3659244,5358768,3858072,4230858,4247784,3807181,2826950,5437272,24408117,46862929,57839363,57839363
France,1998,FR,FRA,EUR,1790140,3813061,5603201,3919056,4206055,4166641,3924848,2652755,3710313,22579668,1705397,3638299,5343696,3810928,4232231,4256633,3937149,2803512,5513323,24553776,47133444,58080344,58080344
France,1999,FR,FRA,EUR,1812330,3796343,5608673,3880547,4187097,4179831,4020750,2660982,3771375,22700582,1725851,3621137,5346988,3775462,4210439,4276504,4052218,2799755,5581584,24695962,47396544,58352208,58352208
France,2000,FR,FRA,EUR,1838791,3783062,5621853,3871574,4149049,4194372,4112649,2676653,3830254,22834551,1750113,3607433,5357546,3768928,4171366,4292535,4165912,2805541,5647216,24851498,47686049,58665453,58665453
France,2001,FR,FRA,EUR,1863380,3773660,5637040,3888095,4098630,4208437,4155659,2745714,3886766,22983301,1774058,3597439,5371497,3786767,4121441,4304561,4232100,2867797,5710270,25022936,48006237,59014772,59014772
France,2002,FR,FRA,EUR,1883520,3765159,5648679,3907414,4056455,4216886,4144801,2872043,3942012,23139611,1795162,3587787,5382949,3807425,4080022,4310822,4242975,2991473,5768834,25201551,48341162,59372786,59372786
France,2003,FR,FRA,EUR,1897185,3761564,5658749,3923323,4026174,4221588,4122771,3011651,3992033,23297540,1809875,3583550,5393425,3824345,4050416,4312944,4242151,3130600,5818082,25378538,48676078,59728262,59728262
France,2004,FR,FRA,EUR,1904724,3765285,5670009,3938115,3997544,4228247,4102969,3151962,4046113,23464950,1818244,3586330,5404574,3839409,4023790,4316041,4239763,3273891,5876011,25568905,49033855,60108438,60108438
France,2005,FR,FRA,EUR,1906339,3777417,5683756,3940461,3975166,4240144,4088878,3296495,4097190,23638334,1820877,3597629,5418506,3840770,4006107,4323178,4238277,3428293,5932857,25769482,49407816,60510079,60510079
France,2006,FR,FRA,EUR,1909320,3793370,5702690,3932535,3950747,4263567,4082428,3445934,4135206,23810417,1824519,3613980,5438499,3830683,3988668,4340458,4241620,3594740,5971377,25967546,49777963,60919150,60919150
France,2007,FR,FRA,EUR,1918250,3808679,5726929,3920910,3915351,4296037,4081995,3582129,4180949,23977371,1833657,3629748,5463405,3816835,3961498,4366321,4248171,3752130,6016709,26161664,50139035,61329376,61329376
France,2008,FR,FRA,EUR,1930270,3830862,5761132,3909113,3872565,4316173,4091645,3691968,4244321,24125785,1845885,3651898,5497783,3802510,3927830,4380741,4262607,3884061,6078552,26336301,50462086,61721009,61721009
France,2009,FR,FRA,EUR,1943894,3862099,5805993,3893222,3836296,4310878,4113742,3786081,4315024,24255243,1859758,3681558,5541316,3784163,3902886,4370518,4286997,3999191,6146985,26490740,50745983,62093296,62093296
France,2010,FR,FRA,EUR,1957096,3890852,5847948,3872472,3823145,4284205,4135701,3874277,4387744,24377544,1873423,3707863,5581286,3761337,3902540,4340986,4305838,4110319,6216767,26637787,51015331,62444567,62444567
France,2011,FR,FRA,EUR,1963675,3917752,5881427,3849706,3830047,4241755,4155006,3916197,4505279,24497990,1880656,3733181,5613837,3735969,3921776,4298360,4318231,4173114,6334571,26782021,51280011,62775268,62775268
France,2012,FR,FRA,EUR,1964205,3945812,5910017,3823520,3835835,4204254,4166505,3907392,4670464,24607970,1881460,3760627,5642087,3706036,3939608,4262004,4323115,4180075,6500505,26911343,51519313,63071416,63071416
France,2013,FR,FRA,EUR,1961122,3969898,5931020,3799492,3834640,4176178,4172453,3887357,4841098,24711218,1878268,3784638,5662906,3678063,3949347,4235928,4322607,4174029,6670060,27030034,51741252,63335180,63335180
France,2014,FR,FRA,EUR,1951667,3988777,5940444,3783083,3828702,4146980,4178944,3869676,5013121,24820506,1869725,3804012,5673737,3656224,3952627,4212205,4321936,4165680,6845137,27153809,51974315,63588491,63588491
France,2015,FR,FRA,EUR,1933823,4000397,5934220,3777479,3807155,4121392,4189367,3856993,5178035,24930421,1853324,3817497,5670821,3644240,3937822,4197217,4324342,4157829,7012858,27274308,52204729,63809769,63809769
France,2016,FR,FRA,EUR,1907215,4005621,5912836,3779638,3772670,4092726,4210243,3851031,5329631,25035939,1827701,3825216,5652917,3640885,3907194,4182769,4336703,4154413,7165668,27387632,52423571,63989319,63989319
France,2017,FR,FRA,EUR,1876517,4010948,5887465,3785133,3733384,4052637,4239716,3850773,5472569,25134212,1798510,3831849,5630359,3640830,3870212,4158720,4358185,4153786,7310308,27492041,52626253,64144086,64144086
France,2018,FR,FRA,EUR,1843067,4016636,5859703,3800115,3695586,4004657,4256932,3860452,5607244,25224986,1766728,3837784,5604512,3650427,3832524,4127490,4368788,4161654,7447726,27588609,52813595,64277808,64277808
France,2019,FR,FRA,EUR,1808338,4018049,5826387,3826226,3658477,3962675,4249935,3882896,5734655,25314864,1733094,3840369,5573463,3670878,3793154,4103640,4355859,4180672,7580847,27685050,52999914,64399759,64399759
France,2020,FR,FRA,EUR,1772380,4011272,5783652,3851333,3623237,3942673,4223265,3907073,5844942,25392523,1698602,3835385,5533987,3690547,3752982,4103286,4324829,4196226,7702024,27769894,53162417,64480053,64480053
France,2021,FR,FRA,EUR,1740068,3988935,5729003,3876890,3592155,3941872,4181972,3929977,5943355,25466221,1667842,3814443,5482285,3712347,3713178,4122160,4282297,4207095,7816842,27853919,53320140,64531444,64531444
France,2022,FR,FRA,EUR,1715727,3964419,5680146,3889937,3564258,3946541,4146785,3946621,6056703,25550845,1644559,3790429,5434988,3730851,3683569,4146398,4246548,4212885,7940398,27960649,53511494,64626628,64626628
France,2023,FR,FRA,EUR,1696968,3942833,5639801,3885131,3542082,3951787,4122261,3958274,6179677,25639212,1627497,3767997,5395494,3738711,3669843,4169814,4221409,4215548,8066747,28082072,53721284,64756584,64756584
France,2024,FR,FRA,EUR,1680795,3913788,5594583,3880496,3524704,3954645,4096661,3970307,6302337,25729150,1613103,3738943,5352046,3744612,3660984,4187868,4200180,4218708,8193709,28206061,53935211,64881830,64881830
France,2025,FR,FRA,EUR,1673398,3872386,5545784,3875152,3512515,3944962,4075246,3986665,6425347,25819887,1605815,3699521,5305336,3748290,3659428,4189707,4188229,4225443,8321280,28332377,54152264,65003384,65003384
France,2026,FR,FRA,EUR,1674860,3821775,5496635,3869552,3501033,3925738,4052007,4012597,6547129,25908056,1606350,3651739,5258089,3749563,3663480,4177869,4177363,4241997,8448202,28458474,54366530,65121251,65121251
France,2027,FR,FRA,EUR,1675175,3773656,5448831,3871757,3485323,3903993,4017871,4046235,6665858,25991037,1605810,3606988,5212798,3754411,3664530,4161607,4158104,4267318,8573975,28579945,54570982,65232615,65232615
France,2028,FR,FRA,EUR,1673560,3730292,5403852,3879724,3472727,3884392,3977216,4067849,6786230,26068138,1603668,3566454,5170122,3762210,3669469,4147257,4132587,4281816,8704727,28698066,54766204,65340179,65340179
France,2029,FR,FRA,EUR,1673198,3688870,5362068,3887351,3466215,3865420,3943990,4065826,6910627,26139429,1602811,3526424,5129235,3769727,3681056,4133670,4115431,4272680,8841715,28814279,54953708,65445007,65445007
France,2030,FR,FRA,EUR,1672688,3651313,5324001,3892155,3454977,3847018,3933241,4044582,7031166,26203139,1601872,3490136,5092008,3773414,3687259,4120162,4123338,4245162,8974958,28924293,55127432,65543452,65543452
France,1950,FR,FRA,EUR,2017140,2801220,4818360,3233418,2633803,2980255,2770997,1783704,1889694,15291871,1942991,2737716,4680707,3124360,2622230,3001781,2952442,2473031,2877568,17051412,32343283,41842355,41842355
France,1951,FR,FRA,EUR,2075441,2864083,4939524,3202438,2785778,2839654,2835684,1799751,1898655,15361960,1999244,2790001,4789245,3091195,2766398,2866123,2968010,2491835,2922376,17105937,32467897,42196657,42196657
France,1952,FR,FRA,EUR,2070064,2988274,5058338,3170880,2951621,2687949,2876111,1837043,1906841,15430445,1993853,2902563,4896416,3058203,2922065,2717927,2975723,2516863,2966421,17157202,32587647,42542401,42542401
France,1953,FR,FRA,EUR,2051147,3126286,5177433,3136268,3102465,2553860,2907539,1881734,1914336,15496202,1976078,3027954,5004032,3024044,3061458,2584531,2987849,2537428,3010320,17205630,32701832,42883297,42883297
France,1954,FR,FRA,EUR,2026711,3269621,5296332,3101887,3230715,2443258,2926823,1937883,1921543,15562109,1952747,3158566,5111313,2990215,3179386,2471882,3000947,2558207,3055255,17255892,32818001,43225643,43225643
France,1955,FR,FRA,EUR,2005849,3423369,5429218,3051009,3287776,2413715,2934764,2007942,1930064,15625270,1932096,3302600,5234696,2938806,3225432,2440441,3009984,2586802,3103196,17304661,32929931,43593851,43593851
France,1956,FR,FRA,EUR,1994390,3588440,5582830,2979296,3286037,2457787,2925810,2085037,1932050,15666017,1920589,3459918,5380507,2865375,3211406,2483069,3005123,2622997,3141897,17329867,32995884,43959221,43959221
France,1957,FR,FRA,EUR,1991855,3741420,5733275,2921321,3290567,2493802,2909446,2167484,1933120,15715740,1917903,3607028,5524931,2803704,3203569,2517055,2994639,2661910,3183269,17364146,33079886,44338091,44338091
France,1958,FR,FRA,EUR,1995543,3865198,5860741,2898904,3296070,2518388,2902933,2248986,1942757,15808038,1921415,3727494,5648909,2775318,3196417,2538481,2993249,2695350,3237850,17436665,33244703,44754358,44754358
France,1959,FR,FRA,EUR,2005042,3976367,5981409,2895807,3299109,2550184,2894819,2324921,1959686,15924526,1930570,3834181,5764751,2767438,3186702,2562289,2991701,2723149,3299878,17531157,33455683,45201849,45201849
France,1960,FR,FRA,EUR,2015007,4086427,6101434,2903483,3296631,2638877,2835488,2399564,1972025,16046068,1939573,3939712,5879285,2770686,3173092,2641014,2938552,2753518,3355921,17632783,33678851,45659575,45659575
France,1961,FR,FRA,EUR,2026309,4144250,6170559,2974047,3285665,2799748,2711142,2460304,1998722,16229628,1949679,3996204,5945883,2834199,3152388,2794391,2816218,2779076,3420679,17796951,34026579,46143030,46143030
France,1962,FR,FRA,EUR,2036598,4146537,6183135,3106880,3274741,2976162,2574789,2501271,2039589,16473432,1959156,3999565,5958721,2959560,3132262,2961692,2680839,2797120,3488426,18019899,34493331,46635189,46635189
France,1963,FR,FRA,EUR,2051026,4139826,6190852,3253922,3260770,3139542,2453585,2533440,2077866,16719125,1972571,3994677,5967248,3099554,3110423,3114158,2558934,2818452,3542515,18244036,34963161,47121247,47121247
France,1964,FR,FRA,EUR,2071659,4133691,6205350,3404347,3246080,3281816,2355416,2557430,2128980,16974069,1991581,3989221,5980802,3244382,3088496,3245696,2456786,2841471,3604906,18481737,35455806,47641952,47641952
France,1965,FR,FRA,EUR,2089927,4131294,6221221,3563568,3214148,3354019,2335682,2572327,2189862,17229606,2007787,3985490,5993277,3401296,3049029,3305315,2433651,2860336,3675073,18724700,35954306,48168804,48168804
France,1966,FR,FRA,EUR,2103615,4138069,6241684,3733540,3159002,3366103,2387282,2572545,2255323,17473795,2019568,3989584,6009152,3570936,2986591,3302977,2483135,2865372,3749445,18958456,36432251,48683086,48683086
France,1967,FR,FRA,EUR,2111059,4151574,6262633,3890998,3113277,3381037,2431206,2566851,2325594,17708963,2025046,3999872,6024918,3729556,2933403,3303776,2524052,2864288,3829819,19184894,36893857,49181410,49181410
France,1968,FR,FRA,EUR,2108827,4173654,6282481,4017705,3099252,3394024,2461493,2567288,2388644,17928406,2020883,4018764,6039647,3859739,2910601,3303133,2550791,2869649,3902837,19396750,37325156,49647279,49647279
France,1969,FR,FRA,EUR,2099545,4205087,6304632,4128593,3101685,3400443,2494956,2563082,2442428,18131187,2010362,4046864,6057226,3973998,2905638,3296938,2577771,2872036,3967623,19594004,37725191,50087049,50087049
France,2031,FR,FRA,EUR,1672702,3621605,5294307,3884494,3443733,3829389,3943024,4009021,7145739,26255400,1601545,3461791,5063336,3764017,3692751,4107580,4152488,4205722,9103023,29025581,55280981,65638631,65638631
France,2032,FR,FRA,EUR,1674231,3597963,5272194,3866708,3438756,3807880,3954080,3978329,7251301,26297054,1602749,3438718,5041467,3745902,3703330,4092601,4182660,4172298,9223206,29119997,55417051,65730716,65730716
France,2033,FR,FRA,EUR,1676274,3578776,5255050,3843542,3434109,3787181,3960241,3957066,7348020,26330159,1604494,3420562,5025056,3722543,3712456,4080217,4206421,4149153,9335990,29206780,55536939,65817039,65817039
France,2034,FR,FRA,EUR,1677842,3562961,5240803,3813921,3429285,3771068,3963953,3934819,7442894,26355940,1605839,3405968,5011807,3693034,3718927,4072400,4224792,4129862,9447383,29286398,55642338,65894943,65894943
France,2035,FR,FRA,EUR,1679559,3555083,5234642,3773264,3423234,3759841,3955457,3916873,7539860,26368529,1607292,3397826,5005118,3653892,3722209,4071569,4227146,4119704,9559313,29353833,55722362,65962123,65962123
France,2036,FR,FRA,EUR,1680700,3556160,5236860,3724037,3416909,3749106,3937626,3897641,7642430,26367749,1608165,3397734,5005899,3606764,3722614,4075950,4215929,4110733,9675999,29407989,55775738,66018497,66018497
France,2037,FR,FRA,EUR,1680537,3557748,5238285,3677528,3417402,3734366,3917646,3868376,7747304,26362622,1607858,3398194,5006052,3563034,3726156,4078158,4200795,4093731,9796026,29457900,55820522,66064851,66064851
France,2038,FR,FRA,EUR,1679848,3558275,5238123,3635252,3423968,3722599,3899625,3832656,7840981,26355081,1607091,3397854,5004945,3523326,3733016,4084272,4187558,4070517,9905921,29504610,55859691,66102758,66102758
France,2039,FR,FRA,EUR,1679113,3559547,5238660,3594702,3431020,3716476,3881893,3803518,7915310,26342919,1606295,3398377,5004672,3483955,3739913,4096388,4174870,4055215,9994739,29545080,55887999,66131331,66131331
France,2040,FR,FRA,EUR,1678973,3560520,5239493,3558228,3435206,3705482,3864901,3795396,7967443,26326656,1606118,3398703,5004821,3448505,3742866,4103146,4162506,4064203,10058348,29579574,55906230,66150546,66150546
France,2041,FR,FRA,EUR,1678641,3561447,5240088,3528431,3428444,3694273,3848442,3806471,8000729,26306790,1605755,3399080,5004835,3420179,3733885,4108469,4150722,4093793,10101130,29608178,55914968,66159894,66159894
France,2042,FR,FRA,EUR,1677683,3562884,5240567,3503504,3412936,3689238,3827779,3818698,8030806,26282961,1604797,3400023,5004820,3396238,3717295,4118186,4136045,4124380,10138901,29631045,55914006,66159385,66159385
France,2043,FR,FRA,EUR,1675654,3564493,5240147,3483101,3391920,3684681,3807828,3826304,8062795,26256629,1602831,3401191,5004022,3377163,3695381,4126456,4123790,4148718,10177385,29648893,55905522,66149696,66149696
France,2044,FR,FRA,EUR,1671550,3565693,5237243,3466632,3363396,3680309,3792605,3831606,8094464,26229012,1598863,3402043,5000906,3362018,3666724,4132730,4116283,4167830,10217091,29662676,55891688,66129829,66129829
France,2045,FR,FRA,EUR,1664644,3567512,5232156,3458869,3322572,3675022,3782515,3825514,8134736,26199228,1592213,3403550,4995763,3353890,3627636,4136613,4116075,4171394,10266334,29671942,55871170,66099099,66099099
France,2046,FR,FRA,EUR,1655646,3568419,5224065,3460484,3272512,3669555,3773144,3810757,8182075,26168527,1583614,3404183,4987797,3354167,3580111,4138068,4121305,4161783,10322864,29678298,55846825,66058684,66058684
France,2047,FR,FRA,EUR,1645490,3567365,5212855,3462518,3225516,3670671,3759676,3793828,8225662,26137871,1573935,3402991,4976926,3354933,3536102,4142375,4124269,4148322,10377408,29683409,55821280,66011064,66011064
France,2048,FR,FRA,EUR,1633846,3564733,5198579,3463333,3183236,3677612,3748839,3778273,8256104,26107397,1562856,3400326,4963182,3354777,3496310,4149595,4130877,4136521,10419194,29687274,55794671,65956429,65956429
France,2049,FR,FRA,EUR,1621623,3559946,5181569,3464981,3142563,3685013,3743499,3762683,8277969,26076708,1551277,3395610,4946887,3355563,3456766,4156922,4143453,4125119,10452070,29689893,55766601,65895052,65895052
France,2050,FR,FRA,EUR,1609262,3552862,5162124,3466406,3105840,3689513,3733459,3747957,8302131,26045306,1539584,3388767,4928351,3356238,3421060,4160389,4150837,4114134,10488631,29691289,55736595,65827072,65827072
Micronesia (Federated States of),1970,FM,FSM,WPR,5584,8510,14094,5616,3666,2690,1888,1252,893,16005,5277,8084,13361,5332,3454,2564,1841,1274,1073,15538,31543,58989,58989
Micronesia (Federated States of),1971,FM,FSM,WPR,5770,8786,14556,5836,3712,2737,1923,1277,912,16397,5449,8341,13790,5544,3496,2605,1877,1306,1102,15930,32327,60673,60673
Micronesia (Federated States of),1972,FM,FSM,WPR,5943,9070,15013,6059,3732,2772,1955,1296,931,16745,5613,8609,14222,5756,3510,2640,1908,1334,1130,16278,33023,62265,62265
Micronesia (Federated States of),1973,FM,FSM,WPR,6103,9367,15470,6298,3753,2804,1989,1318,953,17115,5762,8887,14649,5986,3530,2672,1945,1359,1164,16656,33771,63889,63889
Micronesia (Federated States of),1974,FM,FSM,WPR,6247,9673,15920,6557,3781,2834,2022,1341,972,17507,5898,9175,15073,6228,3556,2702,1979,1388,1196,17049,34556,65552,65552
Micronesia (Federated States of),1975,FM,FSM,WPR,6344,9920,16264,6792,3876,2864,2059,1357,987,17935,5996,9433,15429,6460,3662,2733,2014,1412,1219,17500,35435,67121,67121
Micronesia (Federated States of),1976,FM,FSM,WPR,6414,10114,16528,6987,4039,2897,2092,1374,984,18373,6070,9651,15721,6662,3847,2769,2039,1425,1234,17976,36349,68602,68602
Micronesia (Federated States of),1977,FM,FSM,WPR,6500,10308,16808,7186,4219,2924,2129,1387,991,18836,6157,9867,16024,6871,4044,2800,2068,1445,1252,18480,37316,70144,70144
Micronesia (Federated States of),1978,FM,FSM,WPR,6640,10556,17196,7398,4406,2961,2169,1406,1009,19349,6292,10115,16407,7093,4234,2841,2112,1473,1281,19034,38383,71983,71983
Micronesia (Federated States of),1979,FM,FSM,WPR,6832,10865,17697,7629,4597,3010,2215,1435,1029,19915,6464,10401,16865,7334,4420,2889,2166,1506,1321,19636,39551,74114,74114
Micronesia (Federated States of),1980,FM,FSM,WPR,7024,11177,18201,7865,4800,3062,2261,1467,1058,20513,6635,10691,17326,7580,4619,2940,2220,1541,1360,20260,40773,76299,76299
Micronesia (Federated States of),1981,FM,FSM,WPR,7202,11507,18709,8107,5021,3121,2308,1501,1082,21140,6796,10991,17787,7824,4835,2997,2272,1578,1394,20900,42040,78531,78531
Micronesia (Federated States of),1982,FM,FSM,WPR,7361,11848,19209,8360,5263,3178,2350,1533,1107,21791,6946,11302,18248,8076,5071,3055,2322,1618,1433,21575,43366,80816,80816
Micronesia (Federated States of),1983,FM,FSM,WPR,7508,12191,19699,8622,5515,3237,2390,1570,1136,22470,7085,11617,18702,8334,5320,3121,2373,1659,1475,22282,44752,83153,83153
Micronesia (Federated States of),1984,FM,FSM,WPR,7644,12534,20178,8901,5782,3302,2437,1611,1168,23201,7213,11932,19145,8604,5582,3194,2419,1702,1524,23025,46226,85543,85543
Micronesia (Federated States of),1985,FM,FSM,WPR,7768,12871,20639,9196,6021,3407,2477,1652,1207,23960,7329,12241,19570,8885,5816,3313,2462,1744,1576,23796,47756,87966,87966
Micronesia (Federated States of),1986,FM,FSM,WPR,7878,13192,21070,9508,6231,3562,2523,1690,1240,24754,7433,12535,19968,9186,6022,3479,2501,1787,1626,24601,49355,90397,90397
Micronesia (Federated States of),1987,FM,FSM,WPR,7972,13512,21484,9832,6448,3731,2564,1733,1279,25587,7524,12829,20353,9482,6241,3650,2543,1832,1673,25421,51008,92845,92845
Micronesia (Federated States of),1988,FM,FSM,WPR,8050,13830,21880,10094,6617,3883,2598,1770,1302,26264,7594,13123,20717,9721,6414,3802,2584,1874,1729,26124,52388,94987,94987
Micronesia (Federated States of),1989,FM,FSM,WPR,8107,14142,22249,10307,6736,4017,2625,1806,1333,26824,7646,13406,21052,9903,6535,3932,2608,1916,1775,26669,53493,96796,96796
Micronesia (Federated States of),1990,FM,FSM,WPR,8154,14436,22590,10535,6851,4158,2654,1836,1359,27393,7688,13679,21367,10104,6655,4070,2636,1960,1818,27243,54636,98603,98603
Micronesia (Federated States of),1991,FM,FSM,WPR,8200,14707,22907,10791,6970,4309,2685,1871,1389,28015,7728,13925,21653,10330,6774,4221,2668,2002,1863,27858,55873,100427,100427
Micronesia (Federated States of),1992,FM,FSM,WPR,8308,15074,23382,10906,7110,4687,2718,1937,1480,28838,7785,14264,22049,10488,6934,4533,2684,2042,1937,28618,57456,102893,102893
Micronesia (Federated States of),1993,FM,FSM,WPR,8465,15555,24020,10953,7191,5266,2822,2031,1634,29897,7880,14693,22573,10608,7082,5011,2721,2073,2041,29536,59433,106030,106030
Micronesia (Federated States of),1994,FM,FSM,WPR,8547,15949,24496,11159,7145,5730,3027,2084,1770,30915,7981,15016,22997,10810,7137,5441,2830,2097,2124,30439,61354,108844,108844
Micronesia (Federated States of),1995,FM,FSM,WPR,8486,16070,24556,11409,7075,5939,3244,2087,1808,31562,7986,15067,23053,11024,7184,5693,2991,2116,2141,31149,62711,110328,110328
Micronesia (Federated States of),1996,FM,FSM,WPR,8350,16000,24350,11589,7060,5979,3432,2067,1778,31905,7894,14939,22833,11209,7265,5798,3180,2133,2112,31697,63602,110785,110785
Micronesia (Federated States of),1997,FM,FSM,WPR,8221,15898,24119,11718,7079,5985,3623,2056,1740,32201,7788,14794,22582,11380,7363,5872,3385,2146,2078,32224,64425,111133,111133
Micronesia (Federated States of),1998,FM,FSM,WPR,8109,15733,23842,11839,7116,5980,3809,2054,1694,32492,7707,14635,22342,11531,7466,5928,3590,2171,2048,32734,65226,111406,111406
Micronesia (Federated States of),1999,FM,FSM,WPR,7993,15491,23484,12000,7137,5969,3989,2054,1643,32792,7622,14446,22068,11664,7555,5972,3792,2191,2017,33191,65983,111539,111539
Micronesia (Federated States of),2000,FM,FSM,WPR,7922,15196,23118,12195,7182,5957,4180,2033,1643,33190,7577,14196,21773,11771,7630,6005,4008,2179,2031,33624,66814,111709,111709
Micronesia (Federated States of),2001,FM,FSM,WPR,7898,14887,22785,12335,7299,5944,4376,2007,1692,33653,7570,13949,21519,11818,7686,6038,4210,2147,2088,33987,67640,111948,111948
Micronesia (Federated States of),2002,FM,FSM,WPR,7820,14640,22460,12358,7464,5913,4536,2019,1745,34035,7467,13805,21272,11788,7712,6059,4370,2146,2149,34224,68259,111992,111992
Micronesia (Federated States of),2003,FM,FSM,WPR,7664,14483,22147,12264,7612,5887,4661,2075,1774,34273,7260,13767,21027,11681,7722,6084,4498,2187,2185,34357,68630,111805,111805
Micronesia (Federated States of),2004,FM,FSM,WPR,7451,14371,21822,12112,7713,5884,4767,2173,1776,34425,7047,13715,20762,11499,7742,6106,4621,2268,2192,34428,68853,111438,111438
Micronesia (Federated States of),2005,FM,FSM,WPR,7176,14277,21453,11936,7790,5895,4863,2308,1744,34536,6846,13638,20484,11271,7774,6103,4741,2389,2186,34464,69000,110940,110940
Micronesia (Federated States of),2006,FM,FSM,WPR,6887,14159,21046,11781,7842,5899,4928,2472,1686,34608,6659,13531,20190,11047,7820,6088,4836,2510,2150,34451,69059,110301,110301
Micronesia (Federated States of),2007,FM,FSM,WPR,6665,13944,20609,11682,7831,5905,4970,2635,1623,34646,6506,13322,19828,10893,7821,6082,4913,2624,2116,34449,69095,109532,109532
Micronesia (Federated States of),2008,FM,FSM,WPR,6518,13658,20176,11614,7782,5892,5013,2799,1554,34654,6374,13079,19453,10807,7727,6084,4982,2746,2083,34429,69083,108704,108704
Micronesia (Federated States of),2009,FM,FSM,WPR,6442,13325,19767,11591,7694,5845,5038,2973,1486,34627,6300,12821,19121,10780,7549,6096,5017,2871,2042,34355,68982,107868,107868
Micronesia (Federated States of),2010,FM,FSM,WPR,6380,13016,19396,11643,7678,5829,5058,3186,1458,34852,6211,12609,18820,10843,7441,6108,5054,3053,2023,34522,69374,107588,107588
Micronesia (Federated States of),2011,FM,FSM,WPR,6346,12812,19158,11719,7719,5847,5062,3396,1492,35235,6090,12514,18604,10949,7423,6080,5093,3276,2070,34891,70126,107887,107887
Micronesia (Federated States of),2012,FM,FSM,WPR,6336,12674,19010,11810,7692,5874,5052,3553,1573,35554,6012,12401,18413,11103,7391,5999,5129,3476,2158,35256,70810,108232,108232
Micronesia (Federated States of),2013,FM,FSM,WPR,6284,12556,18840,11957,7685,5879,5046,3659,1685,35911,5936,12226,18162,11310,7382,5913,5175,3647,2263,35690,71601,108609,108609
Micronesia (Federated States of),2014,FM,FSM,WPR,6192,12461,18653,12080,7750,5845,5043,3771,1812,36301,5829,12108,17937,11460,7392,5845,5218,3816,2396,36127,72428,109024,109024
Micronesia (Federated States of),2015,FM,FSM,WPR,6095,12351,18446,12154,7883,5818,5022,3897,1952,36726,5727,12023,17750,11547,7421,5812,5229,3990,2557,36556,73282,109462,109462
Micronesia (Federated States of),2016,FM,FSM,WPR,6025,12258,18283,12153,8060,5815,4985,3990,2098,37101,5659,11946,17605,11556,7485,5832,5218,4131,2706,36928,74029,109925,109925
Micronesia (Federated States of),2017,FM,FSM,WPR,5971,12223,18194,12071,8298,5803,4966,4054,2245,37437,5609,11887,17496,11484,7624,5865,5222,4246,2867,37308,74745,110430,110430
Micronesia (Federated States of),2018,FM,FSM,WPR,5924,12175,18099,11975,8523,5820,4938,4114,2394,37764,5564,11787,17351,11420,7793,5853,5241,4358,3048,37713,75477,110929,110929
Micronesia (Federated States of),2019,FM,FSM,WPR,5886,12110,17996,11874,8723,5866,4887,4157,2569,38076,5527,11667,17194,11378,7961,5816,5282,4435,3243,38115,76191,111379,111379
Micronesia (Federated States of),2020,FM,FSM,WPR,5864,12027,17891,11811,8980,5931,4856,4180,2764,38522,5505,11527,17032,11394,8200,5796,5306,4492,3467,38655,77177,112106,112106
Micronesia (Federated States of),2021,FM,FSM,WPR,5861,11977,17838,11773,9255,6019,4877,4187,2952,39063,5502,11388,16890,11470,8494,5834,5295,4544,3704,39341,78404,113131,113131
Micronesia (Federated States of),2022,FM,FSM,WPR,5866,11943,17809,11732,9521,6095,4943,4187,3096,39574,5508,11285,16793,11468,8832,5905,5258,4590,3932,39985,79559,114164,114164
Micronesia (Federated States of),2023,FM,FSM,WPR,5887,11872,17759,11704,9831,6190,4992,4186,3226,40129,5525,11191,16716,11385,9225,5999,5215,4651,4141,40616,80745,115224,115224
Micronesia (Federated States of),2024,FM,FSM,WPR,5914,11771,17685,11682,10114,6355,5002,4195,3372,40720,5556,11076,16632,11345,9544,6111,5192,4707,4373,41272,81992,116300,116300
Micronesia (Federated States of),2025,FM,FSM,WPR,5949,11677,17626,11628,10337,6582,5023,4194,3538,41302,5589,10976,16565,11322,9786,6240,5198,4734,4621,41901,83203,117389,117389
Micronesia (Federated States of),2026,FM,FSM,WPR,5989,11618,17607,11582,10480,6850,5062,4179,3686,41839,5627,10922,16549,11297,9945,6397,5258,4743,4840,42480,84319,118472,118472
Micronesia (Federated States of),2027,FM,FSM,WPR,6027,11585,17612,11583,10525,7171,5088,4175,3807,42349,5664,10890,16554,11278,10007,6625,5327,4759,5034,43030,85379,119544,119544
Micronesia (Federated States of),2028,FM,FSM,WPR,6064,11572,17636,11564,10547,7482,5146,4170,3932,42841,5698,10880,16578,11202,10073,6887,5357,4794,5251,43564,86405,120617,120617
Micronesia (Federated States of),2029,FM,FSM,WPR,6091,11579,17670,11519,10565,7779,5236,4151,4060,43310,5727,10886,16613,11106,10153,7155,5368,4855,5442,44079,87389,121675,121675
Micronesia (Federated States of),2030,FM,FSM,WPR,6109,11603,17712,11455,10561,8090,5326,4142,4189,43763,5744,10910,16654,10981,10234,7446,5376,4894,5640,44571,88334,122704,122704
Micronesia (Federated States of),1950,FM,FSM,WPR,2645,4072,6717,3069,2287,1692,1213,808,632,9701,2489,3810,6299,2871,2141,1576,1142,782,675,9187,18888,31908,31908
Micronesia (Federated States of),1951,FM,FSM,WPR,2804,4173,6977,3144,2335,1726,1235,819,637,9896,2647,3907,6554,2938,2194,1610,1168,797,683,9390,19286,32813,32813
Micronesia (Federated States of),1952,FM,FSM,WPR,2968,4270,7238,3219,2388,1760,1261,833,640,10101,2812,4001,6813,3010,2246,1648,1195,814,690,9603,19704,33755,33755
Micronesia (Federated States of),1953,FM,FSM,WPR,3140,4373,7513,3297,2443,1802,1285,848,646,10321,2981,4103,7084,3086,2297,1687,1223,831,699,9823,20144,34737,34737
Micronesia (Federated States of),1954,FM,FSM,WPR,3312,4486,7798,3377,2500,1840,1312,864,652,10545,3149,4212,7361,3166,2351,1724,1249,849,706,10045,20590,35751,35751
Micronesia (Federated States of),1955,FM,FSM,WPR,3449,4642,8091,3461,2558,1885,1340,878,657,10779,3281,4371,7652,3245,2415,1773,1278,870,721,10302,21081,36821,36821
Micronesia (Federated States of),1956,FM,FSM,WPR,3552,4846,8398,3550,2619,1931,1371,895,667,11033,3376,4577,7953,3330,2475,1817,1310,892,730,10554,21587,37940,37940
Micronesia (Federated States of),1957,FM,FSM,WPR,3661,5064,8725,3639,2683,1976,1403,915,669,11285,3477,4795,8272,3415,2536,1867,1341,912,743,10814,22099,39095,39095
Micronesia (Federated States of),1958,FM,FSM,WPR,3773,5288,9061,3735,2750,2022,1434,936,684,11561,3582,5017,8599,3502,2604,1911,1373,932,753,11075,22636,40300,40300
Micronesia (Federated States of),1959,FM,FSM,WPR,3894,5524,9418,3833,2820,2071,1467,956,690,11837,3695,5249,8944,3601,2670,1957,1406,955,770,11359,23196,41566,41566
Micronesia (Federated States of),1960,FM,FSM,WPR,4027,5784,9811,3946,2905,2124,1504,975,713,12167,3819,5495,9314,3709,2750,2015,1443,984,798,11699,23866,42986,42986
Micronesia (Federated States of),1961,FM,FSM,WPR,4171,6076,10247,4078,3000,2178,1541,999,742,12538,3952,5769,9721,3824,2836,2067,1479,1016,831,12053,24591,44563,44563
Micronesia (Federated States of),1962,FM,FSM,WPR,4318,6383,10701,4210,3105,2235,1582,1027,769,12928,4089,6053,10142,3946,2930,2126,1516,1051,864,12433,25361,46200,46200
Micronesia (Federated States of),1963,FM,FSM,WPR,4465,6684,11149,4323,3193,2291,1622,1051,791,13271,4229,6338,10567,4050,3009,2177,1559,1078,900,12773,26044,47758,47758
Micronesia (Federated States of),1964,FM,FSM,WPR,4610,6978,11588,4423,3266,2341,1661,1078,802,13571,4365,6628,10993,4150,3081,2229,1599,1101,916,13076,26647,49231,49231
Micronesia (Federated States of),1965,FM,FSM,WPR,4760,7246,12006,4568,3338,2398,1704,1105,815,13928,4505,6878,11383,4296,3147,2282,1645,1127,940,13437,27365,50759,50759
Micronesia (Federated States of),1966,FM,FSM,WPR,4915,7479,12394,4763,3411,2459,1745,1130,829,14337,4649,7106,11755,4494,3220,2336,1688,1154,965,13857,28194,52346,52346
Micronesia (Federated States of),1967,FM,FSM,WPR,5072,7724,12796,4964,3479,2513,1785,1160,844,14745,4796,7332,12128,4693,3280,2392,1730,1183,989,14267,29012,53940,53940
Micronesia (Federated States of),1968,FM,FSM,WPR,5236,7975,13211,5171,3541,2570,1820,1191,860,15153,4949,7576,12525,4895,3333,2448,1767,1212,1018,14673,29826,55553,55553
Micronesia (Federated States of),1969,FM,FSM,WPR,5405,8236,13641,5387,3603,2630,1857,1217,877,15571,5107,7821,12928,5107,3393,2506,1803,1241,1044,15094,30665,57236,57236
Micronesia (Federated States of),2031,FM,FSM,WPR,6114,11643,17757,11406,10536,8369,5421,4172,4290,44194,5747,10946,16693,10841,10319,7749,5416,4887,5840,45052,89246,123700,123700
Micronesia (Federated States of),2032,FM,FSM,WPR,6101,11686,17787,11375,10504,8638,5502,4241,4363,44623,5735,10990,16725,10741,10320,8089,5493,4857,6025,45525,90148,124662,124662
Micronesia (Federated States of),2033,FM,FSM,WPR,6070,11743,17813,11309,10483,8944,5600,4291,4418,45045,5707,11046,16753,10651,10240,8475,5587,4821,6208,45982,91027,125588,125588
Micronesia (Federated States of),2034,FM,FSM,WPR,6030,11802,17832,11209,10462,9222,5760,4307,4489,45449,5670,11100,16770,10536,10203,8795,5697,4800,6394,46425,91874,126475,126475
Micronesia (Federated States of),2035,FM,FSM,WPR,5984,11855,17839,11115,10414,9439,5981,4329,4570,45848,5626,11155,16781,10436,10182,9035,5822,4812,6569,46856,92704,127323,127323
Micronesia (Federated States of),2036,FM,FSM,WPR,5933,11900,17833,11060,10376,9582,6241,4369,4625,46253,5580,11197,16777,10382,10158,9194,5983,4873,6697,47287,93540,128139,128139
Micronesia (Federated States of),2037,FM,FSM,WPR,5881,11925,17806,11030,10373,9631,6552,4399,4667,46652,5528,11223,16751,10353,10139,9256,6212,4942,6810,47712,94364,128917,128917
Micronesia (Federated States of),2038,FM,FSM,WPR,5824,11933,17757,11018,10358,9653,6855,4454,4720,47058,5474,11228,16702,10343,10066,9321,6472,4975,6961,48138,95196,129650,129650
Micronesia (Federated States of),2039,FM,FSM,WPR,5761,11922,17683,11026,10317,9670,7142,4541,4761,47457,5414,11220,16634,10348,9971,9400,6735,4991,7116,48561,96018,130339,130339
Micronesia (Federated States of),2040,FM,FSM,WPR,5690,11898,17588,11054,10253,9671,7442,4629,4822,47871,5347,11197,16544,10374,9846,9484,7024,5004,7253,48985,96856,130984,130984
Micronesia (Federated States of),2041,FM,FSM,WPR,5614,11851,17465,11088,10212,9651,7713,4723,4902,48289,5277,11154,16431,10409,9710,9572,7320,5047,7352,49410,97699,131588,131588
Micronesia (Federated States of),2042,FM,FSM,WPR,5540,11784,17324,11138,10180,9625,7973,4806,4984,48706,5206,11091,16297,10454,9611,9572,7654,5118,7414,49823,98529,132154,132154
Micronesia (Federated States of),2043,FM,FSM,WPR,5470,11701,17171,11193,10115,9602,8268,4897,5044,49119,5137,11009,16146,10510,9519,9493,8036,5210,7479,50247,99366,132686,132686
Micronesia (Federated States of),2044,FM,FSM,WPR,5397,11601,16998,11254,10021,9586,8539,5052,5091,49543,5069,10914,15983,10568,9405,9458,8352,5320,7561,50664,100207,133179,133179
Micronesia (Federated States of),2045,FM,FSM,WPR,5325,11484,16809,11310,9933,9540,8754,5257,5155,49949,5002,10803,15805,10619,9307,9437,8589,5448,7665,51065,101014,133631,133631
Micronesia (Federated States of),2046,FM,FSM,WPR,5257,11359,16616,11352,9879,9505,8893,5502,5216,50347,4935,10686,15621,10662,9253,9414,8745,5606,7778,51458,101805,134048,134048
Micronesia (Federated States of),2047,FM,FSM,WPR,5191,11232,16423,11381,9850,9506,8943,5792,5261,50733,4874,10568,15442,10691,9221,9396,8807,5827,7885,51827,102560,134436,134436
Micronesia (Federated States of),2048,FM,FSM,WPR,5130,11106,16236,11389,9842,9494,8968,6077,5333,51103,4816,10445,15261,10701,9213,9326,8876,6081,8000,52197,103300,134800,134800
Micronesia (Federated States of),2049,FM,FSM,WPR,5078,10970,16048,11380,9851,9459,8987,6345,5437,51459,4764,10317,15081,10688,9220,9232,8958,6340,8106,52544,104003,135139,135139
Micronesia (Federated States of),2050,FM,FSM,WPR,5032,10830,15862,11354,9879,9397,8995,6628,5556,51809,4721,10185,14906,10662,9244,9109,9038,6626,8206,52885,104694,135457,135457
Gabon,1970,GA,GAB,AFR,42686,63091,105777,46948,37659,32983,27807,21806,20107,187310,42454,63488,105942,47604,38341,33914,29558,24175,24573,198165,385475,597192,597192
Gabon,1971,GA,GAB,AFR,44106,65119,109225,48168,38286,33304,28029,21965,20359,190111,43860,65489,109349,48866,38980,34212,29753,24348,24854,201013,391124,609693,609693
Gabon,1972,GA,GAB,AFR,45624,67237,112861,49311,38899,33611,28234,22119,20605,192779,45362,67578,112940,50045,39599,34491,29929,24513,25133,203710,396489,622289,622289
Gabon,1973,GA,GAB,AFR,47224,69431,116655,50553,39458,33908,28440,22270,20836,195465,46947,69754,116701,51295,40190,34777,30106,24682,25409,206459,401924,635288,635288
Gabon,1974,GA,GAB,AFR,48878,71714,120592,51916,40092,34181,28653,22419,21072,198333,48580,72021,120601,52673,40846,35054,30289,24851,25682,209395,407728,648922,648922
Gabon,1975,GA,GAB,AFR,50587,74093,124680,53303,40945,34436,28874,22577,21307,201442,50270,74389,124659,54065,41712,35317,30484,25020,25973,212571,414013,663340,663340
Gabon,1976,GA,GAB,AFR,52366,76610,128976,54776,41917,34704,29105,22735,21542,204779,52026,76892,128918,55513,42730,35591,30688,25193,26275,215990,420769,678660,678660
Gabon,1977,GA,GAB,AFR,54218,79269,133487,56387,42949,34998,29357,22902,21785,208378,53856,79540,133396,57100,43807,35896,30910,25373,26583,219669,428047,694931,694931
Gabon,1978,GA,GAB,AFR,56172,82067,138239,58112,44032,35324,29622,23078,22030,212198,55786,82318,138104,58801,44940,36246,31143,25556,26897,223583,435781,712135,712135
Gabon,1979,GA,GAB,AFR,58233,84984,143217,59932,45145,35713,29893,23261,22275,216219,57818,85221,143039,60595,46102,36656,31397,25745,27222,227717,443936,730188,730188
Gabon,1980,GA,GAB,AFR,60379,88036,148415,61846,46270,36181,30167,23453,22519,220436,59938,88252,148190,62491,47280,37138,31654,25930,27540,232033,452469,749078,749078
Gabon,1981,GA,GAB,AFR,62620,91244,153864,63868,47410,36732,30457,23651,22765,224883,62156,91434,153590,64501,48472,37707,31923,26116,27851,236570,461453,768904,768904
Gabon,1982,GA,GAB,AFR,64904,94631,159535,65988,48571,37350,30767,23854,23004,229534,64418,94796,159214,66608,49681,38342,32221,26301,28148,241301,470835,789585,789585
Gabon,1983,GA,GAB,AFR,67183,98210,165393,68194,49869,37963,31090,24067,23250,234433,66674,98345,165019,68800,50995,38992,32535,26489,28443,246254,480687,811098,811098
Gabon,1984,GA,GAB,AFR,69452,101945,171397,70477,51277,38654,31398,24284,23507,239597,68921,102047,170968,71075,52427,39700,32839,26686,28731,251458,491055,833417,833417
Gabon,1985,GA,GAB,AFR,71670,105827,177497,72851,52690,39533,31683,24509,23762,245028,71119,105891,177010,73450,53858,40599,33125,26887,29026,256945,501973,856482,856482
Gabon,1986,GA,GAB,AFR,73798,109865,183663,75361,54176,40519,31977,24744,24018,250795,73234,109887,183121,75953,55326,41629,33418,27095,29336,262757,513552,880340,880340
Gabon,1987,GA,GAB,AFR,75900,114019,189919,78009,55776,41546,32289,24992,24287,256899,75325,113997,189322,78597,56907,42701,33726,27308,29640,268879,525778,905016,905016
Gabon,1988,GA,GAB,AFR,77992,118261,196253,80788,57482,42607,32624,25249,24556,263306,77407,118199,195606,81364,58589,43804,34068,27526,29943,275294,538600,930464,930464
Gabon,1989,GA,GAB,AFR,80006,122591,202597,83686,59274,43701,33014,25512,24834,270021,79419,122490,201909,84249,60359,44931,34457,27749,30234,281979,552000,956509,956509
Gabon,1990,GA,GAB,AFR,81909,126961,208870,86714,61162,44804,33481,25775,25110,277046,81329,126825,208154,87259,62216,46071,34910,27970,30525,288951,565997,983028,983028
Gabon,1991,GA,GAB,AFR,83698,131329,215027,89894,63149,45921,34020,26047,25397,284428,83133,131163,214296,90415,64178,47210,35437,28200,30805,296245,580673,1009995,1009995
Gabon,1992,GA,GAB,AFR,85350,135704,221054,93246,65233,47062,34624,26344,25685,292194,84807,135506,220313,93740,66234,48366,36022,28445,31072,303879,596073,1037446,1037446
Gabon,1993,GA,GAB,AFR,86850,140063,226913,96787,67396,48334,35229,26655,25994,300395,86336,139839,226175,97253,68369,49620,36619,28705,31351,311917,612312,1065390,1065390
Gabon,1994,GA,GAB,AFR,88176,144328,232504,100488,69646,49709,35901,26947,26294,308985,87686,144093,231779,100927,70592,50985,37264,28952,31620,320340,629325,1093611,1093611
Gabon,1995,GA,GAB,AFR,89288,148433,237721,104385,72048,51122,36756,27221,26608,318140,88807,148196,237003,104721,72893,52340,38082,29180,31892,329108,647248,1121964,1121964
Gabon,1996,GA,GAB,AFR,90239,152327,242566,108498,74652,52634,37713,27499,26937,327933,89749,152098,241847,108657,75311,53717,39017,29402,32157,338261,666194,1150601,1150601
Gabon,1997,GA,GAB,AFR,91160,156049,247209,112741,77442,54278,38714,27790,27266,338231,90646,155841,246487,112728,77883,55210,39983,29639,32425,347868,686099,1179806,1179806
Gabon,1998,GA,GAB,AFR,92173,159614,251787,117102,80420,56060,39765,28115,27620,349082,91623,159433,251056,116911,80610,56809,40980,29903,32689,357902,706984,1209832,1209832
Gabon,1999,GA,GAB,AFR,93375,162936,256311,121585,83592,57970,40864,28495,27979,360485,92792,162784,255576,121215,83484,58509,42007,30216,32962,368393,728878,1240764,1240764
Gabon,2000,GA,GAB,AFR,94923,165963,260886,126169,87005,60030,41992,28947,28353,372496,94310,165833,260143,125612,86550,60331,43065,30602,33251,379411,751907,1272935,1272935
Gabon,2001,GA,GAB,AFR,96819,168743,265562,130839,90719,62276,43180,29477,28732,385223,96183,168622,264805,130070,89854,62304,44154,31067,33549,390998,776221,1306590,1306590
Gabon,2002,GA,GAB,AFR,98912,171369,270281,135606,94778,64723,44429,30083,29143,398762,98247,171247,269494,134589,93412,64412,45277,31599,33875,403164,801926,1341696,1341696
Gabon,2003,GA,GAB,AFR,101119,173949,275068,140444,99201,67355,45836,30698,29572,413106,100419,173821,274240,139162,97258,66662,46520,32152,34229,415983,829089,1378398,1378398
Gabon,2004,GA,GAB,AFR,103494,176582,280076,145324,104029,70224,47411,31396,30006,428390,102744,176435,279179,143740,101396,69072,47895,32766,34588,429457,857847,1417110,1417110
Gabon,2005,GA,GAB,AFR,106047,179398,285445,150252,109339,73397,49091,32282,30457,444818,105252,179216,284468,148296,105854,71669,49314,33545,34943,443621,888439,1458353,1458353
Gabon,2006,GA,GAB,AFR,108796,182442,291238,155197,115200,76949,50946,33292,30945,462529,107966,182211,290177,152792,110687,74519,50820,34456,35316,458590,921119,1502534,1502534
Gabon,2007,GA,GAB,AFR,111834,185684,297518,160140,121555,80898,53029,34395,31495,481512,110967,185396,296363,157234,115854,77647,52493,35425,35728,474381,955893,1549774,1549774
Gabon,2008,GA,GAB,AFR,115214,189162,304376,165040,128334,85230,55323,35567,32095,501589,114289,188794,303083,161598,121316,81045,54323,36456,36181,490919,992508,1599978,1599978
Gabon,2009,GA,GAB,AFR,119064,193024,312088,169805,135548,89955,57821,36803,32753,522685,118049,192569,310618,165794,127079,84711,56310,37541,36714,508149,1030834,1653542,1653542
Gabon,2010,GA,GAB,AFR,123461,197435,320896,174413,143203,95145,60565,38110,33493,544929,122324,196898,319222,169772,133120,88692,58475,38676,37327,526062,1070991,1711105,1711105
Gabon,2011,GA,GAB,AFR,128308,202420,330728,178867,151232,100824,63564,39493,34311,568291,127018,201801,328819,173549,139386,93003,60828,39868,38032,544666,1112957,1772500,1772500
Gabon,2012,GA,GAB,AFR,133258,207917,341175,183144,159511,106969,66802,40958,35220,592604,131799,207199,338998,177159,145818,97650,63357,41126,38832,563942,1156546,1836705,1836705
Gabon,2013,GA,GAB,AFR,137985,213867,351852,187145,167760,113489,70232,42558,36123,617307,136371,213022,349393,180599,152262,102607,66041,42499,39671,583679,1200986,1902226,1902226
Gabon,2014,GA,GAB,AFR,142256,220397,362653,190581,175414,120128,73755,44239,37022,641139,140507,219383,359890,183743,158391,107718,68822,43968,40527,603169,1244308,1966855,1966855
Gabon,2015,GA,GAB,AFR,145821,227539,373360,193239,181912,126630,77313,45896,37954,662944,143955,226332,370287,186525,163892,112880,71690,45448,41490,621925,1284869,2028517,2028517
Gabon,2016,GA,GAB,AFR,148586,235205,383791,195139,186965,132898,80888,47562,38871,682323,146615,233781,380396,188972,168576,118033,74645,46948,42529,639703,1322026,2086206,2086206
Gabon,2017,GA,GAB,AFR,150701,243164,393865,196503,190639,138877,84499,49273,39745,699536,148636,241501,390137,191188,172493,123143,77714,48542,43599,656679,1356215,2140215,2140215
Gabon,2018,GA,GAB,AFR,152304,251183,403487,197847,193273,144665,88203,51060,40629,715677,150171,249264,399435,193461,175809,128254,80926,50237,44723,673410,1389087,2192012,2192012
Gabon,2019,GA,GAB,AFR,153394,259191,412585,199670,195086,150372,92077,52962,41577,731744,151218,256994,408212,196144,178566,133384,84273,52006,45876,690249,1421993,2242785,2242785
Gabon,2020,GA,GAB,AFR,154029,267024,421053,202197,196092,155946,96129,54947,42459,747770,151829,264536,416365,199441,180741,138487,87788,53880,47049,707386,1455156,2292573,2292573
Gabon,2021,GA,GAB,AFR,154366,274491,428857,205496,196385,161272,100312,56962,43127,763554,152160,271715,423875,203457,182467,143531,91481,55825,48126,724887,1488441,2341179,2341179
Gabon,2022,GA,GAB,AFR,154651,281385,436036,209551,196178,166323,104649,59045,43715,779461,152441,278348,430789,208078,183830,148460,95349,57842,49138,742697,1522158,2388992,2388992
Gabon,2023,GA,GAB,AFR,154875,287537,442412,214341,195716,171077,109226,61289,44521,796170,152658,284271,436929,213197,184940,153213,99421,59976,50316,761063,1557233,2436566,2436566
Gabon,2024,GA,GAB,AFR,155017,292734,447751,219994,195196,175453,114053,63771,45742,814209,152805,289285,442090,219002,185994,157736,103698,62277,51798,780505,1594714,2484557,2484557
Gabon,2025,GA,GAB,AFR,155215,296823,452038,226538,194849,179342,119078,66469,47269,833545,153019,293232,446251,225555,187182,161941,108157,64734,53487,801056,1634601,2532885,2532885
Gabon,2026,GA,GAB,AFR,155577,299846,455423,233817,194818,182646,124246,69334,48890,853751,153403,296150,449553,232745,188595,165758,112783,67340,55285,822506,1676257,2581236,2581236
Gabon,2027,GA,GAB,AFR,155968,302198,458166,241533,195160,185375,129498,72377,50632,874575,153826,298426,452252,240308,190261,169196,117523,70106,57193,844587,1719162,2629579,2629579
Gabon,2028,GA,GAB,AFR,156419,304028,460447,249402,195980,187531,134771,75595,52474,895753,154305,300212,454517,247978,192252,172258,122347,73033,59204,867072,1762825,2677790,2677790
Gabon,2029,GA,GAB,AFR,157138,305286,462424,257296,197468,189045,140031,78973,54426,917239,155045,301464,456509,255638,194746,174856,127230,76102,61318,889890,1807129,2726063,2726063
Gabon,2030,GA,GAB,AFR,158090,306134,464224,265042,199799,189899,145203,82522,56491,938956,156013,302336,458349,263133,197928,176940,132104,79330,63549,912984,1851940,2774523,2774523
Gabon,1950,GA,GAB,AFR,26551,41804,68355,38426,34477,30274,25274,19072,14994,162517,26383,42166,68549,38858,35422,31390,27059,21645,19104,173478,335995,472905,472905
Gabon,1951,GA,GAB,AFR,26977,42076,69053,38507,34553,30352,25390,19213,15303,163318,26863,42438,69301,38916,35477,31476,27138,21745,19395,174147,337465,475827,475827
Gabon,1952,GA,GAB,AFR,27374,42428,69802,38616,34636,30431,25505,19352,15597,164137,27312,42789,70101,39005,35533,31566,27221,21846,19681,174852,338989,478897,478897
Gabon,1953,GA,GAB,AFR,27864,42781,70645,38728,34726,30512,25622,19493,15887,164968,27826,43158,70984,39105,35590,31663,27312,21955,19967,175592,340560,482183,482183
Gabon,1954,GA,GAB,AFR,28407,43222,71629,38812,34820,30596,25736,19632,16164,165760,28396,43600,71996,39190,35652,31761,27408,22064,20236,176311,342071,485694,485694
Gabon,1955,GA,GAB,AFR,28876,43892,72768,38864,34917,30683,25848,19765,16434,166511,28888,44265,73153,39247,35724,31859,27507,22176,20507,177020,343531,489459,489459
Gabon,1956,GA,GAB,AFR,29355,44692,74047,38912,35026,30773,25963,19898,16698,167270,29351,45098,74449,39305,35800,31959,27614,22294,20781,177753,345023,493528,493528
Gabon,1957,GA,GAB,AFR,29902,45556,75458,38972,35145,30866,26081,20031,16955,168050,29882,45987,75869,39377,35885,32063,27730,22405,21056,178516,346566,497905,497905
Gabon,1958,GA,GAB,AFR,30526,46483,77009,39063,35276,30967,26198,20164,17212,168880,30487,46938,77425,39487,35982,32170,27849,22526,21323,179337,348217,502647,502647
Gabon,1959,GA,GAB,AFR,31240,47458,78698,39212,35405,31075,26308,20292,17459,169751,31179,47938,79117,39645,36082,32275,27972,22644,21590,180208,349959,507784,507784
Gabon,1960,GA,GAB,AFR,32039,48468,80507,39451,35525,31189,26421,20422,17709,170717,31958,48971,80929,39892,36186,32386,28094,22764,21865,181187,351904,513340,513340
Gabon,1961,GA,GAB,AFR,32914,49508,82422,39779,35665,31311,26534,20554,17952,171795,32809,50038,82847,40221,36308,32494,28222,22889,22133,182267,354062,519329,519329
Gabon,1962,GA,GAB,AFR,33861,50590,84451,40180,35828,31442,26650,20685,18190,172975,33735,51146,84881,40625,36454,32601,28353,23013,22398,183444,356419,525754,525754
Gabon,1963,GA,GAB,AFR,34850,51832,86682,40583,35997,31579,26764,20818,18433,174174,34704,52386,87090,41042,36608,32709,28485,23137,22660,184641,358815,532592,532592
Gabon,1964,GA,GAB,AFR,35847,53203,89050,41065,36134,31718,26881,20951,18660,175409,35683,53763,89446,41532,36746,32826,28620,23270,22931,185925,361334,539830,539830
Gabon,1965,GA,GAB,AFR,36864,54585,91449,41764,36240,31865,27003,21085,18896,176853,36685,55144,91829,42234,36858,32947,28757,23409,23195,187400,364253,547535,547535
Gabon,1966,GA,GAB,AFR,37918,56047,93965,42595,36345,32022,27131,21222,19131,178446,37723,56570,94293,43093,36972,33075,28895,23547,23462,189044,367490,555748,555748
Gabon,1967,GA,GAB,AFR,39001,57634,96635,43482,36462,32184,27260,21356,19364,180108,38797,58122,96919,44011,37102,33208,29033,23691,23728,190773,370881,564436,564436
Gabon,1968,GA,GAB,AFR,40123,59327,99450,44428,36604,32354,27396,21490,19595,181867,39909,59781,99690,44986,37259,33348,29173,23837,23999,192602,374469,573611,573611
Gabon,1969,GA,GAB,AFR,41350,61148,102498,45613,37010,32627,27579,21641,19849,184319,41127,61573,102700,46215,37677,33589,29349,23999,24284,195113,379432,584628,584628
Gabon,2031,GA,GAB,AFR,159214,306848,466062,272436,202999,190170,150208,86256,58692,960761,157157,303089,460246,270268,201823,178571,136920,82735,65909,936226,1896987,2823293,2823293
Gabon,2032,GA,GAB,AFR,160499,307535,468034,279266,207004,190027,155011,90188,61016,982512,158459,303817,462276,276869,206350,179879,141654,86329,68402,959483,1941995,2872311,2872311
Gabon,2033,GA,GAB,AFR,161973,308248,470221,285371,211742,189657,159545,94317,63482,1004114,159945,304579,464524,282784,211443,181016,146259,90131,71021,982654,1986768,2921510,2921510
Gabon,2034,GA,GAB,AFR,163495,309148,472643,290534,217322,189230,163704,98606,66091,1025487,161476,305531,467007,287797,217229,182111,150643,94097,73780,1005657,2031144,2970796,2970796
Gabon,2035,GA,GAB,AFR,165043,310320,475363,294594,223764,188971,167387,103027,68860,1046603,163029,306763,469792,291749,223743,183341,154723,98218,76709,1028483,2075086,3020240,3020240
Gabon,2036,GA,GAB,AFR,166587,311823,478410,297603,230931,189012,170532,107582,71812,1067472,164580,308336,472916,294680,230886,184791,158435,102502,79823,1051117,2118589,3069919,3069919
Gabon,2037,GA,GAB,AFR,168077,313517,481594,299948,238528,189417,173144,112211,74970,1088218,166077,310101,476178,296974,238405,186488,161791,106894,83136,1073688,2161906,3119671,3119671
Gabon,2038,GA,GAB,AFR,169501,315452,484953,301783,246266,190284,175220,116863,78309,1108725,167511,312105,479616,298782,246022,188506,164790,111365,86642,1096107,2204832,3169407,3169407
Gabon,2039,GA,GAB,AFR,170963,317704,488667,303047,254031,191794,176704,121506,81819,1128901,168984,314418,483402,300058,253638,191015,167348,115896,90322,1118277,2247178,3219237,3219237
Gabon,2040,GA,GAB,AFR,172469,320208,492677,303913,261648,194117,177566,126066,85507,1148817,170502,316974,487476,300961,261087,194198,169413,120420,94192,1140271,2289088,3269247,3269247
Gabon,2041,GA,GAB,AFR,173947,322878,496825,304637,268919,197279,177893,130489,89405,1168622,171987,319701,491688,301741,268182,198076,171047,124892,98275,1162213,2330835,3319354,3319354
Gabon,2042,GA,GAB,AFR,175397,325658,501055,305344,275638,201210,177832,134738,93520,1188282,173439,322533,495972,302499,274748,202578,172376,129295,102601,1184097,2372379,3369410,3369410
Gabon,2043,GA,GAB,AFR,176786,328560,505346,306076,281651,205855,177575,138755,97847,1207759,174836,325484,500320,303288,280638,207632,173548,133584,107167,1205857,2413616,3419273,3419273
Gabon,2044,GA,GAB,AFR,178023,331542,509565,306992,286740,211316,177271,142448,102356,1227123,176077,328516,504593,304271,285640,213365,174687,137678,111943,1227584,2454707,3468867,3468867
Gabon,2045,GA,GAB,AFR,179019,334600,513619,308176,290748,217609,177127,145727,107057,1246444,177081,331619,508700,305523,289595,219818,175955,141495,116952,1249338,2495782,3518104,3518104
Gabon,2046,GA,GAB,AFR,179805,337623,517428,309687,293733,224603,177272,148541,111956,1265792,177875,334682,512557,307121,292538,226893,177442,144985,122215,1271194,2536986,3566979,3566979
Gabon,2047,GA,GAB,AFR,180411,340566,520977,311386,296073,232013,177767,150892,117011,1285142,178493,337661,516154,308915,294858,234333,179178,148153,127699,1293136,2578278,3615404,3615404
Gabon,2048,GA,GAB,AFR,180842,343383,524225,313328,297910,239562,178698,152786,122180,1304464,178934,340523,519457,310941,296700,241876,181213,150996,133358,1315084,2619548,3663233,3663233
Gabon,2049,GA,GAB,AFR,181147,346086,527233,315583,299192,247133,180234,154161,127411,1323714,179248,343266,522514,313271,298010,249413,183729,153444,139160,1337027,2660741,3710489,3710489
Gabon,2050,GA,GAB,AFR,181305,348599,529904,318090,300083,254565,182532,154994,132671,1342935,179412,345817,525229,315843,298953,256789,186893,155437,145072,1358987,2701922,3757053,3757053
United Kingdom of Great Britain and Northern Ireland,1970,GB,GBR,EUR,2357925,4513372,6871297,4105818,3475586,3292333,3346749,3140373,2774243,20135102,2264298,4279454,6543752,3987071,3387812,3278484,3484868,3486586,4475188,22100009,42235111,55650166,55650166
United Kingdom of Great Britain and Northern Ireland,1971,GB,GBR,EUR,2316867,4594902,6911769,4094778,3549663,3269271,3352072,3114224,2835501,20215509,2222407,4362280,6584687,3963504,3463812,3246429,3479686,3457821,4552692,22163944,42379453,55875903,55875903
United Kingdom of Great Britain and Northern Ireland,1972,GB,GBR,EUR,2267219,4654014,6921233,4060181,3657287,3256643,3377099,3059227,2894950,20305387,2170754,4422614,6593368,3918650,3573393,3224509,3494751,3399053,4626963,22237319,42542706,56057315,56057315
United Kingdom of Great Britain and Northern Ireland,1973,GB,GBR,EUR,2195115,4694380,6889495,4037084,3761505,3253340,3412208,2985480,2951347,20400964,2096515,4463423,6559938,3886811,3680082,3211847,3520235,3321099,4696158,22316232,42717196,56166630,56166630
United Kingdom of Great Britain and Northern Ireland,1974,GB,GBR,EUR,2109731,4717205,6826936,4048661,3840709,3251332,3418386,2938477,3008423,20505988,2010134,4486102,6496236,3890203,3761509,3200766,3517611,3269974,4764565,22404628,42910616,56233776,56233776
United Kingdom of Great Britain and Northern Ireland,1975,GB,GBR,EUR,2015863,4718628,6734491,4090217,3908934,3242531,3371966,2944753,3063777,20622178,1916836,4486923,6403759,3924426,3830620,3184168,3461701,3273239,4832267,22506421,43128599,56266842,56266842
United Kingdom of Great Britain and Northern Ireland,1976,GB,GBR,EUR,1912651,4701305,6613956,4157217,3970334,3229027,3307036,2970712,3113160,20747486,1816033,4467283,6283316,3986711,3891526,3166523,3385480,3296387,4891845,22618472,43365958,56263232,56263232
United Kingdom of Great Britain and Northern Ireland,1977,GB,GBR,EUR,1817739,4656519,6474258,4238900,4014212,3232256,3252628,2983342,3162222,20883560,1724886,4419459,6144345,4066180,3935413,3168365,3319208,3303931,4949584,22742681,43626241,56244840,56244840
United Kingdom of Great Britain and Northern Ireland,1978,GB,GBR,EUR,1756248,4574793,6331041,4323703,4036659,3266699,3207722,2979990,3213058,21027831,1666574,4335647,6002221,4151087,3958960,3202404,3262890,3292188,5012153,22879682,43907513,56240768,56240768
United Kingdom of Great Britain and Northern Ireland,1979,GB,GBR,EUR,1737037,4461974,6199011,4413143,4045168,3318753,3170081,2968836,3257472,21173453,1648486,4224012,5872498,4242014,3969242,3255813,3214610,3269437,5069073,23020189,44193642,56265154,56265154
United Kingdom of Great Britain and Northern Ireland,1980,GB,GBR,EUR,1752460,4329696,6082156,4504198,4046779,3371232,3140692,2962582,3294416,21319899,1664390,4095766,5760156,4336038,3973563,3311836,3176082,3249804,5116792,23164115,44484014,56326328,56326328
United Kingdom of Great Britain and Northern Ireland,1981,GB,GBR,EUR,1781390,4192552,5973942,4577614,4031436,3443205,3118840,2971137,3317489,21459721,1694407,3963819,5658226,4414243,3962730,3388213,3146335,3246142,5146298,23303961,44763682,56395846,56395846
United Kingdom of Great Britain and Northern Ireland,1982,GB,GBR,EUR,1812615,4054892,5867507,4628696,3989902,3549551,3106770,2997042,3317540,21589501,1726208,3833380,5559588,4470127,3928235,3499773,3126452,3261400,5147553,23433540,45023041,56450133,56450133
United Kingdom of Great Britain and Northern Ireland,1983,GB,GBR,EUR,1839648,3928208,5767856,4662261,3957158,3652716,3103866,3031138,3302712,21709851,1753380,3714638,5468018,4507602,3904080,3609716,3115942,3286714,5131830,23555884,45265735,56501612,56501612
United Kingdom of Great Britain and Northern Ireland,1984,GB,GBR,EUR,1850999,3829618,5680617,4678281,3959477,3729882,3102338,3041522,3312421,21823921,1765813,3623495,5389308,4527361,3914385,3694847,3107174,3287432,5143197,23674396,45498317,56568253,56568253
United Kingdom of Great Britain and Northern Ireland,1985,GB,GBR,EUR,1853820,3756267,5610087,4672347,3991841,3796404,3094592,3008125,3362448,21925757,1769261,3558253,5327514,4526232,3953499,3768947,3093665,3238440,5198897,23779680,45705437,56643045,56643045
United Kingdom of Great Britain and Northern Ireland,1986,GB,GBR,EUR,1863406,3687626,5551032,4647636,4048626,3856872,3082926,2958518,3424189,22018767,1777873,3498895,5276768,4505740,4017651,3836316,3079753,3170454,5265434,23875348,45894115,56721909,56721909
United Kingdom of Great Britain and Northern Ireland,1987,GB,GBR,EUR,1884622,3629120,5513742,4597705,4119583,3900029,3088655,2917938,3478767,22102677,1798113,3449166,5247279,4458783,4096798,3887735,3085262,3112676,5321372,23962626,46065303,56826322,56826322
United Kingdom of Great Britain and Northern Ireland,1988,GB,GBR,EUR,1912751,3598146,5510897,4513240,4194477,3922300,3125926,2885876,3522027,22163846,1825945,3425042,5250987,4377544,4181404,3918660,3122819,3064696,5361797,24026920,46190766,56952648,56952648
United Kingdom of Great Britain and Northern Ireland,1989,GB,GBR,EUR,1937807,3593380,5531187,4398007,4275195,3931586,3181412,2861140,3555230,22202570,1850822,3424012,5274834,4268602,4272617,3935713,3180023,3025381,5385172,24067508,46270078,57076099,57076099
United Kingdom of Great Britain and Northern Ireland,1990,GB,GBR,EUR,1958010,3613319,5571329,4263043,4359531,3934908,3238506,2844338,3587068,22227394,1870584,3444612,5315196,4142630,4367226,3946476,3240537,2995734,5403927,24096530,46323924,57210442,57210442
United Kingdom of Great Britain and Northern Ireland,1991,GB,GBR,EUR,1975586,3651842,5627428,4122535,4430532,3922347,3314622,2834635,3619118,22243789,1887462,3482105,5369567,4012269,4447276,3941958,3321365,2975218,5420575,24118661,46362450,57359454,57359454
United Kingdom of Great Britain and Northern Ireland,1992,GB,GBR,EUR,1984293,3703924,5688217,3982219,4483904,3884163,3424301,2834553,3648219,22257359,1894968,3532324,5427292,3883302,4506715,3913065,3437079,2965050,5431158,24136369,46393728,57509240,57509240
United Kingdom of Great Britain and Northern Ireland,1993,GB,GBR,EUR,1979530,3758989,5738519,3854867,4522656,3854897,3531414,2842869,3670775,22277478,1888858,3585347,5474205,3766169,4550326,3892804,3551541,2963841,5432580,24157261,46434739,57647463,57647463
United Kingdom of Great Britain and Northern Ireland,1994,GB,GBR,EUR,1966778,3797181,5763959,3757944,4545739,3860894,3613434,2852565,3693563,22324139,1874943,3621705,5496648,3676682,4579796,3905771,3641028,2964292,5433590,24201159,46525298,57785900,57785900
United Kingdom of Great Britain and Northern Ireland,1995,GB,GBR,EUR,1944291,3824956,5769247,3688548,4549448,3896956,3684861,2856038,3718979,22394830,1852195,3645825,5498020,3613493,4592214,3947089,3718605,2959674,5437195,24268270,46663100,57930364,57930364
United Kingdom of Great Britain and Northern Ireland,1996,GB,GBR,EUR,1914855,3857073,5771928,3627653,4538610,3957811,3749657,2854736,3743739,22472206,1822925,3673596,5496521,3557423,4589460,4013373,3788598,2953314,5435758,24337926,46810132,58078586,58078586
United Kingdom of Great Britain and Northern Ireland,1997,GB,GBR,EUR,1888365,3888881,5777246,3581335,4508990,4034096,3797782,2868880,3770132,22561215,1796689,3703262,5499951,3513712,4564912,4095167,3842664,2963907,5431422,24411784,46972999,58250198,58250198
United Kingdom of Great Britain and Northern Ireland,1998,GB,GBR,EUR,1865342,3912553,5777895,3565913,4452732,4115512,3825610,2911223,3793941,22664931,1774566,3726150,5500716,3499453,4510624,4183499,3876222,3003535,5421454,24494787,47159718,58438321,58438321
United Kingdom of Great Britain and Northern Ireland,1999,GB,GBR,EUR,1843300,3925404,5768704,3580345,4375136,4202916,3839986,2969445,3817022,22784850,1753851,3738862,5492713,3513313,4433428,4278532,3895064,3060697,5407902,24588936,47373786,58635202,58635202
United Kingdom of Great Britain and Northern Ireland,2000,GB,GBR,EUR,1819303,3925294,5744597,3622818,4286716,4295510,3847591,3028848,3848459,22929942,1731555,3739385,5470940,3554624,4343814,4377447,3906014,3120533,5402136,24704568,47634510,58850043,58850043
United Kingdom of Great Britain and Northern Ireland,2001,GB,GBR,EUR,1791698,3919203,5710901,3684455,4199341,4378197,3840786,3105219,3890513,23098511,1706430,3733025,5439455,3617064,4253936,4464501,3901654,3198336,5407655,24843146,47941657,59092016,59092016
United Kingdom of Great Britain and Northern Ireland,2002,GB,GBR,EUR,1763680,3909792,5673472,3758658,4117416,4445738,3810933,3211721,3939000,23283466,1680426,3722461,5402887,3694612,4169029,4533793,3874080,3307640,5416711,24995865,48279331,59355690,59355690
United Kingdom of Great Britain and Northern Ireland,2003,GB,GBR,EUR,1746388,3891323,5637711,3836666,4051529,4500528,3789382,3315008,3991219,23484332,1663765,3704045,5367810,3776547,4098004,4589419,3854432,3414672,5426864,25159938,48644270,59649799,59649799
United Kingdom of Great Britain and Northern Ireland,2004,GB,GBR,EUR,1746528,3865873,5612401,3899123,4017102,4542941,3801065,3394083,4046692,23701006,1663820,3680186,5344006,3841343,4056320,4633170,3866899,3497088,5443617,25338437,49039443,59995851,59995851
United Kingdom of Great Britain and Northern Ireland,2005,GB,GBR,EUR,1761885,3828231,5590116,3950611,4010161,4569683,3841714,3462459,4100532,23935160,1678948,3645755,5324703,3890765,4042837,4662470,3907225,3567844,5462618,25533759,49468919,60383741,60383741
United Kingdom of Great Britain and Northern Ireland,2006,GB,GBR,EUR,1792461,3780066,5572527,4003653,4008814,4584066,3906785,3524095,4152876,24180289,1708927,3600748,5309675,3939559,4037051,4678884,3972374,3631201,5482146,25741215,49921504,60803700,60803700
United Kingdom of Great Britain and Northern Ireland,2007,GB,GBR,EUR,1838659,3734969,5573628,4053065,4015410,4580413,3987266,3570471,4218662,24425287,1753396,3556835,5310231,3985606,4040981,4674606,4053920,3680007,5516418,25951538,50376825,61260676,61260676
United Kingdom of Great Britain and Northern Ireland,2008,GB,GBR,EUR,1890859,3703002,5593861,4093074,4044498,4550296,4072314,3598940,4305885,24665007,1803405,3525453,5328858,4020789,4068338,4640459,4143239,3710569,5571032,26154426,50819433,61742151,61742151
United Kingdom of Great Britain and Northern Ireland,2009,GB,GBR,EUR,1937391,3687461,5624852,4122809,4092710,4497879,4162576,3616558,4410207,24902739,1848216,3510698,5358914,4042909,4114638,4582664,4240380,3729647,5646637,26356875,51259614,62243378,62243378
United Kingdom of Great Britain and Northern Ireland,2010,GB,GBR,EUR,1981143,3684049,5665192,4140973,4155467,4431003,4257604,3629994,4522528,25137569,1889754,3508320,5398074,4050302,4176152,4510785,4342811,3744853,5734312,26559215,51696784,62760039,62760039
United Kingdom of Great Britain and Northern Ireland,2011,GB,GBR,EUR,2021770,3690911,5712681,4156483,4222583,4359320,4342788,3631687,4657395,25370256,1927753,3516595,5444348,4048986,4246070,4434956,4434536,3747885,5846641,26759074,52129330,63286362,63286362
United Kingdom of Great Britain and Northern Ireland,2012,GB,GBR,EUR,2052085,3711942,5764027,4171280,4289227,4286742,4412902,3613501,4825104,25598756,1956224,3536962,5493186,4041961,4319510,4359013,4509633,3730373,5992274,26952764,52551520,63808727,63808727
United Kingdom of Great Britain and Northern Ireland,2013,GB,GBR,EUR,2065534,3748771,5814305,4175784,4351869,4223735,4469755,3604217,4989887,25815247,1968348,3570982,5539330,4025454,4386605,4291874,4572223,3722484,6134778,27133418,52948665,64302297,64302297
United Kingdom of Great Britain and Northern Ireland,2014,GB,GBR,EUR,2066496,3796435,5862931,4169717,4395530,4185900,4513550,3625711,5130318,26020726,1967951,3616131,5584082,4001708,4427237,4249730,4623148,3746236,6257702,27305761,53326487,64773504,64773504
United Kingdom of Great Britain and Northern Ireland,2015,GB,GBR,EUR,2062961,3857763,5920724,4146811,4425610,4171189,4541087,3673513,5249151,26207361,1963050,3674784,5637834,3965278,4445643,4231823,4659262,3796536,6359914,27458456,53665817,65224364,65224364
United Kingdom of Great Britain and Northern Ireland,2016,GB,GBR,EUR,2053279,3934230,5987509,4108313,4456956,4157771,4554981,3744131,5352754,26374906,1951951,3747422,5699373,3915082,4460277,4218154,4681532,3870281,6448084,27593410,53968316,65655203,65655203
United Kingdom of Great Britain and Northern Ireland,2017,GB,GBR,EUR,2033651,4017880,6051531,4068475,4487807,4147003,4549216,3829095,5451301,26532897,1931715,3826536,5758251,3862859,4472534,4210714,4681234,3959633,6535150,27722124,54255021,66064804,66064804
United Kingdom of Great Britain and Northern Ireland,2018,GB,GBR,EUR,2006332,4090943,6097275,4036832,4513649,4154180,4516262,3917261,5549315,26687499,1904749,3895029,5799778,3822009,4476236,4222561,4649360,4055646,6622628,27848440,54535939,66432993,66432993
United Kingdom of Great Britain and Northern Ireland,2019,GB,GBR,EUR,1973828,4144570,6118398,4016329,4534181,4178399,4461199,4009287,5654271,26853666,1873210,3944472,5817682,3797291,4471083,4250085,4592509,4157665,6720291,27988924,54842590,66778659,66778659
United Kingdom of Great Britain and Northern Ireland,2020,GB,GBR,EUR,1927937,4187887,6115824,4003931,4546833,4218514,4390190,4101625,5745456,27006549,1829323,3983625,5812948,3784766,4456263,4291613,4519567,4262177,6809760,28124146,55130695,67059474,67059474
United Kingdom of Great Britain and Northern Ireland,2021,GB,GBR,EUR,1873875,4219467,6093342,3999456,4557495,4266071,4312898,4179387,5829936,27145243,1777777,4011525,5789302,3783168,4436101,4342704,4441086,4353081,6897015,28253155,55398398,67281039,67281039
United Kingdom of Great Britain and Northern Ireland,2022,GB,GBR,EUR,1823400,4223574,6046974,4000456,4572156,4321868,4238156,4243757,5937106,27313499,1729710,4014913,5744623,3789365,4418687,4403429,4362293,4425788,7004279,28403841,55717340,67508936,67508936
United Kingdom of Great Britain and Northern Ireland,2023,GB,GBR,EUR,1784062,4196322,5980384,4010702,4578363,4383634,4176861,4297663,6057979,27505202,1692447,3989192,5681639,3805335,4399353,4464802,4293014,4484646,7122422,28569572,56074774,67736802,67736802
United Kingdom of Great Britain and Northern Ireland,2024,GB,GBR,EUR,1759461,4150414,5909875,4035080,4567178,4432195,4141731,4339171,6183212,27698567,1669287,3945068,5614355,3834331,4371565,4504230,4249871,4531258,7247393,28738648,56437215,67961439,67961439
United Kingdom of Great Britain and Northern Ireland,2025,GB,GBR,EUR,1749810,4086004,5835814,4076202,4532990,4471869,4130425,4366082,6314694,27892262,1660204,3883116,5543320,3879395,4328076,4526094,4231837,4563677,7380127,28909206,56801468,68180606,68180606
United Kingdom of Great Britain and Northern Ireland,2026,GB,GBR,EUR,1748908,4007991,5756899,4134493,4478397,4516391,4121787,4380840,6455547,28087455,1659355,3807615,5466970,3940328,4268376,4548092,4219299,4582741,7523640,29082476,57169931,68393799,68393799
United Kingdom of Great Britain and Northern Ireland,2027,GB,GBR,EUR,1748386,3927374,5675760,4201347,4418938,4563172,4116783,4377016,6604363,28281619,1658775,3729653,5388428,4008488,4205309,4570570,4214397,4579629,7676595,29254988,57536607,68600792,68600792
United Kingdom of Great Britain and Northern Ireland,2028,GB,GBR,EUR,1746750,3853244,5599994,4259019,4366533,4605800,4130105,4347774,6757104,28466335,1657156,3658365,5315521,4066572,4152706,4586757,4229120,4546508,7836322,29417985,57884320,68799832,68799832
United Kingdom of Great Britain and Northern Ireland,2029,GB,GBR,EUR,1744305,3788149,5532454,4298728,4326437,4642220,4160583,4298299,6913045,28639312,1654809,3596226,5251035,4106182,4115963,4595513,4259876,4490179,8001306,29569019,58208331,68991815,68991815
United Kingdom of Great Britain and Northern Ireland,2030,GB,GBR,EUR,1741572,3724944,5466516,4328671,4296013,4669830,4207715,4235595,7068954,28806778,1652190,3536284,5188474,4135246,4091894,4594809,4306083,4419552,8166414,29713998,58520776,69175770,69175770
United Kingdom of Great Britain and Northern Ireland,1950,GB,GBR,EUR,2210995,3540504,5751499,3135139,3608412,3797128,3191341,2306846,2257162,18296028,2104570,3404137,5508707,3368626,3701882,3897173,3512826,2849324,3169002,20498833,38794861,50055065,50055065
United Kingdom of Great Britain and Northern Ireland,1951,GB,GBR,EUR,2178429,3637413,5815842,3129581,3611508,3759102,3264106,2321654,2265340,18351291,2074184,3490429,5564613,3334462,3692455,3862392,3551759,2878426,3220660,20540154,38891445,50271904,50271904
United Kingdom of Great Britain and Northern Ireland,1952,GB,GBR,EUR,2104789,3760838,5865627,3138891,3635883,3690200,3336846,2340170,2273361,18415351,2005063,3605575,5610638,3314915,3704072,3796803,3590890,2908800,3277721,20593201,39008552,50484813,50484813
United Kingdom of Great Britain and Northern Ireland,1953,GB,GBR,EUR,2037983,3874407,5912390,3161466,3666531,3605876,3406634,2365580,2290605,18496692,1941828,3712035,5653863,3308948,3721755,3715520,3630486,2941257,3347708,20665674,39162366,50728620,50728620
United Kingdom of Great Britain and Northern Ireland,1954,GB,GBR,EUR,2000733,3961093,5961826,3187607,3662837,3552269,3462508,2404328,2304999,18574548,1905388,3792295,5697683,3306427,3707253,3664236,3663494,2979660,3414805,20735875,39310423,50969939,50969939
United Kingdom of Great Britain and Northern Ireland,1955,GB,GBR,EUR,1981960,4032921,6014881,3209363,3606655,3549787,3501101,2459350,2314382,18640638,1885971,3858109,5744080,3298466,3643245,3662664,3688538,3024456,3476294,20793663,39434301,51193266,51193266
United Kingdom of Great Britain and Northern Ireland,1956,GB,GBR,EUR,1986146,4093114,6079260,3230183,3530937,3566967,3527027,2521698,2322684,18699496,1888721,3912563,5801284,3289689,3561222,3678433,3708391,3068857,3534984,20841576,39541072,51421613,51421613
United Kingdom of Great Britain and Northern Ireland,1957,GB,GBR,EUR,2012582,4132929,6145511,3267665,3466619,3571437,3546099,2584965,2335451,18772236,1912588,3947934,5860522,3300446,3488992,3679074,3725679,3110989,3598950,20904130,39676366,51682399,51682399
United Kingdom of Great Britain and Northern Ireland,1958,GB,GBR,EUR,2047262,4150646,6197908,3332153,3416621,3558751,3561005,2650703,2348618,18867851,1944711,3962295,5907006,3342163,3427645,3659715,3740927,3154794,3662803,20988047,39855898,51960813,51960813
United Kingdom of Great Britain and Northern Ireland,1959,GB,GBR,EUR,2086649,4153570,6240219,3409823,3377528,3539567,3570130,2718959,2360452,18976459,1981908,3961969,5943877,3401727,3374920,3630448,3751315,3200363,3722308,21081081,40057540,52241647,52241647
United Kingdom of Great Britain and Northern Ireland,1960,GB,GBR,EUR,2140038,4148102,6288140,3483916,3349246,3528373,3564364,2788245,2376332,19090476,2033064,3952403,5985467,3462828,3332705,3607552,3746313,3245570,3783973,21178941,40269417,52543017,52543017
United Kingdom of Great Britain and Northern Ireland,1961,GB,GBR,EUR,2200989,4125068,6326057,3575321,3330654,3535563,3533319,2856280,2392011,19223148,2092643,3924543,6017186,3544101,3300842,3603806,3714960,3287880,3843273,21294862,40518010,52861251,52861251
United Kingdom of Great Britain and Northern Ireland,1962,GB,GBR,EUR,2258949,4081001,6339950,3695493,3323334,3562503,3471768,2922557,2405368,19381023,2150344,3875891,6026235,3654849,3281035,3620032,3652566,3328854,3899092,21436428,40817451,53183630,53183630
United Kingdom of Great Britain and Northern Ireland,1963,GB,GBR,EUR,2314625,4051136,6365761,3806885,3325497,3596349,3392807,2984643,2420306,19526487,2207334,3841077,6048411,3757269,3272026,3643398,3572040,3369111,3954017,21567861,41094348,53508514,53508514
United Kingdom of Great Britain and Northern Ireland,1964,GB,GBR,EUR,2372671,4055776,6428447,3890908,3328608,3597028,3343546,3036126,2451517,19647733,2266968,3839426,6106394,3833169,3264825,3635653,3520440,3403998,4020836,21678921,41326654,53861500,53861500
United Kingdom of Great Britain and Northern Ireland,1965,GB,GBR,EUR,2421831,4091844,6513675,3960902,3324971,3544205,3347892,3074530,2500085,19752585,2317723,3868499,6186222,3895475,3251317,3576095,3521849,3431454,4100886,21777076,41529661,54229565,54229565
United Kingdom of Great Britain and Northern Ireland,1966,GB,GBR,EUR,2446596,4156352,6602948,4021229,3317649,3472493,3371804,3100626,2550590,19834391,2344634,3927123,6271757,3947609,3236108,3497470,3542051,3451740,4176439,21851417,41685808,54560502,54560502
United Kingdom of Great Britain and Northern Ireland,1967,GB,GBR,EUR,2449925,4238241,6688166,4063671,3326798,3412387,3382009,3120424,2607558,19912847,2350149,4005003,6355152,3981184,3240257,3428768,3547531,3468637,4253837,21920214,41833061,54876365,54876365
United Kingdom of Great Britain and Northern Ireland,1968,GB,GBR,EUR,2436026,4324718,6760744,4087191,3365625,3363992,3374502,3136413,2665351,19993074,2338298,4090223,6428521,3994365,3276345,3370211,3533325,3483181,4329487,21986914,41979988,55169244,55169244
United Kingdom of Great Britain and Northern Ireland,1969,GB,GBR,EUR,2403090,4416852,6819942,4099614,3420832,3323769,3358117,3145045,2718119,20065496,2307811,4182456,6490267,3994418,3331265,3319641,3507357,3491757,4400382,22044820,42110316,55420519,55420519
United Kingdom of Great Britain and Northern Ireland,2031,GB,GBR,EUR,1738517,3663606,5402123,4347322,4274595,4694969,4264090,4168861,7218842,28968679,1649296,3478067,5127363,4152879,4079708,4588592,4363055,4345130,8324213,29853577,58822256,69351743,69351743
United Kingdom of Great Britain and Northern Ireland,2032,GB,GBR,EUR,1736225,3609733,5345958,4345364,4267484,4716903,4324668,4102465,7362489,29119373,1647190,3426784,5073974,4151296,4080950,4578258,4426697,4270597,8474516,29982314,59101687,69521624,69521624
United Kingdom of Great Britain and Northern Ireland,2033,GB,GBR,EUR,1735681,3568843,5304524,4318270,4278076,4723549,4386374,4046739,7499411,29252419,1646765,3387965,5034730,4125652,4097041,4559257,4487839,4205000,8618671,30093460,59345879,69685135,69685135
United Kingdom of Great Britain and Northern Ireland,2034,GB,GBR,EUR,1736268,3541871,5278139,4272539,4302721,4712950,4435268,4016374,7627734,29367586,1647388,3362511,5009899,4081624,4126115,4531834,4527380,4165056,8754635,30186644,59554230,69842265,69842265
United Kingdom of Great Britain and Northern Ireland,2035,GB,GBR,EUR,1738777,3529551,5268328,4208327,4344007,4679551,4475593,4009076,7747350,29463904,1649820,3350853,5000673,4019779,4171215,4488779,4549669,4149729,8881899,30261070,59724974,69993981,69993981
United Kingdom of Great Britain and Northern Ireland,2036,GB,GBR,EUR,1743076,3525646,5268722,4130544,4402357,4625939,4520699,4004407,7863713,29547659,1653945,3347148,5001093,3944401,4232143,4429605,4572119,4139854,9004715,30322837,59870496,70140305,70140305
United Kingdom of Great Britain and Northern Ireland,2037,GB,GBR,EUR,1748655,3522885,5271540,4050166,4469210,4567489,4567934,4003066,7969447,29627312,1659215,3344497,5003712,3866572,4300267,4367090,4595021,4137326,9113913,30380189,60007501,70282755,70282755
United Kingdom of Great Britain and Northern Ireland,2038,GB,GBR,EUR,1755370,3520759,5276129,3976271,4526910,4516035,4611007,4019032,8054374,29703629,1665514,3342490,5008004,3795405,4358330,4314996,4611653,4153672,9199614,30433670,60137299,70421425,70421425
United Kingdom of Great Britain and Northern Ireland,2039,GB,GBR,EUR,1763083,3518947,5282030,3911397,4566706,4476809,4647926,4051246,8122817,29776901,1672768,3340802,5013570,3733387,4397952,4278699,4620908,4185451,9267389,30483786,60260687,70556285,70556285
United Kingdom of Great Britain and Northern Ireland,2040,GB,GBR,EUR,1771929,3518766,5290695,3848414,4596776,4447194,4676172,4099325,8178908,29846789,1681139,3340651,5021790,3673565,4427055,4255039,4620820,4232164,9321564,30530207,60376996,70689476,70689476
United Kingdom of Great Britain and Northern Ireland,2041,GB,GBR,EUR,1781422,3520053,5301475,3787306,4615605,4426536,4701954,4156082,8225721,29913204,1690134,3341912,5032046,3615465,4444745,4243214,4615274,4289230,9365140,30573068,60486272,70819795,70819795
United Kingdom of Great Britain and Northern Ireland,2042,GB,GBR,EUR,1790271,3523378,5313649,3733650,4613913,4420094,4724546,4216706,8267408,29976317,1698525,3345105,5043630,3564292,4443265,4244784,4605661,4352674,9401851,30612527,60588844,70946133,70946133
United Kingdom of Great Britain and Northern Ireland,2043,GB,GBR,EUR,1797858,3529587,5327445,3692945,4587173,4431225,4732085,4278448,8313693,30035569,1705753,3351010,5056763,3525574,4417773,4261139,4587482,4413684,9442240,30647892,60683461,71067664,71067664
United Kingdom of Great Britain and Northern Ireland,2044,GB,GBR,EUR,1803349,3537920,5341269,3666124,4541865,4456268,4722622,4328032,8376569,30091480,1711017,3358917,5069934,3500202,4373926,4290409,4560954,4453761,9500875,30680127,60771607,71182807,71182807
United Kingdom of Great Britain and Northern Ireland,2045,GB,GBR,EUR,1805930,3549306,5355236,3653916,4478134,4497777,4690708,4369580,8453936,30144051,1713477,3369748,5083225,3488605,4312297,4335606,4518940,4477186,9576376,30709010,60853061,71291518,71291518
United Kingdom of Great Britain and Northern Ireland,2046,GB,GBR,EUR,1805505,3563126,5368631,3650100,4400885,4556174,4638872,4415774,8531194,30192999,1713088,3382890,5095978,3484950,4237159,4396525,4460976,4500823,9653871,30734304,60927303,71391913,71391913
United Kingdom of Great Britain and Northern Ireland,2047,GB,GBR,EUR,1801448,3577580,5379028,3647421,4321063,4622962,4582246,4463834,8601893,30239419,1709254,3396574,5105828,3482346,4159579,4464582,4399704,4524817,9726286,30757314,60996733,71481591,71481591
United Kingdom of Great Britain and Northern Ireland,2048,GB,GBR,EUR,1794311,3591906,5386217,3645372,4247692,4680629,4532519,4507716,8669934,30283862,1702449,3410124,5112573,3480387,4088655,4522608,4348761,4542595,9795494,30778500,61062362,71561147,71561147
United Kingdom of Great Britain and Northern Ireland,2049,GB,GBR,EUR,1784524,3605136,5389660,3643641,4183301,4720512,4494875,4545545,8738267,30326141,1693114,3422667,5115781,3478748,4026859,4562258,4313482,4553082,9863102,30797531,61123672,71629117,71629117
United Kingdom of Great Britain and Northern Ireland,2050,GB,GBR,EUR,1771993,3616590,5388583,3643537,4120795,4750734,4466734,4574924,8810065,30366789,1681233,3433521,5114754,3478642,3967259,4591433,4290736,4554404,9932370,30814844,61181633,71684966,71684966
Georgia,1970,GE,GEO,EUR,230733,508681,739414,366664,321705,351571,171379,143646,140345,1495310,225748,505392,731140,375023,370436,375129,246683,241852,225449,1834572,3329882,4800426,4800426
Georgia,1971,GE,GEO,EUR,226622,507641,734263,387086,307731,354511,186858,140903,140306,1517395,220331,504813,725144,393649,357640,378281,258249,241752,230968,1860539,3377934,4837333,4837333
Georgia,1972,GE,GEO,EUR,224474,502540,727014,401172,296137,356115,206113,138189,141749,1539475,217806,500811,718617,408639,345037,380446,274961,240130,236083,1885296,3424771,4870399,4870399
Georgia,1973,GE,GEO,EUR,223035,496116,719151,412917,286892,356673,227293,135067,143656,1562498,216152,495248,711400,421343,333485,383338,292831,237640,241870,1910507,3473005,4903551,4903551
Georgia,1974,GE,GEO,EUR,222351,487965,710316,423497,280220,356637,248218,132234,145811,1586617,215608,487581,703189,432870,323465,386673,309399,235440,248578,1936425,3523042,4936538,4936538
Georgia,1975,GE,GEO,EUR,222914,478077,700991,433683,277221,355741,267057,130132,147865,1611699,216172,478180,694352,444051,316528,389613,323461,233682,255948,1963283,3574982,4970320,4970320
Georgia,1976,GE,GEO,EUR,223930,468335,692265,443055,279255,352627,283248,129102,149692,1636979,216798,468913,685711,454372,314883,390286,334911,232263,263454,1990169,3627148,5005133,5005133
Georgia,1977,GE,GEO,EUR,224773,459531,684304,451682,287210,345973,296368,129778,151186,1662197,217199,460233,677432,463550,320309,386955,343549,231709,270799,2016871,3679068,5040802,5040802
Georgia,1978,GE,GEO,EUR,226208,450811,677019,459102,300699,335295,306416,132935,152685,1687132,218262,451514,669776,471340,332452,378794,349500,232581,278457,2043124,3730256,5077051,5077051
Georgia,1979,GE,GEO,EUR,228580,442256,670836,462563,318099,321689,313853,139366,154233,1709803,220619,443036,663655,476183,349288,366209,353586,236291,285813,2067370,3777173,5111667,5111667
Georgia,1980,GE,GEO,EUR,231409,436668,668077,463732,336353,307358,318674,149197,154549,1729863,222990,436890,659880,477877,367806,352453,355178,243833,290870,2088017,3817880,5145843,5145843
Georgia,1981,GE,GEO,EUR,234537,434708,669245,464246,352729,294041,321456,162396,153255,1748123,224990,433468,658458,477323,384937,339844,355451,255194,293329,2106078,3854201,5181893,5181893
Georgia,1982,GE,GEO,EUR,238214,434068,672282,462768,366760,282745,323050,178564,151262,1765149,227560,431260,658820,474804,399623,328231,356821,269494,294307,2123280,3888429,5219538,5219538
Georgia,1983,GE,GEO,EUR,240879,434602,675481,459584,379169,274062,323758,196532,149485,1782590,230082,430276,660358,471558,412232,317422,359601,284423,295779,2141015,3923605,5259444,5259444
Georgia,1984,GE,GEO,EUR,241741,436066,677807,454403,390883,268321,323974,214433,148321,1800335,232231,431119,663350,466561,423775,308233,363181,297845,298705,2158300,3958635,5299787,5299787
Georgia,1985,GE,GEO,EUR,242256,437310,679566,447535,402310,266015,323910,230294,147717,1817781,234420,433155,667575,458780,435174,302599,366394,308728,302264,2173939,3991720,5338867,5338867
Georgia,1986,GE,GEO,EUR,243348,437744,681092,439968,413264,268158,322519,243399,147816,1835124,236747,435204,671951,449778,446562,302243,367674,317311,305944,2189512,4024636,5377672,5377672
Georgia,1987,GE,GEO,EUR,245365,437477,682842,432774,422960,276392,317121,253888,148764,1851899,238805,437142,675947,440612,457445,309130,363845,324483,309181,2204696,4056595,5415383,5415383
Georgia,1988,GE,GEO,EUR,247095,437003,684098,426703,430565,291233,306567,261733,151156,1867957,239302,439519,678821,431723,467420,323834,353242,329865,313174,2219258,4087215,5450139,5450139
Georgia,1989,GE,GEO,EUR,246193,434922,681115,416449,433049,307852,291422,265385,154992,1869149,237867,438736,676603,421584,473108,339618,337669,329710,316933,2218622,4087771,5445481,5445481
Georgia,1990,GE,GEO,EUR,244183,431035,675218,404792,427134,319917,274126,264606,159168,1849743,234846,435470,670316,409721,470749,351433,319948,324641,319874,2196366,4046109,5391636,5391636
Georgia,1991,GE,GEO,EUR,241691,427333,669024,397448,415449,326636,257677,261910,164031,1823151,230037,433367,663404,398800,462495,359784,302226,319841,323382,2166528,3989679,5322105,5322105
Georgia,1992,GE,GEO,EUR,235998,424075,660073,390367,401540,329235,242576,258280,170581,1792579,223002,430904,653906,389528,450993,363905,284984,316232,327119,2132761,3925340,5239328,5239328
Georgia,1993,GE,GEO,EUR,226985,419135,646120,380412,385501,327882,228232,252965,177577,1752569,213439,426397,639836,380030,435289,363944,267622,311941,330158,2088984,3841553,5127511,5127511
Georgia,1994,GE,GEO,EUR,215171,413407,628578,367865,368711,325104,215479,247221,183386,1707766,201672,420529,622201,370622,415926,362413,251759,306945,331706,2039371,3747137,4997913,4997913
Georgia,1995,GE,GEO,EUR,201133,409815,610948,356030,352110,323684,205728,242538,187641,1667731,188117,415701,603818,362665,395376,362451,239631,302643,332416,1995182,3662913,4877676,4877676
Georgia,1996,GE,GEO,EUR,186470,406381,592851,345672,334828,322640,199463,236941,190089,1629633,173916,410510,584426,355392,374702,363530,231698,297257,331784,1954363,3583996,4761272,4761272
Georgia,1997,GE,GEO,EUR,173059,400229,573288,336318,317897,320052,198349,226909,191185,1590710,160907,402360,563267,348347,354851,363667,229773,286549,329580,1912767,3503477,4640032,4640032
Georgia,1998,GE,GEO,EUR,161547,390993,552540,328034,302836,315683,202972,212050,191609,1553184,149762,390798,540560,342229,336568,362558,234957,269447,326355,1872114,3425298,4518405,4518405
Georgia,1999,GE,GEO,EUR,151386,378573,529959,320568,289918,308899,210538,195274,191309,1516506,140045,375868,515913,337182,319844,359490,244161,249669,321776,1832122,3348628,4394501,4394501
Georgia,2000,GE,GEO,EUR,142243,362953,505196,313846,278986,298607,217601,178959,191154,1479153,131436,358040,489476,332789,304892,352891,253169,230453,317157,1791351,3270504,4265172,4265172
Georgia,2001,GE,GEO,EUR,134333,346043,480376,309196,270968,286293,222537,164489,192272,1445755,124011,339318,463329,329830,293229,343719,260039,213056,315154,1755027,3200782,4144481,4144481
Georgia,2002,GE,GEO,EUR,128441,330807,459248,308867,267314,275540,226142,153329,195345,1426537,118321,322547,440868,329932,286809,335093,265563,198791,318290,1734478,3161015,4061128,4061128
Georgia,2003,GE,GEO,EUR,124716,318252,442968,311794,266196,268317,230234,146280,200847,1423668,114469,308165,422634,331787,284245,327068,270854,188443,326166,1728563,3152231,4017825,4017825
Georgia,2004,GE,GEO,EUR,122761,305776,428537,315891,264462,262833,235093,142350,207094,1427723,112286,293899,406185,333531,282986,317335,276204,181436,334922,1726414,3154137,3988860,3988860
Georgia,2005,GE,GEO,EUR,122124,291536,413660,321109,262076,256339,240466,140361,212247,1432598,111514,278431,389945,335553,282016,305498,282258,177126,342520,1724971,3157569,3961182,3961182
Georgia,2006,GE,GEO,EUR,122356,276978,399334,325946,260388,248641,245929,140848,215007,1436759,111730,262715,374445,336847,280940,292967,288943,176115,347523,1723335,3160094,3933867,3933867
Georgia,2007,GE,GEO,EUR,123582,264110,387692,328294,259644,241398,250272,145365,213456,1438429,113015,248681,361696,335434,279965,281304,294988,180366,346591,1718648,3157077,3906470,3906470
Georgia,2008,GE,GEO,EUR,126178,253596,379774,327368,259460,235588,252917,154119,207428,1436880,115681,237081,352762,330521,279508,270806,299775,190631,339038,1710279,3147159,3879698,3879698
Georgia,2009,GE,GEO,EUR,130016,245477,375493,323314,259879,231681,253460,164983,199273,1432590,119599,228034,347633,322272,279944,261624,302872,204271,328505,1699488,3132078,3855200,3855200
Georgia,2010,GE,GEO,EUR,133765,239413,373178,314218,262505,231429,251642,175954,193340,1429088,123591,221306,344897,309851,281795,256191,302367,218725,320742,1689671,3118759,3836831,3836831
Georgia,2011,GE,GEO,EUR,136730,234603,371333,300901,266931,233920,248372,185039,191337,1426500,126957,216153,343110,294628,284139,254848,298037,231114,317949,1680715,3107215,3821662,3821662
Georgia,2012,GE,GEO,EUR,138940,230925,369865,286886,270879,236239,244941,191376,191975,1422296,129544,212421,341965,279573,285219,255162,291533,239765,318974,1670226,3092522,3804356,3804356
Georgia,2013,GE,GEO,EUR,140147,228965,369112,273099,273518,237549,241913,196199,194326,1416604,131019,210705,341724,265098,284628,256001,283729,246197,322923,1658576,3075180,3786023,3786023
Georgia,2014,GE,GEO,EUR,141302,230910,372212,261411,275411,237692,238357,200149,195291,1408311,132082,212960,345042,252095,284294,256387,276947,251521,327434,1648678,3056989,3774235,3774235
Georgia,2015,GE,GEO,EUR,143152,235947,379099,251598,277604,237448,233843,203726,194514,1398733,133499,218284,351783,240379,285247,256411,271377,256510,331592,1641516,3040249,3771132,3771132
Georgia,2016,GE,GEO,EUR,145192,241282,386474,242259,279644,237716,229182,207291,194230,1390322,135214,223797,359011,229285,285996,256755,265554,261534,336175,1635299,3025621,3771110,3771110
Georgia,2017,GE,GEO,EUR,146567,246805,393372,234375,280470,238633,224947,210457,194226,1383108,136552,229239,365791,219900,285418,257520,260104,266139,340544,1629625,3012733,3771900,3771900
Georgia,2018,GE,GEO,EUR,146489,253028,399517,228622,279330,240295,221531,212736,194170,1376684,136663,235268,371931,212855,282725,258922,255370,269869,344462,1624203,3000887,3772325,3772325
Georgia,2019,GE,GEO,EUR,144134,260071,404205,224903,275970,242651,219135,213753,194134,1370546,134652,242174,376826,208036,277631,260993,251625,272344,348608,1619237,2989783,3770811,3770811
Georgia,2020,GE,GEO,EUR,139549,267665,407214,222767,271060,245654,217870,213214,193675,1364240,130513,249615,380128,205121,270860,263600,249142,273167,352444,1614334,2978574,3765912,3765912
Georgia,2021,GE,GEO,EUR,134880,274927,409807,221532,265601,249105,217505,210987,192361,1357091,126245,256669,382914,203524,263510,266476,247865,272123,354678,1608176,2965267,3757980,3757980
Georgia,2022,GE,GEO,EUR,131035,280459,411494,220567,259410,252353,217559,207571,191046,1348506,122711,262007,384718,202462,255445,268951,247375,269476,355953,1599662,2948168,3744385,3744385
Georgia,2023,GE,GEO,EUR,127390,283417,410807,221023,252343,255212,217720,203913,191110,1341321,119383,264840,384223,202917,246482,270882,247354,265769,358529,1591933,2933254,3728282,3728282
Georgia,2024,GE,GEO,EUR,124471,283175,407646,224203,244359,258163,217980,200681,193905,1339291,116728,264565,381293,206212,236582,272741,247679,261419,364561,1589194,2928485,3717425,3717425
Georgia,2025,GE,GEO,EUR,122377,280488,402865,229034,235505,261289,218415,197573,198553,1340369,114833,261893,376726,211286,225813,274634,248217,256520,373079,1589549,2929918,3709510,3709510
Georgia,2026,GE,GEO,EUR,119839,277803,397642,234113,226610,263876,219150,194292,203422,1341463,112507,259285,371792,216503,215108,275944,248896,251328,381915,1589694,2931157,3700586,3700586
Georgia,2027,GE,GEO,EUR,116824,275292,392116,239355,218659,264859,220308,191296,208032,1342509,109725,257055,366780,221626,205568,275520,249805,246440,390464,1589423,2931932,3690825,3690825
Georgia,2028,GE,GEO,EUR,114123,271560,385683,245280,212359,263497,221994,188936,212102,1344168,107227,253825,361052,227328,197860,272558,251156,242170,398375,1589447,2933615,3680347,3680347
Georgia,2029,GE,GEO,EUR,111688,266237,377925,252059,207873,259759,224257,187419,215489,1346856,104968,249112,354080,233950,192148,266983,253059,238786,405383,1590309,2937165,3669171,3669171
Georgia,2030,GE,GEO,EUR,109602,259464,369066,259407,204776,254285,227044,186847,218094,1350453,103030,242983,346013,241135,188149,259497,255373,236551,411255,1591960,2942413,3657494,3657494
Georgia,1950,GE,GEO,EUR,164921,332819,497740,359903,185303,189626,156449,123863,155073,1170217,158679,326349,485028,358297,236985,263574,190192,141455,173771,1364274,2534491,3517264,3517264
Georgia,1951,GE,GEO,EUR,175727,318667,494394,367334,205387,185407,159813,122073,150763,1190777,169405,311131,480536,364872,252120,262356,197617,141225,173675,1391865,2582642,3557571,3557571
Georgia,1952,GE,GEO,EUR,183934,305470,489404,373092,230392,180238,163475,120338,146877,1214412,177255,297106,474361,370869,272196,258882,204726,141471,173262,1421406,2635818,3599589,3599589
Georgia,1953,GE,GEO,EUR,189981,295488,485469,377135,256901,174912,167099,119043,143413,1238503,182895,286279,469174,376115,293305,254016,211868,142460,172622,1450386,2688889,3643528,3643528
Georgia,1954,GE,GEO,EUR,195060,289830,484890,379526,281442,170250,170338,118538,140145,1260239,187662,279630,467292,379823,312252,248738,219410,144517,172290,1477030,2737269,3689452,3689452
Georgia,1955,GE,GEO,EUR,200043,290181,490224,379071,302867,166666,173104,118846,137208,1277762,192401,278837,471238,380503,327981,243471,227345,147604,172101,1499005,2776767,3738231,3738231
Georgia,1956,GE,GEO,EUR,205313,297754,503067,375028,321280,164055,175491,119898,134660,1290412,197402,285447,482849,377220,340622,238101,235658,151709,172095,1515405,2805817,3791733,3791733
Georgia,1957,GE,GEO,EUR,211690,309722,521412,368958,336619,163090,177343,121726,132362,1300098,203456,297175,500631,370905,350422,233423,243908,156832,172291,1527781,2827879,3849921,3849921
Georgia,1958,GE,GEO,EUR,218824,324260,543084,361174,349339,165771,178174,124171,130305,1308934,210228,312201,522429,361635,358679,231755,250866,162430,172998,1538363,2847297,3912807,3912807
Georgia,1959,GE,GEO,EUR,226457,340472,566929,350906,360031,173901,177542,126909,128481,1317770,217474,329050,546524,349032,366802,235241,255347,167816,174621,1548859,2866629,3980075,3980075
Georgia,1960,GE,GEO,EUR,234224,357359,591583,338348,369564,187934,175462,129821,126882,1328011,224848,346203,571051,334506,375073,244520,257054,173966,175729,1560848,2888859,4051492,4051492
Georgia,1961,GE,GEO,EUR,241159,373445,614604,325190,378069,207779,172127,132984,125321,1341470,231422,362007,593429,320258,382806,260037,256203,180912,176042,1576258,2917728,4125760,4125760
Georgia,1962,GE,GEO,EUR,246396,388153,634549,313061,385127,232290,167926,136328,123829,1358561,236360,376089,612449,307275,390115,280432,253213,187616,176937,1595588,2954149,4201151,4201151
Georgia,1963,GE,GEO,EUR,249708,401514,651222,304104,390663,258291,163647,139622,122726,1379053,239450,388719,628169,297470,396863,301949,248978,194448,178740,1618448,2997501,4276891,4276891
Georgia,1964,GE,GEO,EUR,250366,414449,664815,299342,394699,282557,160083,142638,122205,1401524,240009,400976,640985,291712,402214,321498,244423,201653,181212,1642712,3044236,4350035,4350035
Georgia,1965,GE,GEO,EUR,247452,427415,674867,300351,395887,303908,157585,145314,122423,1425468,237146,413321,650467,291607,404536,337966,239950,209252,184478,1667789,3093257,4418592,4418592
Georgia,1966,GE,GEO,EUR,244227,443923,688150,305112,389281,320402,155230,147171,124971,1442167,235026,430682,665708,299496,402054,350294,236512,217566,190750,1696672,3138839,4492695,4492695
Georgia,1967,GE,GEO,EUR,242354,464123,706477,311816,376112,332071,153746,147816,129534,1451095,235197,453352,688549,312896,396768,358939,235007,225861,199411,1728882,3179977,4575000,4575000
Georgia,1968,GE,GEO,EUR,239739,483390,723129,323994,359876,341073,155442,147455,134182,1462022,234373,475362,709735,330165,390020,365824,235862,233112,208227,1763210,3225232,4658097,4658097
Georgia,1969,GE,GEO,EUR,235830,500140,735970,342802,339986,347343,161048,146136,138779,1476094,231602,495255,726857,352214,381352,370870,239912,238998,217601,1800947,3277041,4739872,4739872
Georgia,2031,GE,GEO,EUR,107894,252102,359996,266424,202434,248046,230188,187101,219931,1354124,101435,236226,337661,247945,185305,251171,257846,235459,415903,1593629,2947753,3645413,3645413
Georgia,2032,GE,GEO,EUR,106480,245159,351639,271836,200981,241630,233401,187871,221243,1356962,100114,229830,329944,253171,183655,242656,260160,235248,419512,1594402,2951364,3632939,3632939
Georgia,2033,GE,GEO,EUR,105365,238829,344194,274784,201502,234876,236456,188739,222451,1358808,99072,224016,323088,255998,184127,233799,262169,235523,422477,1594093,2952901,3620180,3620180
Georgia,2034,GE,GEO,EUR,104590,233490,338080,274555,204706,227199,239506,189491,223853,1359310,98345,219113,317458,255732,187431,223994,264070,236034,425114,1592375,2951685,3607218,3607218
Georgia,2035,GE,GEO,EUR,104070,229322,333392,271886,209546,218651,242654,190278,225380,1358395,97855,215285,313140,253070,192501,213315,265983,236683,427618,1589170,2947565,3594101,3594101
Georgia,2036,GE,GEO,EUR,103769,225082,328851,269215,214619,210065,245280,191340,226867,1357386,97574,211374,308948,250468,197712,202699,267315,237474,430022,1585690,2943076,3580871,3580871
Georgia,2037,GE,GEO,EUR,103701,220666,324367,266723,219849,202396,246362,192774,228302,1356406,97512,207276,304788,248243,202829,193243,266934,238488,432309,1582046,2938452,3567591,3567591
Georgia,2038,GE,GEO,EUR,103807,216860,320667,263007,225753,196324,245189,194691,229759,1354723,97615,203742,301357,245021,208523,185605,264040,239934,434421,1577544,2932267,3554286,3554286
Georgia,2039,GE,GEO,EUR,103965,213660,317625,257715,232500,192016,241749,197141,231319,1352440,97764,200759,298523,240317,215129,179948,258567,241918,436390,1572269,2924709,3540851,3540851
Georgia,2040,GE,GEO,EUR,104105,211060,315165,250968,239811,189066,236664,200074,233010,1349593,97895,198337,296232,234199,222300,175989,251209,244298,438239,1566234,2915827,3527227,3527227
Georgia,2041,GE,GEO,EUR,104256,209058,313314,243641,246799,186853,230863,203325,234763,1346244,98037,196468,294505,227461,229096,173180,243022,246830,439911,1559500,2905744,3513555,3513555
Georgia,2042,GE,GEO,EUR,104375,207586,311961,236734,252183,185515,224903,206619,236530,1342484,98150,195087,293237,221077,234314,171558,234655,249194,441368,1552166,2894650,3499849,3499849
Georgia,2043,GE,GEO,EUR,104390,206582,310972,230437,255134,186116,218624,209748,238348,1338407,98164,194149,292313,215275,237143,172048,225950,251256,442648,1544320,2882727,3486006,3486006
Georgia,2044,GE,GEO,EUR,104352,205968,310320,225126,254929,189354,211463,212855,240299,1334026,98125,193575,291700,210382,236885,175352,216308,253204,443864,1535995,2870021,3472044,3472044
Georgia,2045,GE,GEO,EUR,104275,205592,309867,220977,252313,194184,203484,216057,242471,1329486,98052,193218,291270,206563,234239,180416,205815,255161,445140,1527334,2856820,3457967,3457967
Georgia,2046,GE,GEO,EUR,104036,205448,309484,216763,249691,199241,195478,218772,244931,1324876,97821,193082,290903,202659,231651,185613,195386,256551,446575,1518435,2843311,3443699,3443699
Georgia,2047,GE,GEO,EUR,103635,205504,309139,212369,247247,204438,188339,220047,247748,1320188,97434,193136,290570,198573,229440,190716,186102,256267,448259,1509357,2829545,3429255,3429255
Georgia,2048,GE,GEO,EUR,103105,205627,308732,208585,243588,210294,182704,219253,251082,1315506,96926,193253,290179,195052,226238,196392,178606,253529,450363,1500180,2815686,3414595,3414595
Georgia,2049,GE,GEO,EUR,102453,205753,308206,205404,238367,216979,178734,216383,255028,1310895,96300,193363,289663,192074,221554,202977,173055,248287,453018,1490965,2801860,3399740,3399740
Georgia,2050,GE,GEO,EUR,101656,205821,307477,202825,231717,224220,176055,212022,259552,1306391,95541,193422,288963,189655,215461,210124,169185,241218,456180,1481823,2788214,3384660,3384660
Ghana,1970,GH,GHA,AFR,850252,1268578,2118830,762774,550847,435158,266903,155022,145037,2315741,833441,1235539,2068980,784484,615009,432499,239192,141728,145429,2358341,4674082,8861895,8861895
Ghana,1971,GH,GHA,AFR,863825,1314565,2178390,798254,556314,446199,276301,159824,141947,2378839,848634,1282026,2130660,809003,618753,454064,249868,145684,143620,2420992,4799831,9108878,9108878
Ghana,1972,GH,GHA,AFR,878054,1358840,2236894,839322,562789,457069,287672,164747,137977,2449576,864308,1328432,2192740,835491,621464,476920,262659,149522,140682,2486738,4936314,9365952,9365952
Ghana,1973,GH,GHA,AFR,898834,1396119,2294953,880928,573041,465962,299293,170338,135930,2525492,884300,1369376,2253676,870805,625804,496225,276309,154566,139366,2563075,5088567,9637197,9637197
Ghana,1974,GH,GHA,AFR,921873,1429991,2351864,923022,587956,473562,310886,176561,135306,2607293,905762,1407126,2312888,909975,633180,513469,290487,160603,139226,2646940,5254233,9918979,9918979
Ghana,1975,GH,GHA,AFR,944402,1463137,2407539,970192,603466,479974,322792,183193,136117,2695734,926874,1443680,2370554,950386,643045,529427,305617,167264,140282,2736021,5431755,10209848,10209848
Ghana,1976,GH,GHA,AFR,964828,1496545,2461373,1024775,617488,486175,336130,190270,138242,2793080,946910,1479966,2426876,988810,652640,546846,322826,174071,142485,2827678,5620758,10509006,10509006
Ghana,1977,GH,GHA,AFR,995326,1523629,2518955,1075605,636091,490664,349032,198000,141811,2891203,974113,1510083,2484196,1039428,665078,557590,340840,182262,145942,2931140,5822343,10825496,10825496
Ghana,1978,GH,GHA,AFR,1037322,1546804,2584126,1118198,661512,492555,360661,206031,146948,2985905,1009685,1534894,2544579,1103998,685511,557382,358910,191968,150859,3048628,6034533,11163230,11163230
Ghana,1979,GH,GHA,AFR,1080994,1574764,2655758,1155834,691689,494131,371746,214007,153196,3080603,1047418,1561454,2608872,1167615,714026,552542,377047,202227,156988,3170445,6251048,11515675,11515675
Ghana,1980,GH,GHA,AFR,1126499,1608551,2735050,1188168,725463,497448,381167,221447,152775,3166468,1087831,1591076,2678907,1226553,749392,546487,393557,212268,156560,3284817,6451285,11865246,11865246
Ghana,1981,GH,GHA,AFR,1171206,1649433,2820639,1217067,761988,503162,389329,228789,146999,3247334,1129494,1625552,2755046,1275347,790304,542705,408616,222186,150785,3389943,6637277,12212960,12212960
Ghana,1982,GH,GHA,AFR,1214433,1698500,2912933,1240038,802315,510003,395851,237583,146515,3332305,1170380,1666498,2836878,1320535,838120,537555,422036,234570,150049,3502865,6835170,12584976,12584976
Ghana,1983,GH,GHA,AFR,1263377,1751688,3015065,1252920,846588,518395,399737,247523,150008,3415171,1215108,1710274,2925382,1370852,894402,527798,432603,249667,153186,3628508,7043679,12984131,12984131
Ghana,1984,GH,GHA,AFR,1301036,1816972,3118008,1260062,879947,529287,402163,256215,154443,3482117,1252693,1763696,3016389,1395441,944851,524312,440326,263269,157777,3725976,7208093,13342487,13342487
Ghana,1985,GH,GHA,AFR,1320363,1895218,3215581,1268701,902714,539790,403698,263488,159806,3538197,1276765,1829980,3106745,1391559,984168,531055,445656,274601,163883,3790922,7329119,13651443,13651443
Ghana,1986,GH,GHA,AFR,1339240,1974594,3313834,1280943,926707,550127,404549,271046,165904,3599276,1299083,1900959,3200042,1387896,1022247,541592,449486,286218,171089,3858528,7457804,13971682,13971682
Ghana,1987,GH,GHA,AFR,1355920,2054583,3410503,1301079,949660,563630,405737,279122,172590,3671818,1318376,1975505,3293881,1389171,1059402,556504,452177,298325,179010,3934589,7606407,14310790,14310790
Ghana,1988,GH,GHA,AFR,1365975,2135711,3501686,1332975,972289,581454,407071,287728,179618,3761135,1330570,2053687,3384257,1400050,1095366,578101,452497,311208,187375,4024597,7785732,14671677,14671677
Ghana,1989,GH,GHA,AFR,1376718,2211048,3587766,1375682,994183,603651,408792,296338,187195,3865841,1341836,2129028,3470864,1420961,1128729,607068,450317,324109,196792,4127976,7993817,15052447,15052447
Ghana,1990,GH,GHA,AFR,1392074,2278146,3670220,1427130,1014136,628841,412294,303897,195398,3981696,1356391,2198111,3554502,1450800,1157235,641511,447898,335767,207355,4240566,8222262,15446982,15446982
Ghana,1991,GH,GHA,AFR,1406328,2343652,3749980,1483448,1030707,656182,417164,310305,204050,4101856,1369975,2265763,3635738,1486552,1178569,680068,445907,346273,218525,4355894,8457750,15843471,15843471
Ghana,1992,GH,GHA,AFR,1418604,2401895,3820499,1549311,1045357,685511,423192,315883,213122,4232376,1381879,2326914,3708793,1532906,1193725,722640,444451,356004,230149,4479875,8712251,16241548,16241548
Ghana,1993,GH,GHA,AFR,1429450,2450891,3880341,1625025,1060493,715336,432059,320867,222503,4376283,1392746,2378966,3771712,1590638,1204851,767440,445493,364927,241954,4615303,8991586,16643633,16643633
Ghana,1994,GH,GHA,AFR,1437976,2494725,3932701,1702187,1075558,743002,444571,324965,231659,4521942,1401762,2425153,3826915,1654906,1214179,812967,450816,372587,253833,4759288,9281230,17040854,17040854
Ghana,1995,GH,GHA,AFR,1444402,2534659,3979061,1780187,1092574,771309,457714,327986,240823,4670593,1408716,2466939,3875655,1725113,1224086,858660,460838,378597,266269,4913563,9584156,17438874,17438874
Ghana,1996,GH,GHA,AFR,1449776,2572869,4022645,1860092,1113126,801117,470874,330575,250578,4826362,1414387,2506263,3920650,1799427,1233990,903485,474543,383405,279500,5074350,9900712,17844010,17844010
Ghana,1997,GH,GHA,AFR,1456976,2606867,4063843,1942626,1141963,830021,486923,333427,260724,4995684,1421672,2541317,3962989,1877582,1248197,947071,492147,387208,293324,5245529,10241213,18268040,18268040
Ghana,1998,GH,GHA,AFR,1470300,2632649,4102949,2027291,1181407,857503,506358,336196,271121,5179876,1434709,2568398,4003107,1959019,1269950,988074,515272,388715,307734,5428764,10608640,18714708,18714708
Ghana,1999,GH,GHA,AFR,1492738,2656325,4149063,2105172,1228536,882052,528735,338895,281457,5364847,1456530,2592390,4048920,2036294,1298636,1024552,544276,387695,322512,5613965,10978812,19176791,19176791
Ghana,2000,GH,GHA,AFR,1526311,2681833,4208144,2175490,1284138,904256,553554,342970,291176,5551584,1489240,2617085,4106325,2107268,1335225,1055742,578000,386354,336861,5799450,11351034,19665502,19665502
Ghana,2001,GH,GHA,AFR,1569005,2705270,4274275,2247621,1349538,926111,581526,348640,300293,5753729,1530825,2639781,4170606,2179832,1381736,1082608,616516,385740,350535,5996967,11750696,20195577,20195577
Ghana,2002,GH,GHA,AFR,1616032,2728564,4344596,2314800,1427983,948395,612231,355657,309062,5968128,1576453,2662861,4239314,2248561,1442172,1105917,659677,386024,363927,6206278,12174406,20758326,20758326
Ghana,2003,GH,GHA,AFR,1662486,2756170,4418656,2370918,1514995,970836,643252,365086,317453,6182540,1621414,2690688,4312102,2307039,1512782,1125542,705055,388773,377031,6416222,12598762,21329514,21329514
Ghana,2004,GH,GHA,AFR,1705636,2790779,4496415,2420213,1604363,994946,673172,378046,325245,6395985,1663226,2725551,4388777,2358506,1588232,1142979,751014,395367,389161,6625259,13021244,21906444,21906444
Ghana,2005,GH,GHA,AFR,1746962,2834327,4581289,2464027,1694500,1022058,704273,391767,332477,6609102,1703510,2769017,4472527,2404075,1667245,1159842,796711,406012,400143,6834028,13443130,22496951,22496951
Ghana,2006,GH,GHA,AFR,1785762,2885382,4671144,2504736,1784634,1051950,736513,405422,339781,6823036,1741527,2819408,4560935,2445889,1749058,1176474,841536,419947,410567,7043471,13866507,23098586,23098586
Ghana,2007,GH,GHA,AFR,1820262,2941813,4762075,2541163,1875013,1087879,767081,421237,347321,7039694,1775392,2874824,4650216,2483494,1833735,1196585,884929,437235,420362,7256340,14296034,23708320,23708320
Ghana,2008,GH,GHA,AFR,1853415,3003463,4856878,2568871,1965233,1132322,795629,439662,354695,7256412,1807885,2935156,4743041,2512687,1920417,1223276,925650,459240,428486,7469756,14726168,24326087,24326087
Ghana,2009,GH,GHA,AFR,1887862,3070894,4958756,2593209,2047858,1184194,821614,460643,361909,7469427,1841384,3001122,4842506,2537669,2002129,1256697,962288,486429,434862,7680074,15149501,24950762,24950762
Ghana,2010,GH,GHA,AFR,1921763,3147018,5068781,2616451,2118727,1241763,844469,483278,369262,7673950,1873982,3075785,4949767,2560518,2073999,1296118,993493,517545,440539,7882212,15556162,25574719,25574719
Ghana,2011,GH,GHA,AFR,1958189,3228952,5187141,2635919,2184960,1303574,864800,507703,376800,7873756,1908831,3156228,5065059,2579756,2141642,1340907,1019114,552313,446244,8079976,15953732,26205941,26205941
Ghana,2012,GH,GHA,AFR,2001924,3310337,5312261,2655728,2243391,1374411,884023,533852,384778,8076183,1950738,3236587,5187325,2600200,2202752,1396057,1040322,590891,452764,8282986,16359169,26858762,26858762
Ghana,2013,GH,GHA,AFR,2048946,3389888,5438834,2680216,2291693,1453636,903568,560402,394557,8284072,1995740,3315109,5310849,2625587,2254351,1461114,1058177,631508,461109,8491846,16775918,27525597,27525597
Ghana,2014,GH,GHA,AFR,2092813,3467824,5560637,2711754,2333552,1535220,924860,586270,407075,8498731,2037769,3391754,5429523,2658008,2299219,1530929,1074154,672870,472289,8707469,17206200,28196358,28196358
Ghana,2015,GH,GHA,AFR,2132582,3543849,5676431,2751785,2369833,1617459,948954,613121,419784,8720936,2076020,3466371,5542391,2698673,2338165,1604219,1089709,714168,486252,8931186,17652122,28870939,28870939
Ghana,2016,GH,GHA,AFR,2163571,3620735,5784306,2800692,2404669,1700446,975993,640949,432452,8955201,2105805,3541745,5647550,2747928,2375132,1681052,1105461,754899,502771,9167243,18122444,29554303,29554303
Ghana,2017,GH,GHA,AFR,2175177,3700845,5876022,2855918,2435582,1783143,1008434,667282,447197,9197556,2116612,3620272,5736884,2803269,2408097,1760065,1124274,794307,521787,9411799,18609355,30222262,30222262
Ghana,2018,GH,GHA,AFR,2177345,3782246,5959591,2914460,2456124,1864281,1048125,691631,463814,9438435,2117932,3699869,5817801,2861506,2430744,1839601,1148644,831050,543271,9654816,19093251,30870641,30870641
Ghana,2019,GH,GHA,AFR,2181977,3861754,6043731,2977873,2473094,1938099,1094671,713786,482427,9679950,2121477,3777579,5899056,2924566,2449063,1914389,1179383,864241,567915,9899557,19579507,31522290,31522290
Ghana,2020,GH,GHA,AFR,2183226,3937515,6120741,3051980,2493153,2003786,1147628,732939,501084,9930570,2121778,3851392,5973170,2998733,2469756,1982918,1217040,892647,594819,10155913,20086483,32180401,32180401
Ghana,2021,GH,GHA,AFR,2184169,4007114,6191283,3132835,2512032,2066810,1204763,749102,518708,10184250,2121949,3918676,6040625,3079839,2489470,2049170,1260176,915401,622818,10416874,20601124,32833031,32833031
Ghana,2022,GH,GHA,AFR,2195348,4064237,6259585,3212610,2530280,2121702,1269738,764090,537111,10435531,2132205,3973323,6105528,3159652,2508843,2107959,1312328,933530,652919,10675231,21110762,33475870,33475870
Ghana,2023,GH,GHA,AFR,2208271,4115298,6323569,3290904,2553355,2167276,1342929,780156,558344,10692964,2144391,4021755,6166146,3237949,2533289,2157784,1374119,949242,686932,10939315,21632279,34121985,34121985
Ghana,2024,GH,GHA,AFR,2215303,4165927,6381230,3367875,2583911,2207468,1419264,799288,583805,10961611,2151248,4069887,6221135,3314783,2565414,2201884,1441140,964526,725806,11213553,22175164,34777522,34777522
Ghana,2025,GH,GHA,AFR,2222262,4209015,6431277,3443463,2623728,2243461,1497104,821910,611603,11241269,2158282,4110963,6269245,3390005,2606659,2241300,1512127,980208,767695,11497994,22739263,35439785,35439785
Ghana,2026,GH,GHA,AFR,2230578,4242564,6473142,3519732,2671112,2276966,1575031,846871,639514,11529226,2166772,4142903,6309675,3465689,2655154,2277631,1585889,995845,810491,11790699,23319925,36102736,36102736
Ghana,2027,GH,GHA,AFR,2240933,4267001,6507934,3598996,2724068,2305974,1652280,876414,667195,11824927,2177395,4165944,6343339,3544224,2708953,2309258,1661308,1014098,853454,12091295,23916222,36767488,36767488
Ghana,2028,GH,GHA,AFR,2253967,4284144,6538111,3680072,2782475,2327268,1729251,912876,694537,12126479,2190604,4181879,6372483,3624481,2768060,2333195,1738380,1037941,895973,12398030,24524509,37435099,37435099
Ghana,2029,GH,GHA,AFR,2269480,4298038,6567518,3759513,2846832,2346490,1800031,955621,721200,12429687,2206020,4194898,6400918,3702925,2833130,2354212,1811475,1067760,937174,12706676,25136363,38104805,38104805
Ghana,2030,GH,GHA,AFR,2286442,4307997,6594439,3835094,2920067,2367246,1862536,1003904,747015,12735862,2222751,4204397,6427148,3777122,2907358,2375971,1877886,1103669,976394,13018400,25754262,38775850,38775850
Ghana,1950,GH,GHA,AFR,444805,617841,1062646,567070,396936,243258,150380,107801,123855,1589300,397803,617964,1015767,569358,336419,188929,120800,83805,110577,1409888,2999188,5077596,5077596
Ghana,1951,GH,GHA,AFR,465572,626763,1092335,575408,412008,255483,154434,107577,121663,1626573,428648,612801,1041449,587603,355543,199405,124289,84436,108661,1459937,3086510,5220288,5220288
Ghana,1952,GH,GHA,AFR,489166,639221,1128387,580975,427850,267743,159063,107773,119584,1662988,461476,611414,1072890,602216,376122,210339,128140,85458,106852,1509127,3172115,5373395,5373395
Ghana,1953,GH,GHA,AFR,512992,657134,1170126,584191,443865,280208,163918,108425,117604,1698211,493840,616370,1110210,613099,397546,221874,132071,86893,105134,1556617,3254828,5535165,5535165
Ghana,1954,GH,GHA,AFR,535185,682249,1217434,585755,459270,293106,169190,109686,115771,1732778,524079,629840,1153919,620069,419150,234358,136218,88807,103480,1602082,3334860,5706212,5706212
Ghana,1955,GH,GHA,AFR,559753,710269,1270022,585821,474150,306247,175537,111381,114056,1767192,552249,651834,1204083,622872,441115,247768,141159,91054,101901,1645869,3413061,5887163,5887163
Ghana,1956,GH,GHA,AFR,587361,739343,1326704,585093,488971,319756,182665,113294,112403,1802182,579106,680451,1259557,622458,463825,262034,146663,93540,100388,1688908,3491090,6077347,6077347
Ghana,1957,GH,GHA,AFR,613993,772305,1386298,584784,503635,333398,190312,115410,110857,1838396,604961,714816,1319777,619589,487175,276720,152594,96225,99025,1731328,3569724,6275801,6275801
Ghana,1958,GH,GHA,AFR,639228,809515,1448743,584472,517467,346394,198645,117747,109477,1874202,629449,755993,1385442,612862,510605,291086,159180,99019,97870,1770622,3644824,6479011,6479011
Ghana,1959,GH,GHA,AFR,663075,850657,1513732,585520,530212,359126,207899,120400,108367,1911524,652605,803694,1456299,603597,533476,305816,166692,101924,97025,1808530,3720054,6690090,6690090
Ghana,1960,GH,GHA,AFR,685443,894229,1579672,590790,540781,372226,218188,123418,107690,1953093,674323,855278,1529601,596207,554046,321943,175340,104862,96749,1849147,3802240,6911510,6911510
Ghana,1961,GH,GHA,AFR,707070,931513,1638583,597889,545983,380229,225508,126301,111088,1986998,694629,899542,1594171,596791,567710,333394,182549,108149,100684,1889277,3876275,7109029,7109029
Ghana,1962,GH,GHA,AFR,728154,962712,1690866,605577,546957,383547,229254,128947,117933,2012215,713967,935823,1649790,604624,575988,339992,187680,111838,108195,1928317,3940532,7281192,7281192
Ghana,1963,GH,GHA,AFR,747754,995061,1742815,616789,547325,387680,233032,131420,124109,2040355,732339,972103,1704442,615867,583867,347436,192975,115283,115208,1970636,4010991,7458243,7458243
Ghana,1964,GH,GHA,AFR,765073,1027616,1792689,633011,547377,392107,237139,133858,129550,2073042,748955,1008118,1757073,631690,591158,355444,198801,118596,121705,2017394,4090436,7640196,7640196
Ghana,1965,GH,GHA,AFR,779930,1064598,1844528,650267,546892,397171,241599,136790,134101,2106820,763582,1044706,1808288,651310,597370,364549,205189,122193,127479,2068090,4174910,7827726,7827726
Ghana,1966,GH,GHA,AFR,792957,1105950,1898907,667017,546239,403316,246488,139965,137708,2140733,776592,1081998,1858590,673100,602935,375176,212006,125811,132405,2121433,4262166,8019658,8019658
Ghana,1967,GH,GHA,AFR,805339,1147193,1952532,686139,546159,410328,251477,143151,140597,2177851,788955,1119806,1908761,696743,607999,387282,218794,129364,136759,2176941,4354792,8216086,8216086
Ghana,1968,GH,GHA,AFR,818422,1187519,2005941,708405,546225,417918,256009,146595,143141,2218293,801875,1157322,1959197,723986,610960,400868,225005,133143,140754,2234716,4453009,8418152,8418152
Ghana,1969,GH,GHA,AFR,833386,1227145,2060531,734052,546987,426019,260599,150475,144949,2263081,816584,1194868,2011452,754472,612053,415802,231275,137245,143951,2294798,4557879,8629855,8629855
Ghana,2031,GH,GHA,AFR,2303997,4318421,6622418,3904756,2999245,2386247,1922412,1056184,772333,13041177,2240044,4214737,6454781,3845053,2987734,2396156,1942018,1144787,1013587,13329335,26370512,39447704,39447704
Ghana,2032,GH,GHA,AFR,2322122,4340589,6662711,3962367,3078205,2405436,1975257,1115837,797842,13334944,2257840,4236926,6494766,3900906,3067818,2416887,1999635,1194544,1049200,13628990,26963934,40121418,40121418
Ghana,2033,GH,GHA,AFR,2340604,4367121,6707725,4013990,3155671,2429169,2019367,1182499,824426,13625122,2275969,4263595,6539564,3950634,3146352,2442472,2048731,1252967,1084098,13925254,27550376,40797660,40797660
Ghana,2034,GH,GHA,AFR,2359492,4390569,6750061,4064989,3231720,2459919,2058155,1251175,852840,13918798,2294538,4287305,6581843,3999786,3223275,2475305,2092123,1315666,1119085,14225240,28144038,41475941,41475941
Ghana,2035,GH,GHA,AFR,2380118,4415389,6795507,4108430,3306296,2499394,2092816,1320695,883545,14211176,2314830,4312416,6627246,4041731,3298464,2516820,2130873,1381681,1154707,14524276,28735452,42158202,42158202
Ghana,2036,GH,GHA,AFR,2402620,4442098,6844718,4142529,3381563,2546136,2125165,1390135,915921,14501449,2336977,4339489,6676466,4074653,3374146,2565390,2166705,1450137,1190497,14821528,29322977,42844158,42844158
Ghana,2037,GH,GHA,AFR,2426069,4471337,6897406,4167721,3459726,2598211,2153345,1458953,951587,14789543,2360099,4369135,6729234,4098776,3452621,2619108,2198083,1520092,1228206,15116886,29906429,43533065,43533065
Ghana,2038,GH,GHA,AFR,2449264,4503539,6952803,4185785,3539648,2655506,2174422,1527689,992340,15075390,2382980,4401629,6784609,4115866,3532778,2677976,2222201,1591687,1269933,15410441,30485831,44223240,44223240
Ghana,2039,GH,GHA,AFR,2470280,4538570,7008850,4200657,3617969,2718473,2193525,1590885,1037333,15358842,2403705,4436730,6840435,4130053,3611145,2742619,2243524,1659610,1315283,15702234,31061076,44910363,44910363
Ghana,2040,GH,GHA,AFR,2488852,4576725,7065577,4211681,3692565,2789954,2213982,1646597,1085790,15640569,2422025,4474822,6896847,4140748,3685365,2816165,2265508,1721300,1363837,15992923,31633492,45595915,45595915
Ghana,2041,GH,GHA,AFR,2505251,4617314,7122565,4223149,3761412,2867120,2232819,1699945,1136746,15921191,2438285,4515297,6953582,4152250,3753430,2895686,2286002,1780854,1414856,16283078,32204269,46280424,46280424
Ghana,2042,GH,GHA,AFR,2518853,4659402,7178255,4246038,3818522,2944047,2251883,1747226,1193504,16201220,2451799,4557241,7009040,4175404,3809587,2974909,2307054,1834550,1471797,16573301,32774521,46961808,46961808
Ghana,2043,GH,GHA,AFR,2530842,4701590,7232432,4273172,3869819,3019540,2275280,1786985,1256433,16481229,2463774,4599277,7063051,4202956,3859715,3052635,2332793,1880578,1535409,16864086,33345315,47640796,47640796
Ghana,2044,GH,GHA,AFR,2543657,4742046,7285703,4297312,3920542,3093700,2305345,1822099,1321951,16760949,2476569,4639619,7116188,4227580,3909277,3128813,2365518,1921412,1602564,17155164,33916113,48318003,48318003
Ghana,2045,GH,GHA,AFR,2553876,4781791,7335667,4322795,3963953,3166511,2343726,1853648,1389432,17040065,2486783,4679261,7166044,4253566,3951760,3203361,2406634,1958066,1672935,17446322,34486387,48988101,48988101
Ghana,2046,GH,GHA,AFR,2560905,4821237,7382142,4350128,3998337,3240065,2389037,1883203,1457514,17318284,2493836,4718673,7212509,4281483,3985403,3278461,2454592,1992114,1745320,17737373,35055657,49650302,49650302
Ghana,2047,GH,GHA,AFR,2566737,4858856,7425593,4379939,4024099,3316452,2439395,1909158,1527030,17596073,2499668,4756319,7255987,4311936,4010417,3356351,2507533,2022181,1820407,18028825,35624898,50306482,50306482
Ghana,2048,GH,GHA,AFR,2570269,4894637,7464906,4412639,4042955,3394571,2494664,1929056,1599900,17873785,2503181,4792207,7295388,4345208,4028542,3435929,2565435,2045779,1900152,18321045,36194830,50955129,50955129
Ghana,2049,GH,GHA,AFR,2571549,4929107,7500656,4448111,4058722,3471167,2555223,1947173,1670771,18151167,2504440,4826789,7331229,4381058,4043818,3513795,2628876,2066827,1979463,18613837,36765004,51596895,51596895
Ghana,2050,GH,GHA,AFR,2573225,4958617,7531842,4486652,4070765,3544229,2623789,1966372,1737450,18429257,2506118,4856438,7362556,4419862,4055663,3587664,2700873,2088404,2055663,18908129,37337386,52231785,52231785
Guinea,1970,GN,GIN,AFR,349808,505906,855714,374129,283702,219687,167312,111006,80272,1236108,341589,501892,843481,376538,296171,231850,174838,118354,89323,1287074,2523182,4222374,4222374
Guinea,1971,GN,GIN,AFR,357373,516814,874187,381168,287211,221474,169371,113230,81222,1253676,348842,512497,861339,383708,300164,234889,177880,121158,91083,1308882,2562558,4298087,4298087
Guinea,1972,GN,GIN,AFR,365135,527972,893107,388305,289341,222897,171199,115417,82225,1269384,356252,523327,879579,391230,303328,237796,180864,123983,92941,1330142,2599526,4372212,4372212
Guinea,1973,GN,GIN,AFR,373037,539422,912459,396112,289934,223975,172793,117537,83304,1283655,363697,534412,898109,399467,305562,240515,183768,126788,94881,1350981,2634636,4445207,4445207
Guinea,1974,GN,GIN,AFR,380926,551209,932135,405881,288036,224647,174110,119515,84493,1296682,371079,545777,916856,409618,305898,242909,186541,129516,96915,1371397,2668079,4517073,4517073
Guinea,1975,GN,GIN,AFR,388672,563380,952052,414401,286990,224818,175140,121342,85815,1308506,378346,557482,935828,419007,307180,244929,189186,132182,99138,1391622,2700128,4588006,4588006
Guinea,1976,GN,GIN,AFR,396348,575995,972343,420332,288064,224812,175924,123023,87293,1319448,385568,569543,955111,426259,310577,246921,191724,134792,101567,1411840,2731288,4658743,4658743
Guinea,1977,GN,GIN,AFR,404168,589003,993171,426708,288542,224791,176495,124547,88907,1329990,393016,581936,974952,433874,313695,249021,194161,137336,104175,1432262,2762252,4730375,4730375
Guinea,1978,GN,GIN,AFR,412397,602413,1014810,433798,289009,224727,176916,125963,90649,1341062,400905,594739,995644,441991,316946,251137,196530,139854,106951,1453409,2794471,4804926,4804926
Guinea,1979,GN,GIN,AFR,421465,616253,1037718,441944,289989,224846,177303,127359,92531,1353972,409624,607978,1017602,450788,320577,253407,198875,142397,109860,1475904,2829876,4885199,4885199
Guinea,1980,GN,GIN,AFR,431283,630527,1061810,451410,292040,225286,177745,128783,94542,1369806,419098,621629,1040727,460397,324890,255900,201222,144987,112865,1500261,2870067,4972609,4972609
Guinea,1981,GN,GIN,AFR,441555,645293,1086848,462230,295638,225965,178337,130240,96686,1389096,429036,635732,1064768,470840,330167,258485,203632,147611,115976,1526711,2915807,5067427,5067427
Guinea,1982,GN,GIN,AFR,452603,660726,1113329,474261,301270,226558,179156,131759,98991,1411995,439722,650401,1090123,482036,336777,260863,206160,150279,119159,1555274,2967269,5170731,5170731
Guinea,1983,GN,GIN,AFR,464420,676952,1141372,487238,309218,226802,180154,133315,101436,1438163,451096,665779,1116875,493862,344944,262899,208737,152978,122443,1585863,3024026,5282274,5282274
Guinea,1984,GN,GIN,AFR,476686,694185,1170871,501119,320643,225823,181282,134858,104002,1467727,462834,682098,1144932,506326,355785,263704,211262,155672,125802,1618551,3086278,5402084,5402084
Guinea,1985,GN,GIN,AFR,489650,712342,1201992,516023,332786,226910,182560,136436,106692,1501407,475259,699261,1174520,519500,366891,266013,213710,158363,129265,1653742,3155149,5531661,5531661
Guinea,1986,GN,GIN,AFR,503744,731137,1234881,531869,344296,231244,184267,138059,109485,1539220,488879,717012,1205891,533309,376926,270918,216382,161055,132803,1691393,3230613,5671380,5671380
Guinea,1987,GN,GIN,AFR,518928,750923,1269851,548326,357535,236109,186464,139718,112365,1580517,503689,735637,1239326,547551,387968,276073,219367,163724,136391,1731074,3311591,5820774,5820774
Guinea,1988,GN,GIN,AFR,534973,771800,1306773,564869,371892,241544,188896,141360,115260,1623821,519430,755180,1274610,561975,399681,281593,222448,166332,139940,1771969,3395790,5977175,5977175
Guinea,1989,GN,GIN,AFR,551619,793665,1345284,580774,386410,247243,191399,142909,118056,1666791,535805,775530,1311335,576147,411554,287307,225581,168829,143342,1812760,3479551,6136166,6136166
Guinea,1990,GN,GIN,AFR,573593,823670,1397263,601752,404924,255801,195705,145666,121831,1725679,557389,803743,1361132,595414,427394,295950,230754,172698,147866,1870076,3595755,6354145,6354145
Guinea,1991,GN,GIN,AFR,599473,859622,1459095,626564,426621,266935,201126,149240,126246,1796732,582713,837842,1420555,618355,446176,306950,237175,177506,153187,1939349,3736081,6615734,6615734
Guinea,1992,GN,GIN,AFR,621320,890544,1511864,646404,445019,277184,204507,151632,129622,1854368,603967,867326,1471293,636672,461672,316497,241391,180991,157453,1994676,3849044,6832195,6832195
Guinea,1993,GN,GIN,AFR,642351,921859,1564210,665803,462988,288784,207020,153841,132820,1911256,624189,897469,1521658,654631,476790,326886,244834,184248,161588,2048977,3960233,7046097,7046097
Guinea,1994,GN,GIN,AFR,662714,954319,1617033,685413,480399,302822,207990,155973,135869,1968466,643512,928886,1572398,673065,491793,339382,246949,187374,165649,2104212,4072678,7262112,7262112
Guinea,1995,GN,GIN,AFR,680721,986253,1666974,704476,496904,316322,209989,157736,138603,2024030,660390,959816,1620206,690913,505996,351186,249711,189967,169362,2157135,4181165,7468347,7468347
Guinea,1996,GN,GIN,AFR,698291,1020137,1718428,724505,513814,328686,214747,159774,141410,2082936,676848,992569,1669417,709492,520541,361728,254773,192714,173096,2212344,4295280,7683115,7683115
Guinea,1997,GN,GIN,AFR,713658,1053477,1767135,733970,518242,335756,216989,160818,143086,2108861,691175,1024947,1716122,722318,528623,369738,258642,195054,176313,2250688,4359549,7842806,7842806
Guinea,1998,GN,GIN,AFR,726359,1087956,1814315,743242,519281,341871,218886,161732,144661,2129673,702968,1058290,1761258,735363,535106,377468,262489,197377,179506,2287309,4416982,7992545,7992545
Guinea,1999,GN,GIN,AFR,737957,1123690,1861647,761259,526423,351452,222507,163391,146868,2171900,713803,1092405,1806208,753487,544734,386901,267168,200015,182831,2335136,4507036,8174897,8174897
Guinea,2000,GN,GIN,AFR,749286,1158337,1907623,776729,528158,358591,225439,164562,148492,2201971,724477,1125261,1849738,770743,551670,395265,271682,202465,185810,2377635,4579606,8336967,8336967
Guinea,2001,GN,GIN,AFR,758116,1191623,1949739,784085,517602,359498,226280,164380,148991,2200836,732843,1156725,1889568,784254,552461,400783,275488,204324,188268,2405578,4606414,8445717,8445717
Guinea,2002,GN,GIN,AFR,764959,1225464,1990423,799933,511576,361954,228892,164139,149859,2216353,739432,1188439,1927871,803137,555624,407084,280400,206000,190897,2443142,4659495,8577790,8577790
Guinea,2003,GN,GIN,AFR,773313,1258467,2031780,831043,519027,370074,235426,164463,151729,2271762,747597,1219092,1966689,831072,565752,416099,287438,207715,193948,2502024,4773786,8772254,8772254
Guinea,2004,GN,GIN,AFR,783236,1288937,2072173,861449,525478,376506,243563,163173,153237,2323406,757384,1247438,2004822,859289,575752,424463,296141,208161,196835,2560641,4884047,8961039,8961039
Guinea,2005,GN,GIN,AFR,794208,1317966,2112174,889958,529742,380511,250568,162658,154271,2367708,768210,1274717,2042927,887100,585003,431842,304325,209476,199560,2617306,4985014,9140114,9140114
Guinea,2006,GN,GIN,AFR,807342,1345016,2152358,921418,536351,384252,256140,164406,155453,2418020,781058,1300454,2081512,917279,595699,439218,311193,212824,202531,2678744,5096764,9330625,9330625
Guinea,2007,GN,GIN,AFR,823475,1369691,2193166,958284,549077,389309,262975,166611,157104,2483360,796821,1324198,2121019,951095,609915,447334,318803,216465,205920,2749532,5232892,9547082,9547082
Guinea,2008,GN,GIN,AFR,842320,1392761,2235081,997263,566095,394734,270545,169170,158923,2556730,815199,1346701,2161900,986565,626818,455792,326950,220428,209524,2826077,5382807,9779785,9779785
Guinea,2009,GN,GIN,AFR,862746,1415947,2278693,1035861,585934,399901,278372,172014,160803,2632885,835045,1369577,2204622,1021930,645667,464254,335368,224656,213253,2905128,5538013,10021323,10021323
Guinea,2010,GN,GIN,AFR,883392,1440461,2323853,1073372,608807,405042,286326,175257,162698,2711502,855040,1394032,2249072,1056408,666769,472817,343984,229226,217092,2986296,5697798,10270728,10270728
Guinea,2011,GN,GIN,AFR,903291,1465675,2368966,1110539,635150,410625,294328,179097,164547,2794286,874229,1419359,2293588,1090608,690509,481731,352763,234281,220974,3070866,5865152,10527712,10527712
Guinea,2012,GN,GIN,AFR,922003,1491295,2413298,1146759,664219,416701,302076,183747,166071,2879573,892167,1445201,2337368,1124315,716656,491107,361569,240051,224751,3158449,6038022,10788692,10788692
Guinea,2013,GN,GIN,AFR,939470,1519750,2459220,1180363,695798,423773,309516,189482,167169,2966101,908824,1473778,2382602,1155821,745056,501268,370368,246717,228278,3247508,6213609,11055430,11055430
Guinea,2014,GN,GIN,AFR,956121,1551311,2507432,1212495,730270,432896,316802,197071,167256,3056790,924630,1505307,2429937,1185732,775652,512795,379214,255014,230801,3339208,6395998,11333365,11333365
Guinea,2015,GN,GIN,AFR,973581,1584382,2557963,1244569,767768,444493,324008,204606,168336,3153780,941193,1538084,2479277,1215359,808402,525841,388107,263219,234048,3434976,6588756,11625998,11625998
Guinea,2016,GN,GIN,AFR,992341,1618968,2611309,1275098,808082,458498,331156,211144,171504,3255482,959113,1571701,2530814,1243532,843298,540251,397000,270318,238982,3533381,6788863,11930985,11930985
Guinea,2017,GN,GIN,AFR,1010376,1655136,2665512,1302638,850030,475064,338058,218200,174966,3358956,976512,1606583,2583095,1269241,879744,556354,405865,277808,244220,3633232,6992188,12240789,12240789
Guinea,2018,GN,GIN,AFR,1026655,1692530,2719185,1328504,893090,494668,344816,225702,178686,3465466,992316,1642566,2634882,1293539,917220,574434,414781,285656,249705,3735335,7200801,12554864,12554864
Guinea,2019,GN,GIN,AFR,1041519,1730670,2772189,1355041,937010,517708,351690,233573,182778,3577800,1006740,1679187,2685927,1318498,955214,594740,423856,293805,255506,3841619,7419419,12877539,12877539
Guinea,2020,GN,GIN,AFR,1054591,1769863,2824454,1382938,980491,544016,358583,241264,186297,3693589,1019377,1716776,2736153,1345046,992694,617389,433003,301896,260940,3950968,7644557,13205153,13205153
Guinea,2021,GN,GIN,AFR,1066077,1809538,2875615,1411006,1023258,573331,365508,248432,188743,3810278,1030505,1754750,2785255,1371915,1029490,642265,442171,309565,265349,4060755,7871033,13531906,13531906
Guinea,2022,GN,GIN,AFR,1077370,1847428,2924798,1438955,1065190,605637,372988,255320,191134,3929224,1041556,1791046,2832602,1398949,1065809,669559,451759,317075,269564,4172715,8101939,13859341,13859341
Guinea,2023,GN,GIN,AFR,1088610,1882306,2970916,1469037,1104335,640623,381695,262276,194704,4052670,1052697,1824541,2877238,1428448,1100018,699233,462292,324904,274889,4289784,8342454,14190612,14190612
Guinea,2024,GN,GIN,AFR,1099304,1914736,3014040,1501696,1140885,677762,392329,269582,200281,4182535,1063360,1855768,2919128,1460575,1132114,730781,474247,333325,282009,4413051,8595586,14528770,14528770
Guinea,2025,GN,GIN,AFR,1109658,1945898,3055556,1535538,1175886,716678,404913,276929,207181,4317125,1073701,1885888,2959589,1493787,1163225,763927,487543,342034,290276,4540792,8857917,14873051,14873051
Guinea,2026,GN,GIN,AFR,1119946,1976373,3096319,1570388,1208276,757432,419303,283988,214532,4453919,1083972,1915545,2999517,1527745,1192460,798803,501987,350693,298950,4670638,9124557,15220392,15220392
Guinea,2027,GN,GIN,AFR,1129782,2005786,3135568,1606493,1237444,799638,436019,290770,222299,4592663,1093731,1944435,3038166,1562787,1219147,835126,517983,359298,308026,4802367,9395030,15568760,15568760
Guinea,2028,GN,GIN,AFR,1139414,2033714,3173128,1643638,1264389,842504,455368,297335,230418,4733652,1103272,1972060,3075332,1598817,1244159,872256,535748,367903,317449,4936332,9669984,15918453,15918453
Guinea,2029,GN,GIN,AFR,1148914,2059811,3208725,1681342,1290842,885168,477433,303796,238813,4877394,1112707,1997937,3110644,1635360,1269225,909387,555376,376558,327192,5073098,9950492,16269856,16269856
Guinea,2030,GN,GIN,AFR,1157621,2083536,3241157,1719961,1317972,926814,502304,310301,247406,5024758,1121361,2021539,3142900,1672748,1295490,945705,577091,385316,337214,5213564,10238322,16622388,16622388
Guinea,1950,GN,GIN,AFR,221601,332044,553645,267841,216555,163745,117832,85897,86534,938404,221738,340756,562494,276255,219027,162158,115144,82270,74159,929013,1867417,2983557,2983557
Guinea,1951,GN,GIN,AFR,228188,338269,566457,271008,219510,166987,119530,85478,86222,948735,227254,346202,573456,280105,222746,165783,117387,82563,75205,943789,1892524,3032444,3032444
Guinea,1952,GN,GIN,AFR,234901,344061,578962,274377,222442,170296,121303,85414,85535,959367,233002,351279,584281,284083,226495,169469,119685,83173,75935,958840,1918207,3081454,3081454
Guinea,1953,GN,GIN,AFR,242378,349104,591482,277930,225327,173609,123171,85635,84605,970277,239457,355832,595289,288123,230260,173180,122072,84054,76469,974158,1944435,3131200,3131200
Guinea,1954,GN,GIN,AFR,252068,352226,604294,281606,228136,176843,125195,86044,83601,981425,247983,358733,606716,292086,233990,176849,124605,85096,76901,989527,1970952,3181965,3181965
Guinea,1955,GN,GIN,AFR,260240,357355,617595,285366,230891,179979,127409,86688,82583,992916,255444,363235,618679,295901,237672,180446,127297,86325,77227,1004868,1997784,3234056,3234056
Guinea,1956,GN,GIN,AFR,265216,365817,631033,289585,233626,183005,129794,87564,81571,1005145,260240,370573,630813,299962,241309,183958,130125,87746,77447,1020547,2025692,3287535,3287535
Guinea,1957,GN,GIN,AFR,270324,374141,644465,294358,236359,185887,132319,88579,80621,1018123,265180,377859,643039,304413,244914,187377,133087,89294,77668,1036753,2054876,3342372,3342372
Guinea,1958,GN,GIN,AFR,275569,382563,658132,299498,239100,188657,134967,89703,79753,1031678,270249,385358,655607,309080,248508,190755,136170,90968,77937,1053418,2085096,3398839,3398839
Guinea,1959,GN,GIN,AFR,280916,391072,671988,305026,241876,191395,137703,90932,78963,1045895,275422,393046,668468,314009,252106,194149,139336,92733,78273,1070606,2116501,3456953,3456953
Guinea,1960,GN,GIN,AFR,286405,399747,686152,310855,244711,194118,140489,92249,78268,1060690,280759,400986,681745,319178,255698,197569,142544,94577,78662,1088228,2148918,3516814,3516814
Guinea,1961,GN,GIN,AFR,292098,408787,700885,316749,247672,196829,143336,93643,77703,1075932,286277,409323,695600,324388,259357,201018,145809,96495,79146,1106213,2182145,3578631,3578631
Guinea,1962,GN,GIN,AFR,297963,418618,716581,322257,250829,199534,146246,95105,77281,1091252,291927,418383,710310,329256,263130,204497,149127,98461,79711,1124182,2215434,3642324,3642324
Guinea,1963,GN,GIN,AFR,303944,429585,733529,327084,254168,202206,149168,96646,77006,1106278,297674,428452,726126,333645,266976,208003,152476,100506,80406,1142012,2248290,3707945,3707945
Guinea,1964,GN,GIN,AFR,310025,442936,752961,330136,257623,204816,152028,98327,76912,1119842,303504,440732,744236,336508,270762,211489,155797,102685,81237,1158478,2278320,3775510,3775510
Guinea,1965,GN,GIN,AFR,316182,455172,771354,335015,261156,207371,154807,100154,77015,1135518,309407,452316,761723,340851,274416,214944,159068,105007,82202,1176488,2312006,3845074,3845074
Guinea,1966,GN,GIN,AFR,322443,464721,787164,342979,265107,209917,157496,102124,77321,1154944,315396,461667,777063,347850,278325,218382,162287,107461,83308,1197613,2352557,3916780,3916780
Guinea,1967,GN,GIN,AFR,328876,474603,803479,350874,269595,212480,160083,104230,77839,1175101,321529,471312,792841,354849,282614,221808,165444,110046,84573,1219334,2394435,3990760,3990760
Guinea,1968,GN,GIN,AFR,335564,484794,820358,358874,274405,215057,162597,106464,78548,1195945,327915,481278,809193,362071,287114,225249,168592,112769,86043,1241838,2437783,4067333,4067333
Guinea,1969,GN,GIN,AFR,342544,495239,837783,366711,279275,217525,165035,108749,79383,1216678,334610,491488,826098,369351,291717,228639,171734,115557,87645,1264643,2481321,4145194,4145194
Guinea,2031,GN,GIN,AFR,1165512,2105405,3270917,1759025,1345235,967753,530051,317094,256127,5175285,1129222,2043400,3172622,1710519,1322268,981570,601076,394325,347475,5357233,10532518,16976053,16976053
Guinea,2032,GN,GIN,AFR,1173632,2126458,3300090,1796385,1372494,1007997,560638,324492,264910,5326916,1137308,2064522,3201830,1746644,1349278,1017072,627425,403804,357934,5502157,10829073,17330988,17330988
Guinea,2033,GN,GIN,AFR,1181976,2147521,3329497,1830908,1401999,1045742,593743,332871,273709,5478972,1145588,2085690,3231278,1780093,1378603,1050486,655952,413996,368572,5647702,11126674,17687444,17687444
Guinea,2034,GN,GIN,AFR,1190010,2168149,3358159,1863097,1434031,1081041,628747,342658,282508,5632082,1153564,2106462,3260026,1811360,1410471,1081867,686146,425232,379404,5794480,11426562,18044749,18044749
Guinea,2035,GN,GIN,AFR,1197738,2187588,3385326,1894024,1467186,1114846,665330,354017,291318,5786721,1161260,2126109,3287369,1841521,1443364,1112271,717780,437553,390415,5942904,11729625,18402322,18402322
Guinea,2036,GN,GIN,AFR,1204873,2206153,3411026,1924288,1501316,1146183,703645,366991,300133,5942556,1168384,2144899,3313283,1871228,1476992,1140909,751066,450926,401604,6092725,12035281,18759589,18759589
Guinea,2037,GN,GIN,AFR,1210977,2224532,3435509,1953513,1536660,1174466,743335,382041,308930,6098945,1174521,2163445,3337966,1900196,1511680,1167127,785750,465726,412942,6243421,12342366,19115845,19115845
Guinea,2038,GN,GIN,AFR,1216061,2242938,3458999,1981285,1573019,1200647,783663,399438,317726,6255778,1179703,2181971,3361674,1927936,1547342,1191758,821215,482144,424457,6394852,12650630,19471305,19471305
Guinea,2039,GN,GIN,AFR,1221310,2260913,3482223,2007282,1609931,1226384,823813,419237,326534,6413181,1185054,2200098,3385152,1953970,1583523,1216473,856711,500270,436158,6547105,12960286,19827660,19827660
Guinea,2040,GN,GIN,AFR,1227209,2277840,3505049,2030982,1647749,1252791,863022,441519,335425,6571488,1191042,2217206,3408248,1977797,1620556,1242366,891452,520297,448047,6700515,13272003,20185302,20185302
Guinea,2041,GN,GIN,AFR,1233456,2293392,3526848,2052887,1686018,1279347,901588,466334,344542,6730716,1197344,2232986,3430330,1999926,1657986,1268783,925792,542393,460207,6855087,13585803,20542980,20542980
Guinea,2042,GN,GIN,AFR,1240316,2308168,3548484,2074003,1722661,1305928,939530,493661,354107,6889890,1204190,2248019,3452209,2021345,1693834,1295454,959823,566643,472814,7009913,13899803,20900498,20900498
Guinea,2043,GN,GIN,AFR,1247051,2322158,3569209,2095130,1756577,1334679,975151,523215,364385,7049137,1210851,2262299,3473150,2042812,1727103,1324380,991904,592884,486058,7165141,14214278,21256643,21256643
Guinea,2044,GN,GIN,AFR,1252950,2335994,3588944,2115835,1788270,1365870,1008496,554449,375739,7208659,1216686,2276441,3493127,2063901,1758270,1355779,1022076,620656,500233,7320915,14529574,21611646,21611646
Guinea,2045,GN,GIN,AFR,1258291,2350173,3608464,2135392,1818765,1398153,1040463,587082,388280,7368135,1221978,2290921,3512899,2083889,1788374,1388192,1051358,649752,515385,7476950,14845085,21966440,21966440
Guinea,2046,GN,GIN,AFR,1262938,2364118,3627056,2154092,1848629,1431384,1070146,621232,402051,7527534,1226601,2305159,3531760,2103045,1818063,1421328,1078995,680352,531446,7633229,15160763,22319580,22319580
Guinea,2047,GN,GIN,AFR,1266272,2377685,3643957,2172617,1877504,1465783,1096996,656611,417401,7686912,1229966,2318989,3548955,2121964,1847040,1455503,1104367,712230,548726,7789830,15476742,22669657,22669657
Guinea,2048,GN,GIN,AFR,1269684,2390164,3659848,2191174,1904999,1501164,1121914,692565,434562,7846378,1233423,2331713,3565136,2140871,1874839,1490628,1128267,744831,567396,7946832,15793210,23018196,23018196
Guinea,2049,GN,GIN,AFR,1273566,2401957,3675523,2209312,1930791,1537094,1146462,728350,453579,8005588,1237335,2343766,3581101,2159386,1900990,1526285,1152276,777450,587517,8103904,16109492,23366123,23366123
Guinea,2050,GN,GIN,AFR,1276599,2413796,3690395,2226428,1954379,1573924,1171669,763284,474534,8164218,1240428,2355877,3596305,2176904,1925004,1562798,1177433,809374,609262,8260775,16424993,23711700,23711700
Gambia,1970,GM,GMB,AFR,47354,63457,110811,45142,38710,29785,19221,10780,6778,150416,46957,64086,111043,45528,39865,30848,20194,11845,8187,156467,306883,528731,528731
Gambia,1971,GM,GMB,AFR,48746,65688,114434,45863,39954,30507,20104,11113,7003,154544,48321,66272,114593,46366,41026,31607,21115,12185,8437,160736,315280,544317,544317
Gambia,1972,GM,GMB,AFR,50261,67941,118202,46764,41159,31225,21007,11443,7247,158845,49808,68483,118291,47404,42144,32361,22063,12533,8710,165215,324060,560553,560553
Gambia,1973,GM,GMB,AFR,51900,70231,122131,48044,42134,31940,21919,11796,7494,163327,51420,70738,122158,48787,43054,33114,23022,12902,8993,169872,333199,577488,577488
Gambia,1974,GM,GMB,AFR,53758,72703,126461,49703,42500,32471,22709,12216,7965,167564,53218,73180,126398,50728,43492,33715,23822,13286,9442,174485,342049,594904,594904
Gambia,1975,GM,GMB,AFR,55804,75408,131212,51547,42486,32808,23355,12718,8668,171582,55184,75849,131033,53010,43749,34164,24427,13677,10053,179080,350662,612909,612909
Gambia,1976,GM,GMB,AFR,57913,78288,136201,53520,42545,33137,23929,13280,9413,175824,57224,78640,135864,55387,44225,34619,24958,14116,10696,184001,359825,631894,631894
Gambia,1977,GM,GMB,AFR,60067,81396,141463,55634,42663,33460,24425,13905,10216,180303,59303,81617,140920,57954,44832,35095,25399,14599,11370,189249,369552,651934,651934
Gambia,1978,GM,GMB,AFR,62237,84752,146989,57884,42827,33802,24845,14567,11075,185000,61388,84793,146181,60700,45565,35626,25756,15104,12056,194807,379807,672974,672974
Gambia,1979,GM,GMB,AFR,64462,88348,152810,60257,43046,34202,25199,15246,11964,189914,63535,88179,151714,63598,46438,36242,26062,15607,12769,200716,390630,695155,695155
Gambia,1980,GM,GMB,AFR,66811,92165,158976,62746,43358,34674,25511,15926,12869,195084,65806,91772,157578,66606,47481,36944,26334,16102,13483,206950,402034,718586,718586
Gambia,1981,GM,GMB,AFR,69282,96189,165471,65237,43744,35118,25759,16577,13762,200197,68210,95546,163756,69660,48736,37692,26582,16588,14175,213433,413630,742846,742846
Gambia,1982,GM,GMB,AFR,71899,100402,172301,67817,44368,35515,25971,17222,14638,205531,70764,99500,170264,72749,50283,38425,26807,17069,14845,220178,425709,768272,768272
Gambia,1983,GM,GMB,AFR,74717,104837,179554,70619,45488,35709,26161,17878,15609,211464,73503,103680,177183,75991,52309,38994,26991,17516,15557,227358,438822,795563,795563
Gambia,1984,GM,GMB,AFR,77618,109313,186931,73934,47541,35859,26471,18462,16299,218566,76357,107978,184335,79470,54799,39214,27275,18034,16170,234962,453528,824798,824798
Gambia,1985,GM,GMB,AFR,80599,113765,194364,77742,50365,36232,26949,18980,16664,226932,79316,112374,191690,83143,57488,39326,27691,18635,16690,242973,469905,855958,855958
Gambia,1986,GM,GMB,AFR,83826,118358,202184,81670,53401,36732,27464,19476,17117,235860,82482,116987,199469,86957,60325,39585,28105,19198,17298,251468,487328,888980,888980
Gambia,1987,GM,GMB,AFR,87296,123103,210399,85735,56657,37338,28036,19948,17661,245375,85864,121797,207661,90927,63388,39909,28534,19718,18002,260478,505853,923914,923914
Gambia,1988,GM,GMB,AFR,90990,128015,219005,89968,60137,38055,28692,20401,18283,255536,89453,126805,216258,95080,66685,40293,28996,20197,18796,270047,525583,960837,960837
Gambia,1989,GM,GMB,AFR,94838,133185,228023,94339,63815,38889,29466,20843,18951,266303,93192,132065,225257,99421,70196,40756,29510,20643,19623,280149,546452,999732,999732
Gambia,1990,GM,GMB,AFR,98812,138687,237499,98822,67666,39870,30340,21278,19642,277618,97063,137640,234703,103917,73913,41350,30062,21074,20484,290800,568418,1040616,1040616
Gambia,1991,GM,GMB,AFR,102940,144533,247473,103386,71650,41053,31275,21715,20354,289433,101085,143564,244649,108548,77794,42151,30629,21481,21382,301985,591418,1083536,1083536
Gambia,1992,GM,GMB,AFR,107080,150645,257725,107767,75640,42504,32191,22135,20992,301229,105120,149722,254842,112972,81778,43339,31190,21865,22201,313345,614574,1127152,1127152
Gambia,1993,GM,GMB,AFR,110922,156823,267745,111378,79339,44356,32894,22498,21375,311840,108886,155809,264695,116419,85691,45260,31716,22216,22735,324037,635877,1168309,1168309
Gambia,1994,GM,GMB,AFR,114249,162853,277102,114362,82495,46522,33197,22776,21584,320936,112159,161742,273901,119162,89282,47824,31997,22555,23113,333933,654869,1205882,1205882
Gambia,1995,GM,GMB,AFR,117173,168773,285946,117497,85190,48726,33238,23008,21915,329574,115010,167731,282741,122278,92493,50447,32083,22919,23669,343889,673463,1242155,1242155
Gambia,1996,GM,GMB,AFR,119929,174760,294689,121009,87683,50959,33274,23241,22337,338503,117675,173877,291552,125927,95485,53026,32215,23310,24362,354325,692828,1279070,1279070
Gambia,1997,GM,GMB,AFR,122702,180836,303538,124786,90096,53306,33356,23501,22760,347805,120356,180091,300447,129891,98362,55755,32398,23721,25073,365200,713005,1317002,1317002
Gambia,1998,GM,GMB,AFR,125701,186928,312629,128809,92471,55734,33478,23806,23185,357483,123253,186292,309545,134166,101167,58602,32629,24171,25796,376531,734014,1356189,1356189
Gambia,1999,GM,GMB,AFR,128920,192892,321812,133141,94829,58207,33650,24173,23588,367588,126363,192354,318717,138809,103928,61525,32919,24673,26525,388379,755967,1396499,1396499
Gambia,2000,GM,GMB,AFR,132242,198669,330911,137817,97188,60681,33898,24591,23973,378148,129569,198194,327763,143839,106658,64468,33309,25205,27231,400710,778858,1437539,1437539
Gambia,2001,GM,GMB,AFR,135705,204338,340043,142797,99597,63106,34277,25020,24331,389128,132906,203860,336766,149238,109410,67366,33856,25726,27917,413513,802641,1479449,1479449
Gambia,2002,GM,GMB,AFR,139196,210017,349213,148038,102087,65454,34865,25391,24676,400511,136281,209468,345749,154954,112226,70182,34644,26169,28580,426755,827266,1522223,1522223
Gambia,2003,GM,GMB,AFR,143058,216235,359293,152851,104797,67992,36045,25648,24753,412086,140053,215256,355309,159744,115132,73367,36084,26404,28840,439571,851657,1566257,1566257
Gambia,2004,GM,GMB,AFR,147493,223026,370519,157215,107727,70736,37905,25741,24643,423967,144406,221343,365749,163536,118090,76936,38320,26350,28759,451991,875958,1612225,1612225
Gambia,2005,GM,GMB,AFR,152224,229950,382174,161816,110789,73442,40060,25789,24611,436507,149051,227639,376690,167516,121108,80439,40909,26276,28752,465000,901507,1660368,1660368
Gambia,2006,GM,GMB,AFR,157345,237026,394371,166755,114046,76139,42381,25943,24674,449938,154081,234158,388239,171777,124246,83878,43668,26369,28816,478754,928692,1711294,1711294
Gambia,2007,GM,GMB,AFR,162802,244263,407065,172043,117481,78853,44861,26195,24838,464271,159430,240896,400326,176313,127491,87259,46650,26572,28937,493222,957493,1764883,1764883
Gambia,2008,GM,GMB,AFR,168142,251948,420090,177609,121044,81608,47478,26546,25117,479402,164658,248110,412768,181058,130790,90579,49819,26890,29146,508282,987684,1820542,1820542
Gambia,2009,GM,GMB,AFR,173276,260235,433511,183297,124746,84390,50184,26995,25488,495100,169672,255990,425662,185906,134173,93842,53142,27345,29431,523839,1018939,1878119,1878119
Gambia,2010,GM,GMB,AFR,178361,268952,447313,189032,128608,87184,52941,27566,25923,511254,174615,264344,438959,190790,137650,97021,56560,27974,29762,539757,1051011,1937275,1937275
Gambia,2011,GM,GMB,AFR,183206,278204,461410,194915,132647,90032,55715,28306,26419,528034,179299,273258,452557,195823,141260,100142,60037,28826,30125,556213,1084247,1998212,1998212
Gambia,2012,GM,GMB,AFR,187777,287827,475604,201069,136872,92951,58491,29281,26926,545590,183699,282606,466305,201173,145037,103257,63547,29989,30505,573508,1119098,2061014,2061014
Gambia,2013,GM,GMB,AFR,192076,297484,489560,207591,141247,95935,61243,30610,27307,563933,187832,292008,479840,206911,148910,106335,67051,31563,30760,591530,1155463,2124869,2124869
Gambia,2014,GM,GMB,AFR,195866,307240,503106,214355,145728,98978,63940,32332,27505,582838,191470,301508,492978,212945,152835,109383,70495,33627,30815,610100,1192938,2189019,2189019
Gambia,2015,GM,GMB,AFR,199015,317197,516212,221182,150325,102084,66574,34292,27674,602131,194492,311206,505698,219112,156827,112435,73865,35987,30869,629095,1231226,2253133,2253133
Gambia,2016,GM,GMB,AFR,201448,327274,528722,228105,155107,105277,69159,36380,27950,621978,196841,321013,517854,225449,160957,115513,77140,38498,31089,648646,1270624,2317206,2317206
Gambia,2017,GM,GMB,AFR,203219,337364,540583,235134,160091,108540,71709,38581,28326,642381,198551,330848,529399,231982,165245,118625,80331,41194,31437,668814,1311195,2381182,2381182
Gambia,2018,GM,GMB,AFR,204549,347036,551585,242548,165235,111829,74249,40875,28799,663535,199829,340267,540096,238960,169645,121718,83441,44045,31897,689706,1353241,2444916,2444916
Gambia,2019,GM,GMB,AFR,205716,355994,561710,250539,170447,115219,76797,43238,29392,685632,200953,348999,549952,246576,174098,124861,86490,47032,32529,711586,1397218,2508883,2508883
Gambia,2020,GM,GMB,AFR,207005,364310,571315,259133,175882,118836,79346,45570,29955,708722,202202,357123,559325,254879,178786,128185,89471,50081,33239,734641,1443363,2573995,2573995
Gambia,2021,GM,GMB,AFR,208605,371747,580352,268393,181631,122659,81887,47803,30388,732761,203745,364332,568077,263888,183779,131671,92367,53089,33925,758719,1491480,2639916,2639916
Gambia,2022,GM,GMB,AFR,210529,378312,588841,277930,187578,126617,84451,50001,30920,757497,205590,370662,576252,273189,188978,135238,95194,56076,34728,783403,1540900,2705992,2705992
Gambia,2023,GM,GMB,AFR,212728,384221,596949,287462,193865,130723,87122,52234,31736,783142,207712,376363,584075,282514,194560,138922,98039,59100,35864,808999,1592141,2773168,2773168
Gambia,2024,GM,GMB,AFR,215042,389497,604539,297127,200469,135018,89945,54530,32934,810023,209978,381471,591449,292003,200524,142745,100947,62176,37394,835789,1645812,2841803,2841803
Gambia,2025,GM,GMB,AFR,217247,394201,611448,306985,207188,139492,92914,56877,34469,837925,212162,386063,598225,301702,206692,146707,103926,65261,39308,863596,1701521,2911207,2911207
Gambia,2026,GM,GMB,AFR,219301,398452,617753,316933,214043,144196,96006,59228,36264,866670,214217,390231,604448,311494,213076,150853,106967,68310,41528,892228,1758898,2981095,2981095
Gambia,2027,GM,GMB,AFR,221198,402336,623534,326911,221053,149147,99188,61565,38209,896073,216126,394052,610178,321313,219693,155196,110054,71293,43965,921514,1817587,3051307,3051307
Gambia,2028,GM,GMB,AFR,222889,406008,628897,336523,228480,154313,102435,63915,40295,925961,217827,397679,615506,330778,226806,159717,113168,74227,46622,951318,1877279,3121685,3121685
Gambia,2029,GM,GMB,AFR,224534,409615,634149,345460,236493,159590,105796,66287,42499,956125,219463,401269,620732,339579,234567,164330,116343,77112,49476,981407,1937532,3192412,3192412
Gambia,2030,GM,GMB,AFR,226264,413234,639498,353756,244930,164931,109321,68676,44809,986423,221168,404905,626073,347734,242818,169014,119634,79942,52513,1011655,1998078,3263651,3263651
Gambia,1950,GM,GMB,AFR,28105,38921,67026,29312,20955,14265,9813,5972,3286,83603,27507,39537,67044,30046,21862,15000,10748,7066,4380,89102,172705,306781,306781
Gambia,1951,GM,GMB,AFR,27796,40222,68018,30090,22032,14701,10105,6158,3451,86537,27342,40707,68049,30835,22953,15419,11015,7241,4546,92009,178546,314613,314613
Gambia,1952,GM,GMB,AFR,27728,41467,69195,30850,23130,15137,10402,6347,3613,89479,27420,41804,69224,31599,24073,15836,11291,7416,4714,94929,184408,322827,322827
Gambia,1953,GM,GMB,AFR,28083,42428,70511,31595,24233,15597,10706,6542,3769,92442,27885,42655,70540,32359,25190,16281,11578,7600,4877,97885,190327,331377,331377
Gambia,1954,GM,GMB,AFR,28940,42988,71928,32343,25290,16132,11021,6735,3924,95445,28859,43097,71956,33121,26268,16811,11877,7785,5048,100910,196355,340240,340240
Gambia,1955,GM,GMB,AFR,29989,43421,73410,33118,26283,16766,11347,6936,4081,98531,29992,43442,73434,33900,27288,17445,12186,7975,5213,104007,202538,349374,349374
Gambia,1956,GM,GMB,AFR,31010,43928,74938,33924,27213,17483,11683,7138,4236,101677,31007,43954,74961,34702,28236,18173,12511,8170,5378,107170,208847,358748,358748
Gambia,1957,GM,GMB,AFR,32047,44472,76519,34777,28073,18297,12040,7343,4390,104920,32030,44517,76547,35545,29109,18998,12855,8369,5549,110425,215345,368414,368414
Gambia,1958,GM,GMB,AFR,33128,45030,78158,35717,28876,19181,12408,7554,4544,108280,33095,45116,78211,36458,29929,19903,13218,8576,5717,113801,222081,378454,378454
Gambia,1959,GM,GMB,AFR,34247,45595,79842,36778,29636,20112,12780,7774,4706,111786,34193,45745,79938,37468,30713,20853,13583,8792,5894,117303,229089,388866,388866
Gambia,1960,GM,GMB,AFR,35399,46192,81591,37953,30367,21057,13158,7998,4871,115404,35319,46433,81752,38552,31478,21826,13957,9016,6073,120902,236306,399649,399649
Gambia,1961,GM,GMB,AFR,36580,46876,83456,39176,31084,22025,13538,8233,5034,119090,36468,47235,83703,39667,32221,22821,14333,9249,6262,124553,243643,410801,410801
Gambia,1962,GM,GMB,AFR,37774,47749,85523,40360,31787,23016,13920,8472,5207,122762,37633,48240,85873,40721,32953,23840,14715,9487,6443,128159,250921,422310,422310
Gambia,1963,GM,GMB,AFR,38968,49020,87988,41279,32480,24013,14322,8722,5381,126197,38797,49613,88410,41548,33674,24860,15123,9736,6641,131582,257779,434173,434173
Gambia,1964,GM,GMB,AFR,40148,50788,90936,41827,33183,24971,14794,8976,5554,129305,39954,51486,91440,41995,34402,25849,15604,9997,6839,134686,263991,446375,446375
Gambia,1965,GM,GMB,AFR,41319,52785,94104,42251,33909,25872,15348,9244,5741,132365,41097,53557,94654,42355,35153,26786,16177,10269,7044,137784,270149,458908,458908
Gambia,1966,GM,GMB,AFR,42462,54821,97283,42742,34667,26725,15990,9522,5931,135577,42212,55578,97790,42866,35924,27671,16835,10556,7255,141107,276684,471753,471753
Gambia,1967,GM,GMB,AFR,43615,56911,100526,43297,35501,27531,16717,9823,6131,139000,43325,57645,100970,43451,36761,28504,17589,10861,7472,144638,283638,485132,485132
Gambia,1968,GM,GMB,AFR,44802,59052,103854,43894,36448,28308,17518,10141,6336,142645,44476,59763,104239,44102,37701,29305,18422,11183,7704,148417,291062,499151,499151
Gambia,1969,GM,GMB,AFR,46046,61237,107283,44504,37523,29056,18359,10457,6556,146455,45680,61912,107592,44786,38744,30080,19296,11511,7941,152358,298813,513686,513686
Gambia,2031,GM,GMB,AFR,227943,417003,644946,361163,253856,170415,113001,71104,47201,1016740,222815,408686,631501,355011,251622,173861,123051,82730,55690,1041965,2058705,3335153,3335153
Gambia,2032,GM,GMB,AFR,229598,420879,650477,367694,263123,176152,116821,73582,49675,1047047,224445,412578,637023,361427,260804,178983,126580,85492,59009,1072295,2119342,3406845,3406845
Gambia,2033,GM,GMB,AFR,231405,424776,656181,373558,272432,182256,120787,76119,52217,1077369,226235,416486,642721,367190,270060,184512,130216,88241,62450,1102669,2180038,3478941,3478941
Gambia,2034,GM,GMB,AFR,233181,428723,661904,378796,281863,188648,124891,78731,54819,1107748,227991,420453,648444,372344,279455,190392,133951,90997,66002,1133141,2240889,3551235,3551235
Gambia,2035,GM,GMB,AFR,234802,432701,667503,383513,291517,195181,129162,81431,57483,1138287,229599,424453,654052,377005,289067,196474,137807,93784,69636,1163773,2302060,3623617,3623617
Gambia,2036,GM,GMB,AFR,236444,436532,672976,387808,301288,201862,133652,84223,60204,1169037,231235,428305,659540,381275,298793,202781,141844,96623,73341,1194657,2363694,3696214,3696214
Gambia,2037,GM,GMB,AFR,238019,440186,678205,391749,311093,208694,138374,87098,62988,1199996,232801,431994,664795,385195,308553,209317,146073,99508,77119,1225765,2425761,3768766,3768766
Gambia,2038,GM,GMB,AFR,239344,443789,683133,395484,320542,215930,143302,90036,65850,1231144,234114,435640,669754,388925,317961,216335,150471,102418,80968,1257078,2488222,3841110,3841110
Gambia,2039,GM,GMB,AFR,240464,447311,687775,399146,329342,223732,148335,93076,68784,1262415,235230,439183,674413,392620,326722,223986,154955,105393,84874,1288550,2550965,3913159,3913159
Gambia,2040,GM,GMB,AFR,241367,450759,692126,402828,337519,231943,153431,96266,71763,1293750,236123,442649,678772,396354,334855,232116,159516,108480,88813,1320134,2613884,3984778,3984778
Gambia,2041,GM,GMB,AFR,242032,454182,696214,406647,344834,240631,158665,99594,74794,1325165,236773,446085,682858,400230,342129,240782,164232,111678,92778,1351829,2676994,4056053,4056053
Gambia,2042,GM,GMB,AFR,242480,457518,699998,410578,351300,249642,164138,103053,77877,1356588,237223,449432,686655,404212,348557,249822,169212,114983,96760,1383546,2740134,4126792,4126792
Gambia,2043,GM,GMB,AFR,242735,460752,703487,414520,357116,258699,169962,106643,81032,1387972,237482,452685,690167,408213,354347,258940,174589,118393,100773,1415255,2803227,4196882,4196882
Gambia,2044,GM,GMB,AFR,243017,463753,706770,418506,362327,267881,176060,110357,84254,1419385,237764,455709,693473,412268,359538,268196,180299,121895,104834,1447030,2866415,4266668,4266668
Gambia,2045,GM,GMB,AFR,243354,466385,709739,422523,367036,277277,182295,114230,87549,1450910,238110,458363,696473,416352,364253,277671,186213,125514,108949,1478952,2929862,4336077,4336077
Gambia,2046,GM,GMB,AFR,243687,468798,712485,426396,371339,286790,188677,118303,90944,1482449,238457,460799,699256,420283,368578,287253,192343,129308,113114,1510879,2993328,4405075,4405075
Gambia,2047,GM,GMB,AFR,244034,470933,714967,430093,375298,296340,195200,122586,94426,1513943,238807,462966,701773,424061,372567,296874,198699,133279,117348,1542828,3056771,4473507,4473507
Gambia,2048,GM,GMB,AFR,244283,472629,716912,433740,379053,305549,202117,127058,97980,1545497,239072,464688,703760,427787,376368,306162,205528,137413,121632,1574890,3120387,4541056,4541056
Gambia,2049,GM,GMB,AFR,244231,474151,718382,437304,382744,314135,209574,131620,101659,1577036,239043,466238,705281,431415,380135,314825,212966,141634,125987,1606962,3183998,4607658,4607658
Gambia,2050,GM,GMB,AFR,244129,475511,719640,440796,386444,322124,217418,136245,105472,1608499,238954,467628,706582,434961,383944,322878,220866,145929,130443,1639021,3247520,4673743,4673743
Guinea-Bissau,1970,GW,GNB,AFR,45185,80210,125395,50742,25012,31715,29686,18707,10319,166181,44745,80817,125562,50651,34885,35519,24173,16173,13131,174532,340713,591663,591663
Guinea-Bissau,1971,GW,GNB,AFR,45220,80580,125800,52952,24239,30036,29549,19279,10504,166559,44757,81317,126074,52643,33537,35514,24661,16502,13219,176076,342635,594501,594501
Guinea-Bissau,1972,GW,GNB,AFR,45531,80473,126004,54931,23694,28078,29261,19746,10743,166453,45049,81277,126326,54593,32208,35114,25146,16762,13345,177168,343621,595950,595950
Guinea-Bissau,1973,GW,GNB,AFR,46057,80327,126384,57702,24538,26444,29062,20222,11122,169090,45552,81156,126708,57548,32156,34835,25832,17069,13580,181020,350110,603203,603203
Guinea-Bissau,1974,GW,GNB,AFR,49188,81300,130488,60242,27385,25559,28323,20573,12385,174467,48342,81680,130022,62103,34643,34539,26112,17132,14078,188607,363074,623576,623576
Guinea-Bissau,1975,GW,GNB,AFR,55534,84262,139796,62221,31995,25838,27111,20662,14550,182377,54224,83412,137636,67642,39922,34608,25964,16893,14800,199829,382206,659635,659635
Guinea-Bissau,1976,GW,GNB,AFR,62742,89195,151937,63527,36460,26902,25987,20423,16792,190091,61352,86576,147928,71931,45994,35275,25845,16552,15461,211058,401149,701016,701016
Guinea-Bissau,1977,GW,GNB,AFR,69959,96295,166254,64424,40501,28760,25057,19876,19058,197676,68799,91669,160468,74964,52571,36712,25762,16125,16056,222190,419866,746588,746588
Guinea-Bissau,1978,GW,GNB,AFR,76015,105549,181564,65278,43910,31380,24433,19042,21292,205335,75222,98990,174212,76888,59343,39055,25752,15630,16555,233223,438558,794328,794328
Guinea-Bissau,1979,GW,GNB,AFR,78351,111146,189497,66690,46377,33168,24136,18392,22276,211039,77594,103877,181471,78250,63506,40056,25571,15466,16754,239603,450642,821598,821598
Guinea-Bissau,1980,GW,GNB,AFR,78877,112957,191834,67822,47553,33550,24197,18313,22435,213870,77831,106365,184196,78564,64797,39622,25548,15859,17170,241560,455430,831462,831462
Guinea-Bissau,1981,GW,GNB,AFR,80361,115788,196149,68258,47973,33747,24436,18496,22996,215906,79010,110194,189204,77954,65790,39615,25856,16463,18016,243694,459600,844957,844957
Guinea-Bissau,1982,GW,GNB,AFR,81892,118623,200515,68823,48324,33977,24646,18701,23543,218014,80243,114045,194288,77517,66622,39667,26074,17081,18850,245811,463825,858630,858630
Guinea-Bissau,1983,GW,GNB,AFR,83579,121224,204803,69609,48580,34250,24822,18934,24079,220274,81751,117550,199301,77395,67243,39820,26197,17695,19667,248017,468291,872394,872394
Guinea-Bissau,1984,GW,GNB,AFR,85219,123698,208917,70692,48757,34568,24961,19195,24578,222751,83324,120769,204093,77733,67609,40107,26240,18299,20462,250450,473201,886210,886210
Guinea-Bissau,1985,GW,GNB,AFR,86522,126304,212826,72098,48868,34943,25070,19480,25034,225493,84584,124010,208594,78593,67706,40566,26209,18886,21216,253176,478669,900088,900088
Guinea-Bissau,1986,GW,GNB,AFR,87567,128994,216561,73815,48928,35367,25163,19773,25444,228490,85581,127210,212791,79990,67572,41201,26121,19442,21954,256280,484770,914122,914122
Guinea-Bissau,1987,GW,GNB,AFR,88460,131726,220186,75818,48978,35827,25244,20062,25824,231753,86435,130283,216718,81911,67261,41984,25994,19937,22663,259750,491503,928408,928408
Guinea-Bissau,1988,GW,GNB,AFR,89267,134503,223770,78056,49063,36316,25334,20337,26165,235271,87197,133211,220408,84326,66831,42882,25852,20374,23363,263628,498899,943080,943080
Guinea-Bissau,1989,GW,GNB,AFR,90059,137310,227369,80491,49228,36795,25453,20592,26484,239043,87936,135942,223878,87243,66322,43855,25733,20745,24054,267952,506995,958239,958239
Guinea-Bissau,1990,GW,GNB,AFR,90711,140093,230804,83111,49501,37250,25607,20813,26775,243057,88532,138462,226994,90621,65775,44852,25649,21050,24742,272689,515746,973551,973551
Guinea-Bissau,1991,GW,GNB,AFR,91309,143735,235044,87094,50335,37968,25911,20863,26538,248709,89189,141575,230764,94702,65948,46593,25948,21211,24931,279333,528042,993856,993856
Guinea-Bissau,1992,GW,GNB,AFR,92503,148539,241042,92670,51970,39056,26487,20831,25892,256906,90504,145770,236274,99577,67098,49167,26795,21308,24739,288684,545590,1022904,1022904
Guinea-Bissau,1993,GW,GNB,AFR,94424,153658,248082,98537,54136,40220,27256,20888,25411,266448,92479,150563,243042,104624,68659,51785,27969,21463,24684,299184,565632,1056761,1056761
Guinea-Bissau,1994,GW,GNB,AFR,96523,158151,254674,104235,56631,41237,28068,20907,24931,276009,94575,154998,249573,109351,70393,54112,29338,21559,24609,309362,585371,1089617,1089617
Guinea-Bissau,1995,GW,GNB,AFR,98556,161039,259595,109516,59242,41957,28805,20823,24359,284702,96567,157994,254561,113612,72096,55888,30804,21530,24432,318362,603064,1117222,1117222
Guinea-Bissau,1996,GW,GNB,AFR,100566,162651,263217,114341,62007,42434,29480,20675,23735,292672,98515,159813,258328,117409,73871,57153,32365,21425,24168,326391,619063,1140604,1140604
Guinea-Bissau,1997,GW,GNB,AFR,102476,163881,266357,118849,65019,42796,30124,20518,23090,300396,100351,161274,261625,120916,75894,58061,34041,21312,23847,334071,634467,1162443,1162443
Guinea-Bissau,1998,GW,GNB,AFR,104360,165171,269531,122987,68148,43082,30724,20370,22426,307737,102154,162802,264956,124253,78255,58731,35826,21257,23521,341843,649580,1184071,1184071
Guinea-Bissau,1999,GW,GNB,AFR,106265,166705,272970,126848,71430,43401,31280,20282,21799,315040,103966,164565,268531,127437,81047,59234,37685,21295,23238,349936,664976,1206474,1206474
Guinea-Bissau,2000,GW,GNB,AFR,108246,168573,276819,130674,75129,43920,31852,20302,21254,323131,105842,166610,272452,130461,84284,59634,39597,21467,23003,358446,681577,1230849,1230849
Guinea-Bissau,2001,GW,GNB,AFR,110374,170829,281203,134371,79237,44662,32435,20432,20795,331932,107856,169004,276860,133355,87875,60029,41522,21791,22812,367384,699316,1257380,1257380
Guinea-Bissau,2002,GW,GNB,AFR,112688,173537,286225,137778,83550,45643,32985,20653,20395,341004,110054,171782,281836,136174,91609,60507,43388,22289,22650,376617,717621,1285678,1285678
Guinea-Bissau,2003,GW,GNB,AFR,115236,176680,291916,141019,87820,46949,33492,20964,20046,350290,112481,174941,287422,139110,95151,61172,45125,22983,22490,386031,736321,1315653,1315653
Guinea-Bissau,2004,GW,GNB,AFR,117907,180216,298123,143970,92100,48645,33961,21357,19758,359791,115040,178419,293459,142005,98580,62142,46674,23886,22346,395633,755424,1347009,1347009
Guinea-Bissau,2005,GW,GNB,AFR,120640,184315,304955,146302,96575,50738,34401,21823,19522,369361,117669,182388,300057,144429,102172,63478,48015,25004,22243,405341,774702,1379713,1379713
Guinea-Bissau,2006,GW,GNB,AFR,123509,188959,312468,148207,101141,53225,34827,22360,19348,379108,120438,186856,307294,146497,105861,65201,49161,26321,22172,415213,794321,1414091,1414091
Guinea-Bissau,2007,GW,GNB,AFR,126514,193946,320460,150147,105729,56097,35284,22957,19249,389463,123339,191661,315000,148627,109569,67324,50140,27813,22168,425641,815104,1450572,1450572
Guinea-Bissau,2008,GW,GNB,AFR,129338,199216,328554,152255,110284,59287,35791,23586,19221,400424,126063,196728,322791,150930,113243,69839,50981,29428,22237,436658,837082,1488431,1488431
Guinea-Bissau,2009,GW,GNB,AFR,131851,204665,336516,154603,114737,62760,36387,24215,19248,411950,128480,201958,330438,153464,116824,72773,51704,31128,22398,448291,860241,1527196,1527196
Guinea-Bissau,2010,GW,GNB,AFR,134169,210324,344493,157254,119023,66524,37107,24830,19340,424078,130688,207390,338078,156267,120286,76130,52339,32880,22668,460570,884648,1567220,1567220
Guinea-Bissau,2011,GW,GNB,AFR,136522,216247,352769,160227,123074,70590,37979,25442,19502,436814,132907,213070,345977,159357,123621,79812,52959,34651,23064,473464,910278,1609017,1609017
Guinea-Bissau,2012,GW,GNB,AFR,138919,222435,361354,163606,126879,74877,39075,26034,19745,450216,135166,218998,354164,162797,126897,83643,53664,36379,23604,486984,937200,1652717,1652717
Guinea-Bissau,2013,GW,GNB,AFR,141380,228672,370052,167382,130549,79153,40464,26596,20054,464198,137488,224969,362457,166577,130287,87327,54549,38017,24295,501052,965250,1697753,1697753
Guinea-Bissau,2014,GW,GNB,AFR,143875,234704,378579,171501,133929,83457,42191,27119,20427,478624,139841,230738,370579,170636,133625,90921,55705,39503,25139,515529,994153,1743309,1743309
Guinea-Bissau,2015,GW,GNB,AFR,146097,240564,386661,176130,136707,87956,44263,27620,20853,493529,141953,236320,378273,175145,136494,94682,57190,40810,26136,530457,1023986,1788919,1788919
Guinea-Bissau,2016,GW,GNB,AFR,147733,246500,394233,181221,139061,92546,46687,28106,21337,508958,143511,241965,385476,180078,138998,98527,59020,41954,27305,545882,1054840,1834552,1834552
Guinea-Bissau,2017,GW,GNB,AFR,148514,252488,401002,186573,141394,97142,49437,28605,21874,525025,144234,247659,391893,185264,141513,102372,61199,42949,28607,561904,1086929,1879826,1879826
Guinea-Bissau,2018,GW,GNB,AFR,148715,258323,407038,192160,143850,101695,52468,29138,22437,541748,144399,253208,397607,190666,144156,106168,63722,43817,30024,578553,1120301,1924955,1924955
Guinea-Bissau,2019,GW,GNB,AFR,148858,263871,412729,197873,146484,106147,55748,29743,23026,559021,144512,258464,402976,196180,146973,109861,66617,44571,31537,595739,1154760,1970457,1970457
Guinea-Bissau,2020,GW,GNB,AFR,149200,268910,418110,203723,149351,110385,59226,30361,23452,576498,144829,263213,408042,201814,149994,113385,69839,45170,32980,613182,1189680,2015828,2015828
Guinea-Bissau,2021,GW,GNB,AFR,149782,273334,423116,209760,152460,114322,62878,31000,23686,594106,145392,267365,412757,207619,153221,116726,73283,45640,34260,630749,1224855,2060721,2060721
Guinea-Bissau,2022,GW,GNB,AFR,150737,276895,427632,215982,155894,117984,66679,31805,23886,612230,146309,270686,416995,213602,156721,119952,76813,46144,35483,648715,1260945,2105566,2105566
Guinea-Bissau,2023,GW,GNB,AFR,151854,279878,431732,222215,159680,121516,70500,32903,24194,631008,147387,273448,420835,219584,160515,123277,80223,46864,36802,667265,1298273,2150842,2150842
Guinea-Bissau,2024,GW,GNB,AFR,152909,282784,435693,228238,163784,124834,74451,34402,24733,650442,148440,276155,424595,225367,164583,126585,83630,47945,38317,686427,1336869,2197149,2197149
Guinea-Bissau,2025,GW,GNB,AFR,154020,285569,439589,234082,168371,127622,78645,36255,25391,670366,149577,278792,428369,230962,169089,129459,87238,49377,39913,706038,1376404,2244368,2244368
Guinea-Bissau,2026,GW,GNB,AFR,155198,287964,443162,239996,173393,129999,82926,38395,26064,690773,150788,281071,431859,236616,173999,131984,90927,51110,41471,726107,1416880,2291896,2291896
Guinea-Bissau,2027,GW,GNB,AFR,156455,289839,446294,245950,178660,132346,87212,40801,26757,711726,152088,282850,434938,242316,179146,134513,94616,53146,42974,746711,1458437,2339677,2339677
Guinea-Bissau,2028,GW,GNB,AFR,157879,291296,449175,251758,184147,134807,91467,43440,27501,733120,153543,284244,437787,247864,184502,137164,98266,55485,44438,767719,1500839,2387792,2387792
Guinea-Bissau,2029,GW,GNB,AFR,159409,292639,452048,257273,189746,137432,95627,46290,28282,754650,155080,285569,440649,253118,189957,139977,101817,58146,45846,788861,1543511,2436201,2436201
Guinea-Bissau,2030,GW,GNB,AFR,160914,294192,455106,262279,195469,140264,99625,49344,29128,776109,156586,287131,443717,257866,195529,142975,105224,61121,47208,809923,1586032,2484863,2484863
Guinea-Bissau,1950,GW,GNB,AFR,44721,59585,104306,48570,43733,33017,19156,11297,8414,164187,44554,59817,104371,48535,44095,33705,20457,13415,10338,170545,334732,543413,543413
Guinea-Bissau,1951,GW,GNB,AFR,45156,60288,105444,48337,44162,33977,19646,11526,8646,166294,44887,60684,105571,48887,44239,34093,20696,13634,10615,172164,338458,549480,549480
Guinea-Bissau,1952,GW,GNB,AFR,45385,60630,106015,47923,44636,34811,20108,11814,8896,168188,45021,61087,106108,49361,44340,34044,20755,13876,10907,173283,341471,553602,553602
Guinea-Bissau,1953,GW,GNB,AFR,45554,61005,106559,47394,45087,35564,20636,12124,9125,169930,45122,61421,106543,49803,44512,33820,20800,14120,11189,174244,344174,557279,557279
Guinea-Bissau,1954,GW,GNB,AFR,45796,61259,107055,46813,45493,36280,21255,12403,9328,171572,45306,61564,106870,50219,44763,33510,20859,14309,11449,175109,346681,560612,560612
Guinea-Bissau,1955,GW,GNB,AFR,46090,61432,107522,46208,45856,36984,21963,12639,9510,173160,45557,61567,107124,50592,45109,33162,20922,14437,11683,175905,349065,563713,563713
Guinea-Bissau,1956,GW,GNB,AFR,46362,61640,108002,45576,46155,37668,22763,12836,9666,174664,45796,61566,107362,50876,45551,32794,21010,14497,11895,176623,351287,566658,566658
Guinea-Bissau,1957,GW,GNB,AFR,46661,61839,108500,44939,46379,38337,23674,12983,9807,176119,46061,61552,107613,51069,46075,32425,21139,14482,12079,177269,353388,569505,569505
Guinea-Bissau,1958,GW,GNB,AFR,46992,62007,108999,44351,46529,38979,24638,13120,9940,177557,46364,61525,107889,51195,46672,32069,21268,14413,12251,177868,355425,572314,572314
Guinea-Bissau,1959,GW,GNB,AFR,47358,62031,109389,43994,46579,39593,25559,13284,10094,179103,46703,61290,107993,51485,47324,31735,21293,14337,12446,178620,357723,575105,575105
Guinea-Bissau,1960,GW,GNB,AFR,47761,62041,109802,43765,46515,40162,26401,13514,10282,180639,47078,60991,108069,51828,48012,31442,21191,14275,12674,179422,360061,577933,577933
Guinea-Bissau,1961,GW,GNB,AFR,48501,63250,111751,43510,45835,40574,27275,13828,10391,181413,47884,61955,109839,51367,48558,31725,21341,14254,12852,180097,361510,583107,583107
Guinea-Bissau,1962,GW,GNB,AFR,49443,65529,114972,43493,44473,40772,28155,14225,10461,181579,48958,64137,113095,50356,48768,32571,21766,14281,13010,180752,362331,590399,590399
Guinea-Bissau,1963,GW,GNB,AFR,50125,67764,117889,43609,42573,40627,28828,14646,10517,180800,49716,66462,116178,49435,48475,33380,22126,14346,13169,180931,361731,595802,595802
Guinea-Bissau,1964,GW,GNB,AFR,50242,69827,120069,42474,38820,39433,29014,14972,10397,175110,49869,68732,118601,47182,46270,33485,22204,14360,13196,176697,351807,590481,590481
Guinea-Bissau,1965,GW,GNB,AFR,49571,71762,121333,40841,33916,37522,28892,15274,10186,166631,49207,70956,120163,44313,42588,33050,22090,14355,13112,169508,336139,577638,577638
Guinea-Bissau,1966,GW,GNB,AFR,48404,73733,122137,40841,30016,35901,28888,15746,10060,161452,48041,73264,121305,43199,39553,32997,22169,14497,13064,165479,326931,570375,570375
Guinea-Bissau,1967,GW,GNB,AFR,47233,75758,122991,42903,27917,34927,29153,16460,10051,161411,46860,75626,122486,44400,37969,33634,22570,14861,13059,166493,327904,573380,573380
Guinea-Bissau,1968,GW,GNB,AFR,46345,77696,124041,46197,27179,34349,29570,17315,10132,164742,45956,77873,123829,47090,37413,34703,23205,15368,13086,170865,335607,583475,583475
Guinea-Bissau,1969,GW,GNB,AFR,45608,79196,124804,48502,25939,33143,29691,18050,10197,165522,45189,79621,124810,48841,36112,35220,23688,15794,13085,172740,338262,587880,587880
Guinea-Bissau,2031,GW,GNB,AFR,162394,296002,458396,266672,201370,143323,103395,52613,30064,797437,158053,288968,447021,262021,201270,146179,108485,64341,48561,830857,1628294,2533716,2533716
Guinea-Bissau,2032,GW,GNB,AFR,163834,298215,462049,270211,207465,146703,106920,56033,31116,818448,159484,291215,450699,265347,207201,149665,111663,67664,49961,851501,1669949,2582689,2582689
Guinea-Bissau,2033,GW,GNB,AFR,165213,300761,465974,273188,213577,150408,110300,59442,32335,839250,160853,293797,454650,268137,213145,153442,114917,70840,51476,871957,1711207,2631836,2631836
Guinea-Bissau,2034,GW,GNB,AFR,166561,303389,469950,276093,219489,154414,113436,62890,33779,860101,162191,296471,458662,270874,218892,157473,118121,73958,53150,892468,1752569,2681179,2681179
Guinea-Bissau,2035,GW,GNB,AFR,167832,306053,473885,278888,225233,158875,116067,66509,35427,880999,163455,299181,462636,273540,224456,161914,120906,77227,55015,913058,1794057,2730575,2730575
Guinea-Bissau,2036,GW,GNB,AFR,169003,308752,477755,281303,231047,163741,118326,70215,37288,901920,164619,301928,466547,275862,230072,166744,123365,80581,57085,933709,1835629,2779923,2779923
Guinea-Bissau,2037,GW,GNB,AFR,170108,311489,481597,283205,236906,168850,120567,73932,39364,922824,165716,304725,470441,277685,235741,171809,125833,83936,59347,954351,1877175,2829211,2829211
Guinea-Bissau,2038,GW,GNB,AFR,171126,314333,485459,284703,242628,174172,122922,77621,41611,943657,166723,307619,474342,279128,241270,177083,128424,87268,61813,974986,1918643,2878439,2878439
Guinea-Bissau,2039,GW,GNB,AFR,171999,317248,489247,286083,248066,179608,125440,81232,44035,964464,167588,310560,478148,280507,246516,182462,131179,90516,64499,995679,1960143,2927526,2927526
Guinea-Bissau,2040,GW,GNB,AFR,172734,320067,492801,287676,253012,185162,128157,84704,46643,985354,168322,313394,481716,282122,251263,187955,134112,93644,67388,1016484,2001838,2976354,2976354
Guinea-Bissau,2041,GW,GNB,AFR,173385,322762,496147,289517,257360,190888,131088,87983,49442,1006278,168972,316096,485068,284005,255427,193617,137245,96649,70461,1037404,2043682,3024905,3024905
Guinea-Bissau,2042,GW,GNB,AFR,173941,325351,499292,291754,260882,196812,134313,91058,52419,1027238,169529,318694,488223,286291,258782,199465,140648,99578,73635,1058399,2085637,3073149,3073149
Guinea-Bissau,2043,GW,GNB,AFR,174459,327798,502257,294322,263863,202749,137849,94003,55466,1048252,170056,321141,491197,288913,261612,205329,144330,102568,76769,1079521,2127773,3121218,3121218
Guinea-Bissau,2044,GW,GNB,AFR,174921,330068,504989,296962,266771,208498,141659,96742,58666,1069298,170531,323422,493953,291617,264392,211004,148248,105512,79972,1100745,2170043,3168974,3168974
Guinea-Bissau,2045,GW,GNB,AFR,175292,332127,507419,299639,269569,214086,145887,99056,62117,1090354,170913,325492,496405,294362,267101,216502,152561,108087,83438,1122051,2212405,3216222,3216222
Guinea-Bissau,2046,GW,GNB,AFR,175628,334007,509635,302352,272001,219743,150486,101062,65753,1111397,171266,327387,498653,297140,269470,222056,157240,110373,87105,1143384,2254781,3263074,3263074
Guinea-Bissau,2047,GW,GNB,AFR,175873,335727,511600,305108,273943,225455,155314,103072,69488,1132380,171529,329122,500651,299974,271353,227671,162145,112683,90914,1164740,2297120,3309375,3309375
Guinea-Bissau,2048,GW,GNB,AFR,175993,337322,513315,307958,275489,231033,160350,105201,73289,1153320,171668,330734,502402,302893,272867,233150,167258,115117,94844,1186129,2339449,3355175,3355175
Guinea-Bissau,2049,GW,GNB,AFR,176082,338723,514805,310882,276925,236349,165493,107479,77095,1174223,171772,332155,503927,305866,274318,238356,172480,117713,98838,1207571,2381794,3400527,3400527
Guinea-Bissau,2050,GW,GNB,AFR,176156,339898,516054,313712,278563,241194,170759,109944,80879,1195051,171861,333358,505219,308734,275999,243085,177811,120482,102860,1228971,2424022,3445289,3445289
Equatorial Guinea,1970,GQ,GNQ,AFR,25407,37422,62829,28603,20477,16476,12462,8590,6818,93426,25260,37920,63180,29381,20954,16894,13162,9354,7775,97520,190946,316955,316955
Equatorial Guinea,1971,GQ,GNQ,AFR,25267,36919,62186,28342,19881,16023,12119,8394,6597,91356,25118,37474,62592,29193,20580,16466,12856,9150,7573,95818,187174,311952,311952
Equatorial Guinea,1972,GQ,GNQ,AFR,24924,36273,61197,27954,19252,15539,11731,8169,6373,89018,24758,36818,61576,28778,20096,15962,12480,8904,7341,93561,182579,305362,305362
Equatorial Guinea,1973,GQ,GNQ,AFR,24459,35595,60054,27474,18649,15035,11328,7931,6151,86568,24269,36090,60359,28244,19575,15421,12075,8642,7107,91064,177632,298050,298050
Equatorial Guinea,1974,GQ,GNQ,AFR,23942,34927,58869,26756,18244,14498,10931,7687,5924,84040,23745,35389,59134,27515,19213,14882,11668,8375,6867,88520,172560,290558,290558
Equatorial Guinea,1975,GQ,GNQ,AFR,23435,34300,57735,25877,17990,13933,10541,7431,5699,81471,23246,34750,57996,26672,19014,14354,11274,8115,6634,86063,167534,283262,283262
Equatorial Guinea,1976,GQ,GNQ,AFR,22945,33683,56628,25017,17651,13320,10151,7164,5466,78769,22778,34185,56963,25898,18778,13830,10883,7854,6398,83641,162410,276000,276000
Equatorial Guinea,1977,GQ,GNQ,AFR,22661,33380,56041,24441,17476,12851,9877,6962,5296,76903,22497,33914,56411,25385,18682,13456,10601,7674,6223,82021,158924,271377,271377
Equatorial Guinea,1978,GQ,GNQ,AFR,22698,33565,56263,24301,17598,12622,9776,6871,5230,76398,22514,34073,56587,25240,18821,13315,10484,7605,6158,81623,158021,270866,270866
Equatorial Guinea,1979,GQ,GNQ,AFR,23019,34216,57235,24498,17909,12575,9782,6850,5217,76831,22808,34685,57493,25482,19202,13384,10508,7626,6163,82365,159196,273925,273925
Equatorial Guinea,1980,GQ,GNQ,AFR,23823,35524,59347,25234,18577,12806,9972,6968,5321,78878,23581,35940,59521,26247,19944,13748,10729,7796,6298,84762,163640,282509,282509
Equatorial Guinea,1981,GQ,GNQ,AFR,25181,37497,62678,26550,19653,13317,10375,7237,5557,82689,24903,37856,62759,27546,21043,14387,11141,8120,6586,88823,171512,296950,296950
Equatorial Guinea,1982,GQ,GNQ,AFR,26948,39993,66941,28290,21014,14010,10916,7602,5878,87710,26631,40296,66927,29281,22441,15226,11707,8547,6962,94164,181874,315741,315741
Equatorial Guinea,1983,GQ,GNQ,AFR,28582,42107,70689,30622,23098,15029,11508,7950,6193,94400,28228,42350,70578,31663,24558,16330,12289,8926,7314,101080,195480,336744,336744
Equatorial Guinea,1984,GQ,GNQ,AFR,30123,43619,73742,33176,25559,16443,12077,8249,6467,101971,29735,43807,73542,34298,27052,17760,12826,9209,7582,108727,210698,357995,357995
Equatorial Guinea,1985,GQ,GNQ,AFR,32007,45173,77180,35293,27671,17930,12597,8536,6706,108733,31580,45301,76881,36461,29206,19256,13342,9488,7828,115581,224314,378379,378379
Equatorial Guinea,1986,GQ,GNQ,AFR,34119,46789,80908,36925,29494,19277,13059,8806,6902,114463,33648,46845,80493,38099,31067,20630,13814,9750,8046,121406,235869,397276,397276
Equatorial Guinea,1987,GQ,GNQ,AFR,36366,48465,84831,38152,31018,20512,13468,9066,7075,119291,35849,48457,84306,39297,32628,21899,14261,10003,8259,126347,245638,414769,414769
Equatorial Guinea,1988,GQ,GNQ,AFR,38677,50231,88908,39147,32357,21703,13861,9318,7229,123615,38117,50162,88279,40239,34004,23120,14716,10253,8452,130784,254399,431587,431587
Equatorial Guinea,1989,GQ,GNQ,AFR,40849,52278,93127,40068,33614,22892,14278,9568,7385,127805,40248,52147,92395,41088,35296,24346,15208,10502,8653,135093,262898,448420,448420
Equatorial Guinea,1990,GQ,GNQ,AFR,42724,54752,97476,40978,34830,24110,14732,9816,7544,132010,42089,54558,96647,41923,36545,25592,15751,10750,8853,139414,271424,465549,465549
Equatorial Guinea,1991,GQ,GNQ,AFR,44368,57581,101949,41927,36022,25369,15228,10075,7709,136330,43709,57330,101039,42786,37772,26875,16336,11000,9059,143828,280158,483142,483142
Equatorial Guinea,1992,GQ,GNQ,AFR,45867,60676,106543,42957,37198,26683,15758,10346,7885,140827,45185,60371,105556,43725,38975,28212,16964,11260,9268,148404,289231,501334,501334
Equatorial Guinea,1993,GQ,GNQ,AFR,47305,63956,111261,44092,38374,28042,16353,10625,8068,145554,46602,63595,110197,44773,40162,29607,17646,11541,9485,153214,298768,520236,520236
Equatorial Guinea,1994,GQ,GNQ,AFR,48719,67349,116068,45493,39709,29388,17196,10926,8277,150989,47998,66927,114925,45870,41233,30871,18499,11832,9710,158015,309004,539992,539992
Equatorial Guinea,1995,GQ,GNQ,AFR,50128,70795,120923,47229,41240,30777,18261,11255,8511,157273,49390,70315,119705,47064,42182,32026,19502,12138,9930,162842,320115,560740,560740
Equatorial Guinea,1996,GQ,GNQ,AFR,51562,74287,125849,49179,42875,32305,19386,11606,8768,164119,50801,73749,124550,48488,43136,33253,20535,12464,10178,168054,332173,582573,582573
Equatorial Guinea,1997,GQ,GNQ,AFR,53040,77828,130868,51326,44646,33947,20584,11991,9059,171553,52251,77246,129497,50113,44123,34540,21617,12827,10441,173661,345214,605570,605570
Equatorial Guinea,1998,GQ,GNQ,AFR,54574,81417,135991,53637,46569,35702,21873,12417,9357,179555,53754,80796,134550,51933,45155,35867,22747,13229,10708,179639,359194,629734,629734
Equatorial Guinea,1999,GQ,GNQ,AFR,56173,84904,141077,56249,48632,37552,23238,12894,9678,188243,55322,84240,139562,54083,46251,37224,23925,13682,10983,186148,374391,655029,655029
Equatorial Guinea,2000,GQ,GNQ,AFR,57912,89533,147445,60368,50751,39272,24529,13400,9990,198310,56904,88400,145304,57061,47315,38587,25178,14304,11479,193924,392234,684977,684977
Equatorial Guinea,2001,GQ,GNQ,AFR,59721,94949,154670,66182,53025,40883,25710,13907,10311,210018,58396,93128,151524,60970,48352,39965,26501,15064,12203,203055,413073,719270,719270
Equatorial Guinea,2002,GQ,GNQ,AFR,61499,99425,160924,72735,55681,42641,26895,14413,10679,223044,59794,97294,157088,65517,49517,41380,27863,15794,12988,213059,436103,754115,754115
Equatorial Guinea,2003,GQ,GNQ,AFR,63404,103007,166411,79822,58771,44549,28082,14945,11087,237256,61302,100841,162143,70604,50873,42811,29243,16503,13833,223867,461123,789681,789681
Equatorial Guinea,2004,GQ,GNQ,AFR,65674,105821,171495,87179,62326,46601,29212,15615,11543,252476,63211,103741,166952,76111,52479,44229,30550,17309,14748,235426,487902,826355,826355
Equatorial Guinea,2005,GQ,GNQ,AFR,68494,108190,176684,94449,66373,48791,30384,16425,12040,268462,65792,106118,171910,81874,54396,45590,31809,18233,15775,247677,516139,864726,864726
Equatorial Guinea,2006,GQ,GNQ,AFR,72204,110342,182546,101258,70912,51134,31758,17289,12579,284930,69426,108007,177433,87718,56655,46856,33138,19219,16923,260509,545439,905418,905418
Equatorial Guinea,2007,GQ,GNQ,AFR,77020,112409,189429,107321,75954,53679,33362,18238,13148,301702,74328,109501,183829,93456,59316,48032,34534,20304,18211,273853,575555,948814,948814
Equatorial Guinea,2008,GQ,GNQ,AFR,82743,114711,197454,112418,81565,56491,35212,19257,13742,318685,80266,110961,191227,98895,62456,49160,36007,21486,19598,287602,606287,994971,994971
Equatorial Guinea,2009,GQ,GNQ,AFR,88961,117595,206556,116342,87904,59655,37299,20298,14361,335859,86773,112849,199622,103754,66245,50315,37570,22752,21018,301654,637513,1043686,1043686
Equatorial Guinea,2010,GQ,GNQ,AFR,95066,121446,216512,118975,95089,63269,39602,21301,14982,353218,93169,115756,208925,107783,70820,51584,39246,24048,22391,315872,669090,1094524,1094524
Equatorial Guinea,2011,GQ,GNQ,AFR,99351,126640,225991,120778,102869,67383,42206,22371,15536,371143,97634,120440,218074,110835,76231,53114,40970,25270,22963,329383,700526,1144588,1144588
Equatorial Guinea,2012,GQ,GNQ,AFR,101730,133131,234861,122186,110927,71898,45021,23557,16049,389638,100045,126931,226976,113036,82278,54957,42688,26417,22782,342158,731796,1193636,1193636
Equatorial Guinea,2013,GQ,GNQ,AFR,103556,140621,244177,123268,119032,76701,47870,24813,16625,408309,101806,134693,236499,114648,88647,57063,44361,27556,22679,354954,763263,1243941,1243941
Equatorial Guinea,2014,GQ,GNQ,AFR,104920,148978,253898,124206,126832,81729,50734,26169,17339,427009,103052,143485,246537,115788,95126,59428,45932,28682,22785,367741,794750,1295183,1295183
Equatorial Guinea,2015,GQ,GNQ,AFR,105922,158068,263990,125151,133931,86920,53605,27706,18189,445502,103943,153081,257024,116539,101489,62061,47355,29825,23184,380453,825955,1346973,1346973
Equatorial Guinea,2016,GQ,GNQ,AFR,107572,166858,274430,126154,140062,92257,56505,29482,19148,463608,105513,162395,267908,116953,107542,64969,48614,31037,23854,392969,856577,1398927,1398927
Equatorial Guinea,2017,GQ,GNQ,AFR,109848,175099,284947,127391,145132,97753,59469,31473,20187,481405,107725,171142,278867,117345,113124,68185,49752,32327,24739,405472,886877,1450694,1450694
Equatorial Guinea,2018,GQ,GNQ,AFR,111816,183290,295106,129145,149159,103475,62550,33617,21252,499198,109639,179780,289419,118194,118120,71768,50855,33686,25743,418366,917564,1502091,1502091
Equatorial Guinea,2019,GQ,GNQ,AFR,113526,191024,304550,131661,152138,109559,65802,35870,22302,517332,111302,187871,299173,119936,122362,75818,52000,35108,26747,431971,949303,1553031,1553031
Equatorial Guinea,2020,GQ,GNQ,AFR,114910,197755,312665,133814,152552,115302,68880,37936,23001,531485,112630,194862,307492,122248,124957,80076,53102,36484,27540,444407,975892,1596049,1596049
Equatorial Guinea,2021,GQ,GNQ,AFR,116010,203358,319368,136611,151243,120990,71941,39831,23392,544008,113681,200575,314256,125833,126222,84654,54270,37798,28059,456836,1000844,1634466,1634466
Equatorial Guinea,2022,GQ,GNQ,AFR,116983,207967,324950,141299,149711,127074,75312,41748,23829,558973,114603,205141,319744,131313,126900,89738,55676,39102,28510,471239,1030212,1674908,1674908
Equatorial Guinea,2023,GQ,GNQ,AFR,117882,211658,329540,147034,147497,132941,78853,43684,24415,574424,115448,208687,324135,138074,126801,94997,57284,40368,29049,486573,1060997,1714671,1714671
Equatorial Guinea,2024,GQ,GNQ,AFR,118701,214592,333293,153920,145089,138389,82584,45686,25317,590985,116239,211436,327675,146009,126199,100295,59129,41572,29828,503032,1094017,1754993,1754993
Equatorial Guinea,2025,GQ,GNQ,AFR,119375,216924,336299,161804,142707,143080,86476,47766,26583,608416,116923,213601,330524,154880,125214,105425,61217,42688,30909,520333,1128749,1795574,1795574
Equatorial Guinea,2026,GQ,GNQ,AFR,120004,219654,339658,169630,140513,146786,90490,49910,28177,625506,117592,216196,333788,163600,123960,110215,63553,43681,32285,537294,1162800,1836245,1836245
Equatorial Guinea,2027,GQ,GNQ,AFR,120704,222787,343491,177123,138755,149465,94651,52129,29978,642101,118335,219224,337559,171871,122787,114541,66177,44582,33854,553812,1195913,1876960,1876960
Equatorial Guinea,2028,GQ,GNQ,AFR,121426,225502,346928,184736,137786,151166,99027,54455,31900,659070,119096,221858,340954,180127,122197,118302,69144,45452,35542,570764,1229834,1917711,1917711
Equatorial Guinea,2029,GQ,GNQ,AFR,122258,227841,350099,192026,137880,151899,103734,56928,33864,676331,119951,224148,344099,187903,122655,121358,72550,46365,37248,588079,1264410,1958618,1958618
Equatorial Guinea,2030,GQ,GNQ,AFR,123222,229863,353085,198567,139313,151698,108868,59578,35805,693829,120923,226149,347072,194762,124585,123577,76492,47384,38891,605691,1299520,1999678,1999678
Equatorial Guinea,1950,GQ,GNQ,AFR,16019,23002,39021,19688,16150,12771,10179,7581,5935,72304,16295,23710,40005,20090,16631,13132,10425,8199,6569,75046,147350,226381,226381
Equatorial Guinea,1951,GQ,GNQ,AFR,16867,23302,40169,19913,16305,12949,10203,7635,6004,73009,17034,24128,41162,20284,16836,13306,10507,8223,6670,75826,148835,230172,230172
Equatorial Guinea,1952,GQ,GNQ,AFR,17681,23637,41318,20135,16452,13141,10231,7702,6064,73725,17751,24578,42329,20474,17028,13490,10604,8243,6767,76606,150331,233980,233980
Equatorial Guinea,1953,GQ,GNQ,AFR,18455,24039,42494,20350,16598,13332,10268,7776,6118,74442,18451,25067,43518,20662,17221,13684,10712,8257,6862,77398,151840,237853,237853
Equatorial Guinea,1954,GQ,GNQ,AFR,18973,24724,43697,20545,16760,13521,10320,7843,6167,75156,18942,25780,44722,20855,17417,13885,10827,8276,6958,78218,153374,241788,241788
Equatorial Guinea,1955,GQ,GNQ,AFR,19258,25688,44946,20718,16944,13702,10391,7895,6217,75867,19219,26725,45944,21053,17612,14085,10944,8305,7042,79041,154908,245800,245800
Equatorial Guinea,1956,GQ,GNQ,AFR,19524,26701,46225,20874,17151,13878,10488,7933,6270,76594,19476,27701,47177,21260,17820,14297,11066,8338,7120,79901,156495,249890,249890
Equatorial Guinea,1957,GQ,GNQ,AFR,19791,27731,47522,21026,17385,14041,10602,7962,6318,77334,19734,28672,48406,21486,18032,14507,11193,8377,7194,80789,158123,254060,254060
Equatorial Guinea,1958,GQ,GNQ,AFR,20064,28770,48834,21195,17629,14203,10733,7981,6375,78116,19999,29641,49640,21748,18252,14720,11326,8426,7269,81741,159857,258320,258320
Equatorial Guinea,1959,GQ,GNQ,AFR,20347,29810,50157,21407,17877,14361,10879,7999,6429,78952,20275,30595,50870,22061,18467,14930,11466,8488,7335,82747,161699,262724,262724
Equatorial Guinea,1960,GQ,GNQ,AFR,20647,30845,51492,21693,18140,14530,11036,8025,6492,79916,20568,31536,52104,22438,18686,15138,11619,8556,7402,83839,163755,267351,267351
Equatorial Guinea,1961,GQ,GNQ,AFR,20976,31875,52851,22047,18427,14713,11211,8059,6559,81016,20885,32474,53359,22879,18912,15352,11793,8632,7466,85034,166050,272264,272264
Equatorial Guinea,1962,GQ,GNQ,AFR,21340,32915,54255,22458,18754,14912,11406,8103,6636,82269,21241,33417,54658,23366,19152,15566,11974,8722,7524,86304,168573,277490,277490
Equatorial Guinea,1963,GQ,GNQ,AFR,21751,33931,55682,22942,19104,15130,11616,8155,6710,83657,21643,34362,56005,23893,19412,15787,12168,8829,7585,87674,171331,283018,283018
Equatorial Guinea,1964,GQ,GNQ,AFR,22217,34730,56947,23709,19459,15376,11825,8222,6790,85381,22095,35127,57222,24641,19692,16014,12370,8939,7644,89300,174681,288852,288852
Equatorial Guinea,1965,GQ,GNQ,AFR,22742,35329,58071,24737,19821,15665,12035,8306,6861,87425,22608,35711,58319,25603,19989,16258,12580,9060,7705,91195,178620,295010,295010
Equatorial Guinea,1966,GQ,GNQ,AFR,23336,35933,59269,25817,20193,15980,12247,8413,6932,89582,23190,36301,59491,26605,20305,16518,12797,9183,7770,93178,182760,301517,301517
Equatorial Guinea,1967,GQ,GNQ,AFR,23995,36578,60573,26910,20573,16338,12461,8540,6989,91811,23837,36927,60764,27607,20645,16792,13025,9313,7840,95222,187033,308374,308374
Equatorial Guinea,1968,GQ,GNQ,AFR,24714,37262,61976,27961,20927,16696,12661,8675,7047,93967,24545,37592,62137,28570,21005,17070,13251,9440,7919,97255,191222,315325,315325
Equatorial Guinea,1969,GQ,GNQ,AFR,25253,37621,62874,28571,20921,16777,12685,8713,6999,94666,25086,38004,63090,29223,21142,17140,13324,9471,7914,98214,192880,318846,318846
Equatorial Guinea,2031,GQ,GNQ,AFR,124264,231661,355925,204105,142222,150687,114366,62421,37669,711470,121964,227949,349913,200441,128227,124938,80940,48555,40414,623515,1334985,2040834,2040834
Equatorial Guinea,2032,GQ,GNQ,AFR,125310,233331,358641,208615,146561,149046,120029,65448,39495,729194,123006,229638,352644,204949,133509,125529,85774,49907,41845,641513,1370707,2081992,2081992
Equatorial Guinea,2033,GQ,GNQ,AFR,126253,234929,361182,212257,152162,146979,125567,68618,41354,746937,123949,231261,355210,208477,140183,125483,90814,51432,43214,659603,1406540,2122936,2122936
Equatorial Guinea,2034,GQ,GNQ,AFR,127103,236536,363639,215160,158888,144729,130673,71913,43307,764670,124805,232902,357707,211218,148002,124950,95873,53150,44577,677770,1442440,2163786,2163786
Equatorial Guinea,2035,GQ,GNQ,AFR,127905,238165,366070,217486,166586,142511,135057,75317,45422,782379,125615,234575,360190,213397,156745,124052,100766,55071,45967,695998,1478377,2204633,2204633
Equatorial Guinea,2036,GQ,GNQ,AFR,128655,239867,368522,220205,174236,140477,138521,78826,47727,799992,126370,236333,362703,216006,165341,122895,105337,57218,47421,714218,1514210,2245434,2245434
Equatorial Guinea,2037,GQ,GNQ,AFR,129402,241634,371036,223324,181555,138861,141026,82475,50220,817461,127118,238167,365285,219039,173495,121821,109473,59630,48947,732405,1549866,2286181,2286181
Equatorial Guinea,2038,GQ,GNQ,AFR,130174,243330,373504,226027,188996,137999,142625,86319,52862,834828,127889,239921,367810,221685,181629,121316,113071,62354,50516,750571,1585399,2326720,2326720
Equatorial Guinea,2039,GQ,GNQ,AFR,130898,245034,375932,228364,196122,138160,143336,90467,55624,852073,128614,241679,370293,223991,189304,121831,116003,65488,52118,768735,1620808,2367028,2367028
Equatorial Guinea,2040,GQ,GNQ,AFR,131567,246823,378390,230389,202521,139608,143196,94986,58454,869154,129291,243500,372791,226007,196084,123778,118148,69103,53745,786865,1656019,2407198,2407198
Equatorial Guinea,2041,GQ,GNQ,AFR,132182,248640,380822,232192,207954,142482,142315,99827,61346,886116,129911,245343,375254,227832,201710,127392,119489,73177,55382,804982,1691098,2447173,2447173
Equatorial Guinea,2042,GQ,GNQ,AFR,132676,250453,383129,233869,212394,146729,140865,104801,64311,902969,130413,247179,377592,229544,206195,132604,120101,77597,57070,823111,1726080,2486805,2486805
Equatorial Guinea,2043,GQ,GNQ,AFR,133069,252196,385265,235481,215990,152196,139035,109654,67378,919734,130822,248943,379765,231195,209717,139170,120115,82197,58853,841247,1760981,2526010,2526010
Equatorial Guinea,2044,GQ,GNQ,AFR,133409,253797,387206,237096,218869,158739,137034,114119,70586,936443,131175,250573,381748,232858,212473,146853,119672,86814,60782,859452,1795895,2564853,2564853
Equatorial Guinea,2045,GQ,GNQ,AFR,133771,255299,389070,238735,221195,166217,135068,117938,73967,953120,131541,252106,383647,234559,214677,155424,118885,91272,62908,877725,1830845,2603554,2603554
Equatorial Guinea,2046,GQ,GNQ,AFR,134065,256694,390759,240445,223898,173629,133260,120940,77555,969727,131844,253533,385377,236338,217304,163846,117853,95430,65255,896026,1865753,2641890,2641890
Equatorial Guinea,2047,GQ,GNQ,AFR,134286,257967,392253,242221,226982,180710,131839,123100,81352,986204,132082,254833,386915,238194,220343,171826,116905,99187,67873,914328,1900532,2679707,2679707
Equatorial Guinea,2048,GQ,GNQ,AFR,134532,259166,393698,243924,229666,187905,131125,124471,85393,1002484,132349,256067,388416,239973,223006,179792,116506,102461,70791,932529,1935013,2717119,2717119
Equatorial Guinea,2049,GQ,GNQ,AFR,134759,260266,395025,245639,231995,194800,131378,125086,89711,1018609,132591,257198,389789,241753,225331,187311,117085,105132,74058,950670,1969279,2754095,2754095
Equatorial Guinea,2050,GQ,GNQ,AFR,134805,261332,396137,247435,234020,201006,132843,124984,94340,1034628,132658,258291,390949,243599,227379,193969,119042,107099,77733,968821,2003449,2790533,2790533
Greece,1970,GR,GRC,EUR,385032,713392,1098424,531269,546415,637073,471190,445059,417834,3048840,362738,676010,1038748,611109,583159,658084,500222,471492,534788,3358854,6407694,8544873,8544873
Greece,1971,GR,GRC,EUR,381813,710417,1092230,530955,536240,640371,485070,444178,433144,3069958,359343,674890,1034233,612681,572124,661112,511953,472922,548895,3379687,6449645,8576109,8576109
Greece,1972,GR,GRC,EUR,377060,711605,1088665,531480,530135,640396,503083,440704,447847,3093645,354421,677332,1031753,614115,565721,661276,527332,471720,562434,3402598,6496243,8616667,8616667
Greece,1973,GR,GRC,EUR,372079,716391,1088470,532547,528111,637004,523889,435528,461900,3118979,349285,682082,1031367,615909,563634,658602,544866,468616,575946,3427573,6546552,8666390,8666390
Greece,1974,GR,GRC,EUR,369514,722765,1092279,534241,530959,630975,546036,429478,476350,3148039,346525,686731,1033256,619284,565700,653543,563053,464433,590108,3456121,6604160,8729701,8729701
Greece,1975,GR,GRC,EUR,369224,731453,1100677,536902,537372,623440,567896,423337,490540,3179487,345947,692804,1038751,623964,570572,646483,580854,459803,604829,3486505,6665992,8805415,8805415
Greece,1976,GR,GRC,EUR,370282,741683,1111965,540422,547225,614942,588441,418221,503723,3212974,346766,700005,1046771,629365,577790,638245,597791,455515,620013,3518719,6731693,8890428,8890428
Greece,1977,GR,GRC,EUR,372495,750122,1122617,545314,561650,606612,606747,415396,515869,3251588,348835,705793,1054628,636116,587461,629874,613028,452796,635126,3554401,6805989,8983236,8983236
Greece,1978,GR,GRC,EUR,375349,756007,1131356,552824,578585,599863,622391,416043,527302,3297008,351428,710820,1062248,643694,598494,622054,626249,453328,649879,3593698,6890706,9084308,9084308
Greece,1979,GR,GRC,EUR,377906,760427,1138333,563750,595341,595925,635308,420939,537897,3349160,353683,715801,1069484,651764,609864,615955,637584,458236,663796,3637199,6986359,9194178,9194178
Greece,1980,GR,GRC,EUR,378897,763991,1142888,577692,610558,595254,645392,430485,546328,3405709,354588,720332,1074920,660454,620517,612178,647181,467932,675370,3683632,7089341,9307148,9307148
Greece,1981,GR,GRC,EUR,377407,766169,1143576,594815,623443,596838,652779,445008,552933,3465816,353312,723372,1076684,669995,630035,610220,655276,482547,684849,3732922,7198738,9418994,9418994
Greece,1982,GR,GRC,EUR,373476,766160,1139636,616589,633430,599871,657094,463762,558988,3529734,349762,723760,1073522,681677,638441,609797,661212,501173,693631,3785931,7315665,9528815,9528815
Greece,1983,GR,GRC,EUR,367298,764949,1132247,642371,640982,604535,657648,485348,564989,3595873,344063,722777,1066840,694861,646231,611036,664497,522353,702416,3841394,7437267,9636353,9636353
Greece,1984,GR,GRC,EUR,357655,764464,1122119,669574,647536,611344,654705,508363,571110,3662632,335307,722636,1057943,707744,654447,614407,665136,544569,711378,3897681,7560313,9740382,9740382
Greece,1985,GR,GRC,EUR,344525,764029,1108554,697923,654943,619112,649172,531471,578065,3730686,323351,722441,1045792,721543,663657,619209,662912,566863,720917,3955101,7685787,9840141,9840141
Greece,1986,GR,GRC,EUR,330351,762146,1092497,725702,664269,627990,641347,553773,586643,3799724,310314,720953,1031267,734817,674401,625588,657714,588811,731914,4013245,7812969,9936726,9936726
Greece,1987,GR,GRC,EUR,316937,758819,1075756,749160,676409,639167,631947,574040,596510,3867233,298107,718075,1016182,744949,687157,634226,650219,609197,744224,4069972,7937205,10029141,10029141
Greece,1988,GR,GRC,EUR,304764,754068,1058832,768215,691607,651463,622696,591663,608447,3934091,287043,713346,1000389,753347,700862,644399,641817,627538,758907,4126870,8060961,10120191,10120191
Greece,1989,GR,GRC,EUR,294698,746144,1040842,784438,709433,663795,615616,606289,622828,4002399,277892,705335,983227,760759,714926,655454,634451,643425,776504,4185519,8187918,10211979,10211979
Greece,1990,GR,GRC,EUR,287346,734185,1021531,798307,729005,676060,611857,617327,639154,4071710,271418,693404,964822,766997,729065,666796,629258,656163,795920,4244199,8315909,10302255,10302255
Greece,1991,GR,GRC,EUR,282825,719399,1002224,808891,750214,688598,611231,624394,657546,4140874,267587,678803,946390,771567,743207,678597,626482,665591,816620,4302064,8442938,10391547,10391547
Greece,1992,GR,GRC,EUR,280389,703173,983562,815217,774292,701314,613212,627015,677327,4208377,265352,662952,928304,773345,758696,690782,626357,670900,838065,4358145,8566522,10478388,10478388
Greece,1993,GR,GRC,EUR,278856,685914,964770,818764,800568,714286,617533,625253,698887,4275291,263752,646169,909921,773423,775327,703382,628737,671914,860684,4413467,8688758,10563441,10563441
Greece,1994,GR,GRC,EUR,277985,666512,944497,822582,826386,727989,624737,619808,721468,4342970,262785,627646,890431,774329,791517,716994,633909,669063,883710,4469522,8812492,10647416,10647416
Greece,1995,GR,GRC,EUR,278555,643885,922440,827213,851043,742965,634173,611303,743353,4410050,263049,606374,869423,776095,807999,731393,641805,662276,906445,4526013,8936063,10727927,10727927
Greece,1996,GR,GRC,EUR,279203,621978,901181,830888,872397,759316,646099,599566,764697,4472963,263551,585746,849297,777158,823017,746529,653092,650840,929726,4580362,9053325,10803806,10803806
Greece,1997,GR,GRC,EUR,278562,603806,882368,833198,887531,776841,661027,585638,786462,4530697,263227,568521,831748,776760,833939,762751,667985,635321,953705,4630461,9161158,10875273,10875273
Greece,1998,GR,GRC,EUR,277237,588050,865287,833743,897487,794504,676403,572813,807780,4582730,262289,553722,816011,774415,842125,778620,683879,619533,976868,4675440,9258170,10939475,10939475
Greece,1999,GR,GRC,EUR,275675,575016,850691,829911,903780,810893,690433,563862,827484,4626363,261013,541821,802834,768097,848481,792640,698686,607374,998699,4713977,9340340,10993862,10993862
Greece,2000,GR,GRC,EUR,274441,565059,839500,820705,906988,824162,702908,559952,845462,4660177,260064,532977,793041,756958,852827,803895,711656,600066,1019983,4745385,9405562,11038109,11038109
Greece,2001,GR,GRC,EUR,273762,557537,831299,807335,906820,834109,712737,561062,862755,4684818,259496,526747,786243,742368,853981,812267,721971,597640,1041594,4769821,9454639,11072182,11072182
Greece,2002,GR,GRC,EUR,273297,551454,824751,791843,902726,842877,719613,565002,880088,4702149,259213,522085,781298,726603,850127,820262,729489,598591,1063357,4788429,9490578,11096617,11096617
Greece,2003,GR,GRC,EUR,273075,545654,818729,775033,896751,850408,724785,569406,896297,4712680,259341,517642,776983,710422,843432,828173,735679,600615,1083777,4802098,9514778,11110487,11110487
Greece,2004,GR,GRC,EUR,273001,540951,813952,754611,892165,855025,729011,574881,910538,4716231,259476,514297,773773,691811,837501,833874,741941,603824,1102185,4811136,9527367,11115091,11115091
Greece,2005,GR,GRC,EUR,272482,540797,813279,727901,888878,857795,731874,582511,922309,4711268,259112,515073,774185,668143,832719,838320,747202,609704,1118633,4814721,9525989,11113448,11113448
Greece,2006,GR,GRC,EUR,272259,542115,814374,700974,884153,858794,733196,593335,930220,4700672,259135,517048,776183,644122,827775,841280,751072,620371,1130248,4814868,9515540,11106093,11106093
Greece,2007,GR,GRC,EUR,273334,541352,814686,678253,877389,856475,734180,606430,933804,4686531,260213,517264,777477,624029,821681,841107,755511,635192,1135279,4812799,9499330,11091493,11091493
Greece,2008,GR,GRC,EUR,275848,540619,816467,657212,868297,852320,735304,617490,938062,4668685,262498,517331,779829,606177,813899,839108,760487,649011,1139969,4808651,9477336,11073623,11073623
Greece,2009,GR,GRC,EUR,279074,540382,819456,639076,853890,847846,735883,625398,946685,4648778,265723,517270,782993,591121,802376,836954,764496,659672,1149646,4804265,9453043,11055496,11055496
Greece,2010,GR,GRC,EUR,281225,540650,821875,624651,833261,843173,735221,631293,960059,4627658,268112,517223,785335,579190,785873,835235,766693,667853,1164063,4798907,9426565,11033783,11033783
Greece,2011,GR,GRC,EUR,280840,541862,822702,612786,808264,837729,735245,634206,976613,4604843,267906,517731,785637,569221,765961,832657,768731,673400,1181574,4791544,9396387,11004725,11004725
Greece,2012,GR,GRC,EUR,277305,544113,821418,602483,781634,829942,738365,635235,990660,4578319,264664,519148,783812,559697,745277,826236,774553,677740,1196589,4780092,9358411,10963635,10963635
Greece,2013,GR,GRC,EUR,270421,547827,818248,592170,754745,821604,743211,637189,1001686,4550605,258146,522026,780172,549404,724062,818181,783035,683511,1207300,4765493,9316098,10914505,10914505
Greece,2014,GR,GRC,EUR,261186,552036,813222,583522,724793,815798,747642,640203,1012691,4524649,249035,525355,774390,540486,699227,812164,790630,691540,1216656,4750703,9275352,10862969,10862969
Greece,2015,GR,GRC,EUR,251793,554205,805998,581554,688575,811080,752674,642241,1023303,4499427,239738,526682,766420,537339,667783,807537,798044,699120,1224968,4734791,9234218,10806641,10806641
Greece,2016,GR,GRC,EUR,244144,554158,798302,581869,653641,804387,757985,643246,1034587,4475715,232249,525890,758139,536088,635660,802250,804873,705284,1233432,4717587,9193302,10749742,10749742
Greece,2017,GR,GRC,EUR,238639,552451,791090,580106,624991,795621,761303,645261,1045001,4452283,226817,523705,750522,533174,607885,794881,808991,713201,1240201,4698333,9150616,10692228,10692228
Greece,2018,GR,GRC,EUR,234520,548920,783440,579220,598757,785210,763686,648602,1053575,4429050,222628,519916,742544,531001,582640,784986,811276,723136,1245189,4678228,9107278,10633271,10633271
Greece,2019,GR,GRC,EUR,230883,544208,775091,578694,577242,769631,766233,652616,1062648,4407064,218940,514997,733937,529113,561527,769808,813854,732624,1250998,4657924,9064988,10574024,10574024
Greece,2020,GR,GRC,EUR,227037,538690,765727,578258,561699,748439,767506,656200,1073156,4385258,215132,509501,724633,527385,545424,748965,815953,740283,1258609,4636619,9021877,10512232,10512232
Greece,2021,GR,GRC,EUR,222496,532358,754854,579108,549483,723937,767014,659316,1083175,4362033,210734,503056,713790,527090,532102,725591,815716,746305,1267881,4614685,8976718,10445365,10445365
Greece,2022,GR,GRC,EUR,216257,524123,740380,580166,545134,700713,764888,663939,1087178,4342018,204661,495290,699951,528725,523795,703205,810963,753064,1282871,4602623,8944641,10384971,10384971
Greece,2023,GR,GRC,EUR,209427,513332,722759,580677,546566,680835,763092,670949,1089262,4331381,197991,485503,683494,531516,519074,682809,804378,761215,1304648,4603640,8935021,10341277,10341277
Greece,2024,GR,GRC,EUR,203833,500671,704504,580331,549804,658402,763207,679684,1094051,4325479,192425,473523,665948,533761,516393,660132,799247,770140,1327122,4606795,8932274,10302720,10302720
Greece,2025,GR,GRC,EUR,199340,486993,686333,577959,558619,630476,763235,690227,1099413,4319929,187861,460455,648316,534043,519625,632156,794310,780121,1348467,4608722,8928651,10263298,10263298
Greece,2026,GR,GRC,EUR,196124,473239,669363,573927,567794,604972,760898,700385,1105732,4313708,184530,447563,632093,532644,524050,605258,788656,788437,1369068,4608113,8921821,10223280,10223280
Greece,2027,GR,GRC,EUR,194391,460384,654775,568415,573931,585599,756913,707715,1113080,4305653,182712,435587,618299,529859,526594,583406,781650,792856,1389776,4604141,8909794,10182867,10182867
Greece,2028,GR,GRC,EUR,193458,449450,642908,561241,579144,568326,752283,713355,1121031,4295380,181806,425072,606878,525188,529404,564417,772892,794486,1410561,4596948,8892328,10142119,10142119
Greece,2029,GR,GRC,EUR,192939,439855,632794,553100,582620,556094,742889,718871,1130238,4283812,181294,415771,597065,519436,531471,549836,759614,796067,1430936,4587360,8871172,10101028,10101028
Greece,2030,GR,GRC,EUR,192734,430370,623104,544683,584795,549672,728162,723475,1141465,4272252,181080,406607,587687,513441,532886,540043,741390,797761,1451135,4576656,8848908,10059703,10059703
Greece,1950,GR,GRC,EUR,389012,746206,1135218,755176,528698,487641,367255,233228,229743,2601741,369449,718270,1087719,779426,572719,513939,398466,287873,291999,2844422,5446163,7669099,7669099
Greece,1951,GR,GRC,EUR,388708,742262,1130970,769376,542668,487771,381857,238456,236278,2656406,370138,709007,1079145,791924,585908,517313,409641,294009,301028,2899823,5556229,7766344,7766344
Greece,1952,GR,GRC,EUR,386339,739723,1126062,780566,560663,485808,396141,245041,243100,2711319,368061,702382,1070443,800941,603100,518404,420410,301108,312089,2956052,5667371,7863877,7863877
Greece,1953,GR,GRC,EUR,383372,738266,1121638,788028,582137,481775,409987,252890,249519,2764336,364526,698579,1063105,805447,623585,516909,431305,309318,323946,3010510,5774846,7959592,7959592
Greece,1954,GR,GRC,EUR,381990,738009,1119999,790494,605999,476236,423204,262139,255501,2813573,362071,697415,1059486,804206,646288,513528,442154,318482,335042,3059700,5873273,8052760,8052760
Greece,1955,GR,GRC,EUR,385005,737797,1122802,787016,630767,470171,435732,273083,262082,2858851,363410,697648,1061058,796942,669762,509343,452952,328648,345661,3103308,5962159,8146022,8146022
Greece,1956,GR,GRC,EUR,391644,737741,1129385,777786,654304,464526,447195,285152,267642,2896605,368062,698881,1066943,784549,692312,505308,463617,339815,355891,3141492,6038097,8234417,8234417
Greece,1957,GR,GRC,EUR,398272,739645,1137917,763559,674721,460588,457395,298048,272246,2926557,373500,701586,1075086,768292,712354,502391,473915,351782,365671,3174405,6100962,8313971,8313971
Greece,1958,GR,GRC,EUR,403741,742915,1146656,745179,691033,459728,466257,311884,277943,2952024,378775,705019,1083794,749201,728769,501672,483594,364106,375344,3202686,6154710,8385149,8385149
Greece,1959,GR,GRC,EUR,407978,746166,1154144,723991,702574,462921,473167,326565,285130,2974348,383582,708371,1091953,728457,740622,504130,492063,376352,385002,3226626,6200974,8447073,8447073
Greece,1960,GR,GRC,EUR,409910,748070,1157980,701078,708876,470877,477388,341452,292638,2992309,386699,710604,1097303,707378,747169,510748,498629,388260,395646,3247830,6240139,8495415,8495415
Greece,1961,GR,GRC,EUR,408185,747281,1155466,676475,709736,484187,478872,356194,301439,3006903,386560,710256,1096816,686764,747893,522359,502731,399307,408229,3267283,6274186,8526469,8526469
Greece,1962,GR,GRC,EUR,404179,743770,1147949,650397,705094,502326,477864,370616,312023,3018320,384084,706586,1090670,667595,742579,538401,504118,409225,421949,3283867,6302187,8540805,8540805
Greece,1963,GR,GRC,EUR,399182,739486,1138668,623953,694600,523793,474730,384404,323294,3024774,380127,700981,1081108,650893,731360,557367,503094,418407,436126,3297247,6322021,8541792,8541792
Greece,1964,GR,GRC,EUR,393753,736143,1129896,599269,678206,546747,470148,397455,335029,3026854,374922,695898,1070820,637193,714606,577539,500421,427292,450261,3307312,6334166,8534890,8534890
Greece,1965,GR,GRC,EUR,389559,734414,1123973,576845,656847,569196,465070,409731,347613,3025302,370245,692157,1062402,626061,693187,597259,496931,436420,464716,3314574,6339876,8526254,8526254
Greece,1966,GR,GRC,EUR,387821,732634,1120455,557850,632130,589625,460649,420998,361438,3022690,367486,688531,1056017,617818,668923,615412,493386,445707,480217,3321463,6344153,8520630,8520630
Greece,1967,GR,GRC,EUR,387985,729108,1117093,544753,606307,606931,457994,430533,375392,3021910,366513,684993,1051506,612905,643966,630940,490595,454224,494928,3327558,6349468,8518067,8518067
Greece,1968,GR,GRC,EUR,388398,723925,1112323,537146,581955,620606,458231,437948,389068,3024954,366296,681792,1048088,610509,620028,643283,490012,461487,508158,3333477,6358431,8518837,8518837
Greece,1969,GR,GRC,EUR,387340,718325,1105665,533108,561535,630579,462358,442927,403031,3033538,365110,678742,1043852,610106,599199,652283,493000,467420,521076,3343084,6376622,8526138,8526138
Greece,2031,GR,GRC,EUR,192873,420741,613614,536466,586322,546695,710332,726745,1154513,4261073,181187,397270,578457,506935,534777,532934,720781,797927,1472029,4565383,8826456,10018532,10018532
Greece,2032,GR,GRC,EUR,193210,411674,604884,527540,587118,547371,690691,727300,1169515,4249535,181486,388416,569902,499282,537133,527855,699810,794053,1494873,4553006,8802541,9977332,9977332
Greece,2033,GR,GRC,EUR,193609,403922,597531,516780,587720,548947,671440,726440,1185509,4236836,181852,380849,562701,489510,539951,523197,679687,788007,1518461,4538813,8775649,9935883,9935883
Greece,2034,GR,GRC,EUR,194106,397820,591926,504146,587423,552264,649604,727253,1201926,4222616,182315,374778,557093,477541,542207,520558,657274,783271,1541771,4522622,8745238,9894267,9894267
Greece,2035,GR,GRC,EUR,194662,393131,587793,490498,585107,561107,622379,728039,1219968,4207098,182833,370005,552838,464486,542507,523818,629607,778751,1565572,4504741,8711839,9852471,9852471
Greece,2036,GR,GRC,EUR,195117,390060,585177,476765,581127,570301,597535,726506,1237981,4190215,183260,366789,550049,451609,541128,528258,603014,773506,1587611,4485126,8675341,9810567,9810567
Greece,2037,GR,GRC,EUR,195614,388670,584284,463933,575671,576477,578716,723249,1253729,4171775,183728,365273,549001,439642,538359,530825,581428,766871,1606385,4463510,8635285,9768566,9768566
Greece,2038,GR,GRC,EUR,196168,388144,584312,453016,568547,581722,561964,719276,1267943,4152468,184246,364739,548985,429135,533705,533652,562671,758473,1622891,4440527,8592995,9726290,9726290
Greece,2039,GR,GRC,EUR,196663,388124,584787,443438,560454,585236,550158,710689,1282733,4132708,184709,364694,549403,419845,527971,535737,548281,745613,1639342,4416789,8549497,9683690,9683690
Greece,2040,GR,GRC,EUR,197003,388476,585479,433970,552084,587458,544047,696952,1298084,4112595,185033,365003,550036,410688,521990,537176,538641,727897,1656003,4392395,8504990,9640504,9640504
Greece,2041,GR,GRC,EUR,196996,389075,586071,424351,543909,589025,541303,680212,1313457,4092257,185022,365542,550564,401359,515503,539085,531658,707832,1672052,4367489,8459746,9596379,9596379
Greece,2042,GR,GRC,EUR,196452,389912,586364,415299,535029,589866,542139,661696,1327747,4071776,184514,366311,550825,392510,507867,541458,526684,687401,1686220,4342140,8413916,9551108,9551108
Greece,2043,GR,GRC,EUR,195439,390871,586310,407561,524321,590516,543864,643571,1341337,4051170,183561,367199,550760,384952,498115,544288,522135,667807,1699107,4316404,8367574,9504635,9504635
Greece,2044,GR,GRC,EUR,194141,391864,586005,401470,511737,590269,547298,623044,1356600,4030418,182338,368127,550465,378888,486169,546566,519590,645995,1713078,4290286,8320704,9457173,9457173
Greece,2045,GR,GRC,EUR,192572,392763,585335,396791,498137,588016,556145,597370,1373086,4009545,180859,368972,549831,374123,473136,546890,522896,619033,1727770,4263848,8273393,9408564,9408564
Greece,2046,GR,GRC,EUR,190783,393209,583992,393728,484457,584106,565334,573997,1387183,3988805,179176,369388,548564,370913,460276,545534,527372,593137,1740092,4237324,8226129,9358679,9358679
Greece,2047,GR,GRC,EUR,188882,393168,582050,392341,471663,578716,571539,556421,1397411,3968091,177384,369352,546736,369402,448329,542792,529981,572150,1747948,4210602,8178693,9307471,9307471
Greece,2048,GR,GRC,EUR,186860,392709,579569,391822,460785,571660,576810,540826,1405371,3947274,175473,368923,544396,368869,437842,538163,532843,553925,1751918,4183560,8130834,9254790,9254790
Greece,2049,GR,GRC,EUR,184569,391909,576478,391809,451241,563634,580366,529955,1409427,3926432,173314,368163,541477,368825,428563,532456,534965,539978,1751515,4156302,8082734,9200690,9200690
Greece,2050,GR,GRC,EUR,181979,390687,572666,392168,441807,555334,582649,524514,1409083,3905555,170880,367011,537891,369136,419422,526502,536438,530676,1746666,4128840,8034395,9144951,9144951
Grenada,1970,GD,GRD,AMR,7133,16650,23783,9165,3802,3293,2771,2401,2011,23443,6815,16130,22945,9423,4518,4229,3613,3166,3668,28617,52060,98794,98794
Grenada,1971,GD,GRD,AMR,6794,16328,23122,9621,3925,3243,2802,2385,2100,24076,6532,15741,22273,9816,4591,4162,3620,3122,3751,29062,53138,98535,98535
Grenada,1972,GD,GRD,AMR,6582,15828,22410,10033,4108,3198,2839,2369,2183,24730,6336,15221,21557,10168,4728,4093,3631,3082,3826,29528,54258,98225,98225
Grenada,1973,GD,GRD,AMR,6502,15238,21740,10384,4308,3155,2871,2355,2264,25337,6233,14646,20879,10467,4872,4006,3641,3043,3896,29925,55262,97886,97886
Grenada,1974,GD,GRD,AMR,6497,14633,21130,10670,4509,3118,2895,2343,2340,25875,6193,14071,20264,10708,5014,3921,3648,3013,3951,30255,56130,97528,97528
Grenada,1975,GD,GRD,AMR,6486,14097,20583,10893,4710,3094,2909,2337,2411,26354,6164,13564,19728,10885,5142,3839,3652,2995,3992,30505,56859,97165,97165
Grenada,1976,GD,GRD,AMR,6450,13656,20106,11043,4898,3079,2918,2326,2474,26738,6130,13137,19267,10996,5250,3756,3651,2984,4025,30662,57400,96781,96781
Grenada,1977,GD,GRD,AMR,6390,13307,19697,11124,5068,3078,2919,2317,2525,27031,6091,12787,18878,11046,5339,3685,3640,2976,4042,30728,57759,96329,96329
Grenada,1978,GD,GRD,AMR,6304,13041,19345,11147,5211,3079,2909,2310,2570,27226,6037,12508,18545,11043,5412,3632,3609,2963,4034,30693,57919,95811,95811
Grenada,1979,GD,GRD,AMR,6208,12849,19057,11118,5325,3089,2891,2310,2601,27334,5963,12294,18257,11002,5462,3588,3564,2953,4024,30593,57927,95242,95242
Grenada,1980,GD,GRD,AMR,6136,12701,18837,11053,5488,3113,2862,2320,2634,27470,5909,12088,17997,10938,5560,3561,3507,2951,4017,30534,58004,94838,94838
Grenada,1981,GD,GRD,AMR,6086,12591,18677,11133,5794,3168,2834,2336,2648,27913,5868,11911,17779,11016,5822,3582,3461,2968,4013,30862,58775,95222,95222
Grenada,1982,GD,GRD,AMR,6085,12523,18608,11376,6208,3261,2818,2352,2658,28673,5874,11811,17685,11251,6216,3642,3430,3000,4020,31559,60232,96534,96534
Grenada,1983,GD,GRD,AMR,6211,12466,18677,11572,6648,3376,2794,2373,2662,29425,6005,11741,17746,11453,6679,3723,3398,3048,4027,32328,61753,98177,98177
Grenada,1984,GD,GRD,AMR,6387,12376,18763,11645,7096,3514,2761,2389,2659,30064,6189,11649,17838,11506,7152,3820,3360,3086,4032,32956,63020,99618,99618
Grenada,1985,GD,GRD,AMR,6541,12283,18824,11551,7514,3675,2741,2410,2662,30553,6345,11571,17916,11338,7564,3922,3310,3112,4039,33285,63838,100576,100576
Grenada,1986,GD,GRD,AMR,6761,12127,18888,11249,7841,3851,2727,2431,2663,30762,6549,11437,17986,10949,7875,4028,3243,3120,4045,33260,64022,100893,100893
Grenada,1987,GD,GRD,AMR,7026,11895,18921,10786,8063,4043,2717,2450,2661,30720,6799,11226,18025,10396,8065,4146,3170,3113,4042,32932,63652,100599,100599
Grenada,1988,GD,GRD,AMR,7136,11725,18861,10263,8207,4260,2710,2454,2673,30567,6895,11069,17964,9802,8156,4290,3103,3093,4041,32485,63052,99877,99877
Grenada,1989,GD,GRD,AMR,7160,11615,18775,9808,8293,4505,2719,2447,2697,30469,6916,10971,17887,9281,8190,4467,3056,3061,4045,32100,62569,99224,99224
Grenada,1990,GD,GRD,AMR,7150,11616,18766,9505,8321,4778,2750,2432,2718,30504,6907,10976,17883,8910,8195,4677,3039,3021,4062,31904,62408,99047,99047
Grenada,1991,GD,GRD,AMR,7049,11746,18795,9428,8354,5075,2831,2451,2763,30902,6816,11141,17957,8767,8199,4929,3079,3016,4100,32090,62992,99758,99758
Grenada,1992,GD,GRD,AMR,6884,11979,18863,9457,8375,5393,2949,2528,2825,31527,6669,11439,18108,8749,8183,5207,3167,3057,4179,32542,64069,101040,101040
Grenada,1993,GD,GRD,AMR,6706,12233,18939,9451,8325,5717,3075,2607,2903,32078,6495,11763,18258,8709,8089,5492,3244,3107,4265,32906,64984,102173,102173
Grenada,1994,GD,GRD,AMR,6508,12496,19004,9413,8225,6043,3208,2683,2992,32564,6297,12097,18394,8661,7941,5769,3331,3160,4352,33214,65778,103174,103174
Grenada,1995,GD,GRD,AMR,6263,12744,19007,9393,8098,6349,3356,2764,3098,33058,6049,12405,18454,8655,7763,6030,3425,3217,4453,33543,66601,104060,104060
Grenada,1996,GD,GRD,AMR,6015,12948,18963,9374,7969,6630,3527,2837,3211,33548,5798,12643,18441,8676,7581,6266,3538,3260,4574,33895,67443,104846,104846
Grenada,1997,GD,GRD,AMR,5789,13087,18876,9363,7843,6888,3715,2894,3343,34046,5563,12800,18363,8730,7416,6468,3666,3287,4698,34265,68311,105549,105549
Grenada,1998,GD,GRD,AMR,5611,13082,18693,9431,7715,7103,3935,2927,3489,34600,5374,12802,18176,8886,7259,6630,3819,3302,4836,34732,69332,106200,106200
Grenada,1999,GD,GRD,AMR,5486,12968,18454,9586,7577,7265,4178,2943,3657,35206,5237,12665,17902,9145,7096,6746,3987,3295,4987,35256,70462,106823,106823
Grenada,2000,GD,GRD,AMR,5424,12756,18180,9838,7425,7363,4440,2950,3845,35861,5153,12415,17568,9512,6917,6816,4158,3272,5149,35824,71685,107432,107432
Grenada,2001,GD,GRD,AMR,5324,12475,17799,10166,7335,7428,4704,2925,3978,36536,5047,12088,17135,9945,6788,6886,4341,3232,5272,36464,73000,107936,107936
Grenada,2002,GD,GRD,AMR,5141,12102,17243,10502,7298,7456,5009,2941,4081,37287,4882,11679,16561,10328,6718,6936,4583,3205,5362,37132,74419,108231,108231
Grenada,2003,GD,GRD,AMR,4976,11704,16680,10899,7308,7422,5328,3003,4183,38143,4738,11262,16000,10747,6706,6941,4855,3217,5456,37922,76065,108740,108740
Grenada,2004,GD,GRD,AMR,4848,11358,16206,11344,7379,7367,5613,3070,4235,39008,4637,10892,15529,11210,6763,6912,5119,3238,5527,38769,77777,109516,109516
Grenada,2005,GD,GRD,AMR,4729,11025,15754,11709,7491,7285,5894,3184,4284,39847,4544,10542,15086,11562,6883,6847,5389,3296,5592,39569,79416,110254,110254
Grenada,2006,GD,GRD,AMR,4687,10669,15356,11954,7646,7196,6173,3334,4312,40615,4511,10189,14700,11769,7069,6772,5667,3390,5647,40314,80929,110988,110988
Grenada,2007,GD,GRD,AMR,4720,10304,15024,12066,7841,7110,6442,3525,4344,41328,4542,9838,14380,11837,7325,6696,5936,3511,5694,40999,82327,111725,111725
Grenada,2008,GD,GRD,AMR,4773,9988,14761,12046,8093,7035,6685,3745,4370,41974,4588,9537,14125,11765,7646,6618,6183,3664,5732,41608,83582,112478,112478
Grenada,2009,GD,GRD,AMR,4838,9723,14561,11923,8392,6971,6893,3992,4410,42581,4646,9290,13936,11580,8034,6543,6395,3846,5771,42169,84750,113249,113249
Grenada,2010,GD,GRD,AMR,4907,9509,14416,11709,8740,6932,7044,4260,4465,43150,4707,9092,13799,11308,8459,6477,6579,4040,5812,42675,85825,114039,114039
Grenada,2011,GD,GRD,AMR,4984,9377,14361,11450,9126,6898,7123,4509,4518,43624,4782,8971,13753,11029,8928,6425,6698,4240,5864,43184,86808,114918,114918
Grenada,2012,GD,GRD,AMR,5066,9326,14392,11179,9553,6882,7126,4730,4566,44036,4861,8925,13786,10761,9429,6401,6741,4446,5924,43702,87738,115912,115912
Grenada,2013,GD,GRD,AMR,5129,9305,14434,10892,10003,6898,7075,4958,4634,44460,4925,8917,13842,10476,9925,6410,6736,4671,5987,44205,88665,116945,116945
Grenada,2014,GD,GRD,AMR,5177,9309,14486,10608,10436,6948,6994,5186,4709,44881,4972,8934,13906,10192,10383,6465,6690,4909,6064,44703,89584,117972,117972
Grenada,2015,GD,GRD,AMR,5210,9328,14538,10353,10799,7040,6894,5401,4787,45274,5004,8969,13973,9933,10757,6586,6617,5147,6146,45186,90460,118980,118980
Grenada,2016,GD,GRD,AMR,5230,9423,14653,10072,11071,7180,6792,5612,4876,45603,5023,9064,14087,9674,11017,6775,6534,5392,6231,45623,91226,119966,119966
Grenada,2017,GD,GRD,AMR,5236,9579,14815,9789,11229,7370,6695,5808,4975,45866,5033,9211,14244,9415,11156,7033,6450,5623,6319,45996,91862,120921,120921
Grenada,2018,GD,GRD,AMR,5228,9743,14971,9556,11268,7615,6612,5982,5087,46120,5027,9364,14391,9205,11172,7364,6370,5838,6402,46351,92471,121838,121838
Grenada,2019,GD,GRD,AMR,5207,9901,15108,9372,11216,7912,6539,6124,5209,46372,5008,9514,14522,9040,11092,7758,6298,6026,6510,46724,93096,122724,122724
Grenada,2020,GD,GRD,AMR,5174,10045,15219,9257,11100,8267,6499,6223,5354,46700,4977,9648,14625,8929,10941,8205,6236,6179,6630,47120,93820,123663,123663
Grenada,2021,GD,GRD,AMR,5132,10163,15295,9195,10930,8682,6478,6282,5495,47062,4938,9763,14701,8866,10739,8694,6194,6286,6776,47555,94617,124610,124610
Grenada,2022,GD,GRD,AMR,5076,10249,15325,9147,10688,9124,6476,6293,5666,47394,4887,9850,14737,8828,10486,9197,6181,6332,6953,47977,95371,125438,125438
Grenada,2023,GD,GRD,AMR,5011,10310,15321,9121,10409,9573,6496,6252,5869,47720,4828,9909,14737,8817,10206,9691,6191,6328,7173,48406,96126,126183,126183
Grenada,2024,GD,GRD,AMR,4938,10335,15273,9120,10128,9999,6546,6186,6086,48065,4757,9937,14694,8830,9925,10146,6249,6285,7417,48852,96917,126887,126887
Grenada,2025,GD,GRD,AMR,4862,10332,15194,9132,9871,10366,6642,6106,6304,48421,4687,9936,14623,8864,9673,10519,6372,6216,7671,49315,97736,127553,127553
Grenada,2026,GD,GRD,AMR,4783,10305,15088,9220,9594,10638,6782,6022,6537,48793,4610,9916,14526,8950,9415,10780,6563,6140,7944,49792,98585,128189,128189
Grenada,2027,GD,GRD,AMR,4704,10257,14961,9372,9314,10794,6966,5944,6772,49162,4535,9870,14405,9099,9161,10915,6821,6063,8206,50265,99427,128786,128786
Grenada,2028,GD,GRD,AMR,4628,10186,14814,9529,9081,10838,7206,5882,6995,49531,4463,9803,14266,9243,8956,10934,7148,5989,8462,50732,100263,129341,129341
Grenada,2029,GD,GRD,AMR,4554,10092,14646,9680,8893,10790,7498,5830,7203,49894,4392,9719,14111,9390,8791,10856,7540,5927,8717,51221,101115,129870,129870
Grenada,2030,GD,GRD,AMR,4484,9982,14466,9819,8754,10660,7841,5797,7398,50269,4324,9616,13940,9521,8666,10699,7971,5871,8962,51690,101959,130367,130367
Grenada,1950,GD,GRD,AMR,7503,10864,18367,5707,3394,2560,2498,1548,1295,17002,7599,10860,18459,6586,4660,3593,3270,2435,2640,23184,40186,77020,77020
Grenada,1951,GD,GRD,AMR,7192,11127,18319,5958,3458,2596,2461,1575,1266,17314,7225,11169,18394,6722,4761,3623,3241,2443,2609,23399,40713,77429,77429
Grenada,1952,GD,GRD,AMR,7018,11277,18295,6180,3556,2703,2438,1628,1283,17788,6978,11389,18367,6904,4901,3712,3243,2495,2644,23899,41687,78365,78365
Grenada,1953,GD,GRD,AMR,6996,11396,18392,6387,3662,2812,2426,1682,1306,18275,6888,11548,18436,7104,5033,3802,3256,2548,2705,24448,42723,79552,79552
Grenada,1954,GD,GRD,AMR,7069,11539,18608,6565,3772,2906,2444,1730,1338,18755,6900,11718,18618,7311,5141,3889,3291,2603,2759,24994,43749,80982,80982
Grenada,1955,GD,GRD,AMR,7349,11619,18968,6722,3887,2982,2483,1770,1368,19212,7149,11772,18921,7515,5231,3978,3359,2659,2814,25556,44768,82656,82656
Grenada,1956,GD,GRD,AMR,7805,11664,19469,6851,3998,3044,2552,1807,1407,19659,7613,11744,19357,7698,5316,4060,3443,2719,2872,26108,45767,84591,84591
Grenada,1957,GD,GRD,AMR,8251,11858,20109,6954,4100,3091,2636,1842,1444,20067,8078,11859,19937,7851,5403,4139,3540,2784,2944,26661,46728,86774,86774
Grenada,1958,GD,GRD,AMR,8690,12194,20884,7030,4180,3130,2736,1876,1494,20446,8549,12115,20664,7960,5489,4210,3645,2843,3014,27161,47607,89159,89159
Grenada,1959,GD,GRD,AMR,9082,12669,21751,7083,4242,3171,2835,1911,1543,20785,8994,12520,21514,8027,5588,4273,3739,2903,3101,27631,48416,91679,91679
Grenada,1960,GD,GRD,AMR,9354,13138,22492,7155,4293,3205,2895,1958,1588,21094,9294,12953,22247,8029,5671,4313,3790,2953,3177,27933,49027,93772,93772
Grenada,1961,GD,GRD,AMR,9461,13507,22968,7253,4339,3235,2902,2018,1623,21370,9363,13333,22696,7995,5708,4335,3790,3001,3230,28059,49429,95096,95096
Grenada,1962,GD,GRD,AMR,9434,13869,23303,7354,4368,3272,2885,2085,1661,21625,9270,13728,22998,7970,5708,4355,3764,3051,3283,28131,49756,96052,96052
Grenada,1963,GD,GRD,AMR,9321,14274,23595,7457,4371,3315,2860,2162,1691,21856,9071,14164,23235,7976,5674,4375,3727,3106,3337,28195,50051,96882,96882
Grenada,1964,GD,GRD,AMR,9149,14704,23853,7573,4353,3355,2832,2239,1733,22085,8806,14625,23431,8020,5589,4393,3692,3161,3396,28251,50336,97613,97613
Grenada,1965,GD,GRD,AMR,8924,15151,24075,7710,4304,3389,2805,2305,1771,22284,8505,15070,23575,8107,5455,4407,3659,3205,3454,28287,50571,98226,98226
Grenada,1966,GD,GRD,AMR,8653,15592,24245,7884,4223,3414,2779,2361,1812,22473,8199,15466,23665,8245,5278,4414,3634,3235,3499,28305,50778,98692,98692
Grenada,1967,GD,GRD,AMR,8351,15994,24345,8109,4113,3421,2760,2398,1851,22652,7885,15794,23679,8441,5065,4406,3620,3246,3537,28315,50967,98977,98977
Grenada,1968,GD,GRD,AMR,7977,16343,24320,8389,3979,3401,2753,2413,1895,22830,7538,16050,23588,8700,4836,4369,3611,3237,3565,28318,51148,99056,99056
Grenada,1969,GD,GRD,AMR,7552,16628,24180,8738,3837,3352,2753,2415,1945,23040,7166,16216,23382,9032,4608,4305,3605,3211,3610,28371,51411,98975,98975
Grenada,2031,GD,GRD,AMR,4422,9859,14281,9933,8660,10462,8227,5781,7562,50625,4264,9502,13766,9629,8587,10483,8447,5827,9182,52155,102780,130833,130833
Grenada,2032,GD,GRD,AMR,4367,9726,14093,10018,8601,10216,8653,5783,7706,50977,4212,9374,13586,9718,8541,10229,8939,5820,9379,52626,103603,131280,131280
Grenada,2033,GD,GRD,AMR,4318,9581,13899,10076,8577,9938,9089,5810,7823,51313,4166,9239,13405,9774,8532,9951,9424,5838,9558,53077,104390,131698,131698
Grenada,2034,GD,GRD,AMR,4282,9436,13718,10103,8579,9666,9504,5865,7919,51636,4129,9102,13231,9804,8545,9678,9871,5900,9724,53522,105158,132100,132100
Grenada,2035,GD,GRD,AMR,4254,9290,13544,10101,8592,9417,9855,5961,8010,51936,4104,8962,13066,9804,8576,9428,10236,6020,9884,53948,105884,132494,132494
Grenada,2036,GD,GRD,AMR,4234,9150,13384,10074,8678,9147,10119,6096,8105,52219,4084,8829,12913,9781,8668,9174,10491,6205,10030,54349,106568,132868,132868
Grenada,2037,GD,GRD,AMR,4224,9016,13240,10025,8829,8867,10273,6275,8211,52480,4075,8702,12777,9735,8808,8922,10627,6460,10176,54728,107208,133233,133233
Grenada,2038,GD,GRD,AMR,4218,8895,13113,9952,8987,8639,10316,6511,8315,52720,4072,8582,12654,9674,8959,8718,10646,6782,10320,55099,107819,133581,133581
Grenada,2039,GD,GRD,AMR,4217,8784,13001,9862,9141,8456,10268,6792,8419,52938,4068,8477,12545,9586,9103,8554,10567,7158,10455,55423,108361,133905,133905
Grenada,2040,GD,GRD,AMR,4217,8685,12902,9755,9277,8320,10147,7115,8512,53126,4068,8384,12452,9484,9238,8435,10416,7581,10588,55742,108868,134219,134219
Grenada,2041,GD,GRD,AMR,4214,8605,12819,9629,9391,8229,9957,7485,8601,53292,4064,8304,12368,9372,9347,8356,10208,8038,10711,56032,109324,134511,134511
Grenada,2042,GD,GRD,AMR,4209,8542,12751,9496,9479,8175,9725,7884,8685,53444,4060,8243,12303,9241,9431,8313,9961,8511,10830,56287,109731,134786,134786
Grenada,2043,GD,GRD,AMR,4203,8487,12690,9355,9535,8153,9464,8293,8769,53569,4054,8192,12246,9109,9491,8303,9691,8978,10959,56531,110100,135042,135042
Grenada,2044,GD,GRD,AMR,4197,8449,12646,9210,9563,8159,9205,8680,8869,53686,4049,8153,12202,8971,9519,8319,9425,9409,11105,56748,110434,135279,135279
Grenada,2045,GD,GRD,AMR,4191,8421,12612,9063,9561,8174,8971,9009,8989,53767,4043,8128,12171,8834,9519,8352,9183,9760,11297,56945,110712,135500,135500
Grenada,2046,GD,GRD,AMR,4185,8400,12585,8925,9533,8259,8715,9256,9154,53842,4037,8105,12142,8698,9498,8443,8937,10004,11542,57122,110964,135696,135696
Grenada,2047,GD,GRD,AMR,4172,8383,12555,8795,9490,8413,8449,9400,9367,53914,4022,8089,12111,8572,9455,8586,8694,10138,11840,57285,111199,135867,135867
Grenada,2048,GD,GRD,AMR,4155,8374,12529,8672,9421,8568,8234,9447,9627,53969,4007,8078,12085,8455,9387,8734,8499,10160,12200,57435,111404,136018,136018
Grenada,2049,GD,GRD,AMR,4134,8367,12501,8561,9330,8721,8058,9411,9933,54014,3987,8074,12061,8349,9306,8882,8340,10087,12606,57570,111584,136147,136147
Grenada,2050,GD,GRD,AMR,4109,8361,12470,8465,9223,8861,7933,9301,10278,54061,3963,8067,12030,8255,9204,9016,8223,9947,13055,57700,111761,136253,136253
Greenland,1950,GL,GRL,EUR,1898,3149,5047,2028,1219,1071,805,403,275,5801,1898,3134,5032,2519,1393,1362,943,600,424,7241,13042,23119,23119
Greenland,1951,GL,GRL,EUR,1944,3354,5298,1940,903,1051,817,437,332,5480,1937,3320,5257,2649,1260,1440,991,688,533,7561,13041,23601,23601
Greenland,1952,GL,GRL,EUR,2106,3229,5335,2276,1109,1138,810,460,282,6075,2043,3262,5305,2622,1394,1404,981,662,453,7516,13591,24229,24229
Greenland,1953,GL,GRL,EUR,2204,3210,5414,2443,1343,1212,818,481,249,6546,2119,3263,5382,2564,1549,1379,982,646,404,7524,14070,24867,24867
Greenland,1954,GL,GRL,EUR,2286,3241,5527,2527,1639,1283,837,496,224,7006,2205,3275,5480,2502,1726,1359,982,622,352,7543,14549,25556,25556
Greenland,1955,GL,GRL,EUR,2383,3286,5669,2549,1969,1355,864,504,205,7446,2309,3281,5590,2459,1897,1352,982,597,304,7591,15037,26295,26295
Greenland,1956,GL,GRL,EUR,2513,3365,5878,2589,2202,1413,896,516,204,7820,2440,3319,5759,2486,2024,1357,990,601,293,7751,15571,27210,27210
Greenland,1957,GL,GRL,EUR,2668,3485,6153,2686,2323,1447,928,537,212,8133,2580,3411,5991,2579,2120,1367,1022,621,310,8019,16152,28307,28307
Greenland,1958,GL,GRL,EUR,2835,3625,6460,2772,2455,1482,968,563,229,8469,2728,3521,6249,2673,2216,1384,1055,647,334,8309,16778,29488,29488
Greenland,1959,GL,GRL,EUR,3017,3789,6806,2848,2595,1528,1010,592,245,8818,2888,3656,6544,2765,2323,1409,1086,672,353,8608,17426,30768,30768
Greenland,1960,GL,GRL,EUR,3203,3981,7184,2905,2737,1581,1056,618,261,9158,3056,3821,6877,2841,2423,1448,1113,697,371,8893,18051,32124,32124
Greenland,1961,GL,GRL,EUR,3371,4176,7547,2991,2853,1655,1098,642,280,9519,3204,3996,7200,2907,2489,1502,1138,729,400,9165,18684,33435,33435
Greenland,1962,GL,GRL,EUR,3507,4379,7886,3098,2938,1741,1139,661,307,9884,3330,4177,7507,2957,2525,1574,1153,758,427,9394,19278,34670,34670
Greenland,1963,GL,GRL,EUR,3623,4612,8235,3175,3037,1841,1181,679,329,10242,3447,4397,7844,2982,2560,1652,1168,788,450,9600,19842,35920,35920
Greenland,1964,GL,GRL,EUR,3723,4881,8604,3224,3149,1950,1219,699,352,10593,3563,4650,8213,2989,2604,1740,1178,819,470,9800,20393,37208,37208
Greenland,1965,GL,GRL,EUR,3807,5176,8983,3244,3283,2065,1249,724,376,10941,3685,4924,8609,2978,2665,1831,1191,850,489,10004,20945,38539,38539
Greenland,1966,GL,GRL,EUR,3849,5443,9292,3354,3446,2196,1282,748,406,11432,3751,5167,8918,3042,2733,1921,1208,877,521,10302,21734,39945,39945
Greenland,1967,GL,GRL,EUR,3832,5671,9503,3532,3660,2337,1325,773,428,12055,3741,5381,9122,3177,2809,2015,1221,903,560,10685,22740,41369,41369
Greenland,1968,GL,GRL,EUR,3777,5913,9690,3639,3928,2492,1370,801,453,12683,3689,5609,9298,3290,2922,2102,1243,928,596,11081,23764,42748,42748
Greenland,1969,GL,GRL,EUR,3703,6167,9870,3680,4245,2654,1421,834,472,13306,3607,5857,9464,3368,3069,2175,1272,952,630,11466,24772,44106,44106
Greenland,1970,GL,GRL,EUR,3612,6425,10037,3672,4592,2825,1480,873,492,13934,3504,6113,9617,3417,3240,2234,1312,980,665,11848,25782,45434,45434
Greenland,1971,GL,GRL,EUR,3414,6677,10091,3757,4804,2983,1549,910,517,14520,3284,6373,9657,3509,3353,2279,1364,997,709,12211,26731,46479,46479
Greenland,1972,GL,GRL,EUR,3133,6880,10013,3989,4876,3116,1626,944,545,15096,2982,6578,9560,3678,3393,2316,1428,1009,755,12579,27675,47246,47246
Greenland,1973,GL,GRL,EUR,2880,6996,9876,4252,4943,3243,1714,982,575,15709,2716,6691,9407,3886,3430,2340,1495,1020,801,12972,28681,47965,47965
Greenland,1974,GL,GRL,EUR,2659,7019,9678,4519,5021,3377,1817,1017,602,16353,2488,6697,9185,4129,3461,2364,1565,1020,850,13389,29742,48607,48607
Greenland,1975,GL,GRL,EUR,2459,6956,9415,4786,5119,3511,1922,1054,629,17021,2293,6592,8885,4390,3501,2386,1636,1026,895,13834,30855,49151,49151
Greenland,1976,GL,GRL,EUR,2256,6805,9061,5045,5224,3656,2032,1089,652,17698,2108,6393,8501,4661,3557,2413,1704,1033,936,14304,32002,49569,49569
Greenland,1977,GL,GRL,EUR,2100,6554,8654,5325,5205,3798,2148,1110,677,18263,1968,6111,8079,4920,3566,2459,1785,1034,969,14733,32996,49739,49739
Greenland,1978,GL,GRL,EUR,2051,6218,8269,5608,5089,3915,2261,1121,704,18698,1926,5753,7679,5135,3543,2521,1868,1037,990,15094,33792,49734,49734
Greenland,1979,GL,GRL,EUR,2086,5839,7925,5816,5038,4014,2359,1137,725,19089,1978,5338,7316,5294,3565,2580,1933,1049,1006,15427,34516,49761,49761
Greenland,1980,GL,GRL,EUR,2170,5450,7620,6046,5057,4131,2441,1170,751,19596,2084,4941,7025,5496,3654,2635,1962,1084,1026,15857,35453,50106,50106
Greenland,1981,GL,GRL,EUR,2260,5076,7336,6312,5125,4276,2512,1219,767,20211,2182,4599,6781,5741,3794,2690,1973,1126,1057,16381,36592,50719,50719
Greenland,1982,GL,GRL,EUR,2345,4739,7084,6515,5247,4405,2579,1280,783,20809,2260,4311,6571,5936,3961,2739,1979,1178,1078,16871,37680,51341,51341
Greenland,1983,GL,GRL,EUR,2426,4467,6893,6624,5419,4514,2652,1344,798,21351,2316,4102,6418,6049,4157,2791,1988,1233,1098,17316,38667,51984,51984
Greenland,1984,GL,GRL,EUR,2515,4278,6793,6613,5639,4607,2748,1413,809,21829,2362,3971,6333,6056,4382,2836,2002,1294,1111,17681,39510,52638,52638
Greenland,1985,GL,GRL,EUR,2596,4172,6768,6521,5829,4672,2848,1490,819,22179,2412,3903,6315,5960,4587,2895,2037,1356,1120,17955,40134,53220,53220
Greenland,1986,GL,GRL,EUR,2659,4132,6791,6368,5991,4704,2958,1571,837,22429,2478,3890,6368,5769,4768,2963,2086,1426,1127,18139,40568,53727,53727
Greenland,1987,GL,GRL,EUR,2710,4173,6883,6130,6167,4725,3085,1649,850,22606,2548,3940,6488,5497,4966,3034,2141,1502,1134,18274,40880,54248,54248
Greenland,1988,GL,GRL,EUR,2743,4272,7015,5818,6358,4744,3216,1716,864,22716,2624,4032,6656,5170,5178,3111,2204,1565,1150,18378,41094,54778,54778
Greenland,1989,GL,GRL,EUR,2753,4415,7168,5453,6564,4778,3350,1775,897,22817,2701,4156,6857,4813,5398,3193,2272,1616,1170,18462,41279,55298,55298
Greenland,1990,GL,GRL,EUR,2777,4539,7316,5053,6697,4803,3471,1819,922,22765,2766,4279,7045,4454,5580,3284,2326,1632,1198,18474,41239,55599,55599
Greenland,1991,GL,GRL,EUR,2813,4632,7445,4654,6736,4820,3559,1854,947,22570,2805,4383,7188,4127,5709,3385,2363,1632,1237,18453,41023,55657,55657
Greenland,1992,GL,GRL,EUR,2833,4720,7553,4297,6746,4859,3631,1877,982,22392,2816,4493,7309,3832,5803,3504,2384,1633,1273,18429,40821,55688,55688
Greenland,1993,GL,GRL,EUR,2846,4800,7646,3986,6708,4918,3679,1908,1020,22219,2814,4610,7424,3583,5846,3633,2415,1627,1317,18421,40640,55708,55708
Greenland,1994,GL,GRL,EUR,2860,4874,7734,3748,6599,4990,3701,1954,1056,22048,2801,4723,7524,3394,5818,3773,2427,1621,1354,18387,40435,55700,55700
Greenland,1995,GL,GRL,EUR,2857,4937,7794,3620,6434,5111,3729,2017,1095,22006,2762,4816,7578,3296,5688,3941,2453,1643,1386,18407,40413,55788,55788
Greenland,1996,GL,GRL,EUR,2818,4997,7815,3589,6214,5276,3771,2108,1143,22101,2701,4886,7587,3294,5459,4122,2486,1673,1418,18452,40553,55960,55960
Greenland,1997,GL,GRL,EUR,2747,5062,7809,3606,5933,5440,3798,2211,1183,22171,2626,4957,7583,3338,5161,4302,2535,1706,1456,18498,40669,56072,56072
Greenland,1998,GL,GRL,EUR,2653,5125,7778,3649,5620,5606,3833,2315,1224,22247,2541,5025,7566,3398,4823,4478,2593,1752,1488,18532,40779,56123,56123
Greenland,1999,GL,GRL,EUR,2540,5182,7722,3697,5284,5756,3877,2423,1256,22293,2448,5072,7520,3466,4478,4654,2664,1795,1507,18564,40857,56106,56106
Greenland,2000,GL,GRL,EUR,2438,5213,7651,3793,4931,5901,3944,2528,1299,22396,2359,5094,7453,3574,4151,4835,2754,1835,1527,18676,41072,56184,56184
Greenland,2001,GL,GRL,EUR,2365,5210,7575,3938,4583,6028,4037,2633,1345,22564,2286,5089,7375,3713,3867,5010,2863,1868,1556,18877,41441,56386,56386
Greenland,2002,GL,GRL,EUR,2307,5175,7482,4068,4277,6113,4151,2728,1383,22720,2227,5057,7284,3844,3622,5141,2990,1897,1581,19075,41795,56565,56565
Greenland,2003,GL,GRL,EUR,2260,5127,7387,4176,4026,6143,4280,2812,1424,22861,2186,5002,7188,3966,3430,5214,3135,1928,1602,19275,42136,56728,56728
Greenland,2004,GL,GRL,EUR,2217,5071,7288,4260,3853,6107,4423,2892,1477,23012,2154,4938,7092,4070,3301,5211,3300,1957,1638,19477,42489,56866,56866
Greenland,2005,GL,GRL,EUR,2178,4969,7147,4348,3737,5987,4573,2951,1543,23139,2117,4835,6952,4174,3221,5115,3471,1980,1682,19643,42782,56887,56887
Greenland,2006,GL,GRL,EUR,2154,4821,6975,4450,3670,5792,4728,2983,1631,23254,2082,4702,6784,4282,3190,4933,3631,2013,1747,19796,43050,56811,56811
Greenland,2007,GL,GRL,EUR,2134,4678,6812,4520,3666,5540,4886,3006,1728,23346,2052,4567,6619,4371,3219,4683,3802,2055,1807,19937,43283,56708,56708
Greenland,2008,GL,GRL,EUR,2122,4547,6669,4552,3714,5247,5037,3038,1808,23396,2025,4439,6464,4432,3286,4390,3979,2107,1864,20058,43454,56578,56578
Greenland,2009,GL,GRL,EUR,2119,4435,6554,4548,3798,4929,5167,3087,1887,23416,2005,4325,6330,4450,3385,4077,4153,2166,1911,20142,43558,56442,56442
Greenland,2010,GL,GRL,EUR,2116,4329,6445,4542,3882,4605,5278,3169,1971,23447,1989,4211,6200,4461,3506,3780,4318,2243,1950,20258,43705,56351,56351
Greenland,2011,GL,GRL,EUR,2104,4228,6332,4532,3968,4288,5374,3274,2054,23490,1976,4107,6083,4455,3631,3511,4467,2340,1976,20380,43870,56288,56288
Greenland,2012,GL,GRL,EUR,2086,4155,6241,4493,4048,3993,5447,3395,2131,23507,1950,4019,5969,4408,3775,3271,4579,2461,1993,20487,43994,56199,56199
Greenland,2013,GL,GRL,EUR,2063,4111,6174,4417,4131,3734,5478,3533,2199,23492,1919,3951,5870,4331,3916,3075,4640,2601,1991,20554,44046,56089,56089
Greenland,2014,GL,GRL,EUR,2035,4088,6123,4307,4205,3545,5448,3676,2260,23441,1881,3896,5777,4230,4041,2947,4637,2755,1997,20607,44048,55953,55953
Greenland,2015,GL,GRL,EUR,2025,4053,6078,4228,4282,3441,5343,3813,2334,23441,1874,3833,5707,4155,4139,2886,4550,2910,2025,20665,44106,55895,55895
Greenland,2016,GL,GRL,EUR,2028,4001,6029,4174,4379,3414,5168,3946,2406,23487,1895,3764,5659,4099,4219,2894,4392,3059,2079,20742,44229,55916,55916
Greenland,2017,GL,GRL,EUR,2038,3961,5999,4096,4476,3443,4942,4088,2476,23521,1913,3712,5625,4016,4298,2948,4175,3208,2139,20784,44305,55928,55928
Greenland,2018,GL,GRL,EUR,2056,3934,5990,3997,4557,3508,4682,4229,2545,23518,1939,3683,5622,3902,4380,3034,3921,3365,2194,20796,44314,55931,55931
Greenland,2019,GL,GRL,EUR,2091,3924,6015,3884,4632,3608,4399,4362,2607,23492,1976,3671,5647,3772,4450,3138,3649,3525,2248,20782,44274,55931,55931
Greenland,2020,GL,GRL,EUR,2115,3926,6041,3794,4667,3720,4117,4485,2714,23497,2001,3669,5670,3667,4495,3263,3394,3689,2324,20832,44329,56026,56026
Greenland,2021,GL,GRL,EUR,2117,3938,6055,3735,4658,3836,3850,4587,2871,23537,2012,3681,5693,3596,4495,3401,3161,3853,2446,20952,44489,56243,56243
Greenland,2022,GL,GRL,EUR,2108,3960,6068,3690,4615,3952,3608,4663,3055,23583,2006,3703,5709,3537,4461,3556,2961,3991,2599,21105,44688,56466,56466
Greenland,2023,GL,GRL,EUR,2081,3990,6071,3662,4533,4058,3404,4705,3251,23613,1985,3733,5718,3496,4386,3698,2808,4081,2775,21244,44857,56643,56643
Greenland,2024,GL,GRL,EUR,2035,4024,6059,3653,4432,4153,3257,4688,3448,23631,1943,3775,5718,3473,4290,3831,2709,4104,2975,21382,45013,56789,56789
Greenland,2025,GL,GRL,EUR,1988,4055,6043,3664,4305,4240,3181,4611,3644,23645,1900,3814,5714,3465,4170,3959,2671,4054,3196,21515,45160,56916,56916
Greenland,2026,GL,GRL,EUR,1953,4074,6027,3684,4155,4327,3172,4472,3844,23654,1867,3841,5708,3468,4028,4076,2687,3940,3429,21628,45282,57017,57017
Greenland,2027,GL,GRL,EUR,1919,4088,6007,3708,3995,4397,3214,4290,4038,23642,1832,3866,5698,3479,3879,4180,2751,3772,3677,21738,45380,57089,57089
Greenland,2028,GL,GRL,EUR,1882,4092,5974,3741,3839,4450,3290,4078,4231,23629,1800,3879,5679,3502,3726,4262,2858,3568,3935,21851,45480,57134,57134
Greenland,2029,GL,GRL,EUR,1850,4087,5937,3775,3702,4480,3389,3843,4423,23612,1768,3882,5650,3528,3589,4316,2984,3350,4196,21963,45575,57156,57156
Greenland,2030,GL,GRL,EUR,1816,4069,5885,3802,3591,4479,3500,3606,4612,23590,1734,3872,5606,3553,3477,4338,3117,3131,4456,22072,45662,57152,57152
Greenland,2031,GL,GRL,EUR,1782,4037,5819,3829,3512,4450,3610,3377,4799,23577,1703,3845,5548,3574,3389,4326,3256,2926,4704,22175,45752,57120,57120
Greenland,2032,GL,GRL,EUR,1751,3991,5742,3856,3461,4395,3718,3171,4959,23560,1672,3807,5479,3599,3327,4281,3400,2746,4936,22289,45849,57071,57071
Greenland,2033,GL,GRL,EUR,1721,3930,5651,3884,3433,4320,3820,2994,5092,23543,1645,3752,5397,3630,3285,4209,3546,2609,5128,22407,45950,57002,57002
Greenland,2034,GL,GRL,EUR,1692,3848,5540,3920,3427,4220,3910,2875,5187,23539,1617,3679,5296,3672,3257,4115,3676,2523,5279,22522,46061,56901,56901
Greenland,2035,GL,GRL,EUR,1666,3770,5436,3951,3436,4094,3996,2820,5227,23524,1594,3603,5197,3710,3250,3995,3800,2490,5381,22626,46150,56785,56785
Greenland,2036,GL,GRL,EUR,1648,3703,5351,3969,3456,3947,4079,2823,5212,23486,1573,3537,5110,3737,3258,3858,3915,2509,5439,22716,46202,56665,56665
Greenland,2037,GL,GRL,EUR,1633,3636,5269,3983,3483,3794,4150,2864,5166,23440,1555,3473,5028,3761,3270,3711,4018,2573,5454,22787,46227,56526,56526
Greenland,2038,GL,GRL,EUR,1619,3572,5191,3989,3514,3642,4200,2934,5096,23375,1546,3411,4957,3775,3291,3562,4097,2672,5446,22843,46218,56371,56371
Greenland,2039,GL,GRL,EUR,1613,3509,5122,3983,3545,3507,4229,3031,5014,23309,1540,3353,4893,3778,3316,3427,4149,2794,5417,22881,46190,56208,56208
Greenland,2040,GL,GRL,EUR,1610,3450,5060,3967,3576,3401,4230,3130,4923,23227,1534,3299,4833,3768,3339,3316,4173,2924,5394,22914,46141,56041,56041
Greenland,2041,GL,GRL,EUR,1607,3396,5003,3937,3602,3326,4203,3233,4846,23147,1534,3245,4779,3744,3364,3229,4165,3058,5375,22935,46082,55868,55868
Greenland,2042,GL,GRL,EUR,1607,3351,4958,3889,3629,3280,4151,3333,4778,23060,1535,3199,4734,3708,3388,3171,4120,3194,5356,22937,45997,55685,55685
Greenland,2043,GL,GRL,EUR,1607,3311,4918,3826,3659,3253,4083,3427,4707,22955,1534,3160,4694,3651,3418,3129,4049,3333,5344,22924,45879,55492,55492
Greenland,2044,GL,GRL,EUR,1606,3274,4880,3749,3694,3248,3990,3513,4660,22854,1530,3125,4655,3577,3460,3103,3958,3461,5341,22900,45754,55286,55286
Greenland,2045,GL,GRL,EUR,1600,3243,4843,3669,3724,3257,3870,3593,4619,22732,1530,3099,4629,3503,3500,3098,3844,3577,5344,22866,45598,55077,55077
Greenland,2046,GL,GRL,EUR,1600,3221,4821,3604,3743,3276,3729,3672,4590,22614,1529,3079,4608,3438,3525,3103,3710,3692,5350,22818,45432,54866,54866
Greenland,2047,GL,GRL,EUR,1595,3208,4803,3539,3758,3302,3581,3741,4575,22496,1520,3063,4583,3374,3549,3118,3569,3790,5360,22760,45256,54649,54649
Greenland,2048,GL,GRL,EUR,1590,3195,4785,3474,3762,3335,3439,3791,4575,22376,1520,3050,4570,3311,3563,3140,3426,3869,5390,22699,45075,54434,54434
Greenland,2049,GL,GRL,EUR,1587,3187,4774,3410,3759,3366,3315,3820,4582,22252,1515,3043,4558,3256,3568,3164,3293,3919,5428,22628,44880,54220,54220
Greenland,2050,GL,GRL,EUR,1581,3182,4763,3354,3744,3397,3215,3823,4601,22134,1507,3038,4545,3202,3560,3190,3187,3941,5480,22560,44694,53997,53997
Guatemala,1970,GT,GTM,AMR,509344,762875,1272219,543134,348625,267474,175048,101472,67452,1503205,492672,738668,1231340,527362,316081,264736,166517,101206,70528,1446430,2949635,5453208,5453208
Guatemala,1971,GT,GTM,AMR,522578,783281,1305859,560677,355816,270653,180852,104430,69176,1541604,505672,758213,1263885,545490,325003,265555,173966,103956,72978,1486948,3028552,5598298,5598298
Guatemala,1972,GT,GTM,AMR,535542,804962,1340504,577401,363896,272869,186956,107500,71110,1579732,518458,779073,1297531,562108,335559,264545,182140,106877,75611,1526840,3106572,5744605,5744605
Guatemala,1973,GT,GTM,AMR,548564,827910,1376474,593440,373560,274307,193504,110722,73328,1618861,531338,801261,1332599,577264,348145,262343,190908,109999,78500,1567159,3186020,5895101,5895101
Guatemala,1974,GT,GTM,AMR,562147,849053,1411200,608907,384962,276138,200216,114094,76006,1660323,544752,822305,1367057,592728,362193,260475,199404,113029,81749,1609578,3269901,6048168,6048168
Guatemala,1975,GT,GTM,AMR,576402,867809,1444211,623969,397059,278884,206531,117679,79103,1703225,558805,841521,1400326,609441,376448,259844,206873,116043,85315,1653964,3357189,6201734,6201734
Guatemala,1976,GT,GTM,AMR,589608,885452,1475060,636951,408586,281490,211611,121371,82027,1742036,571887,859202,1431089,624789,389761,259398,212920,119133,88553,1694554,3436590,6342726,6342726
Guatemala,1977,GT,GTM,AMR,603233,904293,1507526,648820,420574,284509,215911,125699,85061,1780574,585264,877806,1463070,639785,403561,259714,218245,122884,91784,1735973,3516547,6487153,6487153
Guatemala,1978,GT,GTM,AMR,618609,926015,1544624,660899,433566,288382,219798,130971,88535,1822151,600202,899302,1499504,655788,418786,261913,222887,127666,95449,1782489,3604640,6648770,6648770
Guatemala,1979,GT,GTM,AMR,634050,949140,1583190,672709,446773,292643,223058,136542,92022,1863747,615306,922051,1537357,671859,434532,266071,225935,132980,99042,1830419,3694166,6814717,6814717
Guatemala,1980,GT,GTM,AMR,649983,974065,1624048,684891,460018,297408,226069,142002,95522,1905910,631022,946433,1577455,688303,450827,272314,227603,138758,102552,1880357,3786267,6987767,6987767
Guatemala,1981,GT,GTM,AMR,666420,1000019,1666439,697509,472549,302881,228579,147338,98959,1947815,647419,971779,1619198,705242,467221,280551,227901,145105,106034,1932054,3879869,7165502,7165502
Guatemala,1982,GT,GTM,AMR,681046,1026754,1707800,705875,482180,308581,229628,152142,103247,1981653,662106,998360,1660466,720837,482430,290504,226669,151971,110458,1982869,3964522,7332790,7332790
Guatemala,1983,GT,GTM,AMR,695521,1056493,1752014,714646,491910,316339,230489,157242,108747,2019373,676437,1027971,1704408,736101,497148,302601,224912,159510,115978,2036250,4055623,7512048,7512048
Guatemala,1984,GT,GTM,AMR,710439,1089966,1800405,730098,504601,326557,232620,163077,114151,2071104,690998,1060764,1751762,753432,513382,316113,224036,167318,121417,2095698,4166802,7718971,7718971
Guatemala,1985,GT,GTM,AMR,723168,1125387,1848555,748440,517999,337203,235404,168476,119201,2126723,703145,1095462,1798607,772119,531000,329618,224348,174446,126780,2158311,4285034,7932185,7932185
Guatemala,1986,GT,GTM,AMR,735187,1161000,1896187,768271,530993,348528,238703,173251,124511,2184257,714268,1130666,1844934,791743,548684,343397,225517,180847,132621,2222809,4407066,8148185,8148185
Guatemala,1987,GT,GTM,AMR,748233,1196045,1944278,789619,543179,360749,242527,177424,130356,2243854,726367,1165445,1891812,812604,565838,357773,227437,186611,139154,2289417,4533271,8369359,8369359
Guatemala,1988,GT,GTM,AMR,762714,1231192,1993906,813062,555127,373886,246944,180979,136806,2306804,740194,1200026,1940220,835177,582784,372901,230663,191291,146374,2359190,4665994,8600111,8600111
Guatemala,1989,GT,GTM,AMR,779339,1265210,2044549,838554,567123,387758,251879,184102,143617,2373033,756320,1233259,1989579,859652,599661,388718,235707,194536,154108,2432382,4805415,8839538,8839538
Guatemala,1990,GT,GTM,AMR,797815,1297199,2095014,866049,579374,401931,257343,187069,150426,2442192,774349,1264257,2038606,886152,616548,405044,242559,196479,162188,2508970,4951162,9084780,9084780
Guatemala,1991,GT,GTM,AMR,816359,1327682,2144041,893865,591803,415857,263486,189725,157266,2512002,792588,1293871,2086459,913632,633098,421462,250996,197186,170691,2587065,5099067,9329557,9329557
Guatemala,1992,GT,GTM,AMR,834427,1357875,2192302,922580,604666,429293,270457,191935,164319,2583250,810342,1323508,2133850,942458,649449,437730,261074,196806,179713,2667230,5250480,9576630,9576630
Guatemala,1993,GT,GTM,AMR,851633,1389485,2241118,953500,618610,441943,278635,193780,171561,2658029,827201,1354497,2181698,973425,666146,453598,272982,195811,189065,2751027,5409056,9831868,9831868
Guatemala,1994,GT,GTM,AMR,867796,1424973,2292769,988099,633012,452957,287472,195713,177428,2734681,843297,1388158,2231455,1005870,682903,468989,285807,195260,197180,2836009,5570690,10094921,10094921
Guatemala,1995,GT,GTM,AMR,883788,1462481,2346269,1026254,647752,462540,296241,198078,181937,2812802,859511,1422903,2282414,1039310,699629,484330,298527,195811,204005,2921612,5734414,10363090,10363090
Guatemala,1996,GT,GTM,AMR,899738,1498371,2398109,1065042,663781,471209,305417,200874,186726,2893049,875660,1456469,2332129,1073029,716751,499481,311428,197201,211113,3009003,5902052,10632293,10632293
Guatemala,1997,GT,GTM,AMR,914792,1533795,2448587,1104256,681886,479013,315349,204167,191904,2976575,890887,1490114,2381001,1106819,735109,514240,324942,199390,218707,3099207,6075782,10905381,10905381
Guatemala,1998,GT,GTM,AMR,928939,1568788,2497727,1144140,702247,486409,326045,207934,197440,3064215,905149,1524024,2429173,1140885,754986,528758,339137,202772,226382,3192920,6257135,11184032,11184032
Guatemala,1999,GT,GTM,AMR,941273,1604221,2545494,1182845,724489,493605,337290,212074,203355,3153658,917339,1559069,2476408,1173629,776057,542938,353845,207751,233726,3287946,6441604,11463504,11463504
Guatemala,2000,GT,GTM,AMR,951660,1640779,2592439,1218113,747336,500279,348440,216529,209713,3240410,927419,1595743,2523162,1202955,797089,556216,368606,214244,240780,3379890,6620300,11735894,11735894
Guatemala,2001,GT,GTM,AMR,962097,1676766,2638863,1252099,771443,507365,359262,221564,216431,3328164,937552,1632090,2569642,1231407,818690,569245,383309,222209,247658,3472518,6800682,12009194,12009194
Guatemala,2002,GT,GTM,AMR,971564,1710891,2682455,1287142,798766,515857,369800,227333,223534,3422432,946745,1666533,2613278,1261963,842782,582756,397938,231722,254527,3571688,6994120,12289856,12289856
Guatemala,2003,GT,GTM,AMR,977677,1742691,2720368,1323370,828827,525588,379470,234022,230978,3522255,952760,1698438,2651198,1294773,869147,596459,411969,242777,261562,3676687,7198942,12570504,12570504
Guatemala,2004,GT,GTM,AMR,981371,1771615,2752986,1360956,861497,536926,388413,241328,238738,3627858,956614,1727253,2683867,1329748,897920,610694,425893,254484,268995,3787734,7415592,12852436,12852436
Guatemala,2005,GT,GTM,AMR,982294,1798759,2781053,1398038,896558,550035,397053,248779,246701,3737164,957882,1754230,2712112,1364798,928871,625684,440294,265966,276866,3902479,7639643,13132814,13132814
Guatemala,2006,GT,GTM,AMR,979397,1826150,2805547,1434083,933458,565294,405159,256864,254720,3849578,955384,1781440,2736824,1399295,961522,641947,454782,277784,285130,4020460,7870038,13412406,13412406
Guatemala,2007,GT,GTM,AMR,975951,1851773,2827724,1470430,971801,583081,412625,265891,262725,3966553,952204,1806876,2759080,1434622,995487,660011,469048,290346,293742,4143256,8109809,13696606,13696606
Guatemala,2008,GT,GTM,AMR,973555,1873093,2846648,1506305,1010913,602984,419632,275779,270509,4086122,949796,1828101,2777897,1470035,1029979,679586,483006,303614,302571,4268791,8354913,13979451,13979451
Guatemala,2009,GT,GTM,AMR,971946,1890124,2862070,1542460,1049354,625009,426610,286389,277966,4207788,947909,1845029,2792938,1506238,1063732,700748,496791,317505,311595,4396609,8604397,14259411,14259411
Guatemala,2010,GT,GTM,AMR,972523,1902872,2875395,1580393,1086873,649582,434088,297388,285201,4333525,947987,1857689,2805676,1544610,1096613,723930,510627,331802,320948,4528530,8862055,14543121,14543121
Guatemala,2011,GT,GTM,AMR,975818,1912073,2887891,1618482,1124908,676616,442669,308354,292499,4463528,950632,1866868,2817500,1583276,1130271,748971,524874,346236,330904,4664532,9128060,14833453,14833453
Guatemala,2012,GT,GTM,AMR,980673,1919467,2900140,1654643,1163752,706228,452489,318926,300152,4596190,954871,1874130,2829001,1619824,1165405,775920,539481,360478,341866,4802974,9399164,15128306,15128306
Guatemala,2013,GT,GTM,AMR,986116,1924533,2910649,1688036,1203583,738246,463533,328594,308489,4730481,959792,1878955,2838747,1653240,1202216,804811,554293,374068,354151,4942779,9673260,15422662,15422662
Guatemala,2014,GT,GTM,AMR,992444,1927814,2920258,1717668,1243823,772100,475895,337349,317399,4864234,965506,1881988,2847494,1682556,1239858,835289,569403,387362,367285,5081753,9945987,15713740,15713740
Guatemala,2015,GT,GTM,AMR,999669,1930297,2929966,1744457,1282378,807623,489683,345546,326534,4996221,971991,1884187,2856178,1708909,1276092,867149,585010,400928,380641,5218729,10214950,16001107,16001107
Guatemala,2016,GT,GTM,AMR,1007201,1931466,2938667,1771446,1319600,844810,505396,353047,336323,5130622,978759,1884991,2863750,1735526,1311298,900346,601698,414469,394631,5357968,10488590,16291004,16291004
Guatemala,2017,GT,GTM,AMR,1012497,1933266,2945763,1796466,1356282,882947,523168,359718,347083,5265664,983253,1886343,2869596,1760227,1346408,934104,619734,427655,409566,5497694,10763358,16578723,16578723
Guatemala,2018,GT,GTM,AMR,1013710,1936417,2950127,1816022,1390895,921383,542604,365844,358782,5395530,983693,1888840,2872533,1779426,1380025,967735,638893,440493,425421,5631993,11027523,16850176,16850176
Guatemala,2019,GT,GTM,AMR,1009137,1941233,2950370,1831054,1424859,959105,563894,371925,371378,5522215,978598,1892592,2871190,1793863,1413521,1000367,659435,453132,442244,5762562,11284777,17106338,17106338
Guatemala,2020,GT,GTM,AMR,997095,1949682,2946777,1845046,1462667,996649,587361,377465,382313,5651501,966345,1899660,2866005,1807166,1451217,1032789,681907,465477,459876,5898432,11549933,17362718,17362718
Guatemala,2021,GT,GTM,AMR,979060,1961295,2940355,1857692,1501797,1034356,612172,382541,388059,5776617,948297,1909768,2858065,1819300,1490633,1065907,705532,477238,474834,6033444,11810061,17608483,17608483
Guatemala,2022,GT,GTM,AMR,960016,1972160,2932176,1869100,1539517,1072479,638846,388398,390386,5898726,929254,1919161,2848415,1830306,1528820,1100338,730461,488560,486096,6164581,12063307,17843908,17843908
Guatemala,2023,GT,GTM,AMR,944397,1979985,2924382,1879065,1576641,1112687,668598,396492,394393,6027876,913454,1925662,2839116,1840070,1566183,1137564,757861,500691,498279,6300648,12328524,18092026,18092026
Guatemala,2024,GT,GTM,AMR,934262,1983268,2917530,1886516,1611372,1154634,701742,408195,403895,6166354,903016,1927759,2830775,1847553,1600823,1176948,788088,514985,515372,6443769,12610123,18358430,18358430
Guatemala,2025,GT,GTM,AMR,930539,1979913,2910452,1892665,1644883,1196475,737876,422742,416836,6311477,898933,1923369,2822302,1853786,1634099,1216515,820843,531065,535989,6592297,12903774,18636532,18636532
Guatemala,2026,GT,GTM,AMR,931771,1970575,2902346,1896860,1678765,1237059,775674,439017,429812,6457187,899767,1913126,2812893,1857947,1667759,1255238,855035,548210,557221,6741410,13198597,18913838,18913838
Guatemala,2027,GT,GTM,AMR,934641,1957782,2892423,1901112,1710854,1277281,814476,457103,443013,6603839,902316,1899451,2801767,1862028,1699612,1294126,889946,566658,579097,6891467,13495306,19189498,19189498
Guatemala,2028,GT,GTM,AMR,936792,1944382,2881174,1906476,1738837,1317136,854358,476917,456658,6750382,904234,1885126,2789360,1866987,1727437,1333328,925594,586434,601714,7041494,13791876,19462401,19462401
Guatemala,2029,GT,GTM,AMR,938229,1930950,2869179,1913228,1762615,1357419,894090,498533,470996,6896881,905466,1870905,2776371,1872910,1751059,1373669,960915,607685,625173,7191411,14088292,19733843,19733843
Guatemala,2030,GT,GTM,AMR,939140,1916101,2855241,1922825,1781947,1398888,932694,522050,486087,7044491,906179,1855456,2761635,1881280,1770253,1415782,995072,630522,649362,7342271,14386762,20003638,20003638
Guatemala,1950,GT,GTM,AMR,299095,404555,703650,320085,222782,147157,100123,61303,35894,887344,287656,367841,655497,317941,206653,141067,95910,56143,35669,853383,1740727,3099869,3099869
Guatemala,1951,GT,GTM,AMR,309203,415571,724774,325810,230713,151454,102125,62331,37217,909650,299145,379828,678973,320183,215903,144046,98260,57559,36512,872463,1782113,3185854,3185854
Guatemala,1952,GT,GTM,AMR,319237,428698,747935,330775,239088,155930,104065,63620,38703,932181,309948,394860,704808,320714,226158,147137,100545,59212,37422,891188,1823369,3276113,3276113
Guatemala,1953,GT,GTM,AMR,328737,443910,772647,334779,247744,160409,106065,65035,40177,954209,319551,412714,732265,319875,236946,150261,102869,61025,38395,909371,1863580,3368486,3368486
Guatemala,1954,GT,GTM,AMR,338132,460387,798519,338527,256308,164816,108305,66487,41603,976046,328737,431936,760673,319025,247540,153353,105369,62943,39495,927725,1903771,3462952,3462952
Guatemala,1955,GT,GTM,AMR,348076,477184,825260,342842,264383,169303,110765,68065,43037,998395,338335,451221,789556,319285,257284,156654,107999,65052,40757,947031,1945426,3560239,3560239
Guatemala,1956,GT,GTM,AMR,357953,494784,852737,347898,271759,174279,113391,69786,44476,1021589,347761,471060,818821,320572,266192,160606,110674,67303,42115,967462,1989051,3660606,3660606
Guatemala,1957,GT,GTM,AMR,367353,513375,880728,353842,278444,180052,116245,71607,45926,1046116,356677,491670,848347,322888,274388,165514,113424,69585,43491,989290,2035406,3764479,3764479
Guatemala,1958,GT,GTM,AMR,376293,532806,909099,360618,284156,186518,119328,73494,47404,1071518,365077,512854,877931,326758,281057,171289,116252,71859,44875,1012090,2083608,3870646,3870646
Guatemala,1959,GT,GTM,AMR,384960,552959,937919,368676,289537,193479,122707,75455,48955,1098809,373145,534382,907527,333352,286104,177918,119158,74124,46344,1037000,2135809,3981253,3981253
Guatemala,1960,GT,GTM,AMR,393724,573437,967161,378452,295328,200651,126434,77478,50632,1128975,381276,555847,937123,343109,289988,185498,122071,76405,48019,1065090,2194065,4098352,4098352
Guatemala,1961,GT,GTM,AMR,402796,593739,996535,390082,301027,208020,130406,79487,52465,1161487,389708,576759,966467,355720,292497,194058,125015,78649,49935,1095874,2257361,4220367,4220367
Guatemala,1962,GT,GTM,AMR,412122,613608,1025730,403570,306212,215915,134552,81451,54375,1196075,398449,596680,995129,371100,293605,203672,128131,80827,52056,1129391,2325466,4346322,4346322
Guatemala,1963,GT,GTM,AMR,421929,632619,1054548,418989,310751,224324,138813,83513,56242,1232632,407785,615098,1022883,389113,293720,214069,131425,83047,54277,1165651,2398283,4475716,4475716
Guatemala,1964,GT,GTM,AMR,432539,651130,1083669,435630,315136,232791,143100,85791,58002,1270450,417999,632713,1050712,408433,293925,224484,134818,85435,56572,1203667,2474117,4608498,4608498
Guatemala,1965,GT,GTM,AMR,443871,669957,1113828,452554,319903,240752,147452,88229,59737,1308627,428971,650525,1079496,427841,295115,234149,138443,87943,59020,1242511,2551138,4744461,4744461
Guatemala,1966,GT,GTM,AMR,455996,688695,1144691,469923,324909,247840,152122,90713,61406,1346913,440743,668180,1108923,447510,296973,242930,142621,90486,61493,1282013,2628926,4882542,4882542
Guatemala,1967,GT,GTM,AMR,468897,706961,1175858,487862,330246,254019,157357,93258,62963,1385705,453276,685435,1138711,467555,299413,250870,147584,93066,63851,1322339,2708044,5022615,5022615
Guatemala,1968,GT,GTM,AMR,482258,725139,1207397,506290,336029,259215,163169,95901,64440,1425044,466245,702682,1168927,487842,303134,257400,153331,95751,66079,1363537,2788581,5164908,5164908
Guatemala,1969,GT,GTM,AMR,495803,743653,1239456,524805,342081,263556,169182,98632,65901,1464157,479423,720312,1199735,507901,308657,261979,159664,98489,68256,1404946,2869103,5308294,5308294
Guatemala,2031,GT,GTM,AMR,939575,1899918,2839493,1935027,1797342,1439898,971146,547340,502120,7192873,906450,1838793,2745243,1892046,1785600,1457666,1029351,654735,674409,7493807,14686680,20271428,20271428
Guatemala,2032,GT,GTM,AMR,940067,1884210,2824277,1946295,1810431,1479091,1010110,574761,519107,7339795,906810,1822698,2729508,1901856,1798574,1497609,1064910,680611,700295,7643855,14983650,20537438,20537438
Guatemala,2033,GT,GTM,AMR,940719,1870999,2811718,1954307,1820678,1516212,1050163,604402,536914,7482676,907355,1809082,2716437,1908521,1808620,1535161,1102419,708401,726803,7789925,15272601,20800765,20800765
Guatemala,2034,GT,GTM,AMR,941024,1862549,2803573,1957819,1828610,1550758,1091175,635990,555580,7619932,907579,1800142,2707721,1910801,1816358,1569790,1141517,738003,753958,7930427,15550359,21061659,21061659
Guatemala,2035,GT,GTM,AMR,940992,1859906,2800898,1954711,1835243,1583900,1131659,669592,575317,7750422,907483,1796933,2704416,1906589,1822771,1602905,1180480,769459,782004,8064208,15814630,21319951,21319951
Guatemala,2036,GT,GTM,AMR,940137,1861725,2801862,1945654,1839980,1617431,1170992,704770,596489,7875316,906585,1798181,2704766,1896546,1827132,1636412,1218639,802306,811358,8192393,16067709,21574343,21574343
Guatemala,2037,GT,GTM,AMR,938140,1865238,2803378,1933187,1844783,1649253,1210035,740927,619343,7997528,904545,1801219,2705764,1883082,1831419,1668140,1256984,835861,842262,8317748,16315276,21824411,21824411
Guatemala,2038,GT,GTM,AMR,935783,1868192,2803975,1920135,1850674,1677099,1248793,778126,643994,8118821,902133,1803816,2705949,1868970,1836580,1695892,1295653,870149,874811,8442055,16560876,22070798,22070798
Guatemala,2039,GT,GTM,AMR,932844,1870089,2802933,1907078,1857925,1700875,1287994,815240,670708,8239820,899162,1805403,2704565,1854969,1842691,1719496,1335448,904157,909222,8565983,16805803,22313313,22313313
Guatemala,2040,GT,GTM,AMR,928522,1871121,2799643,1892658,1867958,1720347,1328351,851364,699617,8360295,894872,1806149,2701021,1839758,1851228,1738727,1376967,937081,945514,8689275,17049570,22550243,22550243
Guatemala,2041,GT,GTM,AMR,923317,1870859,2794176,1876953,1880547,1736008,1368302,887419,730783,8480012,889749,1805650,2695399,1823338,1862146,1754160,1418269,970159,983605,8811677,17291689,22781262,22781262
Guatemala,2042,GT,GTM,AMR,917495,1869510,2787005,1861745,1892209,1749434,1406566,924048,764508,8598510,884047,1804095,2688142,1807488,1872104,1767247,1457695,1004514,1023724,8932772,17531282,23006437,23006437
Guatemala,2043,GT,GTM,AMR,910668,1867962,2778630,1849000,1900673,1760117,1442923,961790,800745,8715248,877388,1802353,2679741,1794099,1878939,1777452,1494815,1040800,1065946,9052051,17767299,23225677,23225677
Guatemala,2044,GT,GTM,AMR,902866,1865487,2768353,1840961,1904711,1768563,1476870,1000516,839278,8830899,869808,1799732,2669540,1785363,1881415,1785377,1529115,1078665,1110187,9170122,18001021,23438911,23438911
Guatemala,2045,GT,GTM,AMR,895022,1861291,2756313,1838651,1902244,1775766,1509519,1038837,880359,8945376,862200,1795463,2657663,1782318,1877435,1791998,1561942,1116452,1156727,9286872,18232248,23646222,23646222
Guatemala,2046,GT,GTM,AMR,887509,1855397,2742906,1840736,1893935,1781144,1542575,1076178,923900,9058468,854897,1789567,2644464,1783706,1867659,1796606,1595159,1153509,1205525,9402164,18460632,23848004,23848004
Guatemala,2047,GT,GTM,AMR,880248,1847750,2727998,1844491,1882295,1786619,1574024,1113327,969558,9170314,847840,1781951,2629791,1786872,1854491,1801152,1626655,1190784,1256183,9516137,18686451,24044234,24044234
Guatemala,2048,GT,GTM,AMR,873329,1838732,2712061,1847689,1870090,1793156,1601691,1150294,1017507,9280427,841099,1773004,2614103,1789593,1840674,1806564,1654266,1228408,1308828,9628333,18908760,24234927,24234927
Guatemala,2049,GT,GTM,AMR,866945,1828156,2695101,1849845,1857893,1801026,1625474,1187741,1066962,9388941,834854,1762573,2597427,1791306,1826973,1812913,1677822,1267131,1362675,9738820,19127761,24420291,24420291
Guatemala,2050,GT,GTM,AMR,861247,1816149,2677396,1851141,1844364,1811617,1645151,1226293,1117202,9495768,829265,1750790,2580055,1792178,1812065,1821664,1697101,1307480,1417014,9847502,19343270,24600727,24600727
Guam,1970,GU,GUM,WPR,6129,11409,17538,11131,7593,6659,3703,1636,647,31369,6028,10904,16932,8008,5716,4153,2434,1300,845,22456,53825,88300,88300
Guam,1971,GU,GUM,WPR,6277,11757,18034,10792,8036,6573,3933,1712,674,31720,6117,11137,17254,8412,5934,4313,2574,1374,887,23494,55214,90505,90505
Guam,1972,GU,GUM,WPR,6468,11966,18434,10507,8535,6469,4195,1800,715,32221,6255,11277,17532,8842,6205,4448,2740,1461,932,24628,56849,92815,92815
Guam,1973,GU,GUM,WPR,6657,12017,18674,10407,9026,6336,4432,1888,767,32856,6422,11342,17764,9264,6533,4570,2904,1555,982,25808,58664,95100,95100
Guam,1974,GU,GUM,WPR,6829,11950,18779,10513,9456,6201,4604,1981,833,33588,6590,11362,17952,9652,6911,4687,3065,1649,1038,27002,60590,97329,97329
Guam,1975,GU,GUM,WPR,6897,11897,18794,10795,9784,6082,4706,2086,910,34363,6679,11413,18092,9970,7348,4815,3227,1749,1113,28222,62585,99478,99478
Guam,1976,GU,GUM,WPR,6855,11932,18787,11204,9974,6008,4753,2191,1001,35131,6705,11546,18251,10212,7841,4949,3384,1848,1193,29427,64558,101590,101590
Guam,1977,GU,GUM,WPR,6779,12030,18809,11605,10092,6001,4758,2306,1089,35851,6684,11719,18403,10374,8393,5069,3549,1952,1278,30615,66466,103676,103676
Guam,1978,GU,GUM,WPR,6723,12107,18830,11936,10217,6063,4733,2414,1184,36547,6629,11881,18510,10501,9005,5167,3712,2071,1373,31829,68376,105710,105710
Guam,1979,GU,GUM,WPR,6715,12154,18869,12165,10401,6204,4635,2534,1277,37216,6665,11979,18644,10616,9618,5317,3832,2197,1485,33065,70281,107790,107790
Guam,1980,GU,GUM,WPR,6836,12330,19166,12351,10674,6411,4527,2702,1369,38034,6820,12051,18871,10754,10070,5545,3916,2337,1597,34219,72253,110286,110286
Guam,1981,GU,GUM,WPR,7048,12645,19693,12595,10950,6729,4507,2910,1444,39135,6973,12183,19156,10928,10309,5836,4000,2480,1688,35241,74376,113221,113221
Guam,1982,GU,GUM,WPR,7229,12917,20146,12890,11201,7120,4527,3132,1516,40386,7088,12310,19398,11148,10430,6153,4108,2626,1788,36253,76639,116189,116189
Guam,1983,GU,GUM,WPR,7376,13053,20429,13215,11524,7512,4593,3343,1585,41772,7214,12370,19584,11421,10517,6468,4232,2760,1885,37283,79055,119067,119067
Guam,1984,GU,GUM,WPR,7475,13017,20492,13639,11877,7919,4724,3491,1676,43326,7299,12426,19725,11703,10606,6785,4364,2892,1988,38338,81664,121885,121885
Guam,1985,GU,GUM,WPR,7533,12854,20387,14179,12210,8346,4890,3612,1789,45026,7341,12483,19824,11975,10707,7129,4514,3027,2093,39445,84471,124675,124675
Guam,1986,GU,GUM,WPR,7595,12695,20290,14700,12558,8751,5060,3736,1892,46697,7402,12509,19911,12224,10841,7474,4644,3174,2197,40554,87251,127462,127462
Guam,1987,GU,GUM,WPR,7679,12619,20298,15098,12935,9167,5219,3858,2008,48285,7519,12487,20006,12426,11054,7820,4729,3338,2302,41669,89954,130259,130259
Guam,1988,GU,GUM,WPR,7796,12588,20384,15344,13371,9602,5362,3969,2133,49781,7704,12450,20154,12527,11377,8164,4778,3482,2423,42751,92532,133079,133079
Guam,1989,GU,GUM,WPR,7853,12591,20444,15393,13892,10049,5529,4036,2302,51201,7837,12489,20326,12451,11808,8501,4851,3597,2577,43785,94986,135759,135759
Guam,1990,GU,GUM,WPR,7926,12763,20689,15105,14336,10462,5717,4050,2513,52183,7942,12671,20613,12284,12196,8869,4973,3704,2747,44773,96956,138263,138263
Guam,1991,GU,GUM,WPR,8139,13078,21217,14601,14576,10778,5947,4044,2732,52678,8106,12956,21062,12194,12440,9250,5179,3806,2911,45780,98458,140739,140739
Guam,1992,GU,GUM,WPR,8353,13384,21737,14143,14751,10997,6233,4054,2935,53113,8244,13281,21525,12203,12582,9568,5459,3907,3085,46804,99917,143173,143173
Guam,1993,GU,GUM,WPR,8536,13663,22199,13709,14935,11163,6543,4098,3107,53555,8337,13631,21968,12238,12691,9838,5782,4016,3245,47810,101365,145541,145541
Guam,1994,GU,GUM,WPR,8736,13885,22621,13277,15106,11310,6870,4182,3253,53998,8435,13926,22361,12301,12779,10083,6149,4154,3393,48859,102857,147843,147843
Guam,1995,GU,GUM,WPR,8881,14127,23008,12934,15157,11458,7207,4294,3389,54439,8522,14184,22706,12382,12855,10314,6542,4311,3536,49940,104379,150094,150094
Guam,1996,GU,GUM,WPR,8897,14468,23365,12753,15029,11637,7529,4409,3510,54867,8545,14460,23005,12439,12943,10549,6944,4463,3691,51029,105896,152261,152261
Guam,1997,GU,GUM,WPR,8871,14804,23675,12708,14787,11848,7829,4515,3613,55300,8521,14727,23248,12471,13046,10807,7350,4588,3846,52108,107408,154330,154330
Guam,1998,GU,GUM,WPR,8868,15088,23956,12735,14504,12079,8104,4620,3715,55757,8476,14987,23463,12502,13122,11094,7754,4705,4009,53186,108943,156357,156357
Guam,1999,GU,GUM,WPR,8905,15322,24227,12789,14221,12316,8344,4744,3808,56222,8458,15222,23680,12563,13158,11386,8131,4851,4182,54271,110493,158395,158395
Guam,2000,GU,GUM,WPR,8985,15553,24538,12790,13946,12549,8582,4866,3923,56656,8464,15405,23869,12603,13107,11616,8441,4991,4369,55127,111783,160188,160188
Guam,2001,GU,GUM,WPR,9050,15776,24826,12746,13668,12764,8824,4993,4058,57053,8477,15504,23981,12593,12954,11757,8680,5111,4563,55658,112711,161524,161524
Guam,2002,GU,GUM,WPR,9018,15983,25001,12745,13368,12943,9040,5160,4196,57452,8463,15555,24018,12574,12764,11856,8871,5266,4774,56105,113557,162563,162563
Guam,2003,GU,GUM,WPR,8879,16166,25045,12817,13031,13076,9228,5369,4332,57853,8377,15594,23971,12577,12558,11923,9035,5450,4970,56513,114366,163385,163385
Guam,2004,GU,GUM,WPR,8662,16266,24928,13001,12663,13162,9412,5614,4465,58317,8212,15619,23831,12619,12328,11963,9193,5672,5156,56931,115248,164004,164004
Guam,2005,GU,GUM,WPR,8384,16282,24666,13270,12287,13183,9618,5882,4581,58821,7987,15615,23602,12694,12076,11988,9343,5935,5307,57343,116164,164430,164430
Guam,2006,GU,GUM,WPR,8101,16203,24304,13577,11928,13134,9850,6162,4674,59325,7760,15549,23309,12776,11820,11988,9499,6221,5424,57728,117053,164675,164675
Guam,2007,GU,GUM,WPR,7861,16009,23870,13894,11616,13015,10104,6442,4735,59806,7574,15392,22966,12884,11589,11947,9661,6527,5514,58122,117928,164763,164763
Guam,2008,GU,GUM,WPR,7680,15711,23391,14189,11384,12831,10357,6703,4797,60261,7442,15132,22574,13006,11386,11865,9822,6832,5586,58497,118758,164725,164725
Guam,2009,GU,GUM,WPR,7556,15333,22889,14438,11239,12589,10606,6923,4874,60669,7366,14806,22172,13142,11207,11748,9953,7107,5685,58842,119511,164580,164580
Guam,2010,GU,GUM,WPR,7654,15047,22701,14539,11118,12291,10855,7131,5061,60995,7442,14553,21995,13247,10982,11609,10101,7359,5921,59219,120214,164905,164905
Guam,2011,GU,GUM,WPR,7889,14888,22777,14505,11004,11944,11089,7329,5381,61252,7596,14420,22016,13320,10708,11435,10263,7596,6290,59612,120864,165649,165649
Guam,2012,GU,GUM,WPR,8130,14745,22875,14454,10953,11560,11284,7503,5720,61474,7754,14301,22055,13401,10464,11220,10408,7790,6707,59990,121464,166392,166392
Guam,2013,GU,GUM,WPR,8335,14631,22966,14387,10953,11144,11430,7673,6084,61671,7880,14219,22099,13472,10254,10960,10533,7956,7148,60323,121994,167054,167054
Guam,2014,GU,GUM,WPR,8447,14559,23006,14305,10982,10717,11527,7841,6456,61828,7919,14167,22086,13517,10078,10676,10626,8117,7607,60621,122449,167543,167543
Guam,2015,GU,GUM,WPR,8431,14635,23066,14199,11034,10300,11557,8030,6810,61930,7872,14222,22094,13522,9940,10370,10692,8283,8083,60890,122820,167978,167978
Guam,2016,GU,GUM,WPR,8333,14812,23145,14080,11081,9902,11514,8259,7145,61981,7778,14337,22115,13470,9845,10056,10726,8464,8555,61116,123097,168346,168346
Guam,2017,GU,GUM,WPR,8168,15040,23208,13949,11121,9538,11407,8510,7472,61997,7623,14484,22107,13369,9794,9737,10720,8659,9015,61294,123291,168606,168606
Guam,2018,GU,GUM,WPR,7934,15266,23200,13810,11154,9223,11234,8777,7792,61990,7404,14635,22039,13238,9780,9428,10674,8861,9472,61453,123443,168678,168678
Guam,2019,GU,GUM,WPR,7713,15428,23141,13664,11165,8973,11006,9047,8107,61962,7198,14726,21924,13095,9799,9124,10583,9056,9943,61600,123562,168624,168624
Guam,2020,GU,GUM,WPR,7495,15607,23102,13628,11286,8863,10745,9308,8386,62216,6996,14830,21826,13075,9979,8898,10474,9245,10415,62086,124302,169231,169231
Guam,2021,GU,GUM,WPR,7310,15785,23095,13697,11521,8890,10473,9546,8655,62782,6826,14932,21758,13177,10313,8754,10354,9420,10877,62895,125677,170534,170534
Guam,2022,GU,GUM,WPR,7174,15901,23075,13732,11729,8976,10172,9756,9007,63372,6699,14976,21675,13248,10655,8639,10194,9575,11333,63644,127016,171774,171774
Guam,2023,GU,GUM,WPR,7123,15916,23039,13751,11908,9114,9845,9928,9408,63954,6654,14928,21582,13307,10973,8562,9999,9716,11816,64373,128327,172952,172952
Guam,2024,GU,GUM,WPR,7123,15860,22983,13788,12070,9294,9509,10059,9825,64545,6658,14809,21467,13380,11279,8531,9782,9833,12314,65119,129664,174114,174114
Guam,2025,GU,GUM,WPR,7148,15658,22806,13955,12220,9499,9194,10131,10262,65261,6680,14595,21275,13531,11539,8546,9555,9924,12822,65917,131178,175263,175263
Guam,2026,GU,GUM,WPR,7179,15392,22571,14205,12352,9712,8902,10141,10718,66030,6710,14353,21063,13723,11748,8613,9323,9987,13342,66736,132766,176397,176397
Guam,2027,GU,GUM,WPR,7201,15114,22315,14490,12462,9930,8644,10090,11188,66804,6732,14095,20827,13936,11904,8739,9095,10016,13873,67563,134367,177508,177508
Guam,2028,GU,GUM,WPR,7221,14860,22081,14759,12555,10154,8442,9982,11664,67556,6750,13859,20609,14134,12021,8915,8878,10012,14401,68361,135917,178605,178605
Guam,2029,GU,GUM,WPR,7244,14675,21919,14960,12628,10366,8306,9826,12136,68222,6772,13693,20465,14266,12113,9134,8675,9968,14925,69081,137303,179686,179686
Guam,2030,GU,GUM,WPR,7263,14501,21764,15151,12677,10570,8245,9625,12605,68873,6790,13531,20321,14382,12182,9402,8494,9890,15432,69782,138655,180746,180746
Guam,1950,GU,GUM,WPR,3941,4492,8433,15289,9649,4987,2234,737,267,33163,3711,4228,7939,3446,3752,2163,1096,589,404,11450,44613,60991,60991
Guam,1951,GU,GUM,WPR,4298,4782,9080,13606,10436,5241,2366,784,263,32696,3938,4533,8471,3476,3791,2257,1161,605,393,11683,44379,61923,61923
Guam,1952,GU,GUM,WPR,4519,5286,9805,11819,11282,5482,2487,839,259,32168,4089,4895,8984,3551,3803,2351,1231,622,384,11942,44110,62893,62893
Guam,1953,GU,GUM,WPR,4590,5969,10559,10098,12068,5688,2602,897,265,31618,4167,5317,9484,3668,3792,2449,1302,640,380,12231,43849,63893,63893
Guam,1954,GU,GUM,WPR,4575,6732,11307,8601,12683,5847,2716,958,279,31084,4232,5750,9982,3805,3769,2551,1372,657,386,12540,43624,64912,64912
Guam,1955,GU,GUM,WPR,4555,7489,12044,7415,13050,5949,2830,1028,298,30570,4322,6166,10488,3964,3730,2660,1443,679,394,12870,43440,65977,65977
Guam,1956,GU,GUM,WPR,4582,8192,12774,6574,13130,6016,2946,1106,322,30094,4429,6581,11010,4130,3693,2769,1511,708,410,13221,43315,67106,67106
Guam,1957,GU,GUM,WPR,4687,8809,13496,6058,12930,6090,3063,1183,349,29673,4553,6981,11534,4311,3673,2869,1580,741,428,13602,43275,68305,68305
Guam,1958,GU,GUM,WPR,4870,9308,14178,5820,12470,6226,3181,1258,380,29335,4701,7351,12052,4509,3679,2962,1643,775,447,14015,43350,69587,69587
Guam,1959,GU,GUM,WPR,5098,9674,14772,5845,11796,6452,3305,1323,412,29133,4863,7683,12546,4729,3728,3046,1710,816,465,14494,43627,70945,70945
Guam,1960,GU,GUM,WPR,5342,9882,15224,6125,10954,6774,3420,1380,447,29100,5037,7976,13013,4983,3812,3116,1775,860,485,15031,44131,72374,72374
Guam,1961,GU,GUM,WPR,5560,9942,15502,6644,10031,7165,3523,1431,481,29275,5214,8233,13447,5275,3944,3175,1841,908,505,15648,44923,73873,73873
Guam,1962,GU,GUM,WPR,5739,9879,15618,7354,9126,7549,3598,1475,511,29613,5392,8457,13849,5599,4105,3234,1908,956,531,16333,45946,75412,75412
Guam,1963,GU,GUM,WPR,5879,9749,15628,8187,8336,7854,3643,1514,546,30080,5560,8664,14224,5950,4288,3288,1978,1003,556,17063,47143,76996,76996
Guam,1964,GU,GUM,WPR,5986,9641,15627,9047,7708,8028,3660,1552,580,30575,5715,8892,14607,6306,4480,3348,2044,1052,585,17815,48390,78621,78621
Guam,1965,GU,GUM,WPR,6065,9646,15711,9831,7264,8039,3646,1582,611,30973,5848,9169,15017,6639,4677,3421,2107,1094,620,18558,49531,80255,80255
Guam,1966,GU,GUM,WPR,6122,9808,15930,10480,6992,7885,3617,1611,635,31220,5951,9481,15432,6946,4879,3512,2164,1134,662,19297,50517,81879,81879
Guam,1967,GU,GUM,WPR,6156,10117,16273,10960,6881,7604,3594,1628,652,31319,6017,9833,15850,7233,5073,3636,2223,1171,706,20042,51361,83480,83480
Guam,1968,GU,GUM,WPR,6159,10528,16687,11244,6942,7249,3589,1633,653,31310,6046,10207,16253,7490,5275,3788,2281,1209,749,20792,52102,85046,85046
Guam,1969,GU,GUM,WPR,6112,10973,17085,11318,7205,6887,3600,1619,648,31277,6023,10578,16601,7716,5497,3969,2339,1249,797,21567,52844,86534,86534
Guam,2031,GU,GUM,WPR,7284,14344,21628,15324,12706,10765,8263,9387,13062,69507,6809,13387,20196,14478,12241,9698,8340,9782,15923,70462,139969,181795,181795
Guam,2032,GU,GUM,WPR,7307,14226,21533,15436,12725,10955,8350,9129,13508,70103,6829,13278,20107,14521,12295,10018,8223,9634,16392,71083,141186,182823,182823
Guam,2033,GU,GUM,WPR,7320,14197,21517,15453,12749,11139,8489,8848,13924,70602,6843,13256,20099,14470,12354,10336,8152,9451,16853,71616,142218,183827,183827
Guam,2034,GU,GUM,WPR,7333,14219,21552,15395,12789,11301,8671,8558,14321,71035,6855,13278,20133,14356,12425,10637,8124,9253,17301,72096,143131,184818,184818
Guam,2035,GU,GUM,WPR,7351,14266,21617,15199,12959,11449,8876,8285,14673,71441,6871,13319,20190,14142,12579,10900,8141,9042,17735,72539,143980,185789,185789
Guam,2036,GU,GUM,WPR,7356,14318,21674,14935,13209,11586,9086,8033,14992,71841,6875,13371,20246,13898,12767,11107,8209,8826,18156,72963,144804,186724,186724
Guam,2037,GU,GUM,WPR,7351,14363,21714,14658,13493,11700,9306,7815,15269,72241,6872,13411,20283,13642,12980,11267,8336,8613,18544,73382,145623,187620,187620
Guam,2038,GU,GUM,WPR,7343,14399,21742,14407,13763,11795,9525,7645,15505,72640,6864,13447,20311,13408,13178,11382,8515,8412,18903,73798,146438,188487,188487
Guam,2039,GU,GUM,WPR,7323,14433,21756,14227,13964,11870,9737,7537,15696,73031,6845,13479,20324,13241,13310,11469,8736,8223,19217,74196,147227,189313,189313
Guam,2040,GU,GUM,WPR,7291,14469,21760,14056,14158,11923,9939,7500,15844,73420,6814,13512,20326,13080,13428,11542,8999,8056,19485,74590,148010,190097,190097
Guam,2041,GU,GUM,WPR,7250,14498,21748,13896,14331,11954,10137,7531,15954,73803,6777,13538,20315,12938,13525,11602,9295,7915,19702,74977,148780,190843,190843
Guam,2042,GU,GUM,WPR,7207,14515,21722,13786,14449,11975,10329,7624,16027,74190,6736,13554,20290,12833,13569,11657,9610,7808,19867,75344,149534,191541,191541
Guam,2043,GU,GUM,WPR,7163,14521,21684,13757,14464,12003,10510,7768,16060,74562,6693,13560,20253,12810,13518,11718,9925,7744,19987,75702,150264,192200,192200
Guam,2044,GU,GUM,WPR,7114,14516,21630,13779,14411,12047,10677,7952,16068,74934,6648,13557,20205,12830,13404,11786,10224,7723,20076,76043,150977,192818,192818
Guam,2045,GU,GUM,WPR,7065,14499,21564,13827,14218,12220,10829,8156,16058,75308,6603,13538,20141,12875,13191,11941,10483,7747,20149,76386,151694,193404,193404
Guam,2046,GU,GUM,WPR,7014,14463,21477,13881,13961,12471,10968,8366,16035,75682,6558,13508,20066,12924,12945,12134,10688,7819,20207,76717,152399,193945,193945
Guam,2047,GU,GUM,WPR,6963,14417,21380,13927,13689,12756,11083,8578,16015,76048,6508,13464,19972,12966,12694,12347,10845,7947,20242,77041,153089,194441,194441
Guam,2048,GU,GUM,WPR,6907,14367,21274,13963,13440,13027,11183,8793,15993,76399,6458,13416,19874,13002,12463,12545,10963,8120,20261,77354,153753,194898,194898
Guam,2049,GU,GUM,WPR,6850,14298,21148,13998,13263,13231,11259,9000,16000,76751,6403,13352,19755,13034,12298,12678,11053,8340,20258,77661,154412,195309,195309
Guam,2050,GU,GUM,WPR,6783,14217,21000,14037,13091,13424,11320,9200,16029,77101,6342,13276,19618,13068,12138,12794,11125,8603,20228,77956,155057,195673,195673
Guyana,1970,GY,GUY,AMR,60912,107462,168374,67179,36571,29009,22793,16021,11007,182580,59657,107261,166918,68214,38746,29809,21842,15156,13621,187388,369968,705261,705261
Guyana,1971,GY,GUY,AMR,60587,108989,169576,69168,37026,28957,23055,16111,11275,185592,59338,108877,168215,70339,39189,29895,22061,15244,13802,190530,376122,713904,713904
Guyana,1972,GY,GUY,AMR,59900,110336,170236,71302,37713,28976,23310,16129,11476,188906,58692,110090,168782,72632,39874,30063,22311,15281,13909,194070,382976,721994,721994
Guyana,1973,GY,GUY,AMR,59318,111284,170602,73423,38590,29020,23555,16122,11679,192389,58179,110876,169055,74973,40726,30225,22567,15325,14012,197828,390217,729865,729865
Guyana,1974,GY,GUY,AMR,58838,111826,170664,75587,39713,29079,23752,16115,11889,196135,57783,111269,169052,77344,41799,30381,22813,15379,14128,201844,397979,737701,737701
Guyana,1975,GY,GUY,AMR,58420,112042,170462,77775,41107,29165,23868,16120,12125,200160,57464,111345,168809,79729,43106,30550,23045,15460,14267,206157,406317,745590,745590
Guyana,1976,GY,GUY,AMR,58066,111949,170015,79965,42784,29265,23896,16153,12397,204460,57200,111129,168329,82097,44662,30731,23256,15574,14432,210752,415212,753553,753553
Guyana,1977,GY,GUY,AMR,57732,111605,169337,82089,44700,29384,23847,16219,12671,208910,56928,110698,167626,84356,46447,30916,23439,15723,14618,215499,424409,761378,761378
Guyana,1978,GY,GUY,AMR,57377,111020,168397,84045,46748,29534,23754,16318,12937,213336,56606,110091,166697,86402,48381,31112,23595,15889,14801,220180,433516,768609,768609
Guyana,1979,GY,GUY,AMR,57039,110094,167133,85659,48794,29717,23636,16439,13160,217405,56269,109210,165479,88077,50352,31318,23715,16060,14950,224472,441877,774482,774482
Guyana,1980,GY,GUY,AMR,56701,108737,165438,86772,50683,29952,23501,16584,13314,220806,55910,107976,163886,89228,52236,31542,23770,16215,15055,228046,448852,778176,778176
Guyana,1981,GY,GUY,AMR,56055,106805,162860,87666,52503,30325,23366,16762,13417,224039,55243,106258,161501,89994,54091,31868,23781,16415,15138,231287,455326,779686,779686
Guyana,1982,GY,GUY,AMR,55040,104545,159585,88371,54284,30907,23242,16944,13477,227225,54219,104274,158493,90426,55928,32365,23760,16661,15201,234341,461566,779639,779639
Guyana,1983,GY,GUY,AMR,53879,102390,156269,88498,55940,31686,23125,17061,13514,229824,53025,102388,155413,90351,57667,33031,23715,16871,15231,236866,466690,778372,778372
Guyana,1984,GY,GUY,AMR,52636,100362,152998,88057,57465,32655,23022,17084,13553,231836,51718,100593,152311,89828,59252,33862,23661,17006,15256,238865,470701,776007,776007
Guyana,1985,GY,GUY,AMR,51434,98388,149822,87157,58795,33777,22929,16995,13605,233258,50422,98804,149226,88973,60618,34836,23609,17043,15289,240368,473626,772671,772671
Guyana,1986,GY,GUY,AMR,50312,96486,146798,85898,59905,34996,22854,16789,13665,234107,49214,96996,146210,87866,61752,35891,23560,16965,15360,241394,475501,768508,768508
Guyana,1987,GY,GUY,AMR,49354,94613,143967,84391,60773,36234,22824,16498,13727,234447,48191,95111,143302,86619,62619,36983,23516,16777,15483,241997,476444,763706,763706
Guyana,1988,GY,GUY,AMR,48694,92692,141386,82742,61362,37401,22862,16153,13760,234280,47494,93104,140598,85301,63212,38040,23503,16491,15636,242183,476463,758450,758450
Guyana,1989,GY,GUY,AMR,48340,90784,139124,81025,61637,38438,22997,15785,13744,233626,47141,91048,138189,83950,63514,39018,23554,16136,15778,241950,475576,752897,752897
Guyana,1990,GY,GUY,AMR,48227,88940,137167,79337,61548,39298,23262,15419,13665,232529,47106,88999,136105,82611,63526,39869,23703,15749,15864,241322,473851,747116,747116
Guyana,1991,GY,GUY,AMR,48425,87423,135848,77966,61596,40212,23673,15169,13592,232208,47382,87263,134645,81420,63715,40812,24021,15520,15906,241394,473602,744096,744096
Guyana,1992,GY,GUY,AMR,49147,86448,135595,77073,61966,41208,24180,15093,13553,233073,48097,86007,134104,80424,64133,41810,24454,15517,15885,242223,475296,744998,744998
Guyana,1993,GY,GUY,AMR,50093,85879,135972,76372,62269,42150,24775,15110,13486,234162,49000,85104,134104,79476,64398,42708,24963,15613,15788,242946,477108,747189,747189
Guyana,1994,GY,GUY,AMR,50871,85607,136478,75623,62423,43114,25455,15160,13434,235209,49716,84540,134256,78447,64530,43626,25564,15751,15678,243596,478805,749546,749546
Guyana,1995,GY,GUY,AMR,51437,85645,137082,74776,62417,44085,26186,15223,13358,236045,50189,84360,134549,77297,64507,44538,26215,15890,15572,244019,480064,751689,751689
Guyana,1996,GY,GUY,AMR,51589,86178,137767,73835,62271,45060,26946,15280,13266,236658,50263,84696,134959,76030,64331,45428,26904,16011,15488,244192,480850,753571,753571
Guyana,1997,GY,GUY,AMR,51366,87118,138484,72815,62006,46027,27720,15346,13160,237074,50007,85456,135463,74669,64023,46294,27622,16110,15472,244190,481264,755211,755211
Guyana,1998,GY,GUY,AMR,51008,88198,139206,71745,61665,46961,28512,15446,13086,237415,49624,86389,136013,73239,63605,47114,28367,16218,15524,244067,481482,756697,756697
Guyana,1999,GY,GUY,AMR,50514,89345,139859,70664,61265,47844,29330,15602,13061,237766,49111,87421,136532,71786,63093,47875,29140,16347,15615,243856,481622,758014,758014
Guyana,2000,GY,GUY,AMR,49875,90493,140368,69608,60835,48622,30156,15837,13069,238127,48465,88472,136937,70357,62510,48541,29947,16531,15728,243614,481741,759051,759051
Guyana,2001,GY,GUY,AMR,49105,91553,140658,68659,60362,49268,30995,16156,13120,238560,47691,89448,137139,69042,61848,49106,30784,16807,15863,243450,482010,759809,759809
Guyana,2002,GY,GUY,AMR,48230,92451,140681,67934,59820,49764,31849,16566,13198,239131,46815,90271,137086,67949,61090,49561,31650,17187,15986,243423,482554,760323,760323
Guyana,2003,GY,GUY,AMR,47032,92999,140031,67473,59262,50038,32723,17090,13369,239955,45627,90736,136363,67332,60499,49918,32588,17693,16182,244212,484167,760562,760562
Guyana,2004,GY,GUY,AMR,45610,93072,138682,67281,58689,50101,33600,17705,13615,240991,44227,90700,134927,67198,60071,50191,33574,18317,16477,245828,486819,760424,760424
Guyana,2005,GY,GUY,AMR,44293,92646,136939,67367,58024,50039,34474,18361,13854,242119,42935,90128,133063,67379,59540,50354,34531,19005,16776,247585,489704,759709,759709
Guyana,2006,GY,GUY,AMR,43130,91523,134653,67886,57261,49870,35327,19048,14093,243485,41795,88866,130661,68001,58886,50401,35451,19742,17091,249572,493057,758367,758367
Guyana,2007,GY,GUY,AMR,42169,89755,131924,68769,56401,49615,36158,19765,14348,245056,40853,86998,127851,68966,58112,50352,36319,20514,17426,251689,496745,756521,756521
Guyana,2008,GY,GUY,AMR,41367,87658,129025,69738,55453,49297,36931,20493,14618,246530,40055,84825,124880,70018,57235,50229,37118,21313,17803,253716,500246,754150,754150
Guyana,2009,GY,GUY,AMR,40649,85358,126007,70729,54452,48926,37620,21224,14929,247880,39346,82470,121816,71075,56282,50036,37835,22133,18195,255556,503436,751258,751258
Guyana,2010,GY,GUY,AMR,40015,82920,122935,71666,53426,48528,38187,21953,15284,249044,38720,79997,118717,72054,55305,49802,38452,22977,18638,257228,506272,747932,747932
Guyana,2011,GY,GUY,AMR,39466,80419,119885,72442,52462,48085,38619,22677,15721,250006,38184,77480,115664,72849,54374,49505,38966,23836,19148,258678,508684,744230,744230
Guyana,2012,GY,GUY,AMR,39145,78403,117548,73469,51965,47801,39039,23438,16236,251948,37888,75460,113348,73777,53900,49386,39530,24763,19759,261115,513063,743966,743966
Guyana,2013,GY,GUY,AMR,39129,77309,116438,74499,51540,47535,39430,24220,16752,253976,37905,74380,112285,74820,53870,49532,40242,25783,20472,264719,518695,747420,747420
Guyana,2014,GY,GUY,AMR,39217,76711,115928,75063,50934,47050,39685,25016,17248,254996,38021,73833,111854,75547,54042,49677,40964,26845,21253,268328,523324,751115,751115
Guyana,2015,GY,GUY,AMR,39285,76283,115568,75410,50663,46480,39861,25855,17784,256053,38104,73473,111577,75906,54565,49723,41629,27920,22092,271835,527888,755031,755031
Guyana,2016,GY,GUY,AMR,39310,76055,115365,75320,50921,45800,39964,26716,18322,257043,38134,73337,111471,75748,55585,49655,42241,28999,22979,275207,532250,759087,759087
Guyana,2017,GY,GUY,AMR,39304,76023,115327,74828,51651,45017,40012,27568,18870,257946,38132,73410,111542,75152,57011,49475,42805,30070,23920,278433,536379,763252,763252
Guyana,2018,GY,GUY,AMR,39651,76516,116167,77759,56564,46101,40883,28773,19790,269870,38484,73927,112411,76335,60604,50112,43705,31272,25029,287057,556927,785514,785514
Guyana,2019,GY,GUY,AMR,39961,76813,116774,78374,59760,46252,41345,29754,20569,276054,38796,74309,113105,76235,63365,50286,44422,32374,26146,292828,568882,798753,798753
Guyana,2020,GY,GUY,AMR,40017,76840,116857,75827,59889,44856,41115,30329,21027,273043,38837,74472,113309,74419,64543,49729,44832,33292,27186,294001,567044,797202,797202
Guyana,2021,GY,GUY,AMR,40119,77152,117271,75605,62393,44670,41293,30903,21503,276367,38936,74809,113745,73569,66474,49598,45320,34132,28098,297191,573558,804567,804567
Guyana,2022,GY,GUY,AMR,40084,77377,117461,75048,64509,44504,41302,31277,21884,278524,38896,75053,113949,72328,67744,49407,45620,34817,28878,298794,577318,808726,808726
Guyana,2023,GY,GUY,AMR,39962,77574,117536,74528,66486,44615,41345,31695,22618,281287,38776,75279,114055,71282,68771,49461,45903,35532,30007,300956,582243,813834,813834
Guyana,2024,GY,GUY,AMR,39635,77851,117486,74080,68211,45041,41405,32148,23651,284536,38471,75574,114045,70429,69436,49801,46151,36272,31434,303523,588059,819594,819594
Guyana,2025,GY,GUY,AMR,39192,78110,117302,73759,69593,45800,41382,32535,24703,287772,38053,75835,113888,69820,69657,50460,46295,36952,32900,306084,593856,825051,825051
Guyana,2026,GY,GUY,AMR,38753,78219,116972,73607,70411,47071,41277,32874,25757,290997,37641,75948,113589,69486,69292,51584,46331,37582,34383,308658,599655,830213,830213
Guyana,2027,GY,GUY,AMR,38292,78244,116536,73635,70682,48797,41083,33175,26808,294180,37203,75981,113184,69410,68410,53076,46246,38162,35879,311183,605363,835082,835082
Guyana,2028,GY,GUY,AMR,37847,78170,116017,73782,70670,50738,40819,33455,27843,297307,36778,75913,112691,69510,67301,54701,46059,38707,37379,313657,610964,839668,839668
Guyana,2029,GY,GUY,AMR,37409,77987,115396,73989,70469,52840,40519,33726,28855,300398,36360,75747,112107,69701,66081,56394,45803,39231,38884,316094,616492,843990,843990
Guyana,2030,GY,GUY,AMR,36987,77687,114674,74232,70115,55039,40224,33997,29847,303454,35953,75469,111422,69948,64819,58061,45518,39747,40390,318483,621937,848033,848033
Guyana,1950,GY,GUY,AMR,37333,50343,87676,36386,26967,22792,17477,9763,6524,119909,36517,49019,85536,37155,28044,22658,16637,10400,9700,124594,244503,417719,417719
Guyana,1951,GY,GUY,AMR,38692,52335,91027,37156,27447,23073,17895,9881,6460,121912,37985,51020,89005,37801,28634,22936,17002,10473,9609,126455,248367,428399,428399
Guyana,1952,GY,GUY,AMR,40190,54476,94666,37842,28151,23498,18288,10047,6442,124268,39491,53354,92845,38464,29371,23220,17328,10639,9560,128582,252850,440356,440356
Guyana,1953,GY,GUY,AMR,41825,56931,98756,38507,28967,23926,18624,10280,6454,126758,41050,56013,97063,39185,30176,23521,17604,10858,9546,130890,257648,453470,453470
Guyana,1954,GY,GUY,AMR,43615,59749,103364,39191,29839,24292,18922,10605,6522,129371,42645,59066,101711,39970,30986,23821,17856,11128,9615,133376,262747,467817,467817
Guyana,1955,GY,GUY,AMR,45708,62633,108341,40046,30690,24591,19217,11021,6626,132191,44512,62120,106632,40958,31767,24128,18092,11437,9758,136140,268331,483316,483316
Guyana,1956,GY,GUY,AMR,47897,65719,113616,41086,31475,24855,19542,11513,6791,135262,46565,65184,111749,42164,32511,24464,18341,11772,9965,139217,274479,499837,499837
Guyana,1957,GY,GUY,AMR,49843,69384,119227,42211,32155,25125,19919,12046,6989,138445,48450,68664,117114,43486,33211,24849,18608,12109,10222,142485,280930,517277,517277
Guyana,1958,GY,GUY,AMR,51565,73485,125050,43463,32702,25471,20368,12576,7233,141813,50192,72448,122640,44948,33880,25323,18911,12430,10522,146014,287827,535510,535510
Guyana,1959,GY,GUY,AMR,52959,77898,130857,44890,33126,25944,20871,13055,7495,145381,51677,76458,128135,46595,34529,25897,19241,12706,10854,149822,295203,554196,554196
Guyana,1960,GY,GUY,AMR,54213,81932,136145,46367,33549,26592,21339,13477,7786,149110,52979,80192,133171,48292,35096,26442,19499,12982,11241,153552,302662,571990,571990
Guyana,1961,GY,GUY,AMR,55420,85470,140890,48024,33965,27229,21664,13807,8058,152747,54213,83584,137797,50023,35629,26983,19752,13238,11543,157168,309915,588597,588597
Guyana,1962,GY,GUY,AMR,56494,88898,145392,49991,34335,27762,21854,14044,8299,156285,55329,86925,142254,51900,36185,27606,20075,13437,11693,160896,317181,604833,604833
Guyana,1963,GY,GUY,AMR,57449,92126,149575,52113,34722,28290,21997,14269,8575,159966,56291,90174,146465,53899,36715,28202,20375,13639,11865,164695,324661,620703,620703
Guyana,1964,GY,GUY,AMR,58263,95136,153399,54356,35103,28753,22097,14505,8875,163689,57114,93270,150384,55995,37201,28737,20645,13848,12063,168489,332178,635957,635957
Guyana,1965,GY,GUY,AMR,58996,97825,156821,56632,35433,29080,22172,14763,9219,167299,57841,96138,153979,58097,37609,29164,20882,14071,12293,172116,339415,650207,650207
Guyana,1966,GY,GUY,AMR,59640,100189,159829,58886,35694,29247,22233,15047,9577,170684,58459,98766,157225,60162,37916,29466,21093,14315,12550,175502,346186,663241,663241
Guyana,1967,GY,GUY,AMR,60170,102267,162437,61091,35900,29278,22304,15340,9952,173865,58964,101148,160112,62196,38138,29650,21287,14556,12824,178651,352516,675064,675064
Guyana,1968,GY,GUY,AMR,60552,104134,164686,63234,36086,29222,22406,15615,10327,176890,59322,103339,162661,64217,38320,29752,21468,14788,13106,181651,358541,685887,685887
Guyana,1969,GY,GUY,AMR,60791,105853,166644,65286,36300,29118,22563,15850,10680,179797,59546,105372,164918,66234,38509,29802,21651,14994,13373,184563,364360,695919,695919
Guyana,2031,GY,GUY,AMR,36559,77287,113846,74485,69659,57241,40013,34248,30815,306461,35541,75093,110634,70221,63576,59609,45287,40231,41895,320819,627280,851765,851765
Guyana,2032,GY,GUY,AMR,36126,76802,112928,74719,69170,59351,39979,34446,31756,309421,35124,74633,109757,70481,62430,60938,45195,40647,43412,323103,632524,855198,855198
Guyana,2033,GY,GUY,AMR,35703,76239,111942,74917,68689,61288,40152,34588,32660,312294,34717,74100,108817,70713,61421,61972,45303,40991,44915,325315,637609,858368,858368
Guyana,2034,GY,GUY,AMR,35280,75484,110764,75197,68272,62974,40592,34682,33532,315249,34310,73386,107696,71013,60599,62643,45660,41257,46402,327574,642823,861278,861278
Guyana,2035,GY,GUY,AMR,34854,74626,109480,75459,67973,64322,41347,34705,34370,318176,33897,72569,106466,71280,60011,62878,46332,41428,47865,329794,647970,863917,863917
Guyana,2036,GY,GUY,AMR,34453,73766,108219,75569,67843,65127,42584,34651,35174,320948,33508,71751,105259,71397,59693,62534,47452,41494,49289,331859,652807,866301,866301
Guyana,2037,GY,GUY,AMR,34084,72878,106962,75594,67886,65414,44248,34526,35961,323629,33150,70900,104050,71432,59636,61687,48928,41452,50688,333823,657452,868452,868452
Guyana,2038,GY,GUY,AMR,33725,72018,105743,75520,68048,65424,46101,34341,36713,326147,32802,70075,102877,71373,59742,60612,50527,41313,52053,335620,661767,870380,870380
Guyana,2039,GY,GUY,AMR,33391,71163,104554,75342,68262,65249,48104,34129,37447,328533,32474,69253,101727,71211,59943,59428,52189,41116,53402,337289,665822,872100,872100
Guyana,2040,GY,GUY,AMR,33101,70319,103420,75044,68517,64930,50193,33926,38172,330782,32192,68440,100632,70938,60201,58204,53823,40897,54749,338812,669594,873641,873641
Guyana,2041,GY,GUY,AMR,32841,69495,102336,74649,68776,64515,52283,33802,38864,332889,31938,67647,99585,70565,60483,57001,55336,40731,56070,340186,673075,874999,874999
Guyana,2042,GY,GUY,AMR,32601,68700,101301,74166,69017,64065,54282,33836,39504,334870,31704,66876,98580,70108,60750,55888,56636,40693,57330,341405,676275,876161,876161
Guyana,2043,GY,GUY,AMR,32378,67924,100302,73609,69223,63626,56118,34061,40085,336722,31487,66123,97610,69578,60986,54911,57651,40849,58528,342503,679225,877143,877143
Guyana,2044,GY,GUY,AMR,32165,67175,99340,72861,69508,63250,57719,34521,40607,338466,31278,65395,96673,68869,61291,54116,58314,41243,59645,343478,681944,877955,877955
Guyana,2045,GY,GUY,AMR,31951,66462,98413,72010,69773,62988,59002,35252,41047,340072,31061,64705,95766,68062,61564,53553,58555,41925,60662,344321,684393,878575,878575
Guyana,2046,GY,GUY,AMR,31713,65807,97520,71159,69896,62890,59785,36410,41424,341564,30828,64065,94893,67250,61691,53256,58236,43027,61561,345021,686585,878991,878991
Guyana,2047,GY,GUY,AMR,31462,65201,96663,70277,69932,62960,60078,37944,41724,342915,30581,63475,94056,66406,61731,53212,57433,44453,62330,345565,688480,879203,879203
Guyana,2048,GY,GUY,AMR,31206,64628,95834,69422,69872,63136,60117,39633,41972,344152,30329,62910,93239,65585,61677,53330,56410,45994,63014,346010,690162,879236,879236
Guyana,2049,GY,GUY,AMR,30941,64088,95029,68578,69703,63370,59987,41446,42195,345279,30066,62380,92446,64769,61523,53537,55285,47582,63641,346337,691616,879094,879094
Guyana,2050,GY,GUY,AMR,30655,63584,94239,67742,69428,63635,59725,43331,42442,346303,29787,61886,91673,63961,61257,53807,54117,49140,64248,346530,692833,878746,878746
"China, Hong Kong SAR",1970,HK,HKG,WPR,210195,535715,745910,385052,230377,265242,209832,122794,56312,1269609,197828,512170,709998,359055,187279,238062,194478,135516,115161,1229551,2499160,3955072,3955072
"China, Hong Kong SAR",1971,HK,HKG,WPR,199695,536452,736147,411302,234859,265387,215342,130607,60677,1318174,187527,512420,699947,384923,190421,236876,199402,141080,121627,1274329,2592503,4028605,4028605
"China, Hong Kong SAR",1972,HK,HKG,WPR,196657,535507,732164,441559,244951,266248,221813,138634,65390,1378595,184476,509203,693679,410897,198916,234530,204809,146718,128026,1323896,2702491,4128333,4128333
"China, Hong Kong SAR",1973,HK,HKG,WPR,197163,530170,727333,471510,259947,266656,228762,146528,70825,1444228,184792,501968,686760,435404,212462,231233,210394,152270,134674,1376437,2820665,4234754,4234754
"China, Hong Kong SAR",1974,HK,HKG,WPR,200607,520155,720762,498966,279971,266584,235785,154348,76978,1512632,187719,490817,678536,457684,230678,227406,215792,157701,141581,1430842,2943474,4342773,4342773
"China, Hong Kong SAR",1975,HK,HKG,WPR,205473,506862,712335,523667,304329,266038,242871,162420,84185,1583510,191594,477003,668597,478074,252498,223035,220758,163219,149201,1486785,3070295,4451220,4451220
"China, Hong Kong SAR",1976,HK,HKG,WPR,208727,493833,702560,546192,331718,265360,249699,170208,92489,1655666,193709,463760,657469,496913,276618,218486,225006,168569,157583,1543175,3198841,4558873,4558873
"China, Hong Kong SAR",1977,HK,HKG,WPR,209252,482066,691318,567247,361732,264878,256235,177194,101266,1728552,193229,452259,645488,514493,302747,214043,228716,173451,166098,1599548,3328100,4664903,4664903
"China, Hong Kong SAR",1978,HK,HKG,WPR,208177,470214,678391,586721,393943,264273,263776,183268,110057,1802038,191180,440827,632007,531085,330697,209812,232461,177982,174325,1656362,3458400,4768798,4768798
"China, Hong Kong SAR",1979,HK,HKG,WPR,207082,459821,666903,602271,427773,265688,270411,189152,119003,1874298,188949,430278,619227,545211,359310,207765,235214,182527,182293,1712320,3586618,4872752,4872752
"China, Hong Kong SAR",1980,HK,HKG,WPR,207334,451982,659316,611054,463386,269806,274965,195946,128849,1944006,188013,421166,609179,554464,388363,208471,236628,187319,190796,1766041,3710047,4978544,4978544
"China, Hong Kong SAR",1981,HK,HKG,WPR,209746,447064,656810,608775,494459,275600,278612,202930,138292,1998668,190437,414057,604494,556643,417721,213158,237833,192809,199602,1817766,3816434,5077742,5077742
"China, Hong Kong SAR",1982,HK,HKG,WPR,213271,444729,658000,597128,517270,284286,281571,209642,146238,2036135,195144,409537,604681,552522,445530,223757,239216,199147,207915,1868087,3904222,5166905,5166905
"China, Hong Kong SAR",1983,HK,HKG,WPR,215803,444112,659915,581391,537030,296709,284154,216571,153548,2069403,198649,407367,606016,543437,472068,238883,240871,205716,215818,1916793,3986196,5252127,5252127
"China, Hong Kong SAR",1984,HK,HKG,WPR,215915,446022,661937,563812,553802,313602,285891,222832,161300,2101239,198307,408259,606566,530829,497081,258078,242121,211969,223753,1963831,4065070,5333571,5333571
"China, Hong Kong SAR",1985,HK,HKG,WPR,213285,450259,663544,545344,568373,333539,285437,229192,170393,2132278,194264,411787,606051,515280,521013,281176,241404,217875,233061,2009809,4142087,5411680,5411680
"China, Hong Kong SAR",1986,HK,HKG,WPR,208456,453001,661457,529265,582987,356301,282684,236561,180235,2168033,189847,414786,604633,503339,544257,306550,238358,222983,243179,2058666,4226699,5492791,5492791
"China, Hong Kong SAR",1987,HK,HKG,WPR,202950,451791,654741,516805,597590,382365,279070,243736,190495,2210061,186058,415278,601336,498064,566519,333251,234231,227353,252977,2112395,4322456,5578533,5578533
"China, Hong Kong SAR",1988,HK,HKG,WPR,198932,448359,647291,505483,610957,408765,275000,252409,200671,2253285,183396,413836,597232,493301,587973,361265,229713,232840,262720,2167812,4421097,5665617,5665617
"China, Hong Kong SAR",1989,HK,HKG,WPR,196825,444384,641209,495161,620638,435263,273508,260018,210598,2295186,182807,410277,593084,488164,607105,390589,227193,237905,272281,2223237,4518423,5752708,5752708
"China, Hong Kong SAR",1990,HK,HKG,WPR,195772,440737,636509,485852,624926,463522,275343,264037,221612,2335292,182593,406889,589482,482826,621497,421984,227409,241015,282565,2277296,4612588,5838574,5838574
"China, Hong Kong SAR",1991,HK,HKG,WPR,195251,438077,633328,477717,622961,491166,280428,267600,233503,2373375,181585,405764,587349,477388,629837,453447,231065,243699,293964,2329400,4702775,5923447,5923447
"China, Hong Kong SAR",1992,HK,HKG,WPR,195194,435898,631092,469888,616385,516091,290700,271750,245143,2409957,180756,405355,586111,471104,635087,482340,240456,246071,305461,2380519,4790476,6007685,6007685
"China, Hong Kong SAR",1993,HK,HKG,WPR,193772,434637,628409,462208,606560,539446,305594,275603,256707,2446118,178051,405702,583753,462626,638747,510854,254907,247588,316806,2431528,4877646,6089808,6089808
"China, Hong Kong SAR",1994,HK,HKG,WPR,190293,433912,624205,456165,594588,558910,326021,277667,268928,2482279,173527,405457,578984,453645,640771,538635,274052,247734,328393,2483230,4965509,6168707,6168707
"China, Hong Kong SAR",1995,HK,HKG,WPR,185873,431612,617485,452483,580490,576318,349933,276912,283099,2519235,168674,402516,571190,445104,641099,565842,297298,244815,341795,2535953,5055188,6243859,6243859
"China, Hong Kong SAR",1996,HK,HKG,WPR,184587,428473,613060,453970,565118,594552,373203,274572,297511,2558926,167091,399224,566315,445338,638596,593499,322789,239826,355092,2595140,5154066,6333444,6333444
"China, Hong Kong SAR",1997,HK,HKG,WPR,185792,426944,612736,458970,549765,612734,396225,272459,310277,2600430,168285,398171,566456,455040,633128,621533,350327,235449,366138,2661615,5262045,6441236,6441236
"China, Hong Kong SAR",1998,HK,HKG,WPR,183111,427548,610659,462546,535207,629879,419715,270269,323858,2641474,166144,398623,564767,463973,625993,650069,380271,231336,377517,2729159,5370633,6546057,6546057
"China, Hong Kong SAR",1999,HK,HKG,WPR,174474,430705,605179,464120,523620,642225,443960,269737,337689,2681351,158540,401065,559605,469533,620852,675880,411274,229008,389285,2795832,5477183,6641965,6641965
"China, Hong Kong SAR",2000,HK,HKG,WPR,160939,435738,596677,465369,515350,647521,470860,270809,350834,2720743,145822,405678,551500,472857,619281,696442,443459,229311,400920,2862270,5583013,6731195,6731195
"China, Hong Kong SAR",2001,HK,HKG,WPR,149963,436734,586697,465582,507082,643447,497353,274038,363410,2750912,135884,406941,542825,475674,616500,707266,474898,233440,413325,2921103,5672015,6801542,6801542
"China, Hong Kong SAR",2002,HK,HKG,WPR,144856,431188,576044,463666,497075,631200,519917,282041,374780,2768679,131903,402272,534175,477904,611096,708406,503371,243259,425915,2969951,5738630,6848847,6848847
"China, Hong Kong SAR",2003,HK,HKG,WPR,141396,420806,562202,462524,487728,614270,540593,293700,385429,2784244,129299,392953,522252,480050,605765,706172,530578,257134,438052,3017751,5801995,6886457,6886457
"China, Hong Kong SAR",2004,HK,HKG,WPR,136308,407411,543719,462293,480776,594238,558694,309115,395124,2800240,125092,380973,506065,480873,601842,703387,555625,275054,449192,3065973,5866213,6915998,6915998
"China, Hong Kong SAR",2005,HK,HKG,WPR,127281,394733,522014,460828,476363,572783,573934,327497,403772,2815177,116884,370102,486986,478211,600381,699937,578312,296957,458892,3112690,5927867,6936874,6936874
"China, Hong Kong SAR",2006,HK,HKG,WPR,119650,382338,501988,458521,473237,552228,588302,346776,411525,2830589,109519,359137,468656,474887,601459,695351,599266,321364,467030,3159357,5989946,6960595,6960595
"China, Hong Kong SAR",2007,HK,HKG,WPR,121650,367166,488816,457091,469811,534121,601288,367677,418807,2848795,110976,344808,455784,473755,605367,688190,619453,347709,473582,3208056,6056851,7001456,7001456
"China, Hong Kong SAR",2008,HK,HKG,WPR,129332,349843,479175,455923,466202,517283,611677,389973,427005,2868063,117421,328496,445917,471325,611999,678052,640798,375124,480227,3257525,6125588,7050677,7050677
"China, Hong Kong SAR",2009,HK,HKG,WPR,135357,332371,467728,453866,464119,501427,617121,412829,436924,2886286,122301,312357,434658,465295,620787,668883,659322,402765,488867,3305919,6192205,7094595,7094595
"China, Hong Kong SAR",2010,HK,HKG,WPR,137135,316631,453766,451082,464231,487286,616121,436983,447935,2903638,124095,297478,421573,457409,631542,663185,671174,430517,499637,3353464,6257102,7132438,7132438
"China, Hong Kong SAR",2011,HK,HKG,WPR,139199,303500,442699,449111,464388,476656,609062,461582,460649,2921448,126331,284540,410871,451960,640044,661505,676007,457262,513567,3400345,6321793,7175364,7175364
"China, Hong Kong SAR",2012,HK,HKG,WPR,148279,292259,440538,447951,463025,470254,598050,484398,476591,2940269,134359,273795,408154,450186,642609,663255,675621,481859,531565,3445095,6385364,7234060,7234060
"China, Hong Kong SAR",2013,HK,HKG,WPR,157876,284810,442686,443044,463144,465700,584753,504863,495788,2957292,143488,267117,410605,445259,643510,665895,674162,504815,552599,3486240,6443532,7296827,7296827
"China, Hong Kong SAR",2014,HK,HKG,WPR,161690,282361,444051,432120,465974,462418,569037,523075,518219,2970843,148046,265472,413518,433410,645300,669455,673270,525671,576666,3523772,6494615,7352183,7352183
"China, Hong Kong SAR",2015,HK,HKG,WPR,159185,284358,443543,418452,468916,460704,551660,539245,543399,2982376,146401,268373,414774,418000,645512,675358,672899,543896,603485,3559150,6541526,7399838,7399838
"China, Hong Kong SAR",2016,HK,HKG,WPR,159111,288666,447777,402866,469832,460121,534699,554051,567571,2989140,146711,272645,419356,399116,634204,680898,673572,561693,630172,3579655,6568795,7435927,7435927
"China, Hong Kong SAR",2017,HK,HKG,WPR,164866,292992,457858,385384,468005,460077,519087,568350,589436,2990339,152270,275779,428049,377417,611705,685206,672245,582527,656172,3585272,6575611,7461519,7461519
"China, Hong Kong SAR",2018,HK,HKG,WPR,170129,296365,466494,367577,464955,459529,504290,581698,611840,2989889,157193,277732,434925,356093,587374,689150,667494,606480,683655,3590246,6580135,7481555,7481555
"China, Hong Kong SAR",2019,HK,HKG,WPR,173756,299702,473458,349099,462637,458720,490719,590798,636441,2988414,160767,279424,440191,335559,562871,691026,663221,628284,713096,3594057,6582471,7496122,7496122
"China, Hong Kong SAR",2020,HK,HKG,WPR,172829,303489,476318,330682,461016,459125,478877,593387,662778,2985865,160356,281714,442070,316113,539560,691289,661289,644019,744434,3596704,6582569,7500958,7500958
"China, Hong Kong SAR",2021,HK,HKG,WPR,161869,311582,473451,313549,459594,460164,469985,588775,691078,2983145,150384,288531,438915,298504,517742,690332,662072,652307,778099,3599056,6582201,7494578,7494578
"China, Hong Kong SAR",2022,HK,HKG,WPR,145569,322577,468146,300245,457972,460843,464529,578029,720605,2982223,135234,298326,433560,286461,498880,687250,665304,654474,812564,3604933,6587156,7488865,7488865
"China, Hong Kong SAR",2023,HK,HKG,WPR,132066,329559,461625,293379,452097,463248,460475,564184,751892,2985275,122713,304804,427517,281659,479847,682079,668533,655734,849345,3617197,6602472,7491609,7491609
"China, Hong Kong SAR",2024,HK,HKG,WPR,120443,333210,453653,291292,440178,467606,457557,548475,785511,2990619,111941,308459,420400,281091,457944,673756,671684,658206,889329,3632010,6622629,7496681,7496681
"China, Hong Kong SAR",2025,HK,HKG,WPR,112210,331906,444116,291867,426296,471269,456331,531444,819271,2996478,104313,307441,411754,282946,437107,660415,676071,661203,929710,3647452,6643930,7499791,7499791
"China, Hong Kong SAR",2026,HK,HKG,WPR,108502,323919,432421,295443,412045,473051,456436,515330,851138,3003443,100884,300279,401163,287194,419173,642981,681084,663779,969723,3663934,6667377,7500962,7500962
"China, Hong Kong SAR",2027,HK,HKG,WPR,106691,314033,420724,300790,396964,472696,457153,500963,880828,3009394,99209,291341,390550,292361,402442,623354,686606,663125,1011654,3679542,6688936,7500208,7500208
"China, Hong Kong SAR",2028,HK,HKG,WPR,104758,306174,410932,305016,381552,471225,457427,487430,909731,3012381,97412,284129,381541,295955,386107,602127,691860,659188,1057370,3692607,6704988,7497463,7497463
"China, Hong Kong SAR",2029,HK,HKG,WPR,102746,298626,401372,309080,365433,470586,457475,475096,936375,3014045,95547,277371,372918,298942,370507,580973,695171,655800,1102939,3704332,6718377,7492674,7492674
"China, Hong Kong SAR",2030,HK,HKG,WPR,100760,289995,390755,313497,349298,470746,458761,464387,959024,3015713,93705,269855,363560,302260,355849,561263,696997,654746,1144736,3715851,6731564,7485887,7485887
"China, Hong Kong SAR",1950,HK,HKG,WPR,162197,153394,315591,243678,216723,143794,63053,22840,12795,702883,144996,134374,279370,208201,185442,130467,80607,41569,36398,682684,1385567,1980524,1980524
"China, Hong Kong SAR",1951,HK,HKG,WPR,183166,158494,341660,242772,223685,152910,68644,25165,12765,725941,165065,137667,302732,207631,192375,137316,85361,45499,36987,705169,1431110,2075503,2075503
"China, Hong Kong SAR",1952,HK,HKG,WPR,199520,169582,369102,241245,230824,161900,74625,27825,12891,749310,180975,146437,327412,206512,199387,144164,90221,49805,37685,727774,1477084,2173597,2173597
"China, Hong Kong SAR",1953,HK,HKG,WPR,212321,185744,398065,239019,238064,170748,81041,30740,13258,772870,193810,160060,353870,204461,206409,151087,95250,54307,38691,750205,1523075,2275010,2275010
"China, Hong Kong SAR",1954,HK,HKG,WPR,217055,212341,429396,235902,245290,179271,87912,33827,13952,796154,199226,183930,383156,201098,213139,158035,100523,58821,40144,771760,1567914,2380472,2380472
"China, Hong Kong SAR",1955,HK,HKG,WPR,219448,243797,463245,231237,252326,187823,95550,37293,15034,819263,202428,213039,415467,196129,219249,165186,106180,63537,42228,792509,1611772,2490487,2490487
"China, Hong Kong SAR",1956,HK,HKG,WPR,228204,272161,500365,225349,259282,196107,103882,41073,16397,842090,211549,239779,451328,189889,224840,172391,112282,68323,44785,812510,1654600,2606293,2606293
"China, Hong Kong SAR",1957,HK,HKG,WPR,239468,301437,540905,218785,266374,203671,112921,45003,18018,864772,222766,267831,490597,182862,230065,179493,119079,72893,47799,832191,1696963,2728466,2728466
"China, Hong Kong SAR",1958,HK,HKG,WPR,252069,331251,583320,212489,273369,210989,122378,49022,19917,888164,234895,296700,531595,176233,234742,186806,126263,77275,51294,852613,1740777,2855692,2855692
"China, Hong Kong SAR",1959,HK,HKG,WPR,263641,361668,625309,208123,279162,218824,131600,53274,22118,913101,245880,326186,572066,171606,238330,194572,133076,81869,55124,874577,1787678,2985050,2985050
"China, Hong Kong SAR",1960,HK,HKG,WPR,272627,391933,664560,206736,283175,227256,140981,57994,24687,940829,254472,355623,610095,169905,240655,202524,139800,86795,59506,899185,1840014,3114671,3114671
"China, Hong Kong SAR",1961,HK,HKG,WPR,277937,418992,696929,209738,283710,234487,150046,62930,26978,967889,260098,382720,642818,172509,240749,209168,146237,91407,64053,924123,1892012,3231758,3231758
"China, Hong Kong SAR",1962,HK,HKG,WPR,279051,440755,719806,218381,280558,240010,158288,67950,28862,994049,262116,405847,667963,180742,238019,214413,152221,95520,68452,949367,1943416,3331188,3331188
"China, Hong Kong SAR",1963,HK,HKG,WPR,277103,458749,735852,232479,275345,245171,166210,73214,31011,1023430,261325,425747,687072,194576,233098,219462,158151,99582,73127,977996,2001426,3424353,3424353
"China, Hong Kong SAR",1964,HK,HKG,WPR,273591,474276,747867,250466,268429,250288,173653,78813,33664,1055313,259082,443023,702105,212854,226453,224224,163822,103841,78286,1009480,2064793,3514763,3514763
"China, Hong Kong SAR",1965,HK,HKG,WPR,268686,488170,756856,270966,259516,254900,180921,85240,37054,1088597,255146,458521,713667,234285,218134,228330,169420,108500,84237,1042906,2131503,3602029,3602029
"China, Hong Kong SAR",1966,HK,HKG,WPR,261022,501827,762849,292927,249941,258785,187802,92367,40824,1122646,248036,473616,721652,257689,209079,231799,174878,113598,90473,1077516,2200162,3684665,3684665
"China, Hong Kong SAR",1967,HK,HKG,WPR,251021,514849,765870,315518,241508,261905,193829,99821,44580,1157161,238322,487746,726068,282230,200655,234641,180009,119054,96492,1113081,2270242,3762177,3762177
"China, Hong Kong SAR",1968,HK,HKG,WPR,239452,525405,764857,338549,234866,264172,199457,107522,48356,1192922,226797,499342,726139,307566,193617,236763,185008,124640,102531,1150125,2343047,3834043,3834043
"China, Hong Kong SAR",1969,HK,HKG,WPR,225655,532624,758279,361959,230947,265335,204796,115170,52181,1230388,213049,507791,720840,333434,188852,238002,189830,130072,108686,1188876,2419264,3898387,3898387
"China, Hong Kong SAR",2031,HK,HKG,WPR,98685,275950,374635,322172,334336,471215,460714,456459,976850,3021746,91779,257067,348846,309914,342794,543295,697735,656351,1181570,3731659,6753405,7476879,7476879
"China, Hong Kong SAR",2032,HK,HKG,WPR,96502,258188,354690,333446,322095,470574,461887,451653,990749,3030404,89754,240586,330340,320089,332965,526447,695570,660059,1215019,3750149,6780553,7465577,7465577
"China, Hong Kong SAR",2033,HK,HKG,WPR,94358,242767,337125,340427,315255,464736,464328,447992,1002843,3035581,87762,226280,314042,326570,328178,507463,690469,663441,1249284,3765405,6800986,7452152,7452152
"China, Hong Kong SAR",2034,HK,HKG,WPR,92331,229141,321472,344079,313180,452876,468704,445394,1013592,3037825,85878,213650,299528,330225,327617,485616,682228,666734,1285461,3777881,6815706,7436708,7436708
"China, Hong Kong SAR",2035,HK,HKG,WPR,90550,218932,309482,342771,313767,439062,472401,444439,1023089,3035529,84223,204192,288415,329207,329473,464834,669000,671263,1322283,3786060,6821589,7419486,7419486
"China, Hong Kong SAR",2036,HK,HKG,WPR,89139,213154,302293,334794,317346,424883,474242,444773,1031511,3027549,82915,198839,281754,322056,333724,446940,651697,676407,1358040,3788864,6816413,7400466,7400466
"China, Hong Kong SAR",2037,HK,HKG,WPR,88189,209165,297354,324912,322691,409871,473963,445721,1039383,3016541,82027,195143,277170,313118,338890,430249,632211,682038,1392174,3788680,6805221,7379746,7379746
"China, Hong Kong SAR",2038,HK,HKG,WPR,87693,205094,292787,317062,326916,394532,472572,446252,1047141,3004475,81566,191357,272923,305907,342487,413954,611137,687412,1426363,3787260,6791735,7357445,7357445
"China, Hong Kong SAR",2039,HK,HKG,WPR,87625,201062,288687,309515,330977,378490,472007,446551,1053721,2991261,81502,187612,269114,299152,345475,398394,590140,690864,1460455,3784480,6775741,7333541,7333541
"China, Hong Kong SAR",2040,HK,HKG,WPR,87910,197295,285205,300888,335391,362438,472232,448016,1057896,2976861,81762,184119,265881,291641,348793,383775,570575,692826,1492579,3780189,6757050,7308138,7308138
"China, Hong Kong SAR",2041,HK,HKG,WPR,88468,193812,282280,286852,344058,347561,472752,450078,1060016,2961317,82276,180888,263164,278861,356447,370758,552738,693674,1521853,3774331,6735648,7281091,7281091
"China, Hong Kong SAR",2042,HK,HKG,WPR,89244,190683,279927,269103,355321,335394,472153,451367,1061319,2944657,82994,177976,260970,262385,366619,360959,536012,691634,1549266,3766875,6711532,7252429,7252429
"China, Hong Kong SAR",2043,HK,HKG,WPR,90251,188047,278298,253695,362298,328605,466404,453899,1061994,2926895,83929,175525,259454,248086,373096,356192,517149,686684,1576537,3757744,6684639,7222400,7222400
"China, Hong Kong SAR",2044,HK,HKG,WPR,91500,185952,277452,240085,365952,326565,454702,458335,1062414,2908053,85090,173582,258672,235459,376754,355645,495435,678648,1604969,3746910,6654963,7191087,7191087
"China, Hong Kong SAR",2045,HK,HKG,WPR,92845,184457,277302,229883,364651,327173,441067,462122,1063331,2888227,86337,172190,258527,226007,375743,357510,474773,665703,1634642,3734378,6622605,7158430,7158430
"China, Hong Kong SAR",2046,HK,HKG,WPR,94328,183611,277939,224108,356689,330765,427066,464105,1064631,2867364,87716,171399,259115,220660,368596,361766,456988,648718,1663314,3720042,6587406,7124458,7124458
"China, Hong Kong SAR",2047,HK,HKG,WPR,95894,183441,279335,220123,346820,336114,412235,464018,1066209,2845519,89170,171228,260398,216967,359668,366934,440392,629570,1690392,3703923,6549442,7089171,7089171
"China, Hong Kong SAR",2048,HK,HKG,WPR,97338,183953,281291,216056,338979,340334,397081,462847,1067614,2822911,90512,171703,262215,213182,352462,370531,424195,608872,1716933,3686175,6509086,7052591,7052591
"China, Hong Kong SAR",2049,HK,HKG,WPR,98515,185131,283646,212028,331444,344392,381237,462473,1068162,2799736,91606,172797,264403,209438,345715,373519,408734,588248,1741252,3666906,6466642,7014690,7014690
"China, Hong Kong SAR",2050,HK,HKG,WPR,99382,186760,286142,208265,322829,348799,365402,462858,1068049,2776202,92413,174309,266722,205946,338211,376839,394208,569036,1762068,3646308,6422510,6975391,6975391
Honduras,1970,HN,HND,AMR,268377,408673,677050,272698,160606,115946,78115,53308,38664,719337,259104,396878,655982,266692,156631,118425,82969,58361,47317,730395,1449732,2782753,2782753
Honduras,1971,HN,HND,AMR,276301,421258,697559,284794,164764,118482,80371,53909,39389,741709,266720,408890,675610,278665,160584,120325,85538,59184,48335,752631,1494340,2867501,2867501
Honduras,1972,HN,HND,AMR,285016,433968,718984,296798,169831,121264,82780,54294,40113,765080,275103,421038,696141,290544,165457,122380,88293,59773,49367,775814,1540894,2956021,2956021
Honduras,1973,HN,HND,AMR,294052,446850,740902,308460,175985,124103,85206,54583,40822,789159,283802,433329,717131,301940,171479,124438,91036,60251,50375,799519,1588678,3046715,3046715
Honduras,1974,HN,HND,AMR,302521,459563,762084,319914,183179,126681,87567,54995,41556,813892,291909,445445,737354,312812,178602,126180,93506,60797,51310,823207,1637099,3136539,3136539
Honduras,1975,HN,HND,AMR,311799,471960,783759,329975,192051,129434,90140,56033,43364,840997,300629,457810,758439,322900,186942,127817,95859,61805,53108,848431,1689428,3231631,3231631
Honduras,1976,HN,HND,AMR,322416,484923,807339,338617,202305,132528,92918,57681,46193,870242,310520,471113,781633,332466,196248,129582,98184,63304,55819,875603,1745845,3334814,3334814
Honduras,1977,HN,HND,AMR,332906,499110,832016,347121,212978,135637,95633,59593,48994,899956,320320,485371,805691,342116,206053,131373,100265,65083,58570,903460,1803416,3441122,3441122
Honduras,1978,HN,HND,AMR,343260,514384,857644,355517,223953,138946,98347,61736,51716,930215,330048,500440,830488,351835,216267,133355,102191,67114,61258,932020,1862235,3550368,3550368
Honduras,1979,HN,HND,AMR,353660,530556,884216,363901,235056,142723,101152,64022,54262,961116,339887,516149,856036,361691,226755,135761,104086,69317,63757,961367,1922483,3662736,3662736
Honduras,1980,HN,HND,AMR,363658,547822,911480,372393,246112,147176,104057,66419,56606,992763,349394,532754,882148,371755,237380,138764,105995,71643,66061,991598,1984361,3777990,3777990
Honduras,1981,HN,HND,AMR,373012,566297,939309,380978,256956,152322,107124,68962,58753,1025095,358280,550406,908686,381954,248041,142392,107951,74138,68166,1022642,2047737,3895736,3895736
Honduras,1982,HN,HND,AMR,381947,585597,967544,389647,267268,158349,110463,71606,60740,1058073,366766,568782,935548,392254,258476,146836,110055,76778,70086,1054485,2112558,4015647,4015647
Honduras,1983,HN,HND,AMR,390555,605391,995946,398696,276872,165453,113948,74273,62691,1091933,374939,587586,962525,402906,268426,152398,112215,79449,71989,1087383,2179316,4137784,4137784
Honduras,1984,HN,HND,AMR,398596,625607,1024203,408370,285957,173528,117299,76935,64821,1126910,382590,606728,989318,414081,277930,159093,114217,82017,74143,1121481,2248391,4261919,4261919
Honduras,1985,HN,HND,AMR,406086,646005,1052091,418802,294365,182709,120454,79579,67257,1163166,389711,626015,1015726,425828,286889,166966,116007,84403,76615,1156708,2319874,4387693,4387693
Honduras,1986,HN,HND,AMR,413399,666182,1079581,430201,302198,192762,123537,82216,69982,1200896,396655,645114,1041769,438331,295526,175720,117710,86617,79416,1193320,2394216,4515568,4515568
Honduras,1987,HN,HND,AMR,420697,685869,1106566,442726,309805,203209,126640,84825,72987,1240192,403585,663766,1067351,451761,304198,184950,119446,88658,82603,1231616,2471808,4645733,4645733
Honduras,1988,HN,HND,AMR,427734,706619,1134353,458205,316673,213295,129597,86998,74677,1279445,410431,682734,1093165,466812,313190,194485,121298,90424,84943,1271152,2550597,4778114,4778114
Honduras,1989,HN,HND,AMR,434938,728069,1163007,476788,323069,222816,132657,88813,74988,1319131,417565,701853,1119418,483414,322637,204241,123486,92033,86307,1312118,2631249,4913676,4913676
Honduras,1990,HN,HND,AMR,442980,748008,1190988,497000,329876,232183,136328,90721,75447,1361555,425340,719914,1145254,501119,332419,214188,126242,93674,87805,1355447,2717002,5053234,5053234
Honduras,1991,HN,HND,AMR,451738,766523,1218261,518899,337167,241266,140613,92793,76032,1406770,433643,736972,1170615,520076,342499,224243,129590,95388,89438,1401234,2808004,5196887,5196887
Honduras,1992,HN,HND,AMR,461280,784026,1245306,542033,345021,249778,145707,95113,76710,1454362,442615,753400,1196015,539948,352848,234178,133722,97244,91155,1449095,2903457,5344774,5344774
Honduras,1993,HN,HND,AMR,471518,800731,1272249,565916,353817,257561,151774,97579,77503,1504150,452267,769273,1221540,560380,363723,243751,138914,99158,92971,1498897,3003047,5496841,5496841
Honduras,1994,HN,HND,AMR,481963,816904,1298867,590364,363934,264845,158719,99952,78523,1556337,462202,784738,1246940,581253,375377,253029,145201,100940,94992,1550792,3107129,5652934,5652934
Honduras,1995,HN,HND,AMR,492123,832945,1325068,615042,375632,271550,166665,102200,79838,1610927,471904,800130,1272034,602388,387964,261989,152671,102565,97227,1604804,3215731,5812832,5812832
Honduras,1996,HN,HND,AMR,501922,849180,1351102,639404,389176,277843,175386,104441,81422,1667672,481206,815747,1296953,623395,401695,270864,161038,104157,99667,1660816,3328488,5976550,5976550
Honduras,1997,HN,HND,AMR,511338,865939,1377277,663027,404689,284130,184426,106759,83285,1726316,490044,831934,1321978,643930,416674,279963,169896,105791,102287,1718541,3444857,6144112,6144112
Honduras,1998,HN,HND,AMR,519264,882262,1401526,685544,421914,290427,193579,109206,85242,1785912,497300,847676,1344976,663627,432439,288980,178922,107423,104737,1776128,3562040,6308537,6308537
Honduras,1999,HN,HND,AMR,527265,899224,1426489,707056,440772,297030,202800,112071,87318,1847047,504569,863992,1368561,682779,449210,298323,188266,109447,107239,1835264,3682311,6477365,6477365
Honduras,2000,HN,HND,AMR,536266,917746,1454012,727405,461543,304265,212040,115611,89585,1910449,512852,881718,1394570,701331,467599,308431,198074,112198,110059,1897692,3808141,6656725,6656725
Honduras,2001,HN,HND,AMR,544295,936514,1480809,746368,484121,312074,221117,119799,91970,1975449,520226,899476,1419702,718920,487398,318938,208098,115589,112960,1961903,3937352,6837861,6837861
Honduras,2002,HN,HND,AMR,550830,955573,1506403,764351,508068,320557,229785,124846,94597,2042204,526123,917325,1443448,735890,508249,329822,218104,119792,115995,2027852,4070056,7019908,7019908
Honduras,2003,HN,HND,AMR,555262,975107,1530369,781604,532949,330103,237828,130819,97373,2110676,529950,935559,1465509,752329,529814,341343,227782,124985,119077,2095330,4206006,7201881,7201881
Honduras,2004,HN,HND,AMR,557077,995140,1552217,798324,558488,341021,245380,137555,100139,2180907,531290,954305,1485595,768398,551966,353730,237211,131219,122162,2164686,4345593,7383407,7383407
Honduras,2005,HN,HND,AMR,556894,1014778,1571672,814923,584352,353555,252398,145187,102953,2253368,530780,972702,1503482,784389,574469,367103,246347,138546,125237,2236091,4489459,7564613,7564613
Honduras,2006,HN,HND,AMR,555661,1033019,1588680,831720,609954,367933,259020,153512,105914,2328053,529347,989705,1519052,800545,596856,381606,255366,146681,128356,2309410,4637463,7745200,7745200
Honduras,2007,HN,HND,AMR,553747,1049291,1603038,848977,634800,384222,265605,162065,109057,2404726,527344,1004673,1532017,817206,618743,397328,264578,155226,131601,2384682,4789408,7924462,7924462
Honduras,2008,HN,HND,AMR,551403,1063131,1614534,866853,658734,402226,272261,170720,112446,2483240,525020,1017177,1542197,834464,640083,414114,273992,164094,135059,2461806,4945046,8101777,8101777
Honduras,2009,HN,HND,AMR,548776,1074537,1623313,885368,681566,421764,279198,179391,116214,2563501,522485,1027315,1549800,852290,660753,431825,283724,173237,138866,2540695,5104196,8277302,8277302
Honduras,2010,HN,HND,AMR,545863,1083807,1629670,904246,702818,442973,286616,187957,120452,2645062,519672,1035486,1555158,870364,680294,450731,293902,182595,143160,2621046,5266108,8450933,8450933
Honduras,2011,HN,HND,AMR,542732,1091014,1633746,923245,722532,465867,294555,196276,125182,2727657,516629,1041798,1558427,888377,698736,470970,304482,192105,148005,2702675,5430332,8622504,8622504
Honduras,2012,HN,HND,AMR,539594,1096017,1635611,942434,741095,490005,303097,204156,130603,2811390,513622,1046054,1559676,906414,716426,492209,315441,201592,153615,2785697,5597087,8792367,8792367
Honduras,2013,HN,HND,AMR,536637,1098462,1635099,962013,758712,514910,312594,211480,136795,2896504,510833,1047912,1558745,924783,733418,514069,327013,210848,160182,2870313,5766817,8960657,8960657
Honduras,2014,HN,HND,AMR,534140,1097989,1632129,982074,775679,540391,323353,218398,143586,2983481,508501,1047036,1555537,943634,749864,536394,339352,219860,167587,2956691,5940172,9127846,9127846
Honduras,2015,HN,HND,AMR,532453,1095214,1627667,1001750,792370,566069,335591,224821,151018,3071619,506991,1044028,1551019,962114,766065,558949,352573,228587,175906,3044194,6115813,9294505,9294505
Honduras,2016,HN,HND,AMR,531769,1091142,1622911,1019970,809052,591320,349523,230867,158991,3159723,506504,1039834,1546338,979173,782284,581282,366878,237235,184974,3131826,6291549,9460798,9460798
Honduras,2017,HN,HND,AMR,532156,1086325,1618481,1036190,826068,615717,365248,236874,167202,3247299,507065,1035033,1542098,994161,798878,603025,382347,246065,194480,3218956,6466255,9626842,9626842
Honduras,2018,HN,HND,AMR,533549,1081238,1614787,1049999,843665,639188,382630,242947,175623,3334052,508563,1030108,1538671,1006698,816044,624212,398865,255094,204430,3305343,6639395,9792850,9792850
Honduras,2019,HN,HND,AMR,535688,1076302,1611990,1061399,861896,661564,401477,249254,184211,3419801,510750,1025400,1536150,1016887,833782,644720,416288,264393,214815,3390885,6810686,9958829,9958829
Honduras,2020,HN,HND,AMR,538184,1071876,1610060,1070723,880561,682364,421772,255592,191904,3502916,513254,1021217,1534471,1025137,851789,664061,434709,273787,224831,3474314,6977230,10121763,10121763
Honduras,2021,HN,HND,AMR,540668,1068234,1608902,1077988,899343,701534,443317,261755,197859,3581796,515720,1017823,1533543,1031537,869732,682185,454095,282947,233611,3554107,7135903,10278345,10278345
Honduras,2022,HN,HND,AMR,543043,1065648,1608691,1083071,918348,719555,465935,268369,203388,3658666,518069,1015499,1533568,1035909,887720,699530,474321,292277,242180,3631937,7290603,10432860,10432860
Honduras,2023,HN,HND,AMR,544997,1064250,1609247,1085738,937945,736959,489787,276713,210978,3738120,520034,1014346,1534380,1037976,906201,716414,495559,302889,253008,3712047,7450167,10593798,10593798
Honduras,2024,HN,HND,AMR,546292,1064044,1610336,1085582,958134,753916,514569,286911,220342,3819454,521385,1014343,1535728,1037394,925265,732927,517563,314852,265894,3793895,7613349,10759406,10759406
Honduras,2025,HN,HND,AMR,547090,1064995,1612085,1083160,977984,770612,539532,298476,229742,3899506,522264,1015472,1537736,1034709,944015,749221,539799,327693,279211,3874648,7774154,10923967,10923967
Honduras,2026,HN,HND,AMR,547513,1066939,1614452,1079463,996497,787377,564129,311608,239202,3978276,522800,1017596,1540396,1030863,961448,765586,561846,341574,292984,3954301,7932577,11087423,11087423
Honduras,2027,HN,HND,AMR,547369,1069841,1617210,1075043,1013127,804542,587956,326404,248762,4055834,522780,1020655,1543435,1026435,976917,782399,583366,356591,307199,4032907,8088741,11249392,11249392
Honduras,2028,HN,HND,AMR,546844,1073320,1620164,1070343,1027428,822333,610922,342725,258503,4132254,522358,1024259,1546617,1021873,990011,799840,604378,372625,321889,4110616,8242870,11409647,11409647
Honduras,2029,HN,HND,AMR,546173,1076881,1623054,1065775,1039370,840782,632871,360405,268522,4207725,521774,1027936,1549710,1017513,1000795,817874,624758,389541,337096,4187577,8395302,11568061,11568061
Honduras,2030,HN,HND,AMR,545270,1080302,1625572,1061687,1049247,859650,653384,379585,278968,4282521,520951,1031457,1552408,1013658,1009647,836182,644065,407569,352898,4264019,8546540,11724522,11724522
Honduras,1950,HN,HND,AMR,144428,193499,337927,145269,100871,76926,55672,36779,29183,444700,138997,185742,324739,143676,101998,76637,57342,38403,32500,450556,895256,1557932,1557932
Honduras,1951,HN,HND,AMR,151801,198819,350620,149040,103944,77866,56563,37487,28915,453815,146578,190982,337560,146854,105452,77838,58196,39488,32398,460226,914041,1602228,1602228
Honduras,1952,HN,HND,AMR,158696,205048,363744,153110,107250,78523,57344,38155,28971,463353,153703,197124,350827,150240,109167,78770,58887,40572,32577,470213,933566,1648137,1648137
Honduras,1953,HN,HND,AMR,165070,212428,377498,157304,110645,79103,58117,38820,29223,473212,160217,204491,364708,153706,112961,79625,59554,41661,32945,480452,953664,1695870,1695870
Honduras,1954,HN,HND,AMR,171178,220878,392056,161222,114001,79873,59025,39521,29523,483165,166222,213113,379335,156980,116600,80688,60410,42742,33364,490784,973949,1745344,1745344
Honduras,1955,HN,HND,AMR,176882,230595,407477,164768,117248,80973,60091,40274,29820,493174,171679,223052,394731,160010,119973,82112,61485,43792,33777,501149,994323,1796527,1796527
Honduras,1956,HN,HND,AMR,182265,241345,423610,168085,120370,82377,61328,41074,30099,503333,176810,233958,410768,162922,123072,83849,62811,44832,34203,511689,1015022,1849391,1849391
Honduras,1957,HN,HND,AMR,187748,252652,440400,171280,123340,84089,62783,41925,30352,513769,182033,245353,427386,165821,125839,85896,64418,45859,34621,522454,1036223,1904009,1904009
Honduras,1958,HN,HND,AMR,193346,264439,457785,174556,126229,86079,64315,42787,30632,524598,187352,257161,444513,168902,128383,88231,66138,46837,35100,533591,1058189,1960492,1960492
Honduras,1959,HN,HND,AMR,199009,276586,475595,178211,129156,88282,65663,43603,31015,535930,192722,269273,461995,172417,130849,90785,67694,47727,35744,545216,1081146,2018738,2018738
Honduras,1960,HN,HND,AMR,204711,288962,493673,182472,132099,90645,66731,44370,31539,547856,198116,281580,479696,176546,133268,93496,68979,48540,36563,557392,1105248,2078617,2078617
Honduras,1961,HN,HND,AMR,210418,301449,511867,187351,135114,93219,67489,45075,32170,560418,203513,293961,497474,181304,135671,96416,69966,49246,37555,570158,1130576,2139928,2139928
Honduras,1962,HN,HND,AMR,216143,313787,529930,193090,138331,95962,67987,45705,32922,573997,208948,306184,515132,186906,138160,99516,70678,49819,38718,583797,1157794,2202854,2202854
Honduras,1963,HN,HND,AMR,221960,325829,547789,199945,141609,98741,68405,46336,33748,588784,214489,318010,532499,193683,140660,102631,71304,50385,39969,598632,1187416,2267708,2267708
Honduras,1964,HN,HND,AMR,227930,337755,565685,207848,144598,101458,68982,47068,34527,604481,220219,329477,549696,201694,142941,105583,72117,51112,41184,614631,1219112,2334492,2334492
Honduras,1965,HN,HND,AMR,234177,349397,583574,216979,147214,104059,69856,47926,35255,621289,226234,340523,566757,211002,144956,108274,73263,52023,42323,631841,1253130,2403465,2403465
Honduras,1966,HN,HND,AMR,240612,360859,601471,227147,149608,106547,71011,48930,35959,639202,232427,351390,583817,221268,146843,110693,74691,53142,43397,650034,1289236,2474523,2474523
Honduras,1967,HN,HND,AMR,247130,372483,619613,237889,151897,108893,72456,50109,36625,657869,238698,362421,601119,232051,148727,112802,76411,54509,44397,668897,1326766,2547497,2547497
Honduras,1968,HN,HND,AMR,253908,384276,638184,249133,154300,111185,74164,51355,37283,677420,245211,373628,618839,243287,150818,114708,78405,55975,45352,688545,1365965,2622982,2622982
Honduras,1969,HN,HND,AMR,261006,396316,657322,260776,157130,113539,76065,52452,37954,697916,252022,385091,637113,254871,153389,116571,80609,57287,46309,709036,1406952,2701381,2701381
Honduras,2031,HN,HND,AMR,543923,1083330,1627253,1058358,1057121,878718,672524,400283,289858,4356862,519679,1034593,1554272,1010566,1016664,854464,662347,426837,369271,4340149,8697011,11878542,11878542
Honduras,2032,HN,HND,AMR,542104,1085680,1627784,1056041,1062829,898043,690644,422072,301240,4430869,517946,1037054,1555000,1008509,1021627,872809,679923,447023,386197,4416088,8846957,12029728,12029728
Honduras,2033,HN,HND,AMR,539962,1087214,1627176,1054887,1066033,917811,707940,444559,313366,4504596,515907,1038714,1554621,1007583,1024207,891524,696861,467791,403888,4491854,8996450,12178241,12178241
Honduras,2034,HN,HND,AMR,537277,1087942,1625219,1054901,1066362,938068,724652,467554,326464,4578001,513331,1039587,1552918,1007781,1024079,910739,713298,489006,422507,4567410,9145411,12323556,12323556
Honduras,2035,HN,HND,AMR,534249,1087944,1622193,1056057,1064413,957967,741129,490733,340689,4650988,510420,1039746,1550166,1009098,1021814,929616,729522,510451,442140,4642641,9293629,12465996,12465996
Honduras,2036,HN,HND,AMR,531132,1087128,1618260,1058189,1061168,976530,757690,513598,356243,4723418,507427,1039112,1546539,1011389,1018351,947156,745821,531738,462958,4717413,9440831,12605632,12605632
Honduras,2037,HN,HND,AMR,528031,1085269,1613300,1061263,1057176,993211,774649,535791,373242,4795332,504457,1037454,1541911,1014609,1014280,962734,762559,552544,485051,4791777,9587109,12742317,12742317
Honduras,2038,HN,HND,AMR,525080,1082708,1607788,1064911,1052891,1007588,792225,557226,391611,4866452,501631,1035088,1536719,1018370,1010054,975946,779910,572875,508318,4865473,9731925,12876433,12876433
Honduras,2039,HN,HND,AMR,522297,1079457,1601754,1068641,1048732,1019653,810453,577750,411290,4936519,498975,1032021,1530996,1022201,1006027,986870,797847,592622,532693,4938260,9874779,13007530,13007530
Honduras,2040,HN,HND,AMR,519578,1075630,1595208,1072229,1045060,1029684,829092,597002,432527,5005594,496387,1028381,1524768,1025885,1002506,995883,816062,611374,558470,5010180,10015774,13135763,13135763
Honduras,2041,HN,HND,AMR,516949,1071276,1588225,1075443,1042142,1037752,847938,615064,455358,5073697,493880,1024211,1518091,1029188,999753,1003083,834260,629184,585751,5081219,10154916,13261233,13261233
Honduras,2042,HN,HND,AMR,514413,1066468,1580881,1077976,1040246,1043700,867042,632246,479427,5140637,491464,1019600,1511064,1031823,998041,1008265,852521,646350,614211,5151211,10291848,13383793,13383793
Honduras,2043,HN,HND,AMR,511923,1061488,1573411,1079706,1039501,1047189,886587,648727,504611,5206321,489081,1014830,1503911,1033661,997461,1011087,871153,662936,643747,5220045,10426366,13503682,13503682
Honduras,2044,HN,HND,AMR,509591,1056130,1565721,1080639,1039919,1047860,906624,664738,530921,5270701,486828,1009697,1496525,1034717,998006,1011242,890285,679072,674382,5287704,10558405,13620656,13620656
Honduras,2045,HN,HND,AMR,507408,1050501,1557909,1080846,1041474,1046302,926334,680607,558190,5333753,484700,1004292,1488992,1035063,999665,1009290,909093,695043,706009,5354163,10687916,13734814,13734814
Honduras,2046,HN,HND,AMR,505203,1044867,1550070,1080242,1044000,1043475,944759,696621,586152,5395249,482535,998884,1481419,1034614,1002298,1006158,926596,711110,738391,5419167,10814416,13845900,13845900
Honduras,2047,HN,HND,AMR,502812,1039339,1542151,1078596,1047458,1039912,961366,713059,614575,5454966,480182,993584,1473766,1033136,1005852,1002422,942178,727625,771313,5482526,10937492,13953405,13953405
Honduras,2048,HN,HND,AMR,500454,1034005,1534459,1076232,1051468,1036058,975750,730123,643325,5512956,477866,988459,1466325,1030933,1009924,998530,955443,744746,804689,5544265,11057221,14058003,14058003
Honduras,2049,HN,HND,AMR,498284,1028990,1527274,1073163,1055537,1032319,987892,747831,672235,5568977,475733,983631,1459364,1028012,1014046,994820,966459,762446,838351,5604134,11173111,14159746,14159746
Honduras,2050,HN,HND,AMR,496196,1024185,1520381,1069509,1059440,1029049,998062,765940,701171,5623171,473683,978985,1452668,1024499,1017988,991598,975602,780419,872192,5662298,11285469,14258514,14258514
Croatia,1970,HR,HRV,EUR,164005,359238,523243,387738,329673,346338,200103,201824,177407,1643083,159012,348431,507443,367498,311647,351067,264457,257330,266866,1818865,3461948,4492638,4492638
Croatia,1971,HR,HRV,EUR,161428,353873,515301,395470,323844,352413,213297,192518,183413,1660955,156336,343026,499362,374410,305063,351137,279374,247969,275707,1833660,3494615,4509275,4509275
Croatia,1972,HR,HRV,EUR,160644,348926,509570,398839,321450,355610,229432,181428,189598,1676357,155288,338215,493503,377645,301764,350439,296191,236114,284840,1846993,3523350,4526426,4526426
Croatia,1973,HR,HRV,EUR,161488,344090,505578,398415,322352,355783,245831,171596,195826,1689803,155881,333564,489445,377790,301568,348679,311288,225780,294211,1859316,3549119,4544133,4544133
Croatia,1974,HR,HRV,EUR,163357,338920,502277,395954,325673,353172,260656,165010,201810,1702275,157442,328669,486111,376337,303656,345396,322131,220081,303595,1871196,3573471,4561861,4561861
Croatia,1975,HR,HRV,EUR,165615,333490,499105,392959,330304,348433,273497,161841,207352,1714386,159467,323595,483062,374446,307153,340468,328762,219288,312760,1882877,3597263,4579428,4579428
Croatia,1976,HR,HRV,EUR,167246,329304,496550,390007,335328,342396,284755,160960,212317,1725763,161071,319554,480625,372717,311214,334443,332735,221553,321593,1894255,3620018,4597191,4597191
Croatia,1977,HR,HRV,EUR,168037,327102,495139,386127,341890,335415,295008,161174,216461,1736075,161882,317244,479126,370181,316859,327698,335492,225159,329989,1905378,3641453,4615729,4615729
Croatia,1978,HR,HRV,EUR,168656,326269,494925,380914,351298,327011,304535,162550,219346,1745654,162466,316335,478801,366316,325222,319776,337734,229834,337505,1916387,3662041,4635773,4635773
Croatia,1979,HR,HRV,EUR,169248,326226,495474,375064,363471,317182,313138,166351,219965,1755171,163075,316175,479250,361830,336228,310638,339372,236778,342776,1927622,3682793,4657517,4657517
Croatia,1980,HR,HRV,EUR,169788,325956,495744,369626,376826,307777,320290,173869,217147,1765535,163651,315708,479359,357606,348820,301730,340207,247887,343267,1939517,3705052,4680144,4680144
Croatia,1981,HR,HRV,EUR,170368,325566,495934,365295,386964,302577,325657,185438,210952,1776883,164121,315115,479236,354246,358997,296355,340539,263509,338267,1951913,3728796,4703980,4703980
Croatia,1982,HR,HRV,EUR,170665,326399,497064,361599,392490,302309,328957,199534,203319,1788208,164232,315810,480042,351095,365388,295226,340638,280661,330398,1963406,3751614,4728725,4728725
Croatia,1983,HR,HRV,EUR,170244,328798,499042,358012,395236,305112,329694,213504,196410,1797968,163725,318115,481840,347763,369541,296813,339882,295301,323744,1973044,3771012,4751890,4751890
Croatia,1984,HR,HRV,EUR,169197,332173,501370,353861,396170,310694,328283,226048,192721,1807777,162685,321322,484007,343923,372120,300860,337785,305195,323323,1983206,3790983,4776362,4776362
Croatia,1985,HR,HRV,EUR,167513,335898,503411,349294,396266,317928,325349,237384,192864,1819085,161066,324880,485946,339684,373930,306532,333881,311426,329421,1994874,3813959,4803325,4803325
Croatia,1986,HR,HRV,EUR,165024,338674,503698,345857,396580,324823,321467,247739,194963,1831429,158704,327544,486248,336310,376147,311986,328873,315756,338238,2007310,3838739,4828684,4828684
Croatia,1987,HR,HRV,EUR,161890,339874,501764,344091,395104,333001,317023,257191,197597,1844007,155733,328656,484389,334360,376644,318773,323556,318930,347548,2019811,3863818,4849962,4849962
Croatia,1988,HR,HRV,EUR,158311,340067,498378,343117,391122,343750,310741,266055,200427,1855212,152287,328709,480996,333380,374695,327986,316684,321610,356887,2031242,3886454,4865828,4865828
Croatia,1989,HR,HRV,EUR,154024,339349,493373,342400,385266,356847,301960,273998,203769,1864240,148142,327950,476092,332594,371205,339464,307693,323435,366087,2040478,3904718,4874182,4874182
Croatia,1990,HR,HRV,EUR,149673,337409,487082,340519,378561,371079,291988,280175,207775,1870097,143966,326137,470103,330400,366691,353064,297382,323954,374928,2046419,3916516,4873707,4873707
Croatia,1991,HR,HRV,EUR,145257,333752,479009,334008,368924,378411,285784,283852,211407,1862386,139402,322507,461909,323637,358871,361004,290588,323734,383382,2041216,3903602,4844522,4844522
Croatia,1992,HR,HRV,EUR,139594,328880,468474,326548,357152,378964,284354,285629,215942,1848589,133376,317612,450988,315942,348258,362731,288230,323633,391479,2030273,3878862,4798321,4798321
Croatia,1993,HR,HRV,EUR,134757,324079,458836,327312,351353,380490,286298,286230,223535,1855218,128280,312783,441063,316891,343003,365322,288826,323145,400104,2037291,3892509,4792403,4792403
Croatia,1994,HR,HRV,EUR,132234,318995,451229,333831,349536,382405,292156,285569,233087,1876584,125610,307756,433366,323842,341793,368149,292985,321600,409881,2058250,3934834,4819426,4819426
Croatia,1995,HR,HRV,EUR,130107,312377,442484,334612,340872,380047,298146,282827,242772,1879276,123368,301251,424619,324429,333797,367086,297686,317393,420332,2060723,3939999,4807100,4807100
Croatia,1996,HR,HRV,EUR,129806,303951,433757,331151,329611,374284,299796,277362,250779,1862983,123149,292917,416066,320766,323298,363582,299192,310720,428269,2045827,3908810,4758628,4758628
Croatia,1997,HR,HRV,EUR,131525,294353,425878,328863,322853,366135,300377,270475,256824,1845527,125265,283588,408853,318611,317377,358205,300241,303535,433151,2031120,3876647,4711373,4711373
Croatia,1998,HR,HRV,EUR,132051,285147,417198,326076,317429,356083,303133,261967,261833,1826521,126260,274784,401044,315766,312885,350903,303331,295081,437200,2015166,3841687,4659932,4659932
Croatia,1999,HR,HRV,EUR,130630,277186,407816,323023,313002,345444,307577,251250,266014,1806310,125150,267460,392610,312651,309261,343270,307983,284850,440583,1998598,3804908,4605329,4605329
Croatia,2000,HR,HRV,EUR,127425,270854,398279,319175,308699,335052,313628,239248,269101,1784903,122121,261844,383965,308996,305228,335679,314828,273408,443148,1981287,3766190,4548434,4548434
Croatia,2001,HR,HRV,EUR,122839,266775,389614,315123,304410,327831,319001,231640,273658,1771663,117779,258027,375806,305017,300790,330057,320840,265504,447473,1969681,3741344,4506759,4506759
Croatia,2002,HR,HRV,EUR,117782,263834,381616,311252,301583,323000,322522,229905,279858,1768120,112942,255048,367990,301142,297459,325739,324456,262670,453675,1965141,3733261,4482868,4482868
Croatia,2003,HR,HRV,EUR,113354,260424,373778,306887,300832,318197,324773,230169,284877,1765735,108612,251735,360347,296912,295882,321212,326730,261874,458669,1961279,3727014,4461139,4461139
Croatia,2004,HR,HRV,EUR,110274,256533,366807,301742,301860,312821,326034,232616,289579,1764652,105506,248021,353527,291940,295785,315975,327976,263123,463565,1958364,3723016,4443350,4443350
Croatia,2005,HR,HRV,EUR,108798,252342,361140,295958,304049,307294,326089,236752,294301,1764443,104009,243864,347873,286489,296781,310178,328441,265900,468442,1956231,3720674,4429681,4429681
Croatia,2006,HR,HRV,EUR,108340,247552,355892,290420,305877,302628,326207,241107,298557,1764796,103526,239172,342698,281074,297554,304748,329592,268530,472667,1954165,3718961,4417560,4417560
Croatia,2007,HR,HRV,EUR,108420,242702,351122,284719,306748,299260,325464,246463,302259,1764913,103480,234578,338058,275355,297388,300302,329959,272024,476411,1951439,3716352,4405532,4405532
Croatia,2008,HR,HRV,EUR,109378,238276,347654,278316,307427,296597,323152,253798,304586,1763876,104337,230232,334569,269111,296862,296711,328449,277629,478798,1947560,3711436,4393664,4393664
Croatia,2009,HR,HRV,EUR,110738,234070,344808,271921,307881,294478,319557,263508,305254,1762599,105707,225639,331346,262985,296273,293661,325797,285588,479074,1943378,3705977,4382130,4382130
Croatia,2010,HR,HRV,EUR,111343,229937,341280,266606,307345,292264,315388,275417,304443,1761463,106307,221077,327384,257606,295128,290104,322481,296299,476943,1938561,3700024,4368682,4368682
Croatia,2011,HR,HRV,EUR,110997,225054,336051,263203,305351,289573,311825,284859,305728,1760539,105972,216053,322025,253372,292637,286011,319182,304963,477058,1933223,3693762,4351842,4351842
Croatia,2012,HR,HRV,EUR,110430,219722,330152,260638,302160,287519,308284,290021,310042,1758664,105303,210581,315884,249773,288929,282570,315427,309306,480881,1926886,3685550,4331595,4331595
Croatia,2013,HR,HRV,EUR,109090,215547,324637,257537,298112,286836,304105,293573,315137,1755300,103679,206227,309906,245845,284384,280270,310840,311992,485686,1919017,3674317,4308854,4308854
Croatia,2014,HR,HRV,EUR,106610,212914,319524,253988,292993,287423,298902,295845,321535,1750686,100958,203441,304399,241531,278731,279125,305084,313444,491452,1909367,3660053,4283972,4283972
Croatia,2015,HR,HRV,EUR,103575,211115,314690,250155,286883,288971,293079,296452,328335,1743875,97822,201528,299350,236831,272265,279028,298242,313809,496725,1896900,3640775,4254815,4254815
Croatia,2016,HR,HRV,EUR,100824,209623,310447,245395,280900,290226,287797,296541,334580,1735439,95160,199827,294987,231422,265681,278902,291401,314534,500931,1882871,3618310,4223751,4223751
Croatia,2017,HR,HRV,EUR,98368,208790,307158,240189,274911,290382,283704,295618,341205,1726009,92958,198513,291471,225984,258687,277961,285476,314479,505238,1867825,3593834,4192467,4192467
Croatia,2018,HR,HRV,EUR,96301,208229,304530,235167,268624,290067,280408,293144,348190,1715600,91187,197297,288484,220760,251487,276561,280548,312349,510169,1851874,3567474,4160485,4160485
Croatia,2019,HR,HRV,EUR,94895,207202,302097,230228,262377,289681,277787,289486,355841,1705400,89966,195882,285848,215293,244672,275135,276426,309108,515772,1836406,3541806,4129752,4129752
Croatia,2020,HR,HRV,EUR,93755,205127,298882,225583,257049,288731,275200,285227,362983,1694773,88967,193609,282576,210206,238626,273470,272262,305327,520749,1820640,3515413,4096869,4096869
Croatia,2021,HR,HRV,EUR,92631,202461,295092,220299,253957,286605,272402,281305,367188,1681756,87858,191052,278910,205026,234205,270790,268045,301449,524863,1804378,3486134,4060135,4060135
Croatia,2022,HR,HRV,EUR,91338,200465,291803,214370,252454,284052,270736,277965,371657,1671234,86515,189301,275816,199822,231776,267780,265149,297613,529359,1791499,3462733,4030358,4030358
Croatia,2023,HR,HRV,EUR,89823,198559,288382,209601,250803,281461,270726,274788,377905,1665284,85076,187428,272504,195997,230023,264912,263871,293607,534038,1782448,3447732,4008617,4008617
Croatia,2024,HR,HRV,EUR,88120,196030,284150,206643,248461,277984,271926,270943,384020,1659977,83430,184878,268308,193876,227746,261263,263776,288910,538624,1774195,3434172,3986627,3986627
Croatia,2025,HR,HRV,EUR,86602,193042,279644,204828,245626,273532,274297,266554,389938,1654775,81879,181967,263846,192864,224947,256888,264949,283212,543260,1766120,3420895,3964392,3964392
Croatia,2026,HR,HRV,EUR,85334,190160,275494,203673,241520,269186,276713,262589,395399,1649080,80577,179295,259872,192209,221321,252389,266454,277379,547765,1757517,3406597,3941961,3941961
Croatia,2027,HR,HRV,EUR,84261,187171,271432,203440,236633,264834,278164,259738,400327,1643136,79527,176655,256182,192000,217473,247459,267311,272478,551846,1748567,3391703,3919328,3919328
Croatia,2028,HR,HRV,EUR,83255,184145,267400,203626,231685,260252,279058,257703,404686,1637010,78573,174104,252677,191872,213624,242379,267647,268692,555172,1739386,3376396,3896470,3896470
Croatia,2029,HR,HRV,EUR,82259,181494,263753,203430,226597,255661,279815,256313,408524,1630340,77627,171792,249419,191559,209275,237654,267875,265761,557773,1729897,3360237,3873407,3873407
Croatia,2030,HR,HRV,EUR,81278,179212,260490,202215,221742,251701,280093,254976,412423,1623150,76694,169705,246399,190399,205154,233476,267831,262815,560430,1720105,3343255,3850140,3850140
Croatia,1950,HR,HRV,EUR,198356,322975,521331,363228,225445,248731,227618,124934,127861,1317817,194367,315572,509939,360097,285063,282952,249514,163477,174500,1515603,2833420,3864691,3864691
Croatia,1951,HR,HRV,EUR,204235,320496,524731,368077,238598,237066,232027,127215,125280,1328263,200112,314865,514977,361629,299400,273985,255640,166408,175291,1532353,2860616,3900322,3900322
Croatia,1952,HR,HRV,EUR,206936,320841,527777,370840,255340,223665,235954,130735,123323,1339857,202687,316600,519287,362519,315834,262507,261511,169848,176636,1548855,2888712,3935773,3935773
Croatia,1953,HR,HRV,EUR,207282,324538,531820,371380,272804,211360,239225,135522,121986,1352277,202963,321293,524256,362359,331012,252075,266875,174279,178499,1565099,2917376,3973455,3973455
Croatia,1954,HR,HRV,EUR,206187,330672,536859,369616,288926,202234,241450,141452,121047,1364725,201827,328103,529930,360639,342599,245386,271351,180009,180367,1580351,2945076,4011865,4011865
Croatia,1955,HR,HRV,EUR,205162,337474,542636,365956,302994,196693,242500,148245,120253,1376641,200628,335399,536027,357387,350197,242965,274913,186916,181974,1594352,2970993,4049659,4049659
Croatia,1956,HR,HRV,EUR,204483,343953,548436,360964,315255,194103,242630,155565,119559,1388076,199730,342049,541779,352978,354542,243960,277830,194644,183392,1607346,2995422,4085640,4085640
Croatia,1957,HR,HRV,EUR,202817,351137,553954,354895,326399,193598,242062,162952,119220,1399126,197986,348913,546899,347565,356953,247123,280333,202441,184964,1619379,3018505,4119357,4119357
Croatia,1958,HR,HRV,EUR,199415,360084,559499,347924,336587,195255,240437,169974,119663,1409840,194659,357132,551791,341133,358391,252104,281848,209676,187250,1630402,3040242,4151529,4151529
Croatia,1959,HR,HRV,EUR,195107,370106,565213,340640,345630,200235,236561,176494,121033,1420593,190521,366289,556810,334122,359181,259839,280630,216471,190427,1640670,3061263,4183291,4183291
Croatia,1960,HR,HRV,EUR,190594,379630,570224,334326,353354,209568,229471,182602,123280,1432601,186210,374978,561188,327705,359507,271232,275321,223136,194410,1651311,3083912,4215324,4215324
Croatia,1961,HR,HRV,EUR,186524,386803,573327,330344,359469,223566,219122,188418,126406,1447325,182156,381350,563506,323129,359439,286389,265819,229774,199147,1663697,3111022,4247852,4247852
Croatia,1962,HR,HRV,EUR,183287,390217,573504,329628,363581,240828,207145,193879,130327,1465388,178696,384000,562696,321387,358841,303407,254071,236336,204450,1678492,3143880,4280073,4280073
Croatia,1963,HR,HRV,EUR,180664,389740,570404,332232,365420,258642,196462,198787,135006,1486549,175756,382876,558632,322657,357338,318792,243794,242487,210391,1695459,3182008,4311042,4311042
Croatia,1964,HR,HRV,EUR,178232,387049,565281,337044,364887,275332,189011,202839,140457,1509570,172982,379684,552666,325943,354429,330425,237602,247840,217281,1713520,3223090,4341043,4341043
Croatia,1965,HR,HRV,EUR,176104,383765,559869,342860,362401,290281,185120,205926,146561,1533149,170584,375829,546413,330270,350029,338163,235926,252370,225189,1731947,3265096,4371381,4371381
Croatia,1966,HR,HRV,EUR,174375,380404,554779,349118,358458,303661,183979,208201,153066,1556483,168772,371775,540547,335027,344427,342957,237617,256282,233647,1749957,3306440,4401775,4401775
Croatia,1967,HR,HRV,EUR,172449,376338,548787,356592,353065,316102,184410,209674,159485,1579328,166923,367062,533985,340872,337663,346199,241115,259790,242059,1767698,3347026,4429801,4429801
Croatia,1968,HR,HRV,EUR,170076,371110,541186,366132,346034,327614,186407,209875,165581,1601643,164693,361227,525920,348746,329537,348593,246026,262320,250171,1785393,3387036,4454141,4454141
Croatia,1969,HR,HRV,EUR,167260,365180,532440,377101,337749,337858,191245,207599,171509,1623061,162091,354730,516821,358148,320424,350222,253411,262035,258321,1802561,3425622,4474891,4474891
Croatia,2031,HR,HRV,EUR,80296,177163,257459,200323,216272,249681,279244,253525,416512,1615557,75763,167667,243430,188812,200795,230621,266699,259826,563439,1710192,3325749,3826638,3826638
Croatia,2032,HR,HRV,EUR,79316,174970,254286,198679,210272,248682,277379,252780,420137,1607929,74834,165442,240276,187494,195960,228904,264456,257636,565897,1700347,3308276,3802838,3802838
Croatia,2033,HR,HRV,EUR,78315,172459,250774,196780,205531,247073,274921,253176,422946,1600427,73888,163055,236943,185623,192145,227167,261642,256550,567391,1690518,3290945,3778659,3778659
Croatia,2034,HR,HRV,EUR,77325,169766,247091,194260,202597,244771,271595,254675,425023,1592921,72953,160469,233422,183074,190031,224908,258056,256605,568047,1680721,3273642,3754157,3754157
Croatia,2035,HR,HRV,EUR,76374,167272,243646,191282,200803,241975,267321,257249,426411,1585041,72056,157989,230045,180167,189027,222126,253755,257878,567683,1670636,3255677,3729368,3729368
Croatia,2036,HR,HRV,EUR,75445,165025,240470,188408,199663,237921,263156,259847,427738,1576733,71178,155759,226937,177499,188378,218516,249329,259460,566914,1660096,3236829,3704237,3704237
Croatia,2037,HR,HRV,EUR,74604,162977,237581,185427,199444,233079,258980,261531,429563,1568024,70385,153785,224170,174865,188170,214689,244469,260411,566450,1649054,3217078,3678832,3678832
Croatia,2038,HR,HRV,EUR,73882,160976,234858,182406,199635,228176,254578,262676,431567,1559038,69701,151889,221590,172313,188045,210855,239467,260848,566134,1637662,3196700,3653156,3653156
Croatia,2039,HR,HRV,EUR,73216,158997,232213,179765,199452,223129,250166,263688,433668,1549868,69071,150012,219083,170007,187738,206522,234816,261179,565756,1626018,3175886,3627181,3627181
Croatia,2040,HR,HRV,EUR,72611,157065,229676,177489,198255,218322,246381,264234,435836,1540517,68500,148185,216685,167927,186583,202420,230708,261232,565245,1614115,3154632,3600992,3600992
Croatia,2041,HR,HRV,EUR,72064,155160,227224,175446,196378,212910,244494,263682,438090,1531000,67988,146379,214367,165891,184996,198082,227914,260217,564865,1601965,3132965,3574556,3574556
Croatia,2042,HR,HRV,EUR,71541,153345,224886,173260,194747,206966,243610,262155,440595,1521333,67493,144659,212152,163666,183684,193271,226248,258106,564602,1589577,3110910,3547938,3547938
Croatia,2043,HR,HRV,EUR,71081,151625,222706,170752,192863,202277,242118,260070,443430,1511510,67058,143032,210090,161282,181819,189471,224556,255437,564388,1576953,3088463,3521261,3521261
Croatia,2044,HR,HRV,EUR,70670,149972,220642,168063,190360,199386,239930,257159,446654,1501552,66666,141473,208139,158701,179276,187378,222342,252013,564433,1564143,3065695,3494484,3494484
Croatia,2045,HR,HRV,EUR,70275,148421,218696,165576,187398,197623,237241,253357,450302,1491497,66292,140006,206298,156222,176377,186387,219605,247888,564697,1551176,3042673,3467671,3467671
Croatia,2046,HR,HRV,EUR,69923,146947,216870,163333,184538,196511,233299,249663,453987,1481331,65957,138614,204571,153997,173714,185746,216042,243643,564958,1538100,3019431,3440872,3440872
Croatia,2047,HR,HRV,EUR,69535,145585,215120,161294,181571,196310,228578,245946,457376,1471075,65589,137329,202918,152023,171082,185547,212259,238979,565043,1524933,2996008,3414044,3414044
Croatia,2048,HR,HRV,EUR,69041,144409,213450,159297,178566,196521,223782,241995,460534,1460695,65122,136215,201337,150128,168539,185427,208465,234159,564949,1511667,2972362,3387150,3387150
Croatia,2049,HR,HRV,EUR,68521,143338,211859,157320,175938,196351,218843,238043,463735,1450230,64629,135197,199826,148255,166238,185126,204176,229695,564887,1498377,2948607,3360287,3360287
Croatia,2050,HR,HRV,EUR,67935,142335,210270,155393,173676,195169,214149,234683,466651,1439721,64079,134252,198331,146428,164155,183976,200121,225769,564652,1485101,2924822,3333425,3333425
Haiti,1970,HT,HTI,AMR,363493,586945,950438,436889,326196,219170,161464,115778,76094,1335591,363827,593664,957491,443304,325398,234622,188426,142028,103521,1437299,2772890,4680812,4680812
Haiti,1971,HT,HTI,AMR,368589,598015,966604,446592,331900,225012,162588,117339,78746,1362177,368743,604245,972988,454156,330446,238851,189595,144223,107373,1464644,2826821,4766423,4766423
Haiti,1972,HT,HTI,AMR,373793,608951,982744,457259,336656,231624,163741,118813,81312,1389405,373742,614720,988462,465852,334721,243771,190664,146279,111219,1492506,2881911,4853117,4853117
Haiti,1973,HT,HTI,AMR,379060,619718,998778,469671,339903,238703,165024,120175,83789,1417265,378771,625035,1003806,479186,337629,249133,191715,148183,115009,1520855,2938120,4940710,4940710
Haiti,1974,HT,HTI,AMR,385128,630222,1015350,482886,343033,245726,166627,121400,86211,1445883,384566,635083,1019649,492422,341317,254513,192889,149908,118717,1549766,2995649,5030652,5030652
Haiti,1975,HT,HTI,AMR,392724,640745,1033469,495339,347552,252395,168678,122488,88585,1475037,391852,645158,1037010,504038,347263,259657,194295,151466,122329,1579048,3054085,5124560,5124560
Haiti,1976,HT,HTI,AMR,401836,651334,1053170,507379,352994,258748,171165,123470,90897,1504653,400628,655282,1055910,515236,354107,264629,195938,152879,125822,1608611,3113264,5222342,5222342
Haiti,1977,HT,HTI,AMR,412454,661927,1074381,519135,359109,264883,174085,124362,93145,1534719,410931,665361,1076292,526192,361554,269540,197803,154165,129181,1638435,3173154,5323827,5323827
Haiti,1978,HT,HTI,AMR,424423,672498,1096921,530545,365857,270834,177470,125182,95293,1565181,422631,675378,1098009,536863,369574,274426,199981,155324,132392,1668560,3233741,5428667,5428667
Haiti,1979,HT,HTI,AMR,437022,683562,1120584,541775,373113,276545,181395,125961,97295,1596084,435013,685824,1120837,547373,378002,279177,202598,156329,135427,1698906,3294990,5536423,5536423
Haiti,1980,HT,HTI,AMR,449525,696025,1145550,552581,380917,281955,185841,126755,99163,1627212,447341,697557,1144898,557420,386815,283686,205642,157191,138255,1729009,3356221,5646676,5646676
Haiti,1981,HT,HTI,AMR,461962,710200,1172162,562836,389441,286857,190877,127572,100917,1658500,459674,710926,1170600,566914,396176,287808,209198,157939,140897,1758932,3417432,5760197,5760197
Haiti,1982,HT,HTI,AMR,474523,726042,1200565,572927,398775,290815,196568,128404,102531,1690020,472177,725925,1198102,576267,406214,291154,213356,158609,143390,1788990,3479010,5877684,5877684
Haiti,1983,HT,HTI,AMR,486735,743332,1230067,582827,409643,293313,202645,129352,104038,1721818,484348,742394,1226742,585431,417664,293158,217883,159266,145706,1819108,3540926,5997739,5997739
Haiti,1984,HT,HTI,AMR,498340,761966,1260306,592497,421209,295669,208664,130577,105451,1754067,495897,760235,1256132,594353,428948,295849,222401,160033,147847,1849431,3603498,6119932,6119932
Haiti,1985,HT,HTI,AMR,509853,781893,1291746,602214,432003,299272,214334,132173,106765,1786761,507326,779460,1286786,603368,438666,300622,226703,161033,149853,1880245,3667006,6245539,6245539
Haiti,1986,HT,HTI,AMR,521324,803199,1324523,612015,442360,303689,219694,134134,107984,1819876,518674,800224,1318898,612550,448029,306251,230871,162297,151795,1911793,3731669,6375097,6375097
Haiti,1987,HT,HTI,AMR,532401,826102,1358503,621885,452489,308750,224870,136463,109162,1853619,529584,822693,1352277,621794,457242,312480,235006,163789,153630,1943941,3797560,6508349,6508349
Haiti,1988,HT,HTI,AMR,543341,850110,1393451,631840,462403,314457,229935,139218,110323,1888176,540314,846314,1386628,631075,466274,319271,239142,165576,155361,1976699,3864875,6644959,6644959
Haiti,1989,HT,HTI,AMR,554300,874215,1428515,642337,472240,320693,234821,142425,111415,1923931,551040,870073,1421113,640868,475291,326524,243198,167765,156950,2010596,3934527,6784161,6784161
Haiti,1990,HT,HTI,AMR,564710,898144,1462854,654226,481810,327534,239459,146050,112447,1961526,561211,893654,1454865,651974,484050,334263,247094,170334,158365,2046080,4007606,6925331,6925331
Haiti,1991,HT,HTI,AMR,572934,921974,1494908,667776,490905,335079,243653,150154,113448,2001015,569159,917283,1486442,664774,492461,342631,250721,173390,159710,2083687,4084702,7066055,7066055
Haiti,1992,HT,HTI,AMR,578561,945571,1524132,682979,499939,343440,247054,154792,114425,2042629,574483,940829,1515312,679274,500922,351744,253719,177017,161034,2123710,4166339,7205780,7205780
Haiti,1993,HT,HTI,AMR,582446,968858,1551304,699709,508991,353352,249227,159790,115493,2086562,578073,964059,1542132,695301,509387,362309,255564,181004,162369,2165934,4252496,7345940,7345940
Haiti,1994,HT,HTI,AMR,584664,991669,1576333,717808,517960,364015,251358,164771,116816,2132728,579985,986746,1566731,712762,517772,372831,258105,185015,163806,2210291,4343019,7486091,7486091
Haiti,1995,HT,HTI,AMR,585645,1013931,1599576,737248,527116,374096,254723,169531,118448,2181162,580643,1008842,1589485,731672,526390,382025,262636,188887,165481,2257091,4438253,7627316,7627316
Haiti,1996,HT,HTI,AMR,587043,1034239,1621282,758124,536490,383911,258922,174093,120389,2231929,581689,1029005,1610694,752169,535299,391011,268027,192716,167470,2306692,4538621,7770593,7770593
Haiti,1997,HT,HTI,AMR,589446,1051762,1641208,780589,545986,393576,263753,178528,122597,2285029,583689,1046366,1630055,774363,544350,399927,274015,196547,169675,2358877,4643906,7915172,7915172
Haiti,1998,HT,HTI,AMR,592143,1067539,1659682,804155,555630,403082,269208,182893,125120,2340088,586007,1061932,1647939,797754,553531,408760,280569,200427,172151,2413192,4753280,8060896,8060896
Haiti,1999,HT,HTI,AMR,595155,1081947,1677102,827966,565980,412685,275273,187221,128025,2397150,588745,1076117,1664862,821509,563441,417765,287688,204360,175064,2469827,4866977,8208941,8208941
Haiti,2000,HT,HTI,AMR,598990,1094700,1693690,851759,577833,422186,282003,191439,131281,2456501,592303,1088667,1680970,845357,574884,426753,295410,208278,178376,2529058,4985559,8360225,8360225
Haiti,2001,HT,HTI,AMR,602668,1105721,1708389,875501,591383,431323,289411,195317,134840,2517775,595659,1099409,1695068,869299,588025,435460,303731,211966,182007,2590488,5108263,8511728,8511728
Haiti,2002,HT,HTI,AMR,605127,1115198,1720325,899046,606566,440428,297550,198537,138746,2580873,597817,1108511,1706328,893163,602829,444216,312727,215083,185999,2654017,5234890,8661546,8661546
Haiti,2003,HT,HTI,AMR,607298,1123252,1730550,922359,623265,449583,307083,200741,142950,2645981,599609,1116182,1715791,916850,619254,453086,323117,217242,190371,2719920,5365901,8812245,8812245
Haiti,2004,HT,HTI,AMR,609027,1129818,1738845,945186,641275,458640,317254,202870,147183,2712408,600666,1122375,1723041,940030,637096,461883,333460,220001,194730,2787200,5499608,8961489,8961489
Haiti,2005,HT,HTI,AMR,610123,1135882,1746005,967472,660608,467901,326916,206066,151394,2780357,600970,1128083,1729053,962672,656411,470959,342649,224575,199210,2856476,5636833,9111900,9111900
Haiti,2006,HT,HTI,AMR,611873,1142312,1754185,987865,681400,477440,336407,210041,155677,2848830,601955,1134156,1736111,983467,677407,480440,351770,230035,204037,2927156,5775986,9266288,9266288
Haiti,2007,HT,HTI,AMR,614600,1148393,1762993,1005485,703694,487107,345782,214580,160027,2916675,603863,1139823,1743686,1001478,700053,490086,360851,236038,208973,2997479,5914154,9420826,9420826
Haiti,2008,HT,HTI,AMR,617651,1154211,1771862,1021304,726977,496880,355011,219667,164476,2984315,606164,1145147,1751311,1017655,723810,499855,369863,242549,214026,3067758,6052073,9575247,9575247
Haiti,2009,HT,HTI,AMR,621038,1160305,1781343,1035650,750346,507225,364266,225239,169030,3051756,608997,1150607,1759604,1032298,747751,510194,378966,249507,219217,3137933,6189689,9730638,9730638
Haiti,2010,HT,HTI,AMR,621382,1162748,1784130,1045386,771260,517036,371560,229722,171655,3106619,609303,1151141,1760444,1041081,768474,519583,385921,255078,221554,3191691,6298310,9842880,9842880
Haiti,2011,HT,HTI,AMR,622106,1164869,1786975,1053220,791885,528315,378456,234737,174153,3160766,610152,1151366,1761518,1047889,789056,530471,392575,261161,223914,3245066,6405832,9954312,9954312
Haiti,2012,HT,HTI,AMR,626158,1170236,1796394,1062320,814461,542927,387140,241965,178354,3227167,614106,1156067,1770173,1057029,812504,545149,401333,269708,229077,3314800,6541967,10108539,10108539
Haiti,2013,HT,HTI,AMR,629479,1175325,1804804,1070009,836706,558904,395842,250276,181914,3293651,617324,1160579,1777903,1064701,835649,561292,410169,279397,233635,3384843,6678494,10261206,10261206
Haiti,2014,HT,HTI,AMR,632364,1180306,1812670,1076406,858411,576061,404451,259101,185426,3359856,620021,1165118,1785139,1071140,858262,578782,418978,289121,238796,3455079,6814935,10412740,10412740
Haiti,2015,HT,HTI,AMR,634542,1185349,1819891,1082224,879380,594341,413169,267504,189654,3426272,622084,1169709,1791793,1076990,880105,597547,427971,297843,245339,3525795,6952067,10563757,10563757
Haiti,2016,HT,HTI,AMR,635702,1191509,1827211,1087997,898182,613772,421988,275665,194304,3491908,623315,1175331,1798646,1082733,899769,617652,437143,306364,252422,3596083,7087991,10713849,10713849
Haiti,2017,HT,HTI,AMR,637176,1198479,1835655,1093349,914183,634552,430882,283713,199341,3556020,624863,1181801,1806664,1088006,916606,639285,446446,314865,260003,3665211,7221231,10863543,10863543
Haiti,2018,HT,HTI,AMR,639471,1204816,1844287,1098488,928417,656230,439858,291647,204807,3619447,627172,1187763,1814935,1092960,931603,661961,455844,323308,268071,3733747,7353194,11012421,11012421
Haiti,2019,HT,HTI,AMR,641870,1210597,1852467,1103923,941227,677957,449334,299585,210632,3682658,629513,1193424,1822937,1098159,945167,684838,465792,331856,276561,3802373,7485031,11160438,11160438
Haiti,2020,HT,HTI,AMR,643900,1216351,1860251,1109674,952527,699608,460013,307128,216192,3745142,631394,1199214,1830608,1103616,957185,707735,477024,340186,285051,3870797,7615939,11306801,11306801
Haiti,2021,HT,HTI,AMR,644818,1222189,1867007,1115444,962285,721142,471940,313975,221050,3805836,632119,1205091,1837210,1109008,967510,730616,489591,347865,292919,3937509,7743345,11447569,11447569
Haiti,2022,HT,HTI,AMR,644684,1228313,1872997,1120895,970719,742442,485180,320694,225778,3865708,631848,1211185,1843033,1114062,976378,753359,503552,355397,300508,4003256,7868964,11584996,11584996
Haiti,2023,HT,HTI,AMR,644271,1234555,1878826,1126277,978102,763626,499899,327696,231269,3926869,631446,1217287,1848733,1119073,984096,775992,519079,363259,308834,4070333,7997202,11724763,11724763
Haiti,2024,HT,HTI,AMR,643425,1240567,1883992,1131734,984598,784571,516034,335059,237900,3989896,630737,1223007,1853744,1124247,990921,798355,536128,371485,318270,4139406,8129302,11867030,11867030
Haiti,2025,HT,HTI,AMR,641764,1245486,1887250,1137326,990826,805032,533443,342866,245428,4054921,629285,1227681,1856966,1129508,997442,820172,554573,380169,328507,4210371,8265292,12009506,12009506
Haiti,2026,HT,HTI,AMR,639817,1248405,1888222,1144094,997309,823651,552088,350949,253447,4121538,627562,1230530,1858092,1135833,1004110,840069,574411,389153,339186,4282762,8404300,12150613,12150613
Haiti,2027,HT,HTI,AMR,637990,1250623,1888613,1151701,1003649,839798,572078,359132,261630,4187988,625944,1232736,1858680,1143000,1010529,857393,595780,398251,350107,4355060,8543048,12290342,12290342
Haiti,2028,HT,HTI,AMR,636026,1253183,1889209,1158683,1009972,854420,592955,367417,269995,4253442,624153,1235343,1859496,1149647,1016802,873072,618198,407434,361288,4426441,8679883,12428585,12428585
Haiti,2029,HT,HTI,AMR,633875,1255299,1889174,1165175,1016735,867815,613941,376218,278621,4318505,622146,1237533,1859679,1156007,1023370,887403,640827,417126,372808,4497541,8816046,12564896,12564896
Haiti,2030,HT,HTI,AMR,632072,1256269,1888341,1171660,1023855,879785,634869,386162,287396,4383727,620461,1238576,1859037,1162502,1030174,900196,663468,428034,384521,4568895,8952622,12700006,12700006
Haiti,1950,HT,HTI,AMR,251232,401546,652778,294199,222764,176315,121985,64638,50620,930521,249651,398775,648426,305991,243204,192578,132103,74127,67500,1015503,1946024,3247231,3247231
Haiti,1951,HT,HTI,AMR,253977,408545,662522,301754,224288,178247,125558,66487,50186,946520,254523,405243,659766,311847,244964,195419,136938,76293,67533,1032994,1979514,3301802,3301802
Haiti,1952,HT,HTI,AMR,257944,414419,672363,310283,225956,180140,128811,68612,50041,963843,260268,410796,671064,318563,246691,198125,141558,78747,67762,1051446,2015289,3358719,3358719
Haiti,1953,HT,HTI,AMR,264207,418592,682799,319428,227886,181967,131785,71039,50096,982201,268036,414844,682880,325877,248490,200706,145956,81559,68163,1070751,2052952,3418644,3418644
Haiti,1954,HT,HTI,AMR,271442,422549,693991,328557,230275,183669,134582,73792,50236,1001111,275764,419663,695427,333272,250505,203129,150120,84788,68621,1090435,2091546,3480966,3480966
Haiti,1955,HT,HTI,AMR,278326,427968,706294,337308,233264,185241,137257,76814,50475,1020359,282190,426855,709045,340447,252861,205395,154055,88412,69132,1110302,2130661,3545999,3545999
Haiti,1956,HT,HTI,AMR,285349,434388,719737,345721,236847,186714,139794,80112,50798,1039986,288752,435018,723770,347465,255558,207548,157748,92417,69739,1130475,2170461,3613972,3613972
Haiti,1957,HT,HTI,AMR,292139,441540,733679,353894,240991,188100,142171,83691,51199,1060046,295123,443852,738975,354437,258567,209583,161150,96779,70409,1150925,2210971,3683628,3683628
Haiti,1958,HT,HTI,AMR,298649,449394,748043,361842,245743,189415,144386,87365,51727,1080478,301272,453332,754604,361382,261991,211498,164297,101355,71226,1171749,2252227,3754874,3754874
Haiti,1959,HT,HTI,AMR,305136,457871,763007,369469,251146,190690,146459,90877,52523,1101164,307444,463354,770798,368150,265933,213240,167246,105878,72325,1192772,2293936,3827747,3827747
Haiti,1960,HT,HTI,AMR,311235,467067,778302,376638,257093,191945,148380,94099,53631,1121786,313270,473996,787266,374600,270340,214815,170015,110215,73795,1213780,2335566,3901139,3901139
Haiti,1961,HT,HTI,AMR,316980,477121,794101,383083,263634,193182,150166,97055,55025,1142145,318783,485366,804149,380496,275251,216224,172593,114370,75598,1234532,2376677,3974934,3974934
Haiti,1962,HT,HTI,AMR,322761,488169,810930,388354,270872,194403,151847,99728,56693,1161897,324378,497596,821974,385408,280758,217472,174995,118329,77731,1254693,2416590,4049504,4049504
Haiti,1963,HT,HTI,AMR,327998,500681,828679,391863,278508,195721,153369,102108,58558,1180127,329404,511168,840572,388675,286557,218549,177108,121950,80035,1272874,2453001,4122260,4122260
Haiti,1964,HT,HTI,AMR,333088,514006,847094,395222,286087,197414,154751,104349,60627,1198450,334313,524620,858933,392727,292358,219766,179039,125353,82628,1291871,2490321,4196349,4196349
Haiti,1965,HT,HTI,AMR,338574,526886,865460,400122,293336,199663,156038,106542,62915,1218616,339676,536734,876410,399245,298039,221380,180925,128672,85598,1313859,2532475,4274348,4274348
Haiti,1966,HT,HTI,AMR,343788,539330,883118,405997,300258,202422,157212,108612,65355,1239856,344752,548440,893192,406726,303555,223264,182666,131756,88813,1336780,2576636,4352949,4352949
Haiti,1967,HT,HTI,AMR,348844,551534,900378,412643,306997,205691,158305,110557,67958,1262151,349660,559976,909636,414908,309057,225419,184289,134594,92278,1360545,2622696,4432716,4432716
Haiti,1968,HT,HTI,AMR,353836,563491,917327,420036,313596,209531,159351,112394,70672,1285580,354495,571316,925811,423775,314590,227958,185799,137224,95936,1385282,2670862,4514006,4514006
Haiti,1969,HT,HTI,AMR,358642,575363,934005,428082,320010,214035,160383,114132,73389,1310031,359141,582616,941757,433214,320050,231017,187165,139695,99704,1410845,2720876,4596642,4596642
Haiti,2031,HT,HTI,AMR,630815,1255988,1886803,1178372,1031104,890374,655803,397430,296165,4449248,619320,1238363,1857683,1169268,1037049,911467,686236,440373,396265,4640658,9089906,12834396,12834396
Haiti,2032,HT,HTI,AMR,629426,1254796,1884222,1185493,1038148,899794,676640,409992,305016,4515083,618059,1237284,1855343,1176417,1043704,921403,708986,454133,408122,4712765,9227848,12967403,12967403
Haiti,2033,HT,HTI,AMR,627853,1253038,1880891,1192679,1045064,908127,697276,423687,313973,4580806,616612,1235721,1852333,1183524,1050265,930116,731538,469207,420152,4784802,9365608,13098831,13098831
Haiti,2034,HT,HTI,AMR,626573,1250554,1877127,1199613,1052069,915594,717623,438423,323075,4646397,615465,1233490,1848955,1190210,1056999,937920,753743,485526,432391,4856789,9503186,13229269,13229269
Haiti,2035,HT,HTI,AMR,625431,1247672,1873103,1205546,1059375,922927,737568,454158,332354,4711928,614446,1230902,1845348,1195906,1063973,945519,775457,503065,444864,4928784,9640712,13359166,13359166
Haiti,2036,HT,HTI,AMR,624171,1245147,1869318,1209598,1068022,930633,755852,470945,341793,4776843,613295,1228680,1841975,1199877,1072186,953383,795376,521880,457550,5000252,9777095,13488390,13488390
Haiti,2037,HT,HTI,AMR,622922,1242609,1865531,1212992,1077608,938282,771863,488904,351382,4841031,612174,1226442,1838616,1203245,1081366,961084,812871,542130,470469,5071165,9912196,13616339,13616339
Haiti,2038,HT,HTI,AMR,622044,1239750,1861794,1216683,1086634,945962,786476,507610,361147,4904512,611427,1223846,1835273,1206984,1090100,968697,828814,563341,483611,5141547,10046059,13743136,13743136
Haiti,2039,HT,HTI,AMR,621069,1236985,1858054,1219862,1095176,954089,799950,526393,371459,4966929,610550,1221315,1831865,1210237,1098546,976623,843469,584750,497433,5211058,10177987,13867905,13867905
Haiti,2040,HT,HTI,AMR,619650,1234667,1854317,1221818,1103648,962552,812095,545153,382718,5027984,609237,1219204,1828441,1212249,1107069,984775,856656,606197,512413,5279359,10307343,13990109,13990109
Haiti,2041,HT,HTI,AMR,617957,1232736,1850693,1222446,1112246,971094,822953,563943,394953,5087635,607661,1217463,1825124,1212914,1115771,992963,868375,627789,528604,5346416,10434051,14109871,14109871
Haiti,2042,HT,HTI,AMR,616325,1230659,1846984,1222095,1121136,979397,832722,582676,408174,5146200,606115,1215596,1821711,1212626,1124734,1000893,878804,649384,546029,5412470,10558670,14227369,14227369
Haiti,2043,HT,HTI,AMR,614748,1228750,1843498,1221115,1129956,987516,841474,601254,422281,5203596,604574,1213903,1818477,1211785,1133532,1008670,888050,670813,564646,5477496,10681092,14343068,14343068
Haiti,2044,HT,HTI,AMR,613445,1227016,1840461,1219373,1138383,995631,849406,619581,437201,5259575,603326,1212354,1815680,1210230,1141763,1016534,896396,691929,584394,5541246,10800821,14456973,14456973
Haiti,2045,HT,HTI,AMR,612422,1224958,1837380,1217205,1145686,1003933,857192,637542,452907,5314465,602372,1210483,1812855,1208289,1148854,1024530,904524,712588,605263,5604048,10918513,14568753,14568753
Haiti,2046,HT,HTI,AMR,611357,1222489,1833846,1215352,1150985,1013415,865272,654006,469411,5368441,601362,1208190,1809552,1206676,1154065,1033615,912851,731564,627319,5666090,11034531,14677930,14677930
Haiti,2047,HT,HTI,AMR,610293,1220063,1830356,1213452,1155496,1023670,873203,668449,486816,5421086,600355,1205930,1806285,1205008,1158530,1043521,920943,748273,650675,5726950,11148036,14784689,14784689
Haiti,2048,HT,HTI,AMR,609046,1218031,1827077,1211178,1160182,1033294,881117,681649,504783,5472203,599171,1204022,1803193,1202916,1163229,1052894,928909,763534,674930,5786412,11258615,14888886,14888886
Haiti,2049,HT,HTI,AMR,607529,1216158,1823687,1208933,1164268,1042377,889425,693829,523064,5521896,597698,1202260,1799958,1200825,1167347,1061921,937152,777586,699763,5844594,11366490,14990139,14990139
Haiti,2050,HT,HTI,AMR,605477,1214114,1819591,1207068,1167078,1051362,898027,704864,541897,5570296,595675,1200335,1796010,1199089,1170165,1070987,945595,790300,725487,5901623,11471919,15087520,15087520
Hungary,1970,HU,HUN,EUR,366391,738833,1105224,875164,696636,701119,559600,566174,495193,3893886,344314,699355,1043669,839701,711884,735795,627476,661703,696024,4272583,8166469,10315366,10315366
Hungary,1971,HU,HUN,EUR,374308,709481,1083789,897992,700993,690802,589147,546539,503634,3929107,352294,671178,1023472,860691,711113,725444,658982,642120,710647,4308997,8238104,10345364,10345364
Hungary,1972,HU,HUN,EUR,378834,694332,1073166,905427,712009,681608,621641,519683,514060,3954428,356927,656257,1013184,867538,715546,717702,694028,613009,728020,4335843,8290271,10376617,10376617
Hungary,1973,HU,HUN,EUR,380669,691245,1071914,899141,727928,673668,654615,490918,525847,3972117,358548,653005,1011553,860878,725637,711458,728682,581297,746974,4354926,8327043,10410508,10410508
Hungary,1974,HU,HUN,EUR,388940,693681,1082621,887251,744241,666307,675424,473125,538112,3984460,366984,654084,1021068,849313,737315,705018,748704,562449,766997,4369796,8354256,10457947,10457947
Hungary,1975,HU,HUN,EUR,407278,698217,1105495,870673,759615,660901,680793,470247,549924,3992153,385126,657031,1042157,833699,749019,699686,749367,562054,786610,4380435,8372588,10520237,10520237
Hungary,1976,HU,HUN,EUR,426681,704019,1130700,851586,773850,658236,680085,471993,560019,3995769,403676,662087,1065763,814727,761192,695790,743438,567469,803660,4386276,8382045,10578508,10578508
Hungary,1977,HU,HUN,EUR,441681,714209,1155890,830361,785725,658912,675512,474384,569814,3994708,418321,671345,1089666,793312,771358,694408,734468,572859,821234,4387639,8382347,10627916,10627916
Hungary,1978,HU,HUN,EUR,450984,727370,1178354,803656,800612,661126,669769,476829,577809,3989801,427540,683602,1111142,766825,784202,694380,726190,576369,837595,4385561,8375362,10664862,10664862
Hungary,1979,HU,HUN,EUR,449751,746977,1196728,769192,822093,666981,663933,478900,583429,3984528,425463,702615,1128078,733148,803742,697386,720265,576712,852130,4383383,8367911,10692715,10692715
Hungary,1980,HU,HUN,EUR,433771,774360,1208131,732175,846222,672014,655675,488725,579119,3973930,410184,729350,1139534,697725,826148,699175,712025,586825,855192,4377090,8351020,10698679,10698679
Hungary,1981,HU,HUN,EUR,411171,800144,1211315,701605,867048,674242,643529,510537,561056,3958017,390446,754703,1145149,668678,846238,697049,700466,613876,839834,4366141,8324158,10680620,10680620
Hungary,1982,HU,HUN,EUR,389223,818706,1207929,684285,872716,682847,632389,534016,539039,3945292,370416,773446,1143862,652360,852143,700077,691856,643684,818428,4358548,8303840,10655624,10655624
Hungary,1983,HU,HUN,EUR,367566,829676,1197242,678597,864542,695937,622475,556678,516674,3934903,350261,784484,1134745,647514,844573,708655,684710,672592,795997,4354041,8288944,10620934,10620934
Hungary,1984,HU,HUN,EUR,347392,835691,1183083,678478,850329,709402,612932,568941,504485,3924567,332151,790749,1122900,647069,831953,718863,677218,688302,786952,4350357,8274924,10580906,10580906
Hungary,1985,HU,HUN,EUR,333448,836938,1170386,680663,831436,722050,605336,569396,504986,3913867,319110,793131,1112241,648472,815451,729049,670851,687089,795344,4346256,8260123,10542754,10542754
Hungary,1986,HU,HUN,EUR,325276,834237,1159513,684138,810487,733231,600556,565012,509189,3902613,310990,791887,1102877,651918,795581,739680,665773,680393,807428,4340773,8243386,10505772,10505772
Hungary,1987,HU,HUN,EUR,319528,827445,1146973,692486,787806,741549,599030,557635,514939,3893445,305673,786474,1092147,659795,773273,748255,663326,671032,820949,4336630,8230075,10469192,10469192
Hungary,1988,HU,HUN,EUR,316889,814715,1131604,704989,759464,752525,599209,550365,521519,3888071,303145,775307,1078452,671479,745998,759142,662396,662495,834626,4336136,8224207,10434265,10434265
Hungary,1989,HU,HUN,EUR,316068,790800,1106868,725892,723001,769538,602456,543153,526490,3890530,301900,753621,1055521,691458,711274,776354,664329,656178,844659,4344252,8234782,10397173,10397173
Hungary,1990,HU,HUN,EUR,315275,759016,1074291,756758,687970,790763,606314,535220,531264,3908289,301093,724090,1025183,721035,677353,797842,666768,649529,855703,4368230,8276519,10375989,10375989
Hungary,1991,HU,HUN,EUR,314994,730401,1045395,785332,663310,811026,609285,526002,537376,3932331,300882,697645,998527,748405,652463,818983,667106,641732,869801,4398490,8330821,10374747,10374747
Hungary,1992,HU,HUN,EUR,314512,706430,1020942,804622,651160,817593,617471,517592,541360,3949798,300184,675279,975463,767151,639804,827096,672115,636361,881345,4423872,8373670,10370060,10370060
Hungary,1993,HU,HUN,EUR,312097,686241,998338,815646,649927,811473,629307,510233,544354,3960940,297863,655912,953775,777711,638081,822529,682085,632236,891727,4444369,8405309,10357421,10357421
Hungary,1994,HU,HUN,EUR,308571,669310,977881,821582,653985,799706,641764,503429,548316,3968782,294455,639875,934330,783482,640525,812923,693599,628224,902675,4461428,8430210,10342434,10342434
Hungary,1995,HU,HUN,EUR,303295,656697,959992,823597,660140,784270,654054,498491,553723,3974275,289008,628247,917255,785898,644560,799769,705444,625243,914737,4475651,8449926,10327169,10327169
Hungary,1996,HU,HUN,EUR,294588,648462,943050,822915,667417,767880,665262,496221,558290,3977985,280216,620734,900950,785358,650333,783923,717416,623683,925574,4486287,8464272,10308267,10308267
Hungary,1997,HU,HUN,EUR,284085,642451,926536,818818,678675,750053,674116,497095,561621,3980378,269626,615323,884949,781315,659991,765542,727506,624855,935147,4494356,8474734,10286220,10286220
Hungary,1998,HU,HUN,EUR,273811,637272,911083,810162,692406,727018,685083,499756,565257,3979682,259409,610560,869969,773053,672216,742268,739859,627198,945637,4500231,8479913,10260967,10260967
Hungary,1999,HU,HUN,EUR,263783,631734,895517,793017,712255,697076,702137,504315,567725,3976525,249653,604812,854465,757051,690707,712289,758311,631693,953697,4503748,8480273,10230256,10230256
Hungary,2000,HU,HUN,EUR,254949,623376,878325,769415,739378,667383,722580,508321,569556,3976633,241656,596035,837691,734918,716496,681558,780153,635293,960989,4509407,8486040,10202055,10202055
Hungary,2001,HU,HUN,EUR,248397,611237,859634,745876,766763,645668,741354,510839,570220,3980720,236014,583502,819516,713513,742139,657193,801140,635296,968810,4518091,8498811,10177955,10177955
Hungary,2002,HU,HUN,EUR,245237,598266,843503,722660,787209,635277,747478,517771,569513,3979908,233207,570222,803429,692126,761391,644103,809005,639216,975726,4521567,8501475,10148401,10148401
Hungary,2003,HU,HUN,EUR,244632,585300,829932,701653,799350,635722,742081,528391,569296,3976493,232387,557609,789996,672170,772747,642113,804237,648137,982240,4521644,8498137,10118062,10118062
Hungary,2004,HU,HUN,EUR,244901,571366,816267,683280,809259,641949,732811,539480,570270,3977049,232198,544461,776659,655281,781042,645018,795328,658571,989272,4524512,8501561,10094493,10094493
Hungary,2005,HU,HUN,EUR,245719,557389,803108,669329,816287,650487,720228,550643,573032,3980006,232397,531085,763482,643036,786197,649129,782175,668957,997435,4526929,8506935,10073525,10073525
Hungary,2006,HU,HUN,EUR,246928,543694,790622,659716,820093,660172,706742,561087,577193,3985003,233344,517605,750949,634612,788811,654713,766388,679701,1006259,4530484,8515487,10057063,10057063
Hungary,2007,HU,HUN,EUR,248037,531176,779213,652287,820109,672887,691930,568571,582782,3988566,234822,505220,740042,627354,787931,664229,748524,688352,1016957,4533347,8521913,10041172,10041172
Hungary,2008,HU,HUN,EUR,249145,520693,769838,645920,815767,687796,672915,578158,589133,3989689,236281,494622,730903,620674,783241,676122,725929,699004,1028107,4533077,8522766,10023510,10023510
Hungary,2009,HU,HUN,EUR,250561,511184,761745,641522,802666,708824,647801,593720,597045,3991578,237872,485146,723018,615140,770116,694094,696576,715714,1040595,4532235,8523813,10008579,10008579
Hungary,2010,HU,HUN,EUR,249177,503479,752656,635061,780918,737588,622545,611827,603306,3991245,236874,477536,714410,607496,748484,720111,666216,735563,1050637,4528507,8519752,9986825,9986825
Hungary,2011,HU,HUN,EUR,244278,499304,743582,626445,733110,765308,611155,640081,611594,3987693,232540,472663,705203,596446,706923,748272,646587,762359,1056177,4516764,8504457,9953245,9953245
Hungary,2012,HU,HUN,EUR,239600,497535,737135,618800,685577,785332,610895,658459,624622,3983685,227609,470875,698484,586455,664825,769200,639046,777537,1065766,4502829,8486514,9922127,9922127
Hungary,2013,HU,HUN,EUR,235816,497649,733465,608265,664910,795996,613838,655730,637903,3976642,223452,471463,694915,576333,642938,778705,638038,773384,1080215,4489613,8466255,9894639,9894639
Hungary,2014,HU,HUN,EUR,233004,499493,732497,595608,648160,800712,621411,649108,652508,3967507,220694,473343,694037,564345,624076,783105,640812,764750,1096772,4473860,8441367,9867901,9867901
Hungary,2015,HU,HUN,EUR,233018,499032,732050,582485,637793,801723,631033,639656,667792,3960482,220509,473298,693807,551149,610924,784304,645381,752503,1113645,4457906,8418388,9844246,9844246
Hungary,2016,HU,HUN,EUR,235589,495259,730848,568080,633127,798441,640724,628697,682338,3951407,222723,470125,692848,536867,602793,781349,651112,736920,1130955,4439996,8391403,9815104,9815104
Hungary,2017,HU,HUN,EUR,238123,492070,730193,554785,632672,792248,653415,615875,694589,3943584,225431,466805,692236,524104,598958,774347,660484,718750,1146286,4422929,8366513,9788941,9788941
Hungary,2018,HU,HUN,EUR,239733,490268,730001,544669,637138,784309,669457,599782,708662,3944017,227269,464617,691886,513785,599586,764198,673175,696830,1162879,4410453,8354470,9776358,9776358
Hungary,2019,HU,HUN,EUR,240588,489363,729951,535083,643637,768090,692470,579986,729378,3948644,227890,463795,691685,503758,602324,746090,692743,669479,1187122,4401516,8350160,9771796,9771796
Hungary,2020,HU,HUN,EUR,241100,487658,728758,525296,644754,742078,722314,560091,749219,3943752,228036,462600,690636,494264,602597,719052,719815,641305,1210400,4387433,8331185,9750573,9750573
Hungary,2021,HU,HUN,EUR,240777,484719,725496,518616,641570,715294,749215,545226,758866,3928787,227635,459980,687615,488592,600005,692142,744794,618493,1223863,4367889,8296676,9709786,9709786
Hungary,2022,HU,HUN,EUR,248199,490387,738586,558788,685009,716091,778208,544693,763972,4046761,235051,465791,700842,533989,644495,690623,770985,610470,1230553,4481115,8527876,9967308,9967308
Hungary,2023,HU,HUN,EUR,255652,493633,749285,584039,713531,716258,797162,552787,769738,4133515,242245,468967,711212,562780,675435,687848,787629,612801,1235730,4562223,8695738,10156239,10156239
Hungary,2024,HU,HUN,EUR,253731,487981,741712,554138,682901,693259,799252,560114,774075,4063739,240132,462806,702938,531312,647259,663607,789519,615216,1239693,4486606,8550345,9994993,9994993
Hungary,2025,HU,HUN,EUR,251121,486883,738004,529328,656118,678188,798120,569072,777828,4008654,237472,461058,698530,505861,622236,647075,788911,619502,1242103,4425688,8434342,9870870,9870870
Hungary,2026,HU,HUN,EUR,248633,489254,737887,510558,633850,672107,794750,578943,781157,3971365,234867,462992,697859,486963,601788,638863,786343,625483,1242986,4382426,8353791,9789542,9789542
Hungary,2027,HU,HUN,EUR,246374,491601,737975,500058,615212,671824,789078,591661,782584,3950417,232485,465632,698117,475866,585587,636597,780746,635178,1240823,4354797,8305214,9741316,9741316
Hungary,2028,HU,HUN,EUR,242959,494459,737418,494741,598536,674411,779412,606081,783595,3936776,229183,468621,697804,469906,571016,637917,770812,647341,1237448,4334440,8271216,9706442,9706442
Hungary,2029,HU,HUN,EUR,238920,497113,736033,492232,582278,678422,760987,626146,785785,3925850,225423,470845,696268,467308,556098,640927,752357,665696,1234795,4317181,8243031,9675328,9675328
Hungary,2030,HU,HUN,EUR,235407,498007,733414,490072,567004,680348,735791,653503,788761,3915479,222132,471344,693476,465510,541628,642898,726207,691851,1232443,4300537,8216016,9642912,9642912
Hungary,1950,HU,HUN,EUR,421142,760855,1181997,767650,609717,679449,572290,363281,320027,3312414,403620,742195,1145815,774830,674119,748758,631455,459288,409039,3697489,7009903,9337714,9337714
Hungary,1951,HU,HUN,EUR,436981,759770,1196751,761117,643029,657236,582784,370515,326876,3341557,418881,740331,1159212,763557,706288,727181,636485,470188,421819,3725518,7067075,9423044,9423044
Hungary,1952,HU,HUN,EUR,445504,765723,1211227,755871,680911,626482,593684,379722,331945,3368615,427823,744232,1172055,755278,742815,694922,643744,482183,432988,3751930,7120545,9503834,9503834
Hungary,1953,HU,HUN,EUR,452592,778273,1230865,751016,720556,593382,604033,392443,335827,3397257,434444,754131,1188575,748911,779330,659554,653151,493046,443526,3777518,7174775,9594223,9594223
Hungary,1954,HU,HUN,EUR,467008,792914,1259922,745749,747508,572894,614366,407575,339690,3427782,447352,766466,1213818,742453,800491,638374,664632,503675,453381,3803006,7230788,9704520,9704520
Hungary,1955,HU,HUN,EUR,480710,808130,1288840,741149,757658,569725,623529,426299,344524,3462884,459736,779180,1238916,736907,801386,636681,675808,519512,462406,3832700,7295584,9823331,9823331
Hungary,1956,HU,HUN,EUR,485373,815431,1300804,716696,749268,567317,629052,444948,349761,3457042,463494,787992,1251486,725510,789645,638213,684118,535502,471811,3844799,7301841,9854129,9854129
Hungary,1957,HU,HUN,EUR,481798,818335,1300133,691924,733441,563840,632616,460695,354910,3437426,458802,793199,1252001,715521,772746,638150,692352,547130,482197,3848096,7285522,9837655,9837655
Hungary,1958,HU,HUN,EUR,467572,832259,1299831,692265,727346,565767,637581,475323,361899,3460181,444322,805120,1249442,714994,762334,638687,701735,557115,495505,3870370,7330551,9879818,9879818
Hungary,1959,HU,HUN,EUR,440597,855151,1295748,701464,723493,569433,643388,487891,369374,3495043,419065,824704,1243769,719978,756297,637299,712212,565529,510137,3901452,7396495,9936018,9936018
Hungary,1960,HU,HUN,EUR,409926,880838,1290764,709907,717110,584283,639421,498080,376456,3525257,389982,846817,1236799,723699,748374,648342,711858,572514,525000,3929787,7455044,9982610,9982610
Hungary,1961,HU,HUN,EUR,384087,904397,1288484,715403,706873,616324,618603,508362,385904,3551469,364470,867507,1231977,722986,737309,680203,691328,579636,542459,3953921,7505390,10025847,10025847
Hungary,1962,HU,HUN,EUR,363677,913118,1276795,727936,697389,651942,589440,518642,395650,3580999,344631,874110,1218741,727620,728910,716037,660599,588220,559538,3980924,7561923,10057458,10057458
Hungary,1963,HU,HUN,EUR,348942,907913,1256855,745334,689285,688242,557757,527820,407236,3615674,330491,867055,1197546,737784,722261,751557,626725,598232,576705,4013264,7628938,10083327,10083327
Hungary,1964,HU,HUN,EUR,338770,897234,1236004,762541,682634,711672,538057,536990,421673,3653567,320280,855280,1175560,749427,715658,772034,606436,610015,595473,4049043,7702610,10114174,10114174
Hungary,1965,HU,HUN,EUR,331495,882108,1213603,778579,678329,718774,534646,544876,435786,3690990,313078,839290,1152368,761112,710262,772687,605036,620900,613901,4083898,7774888,10140853,10140853
Hungary,1966,HU,HUN,EUR,328275,864370,1192645,793414,676877,719519,536607,551778,450270,3728465,309945,820045,1129990,773165,706480,766761,609635,630503,632446,4118990,7847455,10170085,10170085
Hungary,1967,HU,HUN,EUR,333169,843604,1176773,806246,678802,716457,539186,558806,465081,3764578,314264,798254,1112518,783323,705413,757747,614170,641340,650962,4152955,7917533,10206826,10206826
Hungary,1968,HU,HUN,EUR,343837,815452,1159289,823266,682354,712295,542210,564833,477541,3802499,324169,770700,1094869,796592,705662,749389,616710,651855,667477,4187685,7990184,10244338,10244338
Hungary,1969,HU,HUN,EUR,355595,777627,1133222,848121,689725,707850,545691,570030,487095,3848512,334662,735412,1070074,816717,709060,743415,616073,661996,682051,4229312,8077824,10281121,10281121
Hungary,2031,HU,HUN,EUR,232238,497278,729516,487703,554602,678979,711752,679556,793128,3905720,219137,470446,689583,463340,529980,642095,701022,716746,1231076,4284259,8189979,9609082,9609082
Hungary,2032,HU,HUN,EUR,229316,495001,724317,486867,544675,674576,691120,698494,800802,3896534,216356,468068,684424,462382,521242,638357,678724,734481,1233281,4268467,8165001,9573742,9573742
Hungary,2033,HU,HUN,EUR,226473,492448,718921,486324,537230,666661,674580,709936,812030,3886761,213657,465394,679051,461795,514412,632200,659617,744592,1239453,4252069,8138830,9536799,9536799
Hungary,2034,HU,HUN,EUR,223498,489473,712971,485896,531638,656150,661989,716471,824656,3876800,210835,462486,673321,461254,508827,623948,644510,750175,1246442,4235156,8111956,9498246,9498246
Hungary,2035,HU,HUN,EUR,220461,485643,706104,488143,523830,644242,654698,718934,837285,3867132,207949,458819,666768,463084,501506,613676,634817,752416,1252803,4218302,8085434,9458299,9458299
Hungary,2036,HU,HUN,EUR,217477,481322,698799,492226,514284,630454,653138,717953,849337,3857392,205121,454549,659670,466832,492431,601582,630555,751606,1258383,4201389,8058781,9417257,9417257
Hungary,2037,HU,HUN,EUR,214622,476651,691273,495179,507149,615105,654733,713797,861472,3847435,202421,449890,652311,470110,484893,588539,629855,746930,1263844,4184171,8031606,9375191,9375191
Hungary,2038,HU,HUN,EUR,212078,470537,682615,498193,502709,599457,657953,705543,874465,3838320,200006,444022,644028,473254,479827,574851,631652,737688,1270162,4167434,8005754,9332392,9332392
Hungary,2039,HU,HUN,EUR,209932,463535,673467,500859,500260,583460,662113,689514,893271,3829477,197965,437455,635420,475484,477252,560052,634752,720305,1282913,4150758,7980235,9289117,9289117
Hungary,2040,HU,HUN,EUR,208105,456995,665100,501772,498161,568444,664260,667926,919117,3819680,196230,431282,627512,475988,475472,545702,636824,695808,1303366,4133160,7952840,9245460,9245460
Hungary,2041,HU,HUN,EUR,206547,450855,657402,501061,495851,556271,663200,647609,945184,3809176,194745,425470,620215,475101,473323,534156,636158,672319,1323821,4114878,7924054,9201661,9201661
Hungary,2042,HU,HUN,EUR,205204,445091,650295,498807,495073,546539,659132,630332,968120,3798003,193471,419998,613469,472732,472386,525505,632562,651572,1341198,4095955,7893958,9157724,9157724
Hungary,2043,HU,HUN,EUR,203990,439715,643705,496273,494579,539262,651609,616730,987828,3786281,192327,414890,607217,470066,471816,518752,626555,633859,1355521,4076569,7862850,9113778,9113778
Hungary,2044,HU,HUN,EUR,202893,434607,637500,493323,494201,533809,641548,606682,1004687,3774250,191291,410038,601329,467172,471294,513228,618485,619964,1366837,4056980,7831230,9070049,9070049
Hungary,2045,HU,HUN,EUR,201947,429753,631700,489518,496485,526151,630172,601406,1018218,3761950,190398,405421,595819,463513,473133,505974,608429,611252,1374923,4037224,7799174,9026703,9026703
Hungary,2046,HU,HUN,EUR,201084,425220,626304,485221,500590,516773,617022,601299,1028452,3749357,189576,401116,590692,459253,476894,496969,596608,607737,1379889,4017350,7766707,8983698,8983698
Hungary,2047,HU,HUN,EUR,200415,421031,621446,480574,503573,509778,602363,603953,1036108,3736349,188932,397149,586081,454606,480174,489495,583844,607565,1381621,3997305,7733654,8941182,8941182
Hungary,2048,HU,HUN,EUR,199981,417287,617268,474482,506615,505454,587386,607885,1041086,3722908,188514,393596,582110,448751,483328,484484,570444,609704,1380390,3977101,7700009,8899389,8899389
Hungary,2049,HU,HUN,EUR,199647,414049,613696,467514,509311,503097,572069,612538,1044485,3709014,188195,390523,578718,442197,485571,481952,555939,613049,1378011,3956719,7665733,8858142,8858142
Hungary,2050,HU,HUN,EUR,199382,411283,610665,460997,510265,501095,557735,615338,1049269,3694699,187939,387901,575840,436035,486088,480213,541894,615393,1376564,3936187,7630886,8817396,8817396
Indonesia,1970,ID,IDN,SEA,9786555,15105758,24892313,9754948,7945742,6299838,4149953,2805709,1653886,32610076,9440080,14679119,24119199,9804042,8399206,6417393,4123366,2945447,1917360,33606814,66216890,115228394,115228394
Indonesia,1971,ID,IDN,SEA,9940935,15620455,25561390,10132084,8014876,6469306,4284712,2871214,1733547,33505739,9587636,15175402,24763038,10107899,8497889,6631364,4254080,3013365,2012371,34516968,68022707,118347135,118347135
Indonesia,1972,ID,IDN,SEA,10081575,16119789,26201364,10557005,8077076,6633871,4435891,2931428,1814868,34450139,9721537,15657124,25378661,10463116,8581724,6837947,4405117,3075729,2110346,35473979,69924118,121504145,121504145
Indonesia,1973,ID,IDN,SEA,10224142,16594553,26818695,11028424,8135725,6792173,4599331,2987427,1899330,35442410,9856278,16115755,25972033,10873317,8648033,7035730,4573805,3134246,2210789,36475920,71918330,124709058,124709058
Indonesia,1974,ID,IDN,SEA,10359671,17046859,27406530,11532145,8207340,6942660,4770442,3042051,1986072,36480710,9983225,16552189,26535414,11331784,8706007,7223613,4757296,3190616,2313232,37522548,74003258,127945196,127945196
Indonesia,1975,ID,IDN,SEA,10488349,17475884,27964233,12060998,8303423,7083918,4945106,3098095,2074421,37565961,10101989,16965758,27067747,11833823,8764078,7400650,4952835,3246627,2417252,38615265,76181226,131213215,131213215
Indonesia,1976,ID,IDN,SEA,10620601,17877956,28498557,12602730,8435327,7214229,5120120,3158368,2163488,38694262,10222098,17353590,27575688,12357007,8844351,7565868,5157695,3304884,2522715,39752520,78446782,134521025,134521025
Indonesia,1977,ID,IDN,SEA,10752148,18257895,29010043,13143583,8613476,7332409,5294045,3225958,2252200,39861671,10338553,17720045,28058598,12879775,8966087,7718436,5369026,3368987,2628912,40931223,80792894,137861540,137861540
Indonesia,1978,ID,IDN,SEA,10884841,18624718,29509559,13678237,8841752,7437903,5466600,3304009,2339395,41067896,10453364,18072346,28525710,13396678,9133110,7857260,5583519,3442678,2734549,42147794,83215690,141250964,141250964
Indonesia,1979,ID,IDN,SEA,11026869,18973031,29999900,14204804,9120919,7530604,5637849,3395705,2424195,42314076,10574943,18403755,28978698,13905971,9346576,7981764,5798166,3529830,2838106,43400413,85714489,144693087,144693087
Indonesia,1980,ID,IDN,SEA,11170748,19303166,30473914,14724419,9448146,7611523,5807562,3503530,2505792,43600972,10695898,18714612,29410510,14409459,9605260,8093013,6010674,3634415,2938869,44691690,88292662,148177096,148177096
Indonesia,1981,ID,IDN,SEA,11305545,19618079,30923624,15237823,9818199,7686709,5974834,3627889,2583915,44929369,10805721,19007844,29813565,14906503,9905896,8195171,6218256,3757860,3036089,46019775,90949144,151686337,151686337
Indonesia,1982,ID,IDN,SEA,11437930,19919133,31357063,15737885,10236278,7756104,6138806,3766930,2660140,46296143,10911853,19283490,30195343,15390197,10257550,8283246,6419310,3899393,3130405,47380101,93676244,155228658,155228658
Indonesia,1983,ID,IDN,SEA,11552704,20221965,31774669,16215089,10701321,7822833,6297701,3916669,2735832,47689445,11000503,19557078,30557581,15852847,10664954,8355828,6613465,4057549,3224275,48768918,96458363,158790611,158790611
Indonesia,1984,ID,IDN,SEA,11631921,20526601,32158522,16670642,11199149,7902465,6449972,4073377,2812940,49108545,11055090,19828876,30883966,16293736,11120332,8420696,6798817,4229093,3318256,50180930,99289475,162331962,162331962
Indonesia,1985,ID,IDN,SEA,11650206,20826306,32476512,17103656,11722842,8006323,6594807,4234334,2894228,50556190,11053633,20091650,31145283,16711320,11618289,8485400,6974041,4411303,3413358,51613711,102169901,165791694,165791694
Indonesia,1986,ID,IDN,SEA,11596125,21120059,32716184,17509927,12260418,8145367,6729942,4396124,2980346,52022124,10987687,20344405,31332092,17103091,12137512,8571952,7138584,4602113,3511619,53064871,105086995,169135273,169135273
Indonesia,1987,ID,IDN,SEA,11504020,21410014,32914034,17893609,12797725,8329092,6853411,4556805,3071968,53502610,10888988,20588831,31477819,17471952,12655478,8697752,7290248,4797699,3613797,54526926,108029536,172421390,172421390
Indonesia,1988,ID,IDN,SEA,11408490,21682374,33090864,18263281,13328099,8559923,6963367,4715020,3169192,54998882,10788998,20812443,31601441,17825462,13166607,8866291,7427887,4995107,3722107,56003461,111002343,175694647,175694647
Indonesia,1989,ID,IDN,SEA,11317425,21928375,33245800,18613893,13849073,8838238,7059498,4870786,3273342,56504830,10696133,21009021,31705154,18158384,13670179,9079686,7552029,5192899,3840209,57493386,113998216,178949174,178949174
Indonesia,1990,ID,IDN,SEA,11244559,22117793,33362352,18946104,14361883,9161940,7143860,5025298,3387352,58026437,10622917,21151147,31774064,18470257,14167054,9336308,7663358,5389041,3971009,58997027,117023464,182159874,182159874
Indonesia,1991,ID,IDN,SEA,11228393,22228875,33457268,19262774,14867279,9526206,7222461,5178019,3511422,59568161,10603828,21219414,31823242,18763485,14655806,9632468,7765441,5580639,4114723,60512562,120080723,185361228,185361228
Indonesia,1992,ID,IDN,SEA,11234854,22298967,33533821,19565871,15358570,9936018,7295244,5328161,3644726,61128590,10606630,21251187,31857817,19038876,15129989,9977058,7853793,5766695,4271776,62038187,123166777,188558416,188558416
Indonesia,1993,ID,IDN,SEA,11226566,22346747,33573313,19871015,15826890,10390368,7364841,5473508,3784605,62711227,10598493,21264611,31863104,19312883,15583190,10375288,7927543,5947540,4443201,63589645,126300872,191737287,191737287
Indonesia,1994,ID,IDN,SEA,11231796,22363827,33595623,20178395,16274115,10876105,7446066,5612209,3929060,64315950,10606232,21251440,31857672,19585492,16015047,10819677,7993546,6120258,4625262,65159282,129475232,194928533,194928533
Indonesia,1995,ID,IDN,SEA,11272224,22340466,33612690,20481398,16699720,11386816,7549715,5743268,4077419,65938336,10649184,21203186,31852370,19849274,16424359,11305258,8058891,6283135,4815842,66736759,132675095,198140162,198140162
Indonesia,1996,ID,IDN,SEA,11331568,22302703,33634271,20778469,17099453,11910779,7685923,5864163,4227651,67566438,10712571,21144835,31857406,20102714,16808227,11811095,8144398,6435228,5014007,68315669,135882107,201373791,201373791
Indonesia,1997,ID,IDN,SEA,11410023,22248142,33658165,21071580,17477480,12434579,7864158,5973742,4379308,69200847,10795723,21074599,31870322,20348194,17170583,12316567,8267949,6575861,5219529,69898683,139099530,204628007,204628007
Indonesia,1998,ID,IDN,SEA,11494812,22173324,33668136,21347327,17842427,12952417,8087759,6072133,4533720,70835783,10883547,20990720,31874267,20573131,17518391,12816087,8433022,6704413,5432258,71477302,142313085,207855486,207855486
Indonesia,1999,ID,IDN,SEA,11542375,22113926,33656301,21595131,18186998,13460132,8355473,6157588,4689944,72445266,10932731,20927560,31860291,20769513,17844304,13307518,8640631,6820617,5652473,73035056,145480322,210996910,210996910
Indonesia,2000,ID,IDN,SEA,11558897,22105598,33664495,21784700,18511294,13958779,8665003,6231721,4848951,74000448,10950151,20917364,31867515,20909415,18147223,13791284,8888711,6924504,5878834,74539971,148540419,214072421,214072421
Indonesia,2001,ID,IDN,SEA,11554376,22169361,33723737,21894869,18818301,14449559,9012345,6300888,5011185,75487147,10946008,20978736,31924744,20974171,18430206,14266991,9174602,7020320,6110519,75976809,151463956,217112437,217112437
Indonesia,2002,ID,IDN,SEA,11524563,22272705,33797268,21962608,19109055,14925406,9402102,6365390,5176523,76941084,10916337,21079873,31996210,21000892,18693371,14728054,9506632,7104174,6347413,77380536,154321620,220115092,220115092
Indonesia,2003,ID,IDN,SEA,11492464,22367055,33859519,22007126,19398922,15377345,9832996,6427550,5342084,78386023,10884455,21174265,32058720,21007688,18951644,15166638,9888450,7174070,6587371,78775861,157161884,223080121,223080121
Indonesia,2004,ID,IDN,SEA,11484082,22429116,33913198,22016383,19684113,15802907,10288832,6496986,5499657,79788878,10875346,21236897,32112243,20982459,19201121,15577373,10308580,7232798,6821943,80124274,159913152,225938595,225938595
Indonesia,2005,ID,IDN,SEA,11513057,22493131,34006188,21986605,19963896,16205997,10767155,6586369,5651256,81161278,10902838,21300584,32203422,20922589,19440037,15964097,10766117,7289876,7051541,81434257,162595535,228805144,228805144
Indonesia,2006,ID,IDN,SEA,11584319,22559703,34144022,21948077,20241786,16586468,11260040,6707261,5797674,82541306,10972324,21369110,32341434,20860416,19674955,16332186,11248529,7371237,7283338,82770661,165311967,231797427,231797427
Indonesia,2007,ID,IDN,SEA,11703250,22618802,34322052,21894424,20516660,16945961,11753307,6866803,5937191,83914346,11088292,21430872,32519164,20788424,19902990,16679619,11731372,7489008,7511308,84102721,168017067,234858289,234858289
Indonesia,2008,ID,IDN,SEA,11853468,22681443,34534911,21821460,20775114,17292512,12240864,7066930,6069772,85266652,11234914,21494321,32729235,20702703,20110017,17011234,12207169,7643864,7730764,85405751,170672403,237936543,237936543
Indonesia,2009,ID,IDN,SEA,11996204,22736737,34732941,21764613,21008538,17620135,12718749,7305776,6194049,86611860,11374717,21549359,32924076,20639200,20291659,17322911,12676096,7838441,7944115,86712422,173324282,240981299,240981299
Indonesia,2010,ID,IDN,SEA,12113830,22798612,34912442,21761282,21190533,17931617,13190073,7582648,6314079,87970232,11489888,21609764,33099652,20631807,20423472,17615606,13139605,8071321,8152043,88033854,176004086,244016173,244016173
Indonesia,2011,ID,IDN,SEA,12224980,22875916,35100896,21832774,21301610,18230840,13656494,7894114,6434602,89350434,11596898,21683720,33280618,20698493,20487240,17891856,13596136,8338650,8355370,89367745,178718179,247099697,247099697
Indonesia,2012,ID,IDN,SEA,12319934,22975339,35295273,21945706,21376995,18517859,14109652,8241846,6552162,90744220,11687011,21778503,33465514,20807214,20519859,18152490,14039901,8647985,8550245,90717694,181461914,250222695,250222695
Indonesia,2013,ID,IDN,SEA,12359690,23103139,35462829,22049983,21433231,18806438,14540259,8623743,6665929,92119583,11724332,21901861,33626193,20910859,20538360,18412740,14464875,9003971,8736505,92067310,184186893,253275918,253275918
Indonesia,2014,ID,IDN,SEA,12358003,23253280,35611283,22128726,21461913,19097723,14951874,9031443,6788090,93459769,11722189,22048471,33770660,20990618,20533870,18672743,14871133,9400624,8919054,93388042,186847811,256229761,256229761
Indonesia,2015,ID,IDN,SEA,12322292,23415535,35737827,22208903,21453396,19385627,15344480,9460593,6926502,94779501,11688403,22206711,33895114,21070686,20496741,18924221,15256093,9832090,9099697,94679528,189459029,259091970,259091970
Indonesia,2016,ID,IDN,SEA,12221618,23606553,35828171,22283916,21431888,19668012,15712702,9900261,7084856,96081635,11593965,22391013,33984978,21146679,20451241,19166021,15617089,10280856,9293514,95955400,192037035,261850182,261850182
Indonesia,2017,ID,IDN,SEA,12056789,23827901,35884690,22350176,21394844,19947240,16060459,10339493,7268496,97360708,11438361,22603678,34042039,21214324,20395249,19400677,15957651,10729377,9514128,97211406,194572114,264498852,264498852
Indonesia,2018,ID,IDN,SEA,11886975,24025169,35912144,22419006,21339194,20212095,16397818,10775412,7481011,98624536,11276612,22794137,34070749,21283648,20327866,19618421,16286919,11175369,9767190,98459413,197083949,267066843,267066843
Indonesia,2019,ID,IDN,SEA,11741348,24173939,35915287,22480297,21299477,20454288,16720030,11206174,7722888,99883154,11136086,22938987,34075073,21344638,20282441,19812755,16599108,11617505,10052919,99709366,199592520,269582878,269582878
Indonesia,2020,ID,IDN,SEA,11615021,24263722,35878743,22548728,21310356,20641010,17015163,11605263,7928323,101048843,11012577,23027659,34040236,21410921,20289559,19953877,16884722,12039034,10312041,100890154,201938997,271857970,271857970
Indonesia,2021,ID,IDN,SEA,11507614,24281478,35789092,22631559,21390040,20748166,17277087,11958254,8058282,102063388,10906703,23046898,33953601,21490650,20366225,20021244,17140652,12427172,10501171,101947114,204010502,273753191,273753191
Indonesia,2022,ID,IDN,SEA,11419556,24217862,35637418,22732492,21503968,20815617,17523117,12294273,8196389,103065856,10819770,22987018,33806788,21587930,20478585,20053506,17378204,12797858,10695190,102991273,206057129,275501339,275501339
Indonesia,2023,ID,IDN,SEA,11345991,24093695,35439686,22861044,21608857,20872225,17795679,12659924,8470410,104268139,10748353,22868148,33616501,21712050,20583652,20075565,17630815,13182380,11025329,104209791,208477930,277534122,277534122
Indonesia,2024,ID,IDN,SEA,11276803,23951927,35228730,23013031,21690313,20908408,18089433,13047207,8858167,105606559,10683257,22731197,33414454,21860364,20666290,20079474,17895802,13574996,11471382,105548308,211154867,279798049,279798049
Indonesia,2025,ID,IDN,SEA,11215120,23794542,35009662,23176795,21772491,20907277,18378769,13416772,9268474,106920578,10626005,22578942,33204947,22020552,20749572,20051813,18153269,13949231,11944685,106869122,213789700,282004306,282004306
Indonesia,2026,ID,IDN,SEA,11161387,23590238,34751625,23369146,21849623,20893611,18662884,13765614,9699220,108240098,10576780,22383031,32959811,22206977,20829099,20016318,18401761,14302353,12443141,108199649,216439747,284151182,284151182
Indonesia,2027,ID,IDN,SEA,11113582,23340953,34454535,23591623,21918205,20865022,18944167,14097159,10146183,109562359,10533766,22144918,32678684,22421943,20900717,19970996,18643811,14637521,12962676,109537664,219100023,286233232,286233232
Indonesia,2028,ID,IDN,SEA,11077820,23101383,34179203,23790110,21988924,20817626,19210708,14418559,10605873,110831800,10501442,21916396,32417838,22614831,20973300,19913606,18868338,14961204,13500518,110831797,221663597,288260632,288260632
Indonesia,2029,ID,IDN,SEA,11051543,22889995,33941538,23940166,22051841,20785108,19454141,14725258,11075986,112032500,10477359,21715078,32192437,22762154,21036901,19876714,19068611,15267738,14054826,112066944,224099444,290233414,290233414
Indonesia,2030,ID,IDN,SEA,11028579,22704517,33733096,24031182,22120456,20800545,19646458,15017862,11555633,113172136,10456532,21537826,31994358,22853451,21105046,19890715,19219035,15557293,14624971,113250511,226422647,292150100,292150100
Indonesia,1950,ID,IDN,SEA,5256227,8903507,14159734,7255687,5045576,3907282,2477575,1187479,526687,20400286,5334836,9218804,14553640,7231821,4873165,3829517,2473228,1359150,687076,20453957,40854243,69567619,69567619
Indonesia,1951,ID,IDN,SEA,5346153,8945868,14292021,7431354,5192095,3985505,2582358,1255956,561824,21009092,5349650,9286359,14636009,7447632,5008588,3902171,2569967,1426503,727365,21082226,42091318,71019347,71019347
Indonesia,1952,ID,IDN,SEA,5484621,8977821,14462442,7599978,5358258,4055602,2686767,1327557,598910,21627072,5419908,9337495,14757403,7654041,5168053,3967458,2670987,1493602,769763,21723904,43350976,72570827,72570827
Indonesia,1953,ID,IDN,SEA,5675076,9004125,14679201,7756916,5535370,4116939,2792121,1402291,637852,22241489,5552473,9369574,14922047,7845965,5344478,4025858,2775525,1559336,814082,22365244,44606733,74207986,74207986
Indonesia,1954,ID,IDN,SEA,5901234,9043476,14944710,7900724,5717658,4173321,2896812,1480213,678561,22847289,5738192,9392649,15130841,8022466,5534063,4079332,2881251,1625118,860254,23002484,45849773,75925325,75925325
Indonesia,1955,ID,IDN,SEA,6152336,9109328,15261664,8033745,5903784,4230362,3000370,1561930,721428,23451619,5968437,9416573,15385010,8186568,5736993,4131674,2986277,1693110,908581,23643203,47094822,77741502,77741502
Indonesia,1956,ID,IDN,SEA,6418588,9215166,15633754,8154789,6090320,4292178,3101396,1647800,766596,24053079,6222701,9465766,15688467,8337595,5950133,4186061,3088769,1764586,959383,24286527,48339606,79661837,79661837
Indonesia,1957,ID,IDN,SEA,6692224,9372221,16064445,8262267,6275157,4362657,3197997,1737333,814078,24649489,6484220,9560831,16045051,8474841,6170193,4247009,3187335,1839754,1012865,24931997,49581486,81690984,81690984
Indonesia,1958,ID,IDN,SEA,6969538,9583772,16553310,8352835,6455156,4444678,3288162,1828855,863754,25233440,6748444,9705467,16453911,8597272,6393512,4319415,3280594,1918154,1069138,25578085,50811525,83818754,83818754
Indonesia,1959,ID,IDN,SEA,7248666,9850485,17099151,8426613,6630907,4542751,3371608,1920914,915874,25808667,7014111,9900993,16915104,8704395,6616746,4408317,3367390,1999395,1128504,26224747,52033414,86047674,86047674
Indonesia,1960,ID,IDN,SEA,7532105,10169670,17701775,8485894,6803907,4661123,3449944,2010709,970691,26382268,7283692,10145172,17428864,8796050,6836052,4517729,3446358,2082792,1190988,26869969,53252237,88382881,88382881
Indonesia,1961,ID,IDN,SEA,7816723,10536194,18352917,8536593,6972682,4800433,3523426,2097261,1028395,26958790,7553536,10434732,17988268,8877097,7048627,4649773,3517140,2168543,1255776,27516956,54475746,90816938,90816938
Indonesia,1962,ID,IDN,SEA,8095050,10955258,19050308,8579399,7137233,4958582,3590468,2184215,1089370,27539267,7816979,10779347,18596326,8942459,7253057,4803697,3581162,2257926,1321289,28159590,55698857,93345489,93345489
Indonesia,1963,ID,IDN,SEA,8365318,11425455,19790773,8618060,7295789,5130447,3651571,2272916,1153546,28122329,8073006,11183223,19256229,8989946,7448235,4976693,3640456,2350853,1387005,28793188,56915517,95962527,95962527
Indonesia,1964,ID,IDN,SEA,8626854,11931983,20558837,8670588,7447205,5311256,3710372,2362185,1221084,28722690,8321223,11640231,19961454,9031209,7635276,5166895,3697753,2446146,1454799,29432078,58154768,98675061,98675061
Indonesia,1965,ID,IDN,SEA,8840077,12452921,21292998,8711213,7545348,5469367,3752259,2436356,1279543,29194086,8525148,12131134,20656282,9059717,7797046,5361350,3747085,2534185,1515127,30014510,59208596,101157868,101157868
Indonesia,1966,ID,IDN,SEA,9029001,12977975,22006976,8776117,7611756,5615370,3792620,2505367,1338732,29639962,8708150,12635551,21343701,9096488,7929125,5556059,3793546,2617772,1577481,30570471,60210433,103561105,103561105
Indonesia,1967,ID,IDN,SEA,9233924,13513942,22747866,8922157,7696381,5779535,3856099,2584475,1412617,30251264,8907248,13150028,22057276,9181780,8050609,5760929,3851479,2704956,1654590,31204343,61455607,106260749,106260749
Indonesia,1968,ID,IDN,SEA,9428587,14052527,23481114,9138876,7784004,5951255,3936101,2662077,1491421,30963734,9096089,13665816,22761905,9331215,8172071,5976694,3924062,2790186,1737745,31931973,62895707,109138723,109138723
Indonesia,1969,ID,IDN,SEA,9612986,14583312,24196298,9421158,7870132,6126447,4033770,2735905,1572839,31760251,9273987,14175660,23449647,9543172,8291433,6197983,4013915,2870901,1825645,32743049,64503300,112149246,112149246
Indonesia,2031,ID,IDN,SEA,11011056,22544958,33556014,24050372,22203528,20883312,19768136,15299542,12045511,114250401,10440704,21385426,31826130,22875601,21186270,19972931,19302379,15833252,15210854,114381287,228631688,294013829,294013829
Indonesia,2032,ID,IDN,SEA,10998552,22410462,33409014,23989057,22308043,21002706,19853634,15570877,12540802,115265119,10429340,21258080,31687420,22819363,21287833,20092647,19353506,16095366,15807196,115455911,230721030,295817463,295817463
Indonesia,2033,ID,IDN,SEA,10986490,22302890,33289380,23867915,22440262,21112451,19920879,15844377,13034704,116220588,10418370,21157102,31575472,22704469,21417022,20204769,19389013,16356095,16406947,116478315,232698903,297563755,297563755
Indonesia,2034,ID,IDN,SEA,10972248,22209298,33181546,23729098,22593856,21196596,19962256,16120785,13528782,117131373,10405062,21070493,31475555,22571116,21568599,20292334,19401995,16616798,17011866,117462708,234594081,299251173,299251173
Indonesia,2035,ID,IDN,SEA,10957693,22126380,33084073,23574612,22758780,21281035,19968271,16394493,14023562,118000753,10390929,20994758,31385687,22422267,21731573,20380038,19384492,16871522,17622267,118412159,236412912,300882677,300882677
Indonesia,2036,ID,IDN,SEA,10945110,22056727,33001837,23373624,22951712,21360340,19962931,16664339,14515197,118828143,10378485,20931839,31310324,22229808,21920273,20463692,19359581,17118537,18233483,119325374,238153517,302465687,302465687
Indonesia,2037,ID,IDN,SEA,10931997,21997893,32929890,23128080,23174128,21431016,19943982,16932313,15002993,119612512,10365714,20879370,31245084,21995203,22136952,20539181,19325305,17360106,18844489,120201236,239813748,303988726,303988726
Indonesia,2038,ID,IDN,SEA,10915307,21951353,32866660,22892048,23372563,21503459,19907459,17187797,15490935,120354261,10349480,20837767,31187247,21769917,22331358,20615184,19279326,17585835,19458486,121040106,241394367,305448276,305448276
Indonesia,2039,ID,IDN,SEA,10895727,21912047,32807774,22683828,23522967,21568140,19885672,17422521,15974045,121057173,10330564,20801926,31132490,21571472,22480222,20682080,19253244,17788986,20069173,121845177,242902350,306842611,306842611
Indonesia,2040,ID,IDN,SEA,10868941,21875707,32744648,22501223,23614916,21638413,19909605,17610228,16452104,121726489,10305143,20768392,31073535,21396799,22573216,20753304,19276143,17945006,20675660,122620128,244346617,308164809,308164809
Indonesia,2041,ID,IDN,SEA,10830819,21846701,32677520,22344247,23635824,21722962,19997335,17733307,16928919,122362594,10268954,20741407,31010361,21246680,22597363,20837330,19364530,18037576,21280594,123364073,245726667,309414550,309414550
Indonesia,2042,ID,IDN,SEA,10787564,21822128,32609692,22212010,23577129,21828682,20119939,17823941,17401970,122963671,10227697,20718426,30946123,21121319,22543486,20941340,19488886,18099792,21879351,124074174,247037845,310593657,310593657
Indonesia,2043,ID,IDN,SEA,10741622,21794381,32536003,22106404,23459267,21961530,20233176,17899498,17876011,123535886,10183721,20692285,30876006,21022069,22431245,21072436,19605577,18147899,22476810,124756036,248291922,311703932,311703932
Indonesia,2044,ID,IDN,SEA,10685146,21761599,32446745,22014674,23323940,22115137,20321392,17953055,18352244,124080442,10129534,20661103,30790637,20937081,22300622,21225393,19698042,18175518,23074834,125411490,249491932,312729314,312729314
Indonesia,2045,ID,IDN,SEA,10619171,21721348,32340519,21933566,23173201,22279755,20409349,17975537,18826665,124598073,10066150,20622558,30688708,20862886,22154606,21389447,19790211,18174727,23667799,126039676,250637749,313666981,313666981
Indonesia,2046,ID,IDN,SEA,10551993,21671759,32223752,21865660,22976668,22471965,20492463,17989376,19296271,125092403,10001414,20574903,30576317,20801422,21965368,21578911,19878383,18167508,24251082,126642674,251735077,314535140,314535140
Indonesia,2047,ID,IDN,SEA,10480050,21616554,32096604,21808486,22736242,22693140,20567295,17992633,19762919,125560715,9932138,20521846,30453984,20750338,21734369,21795958,19958520,18152135,24826734,127218054,252778769,315329358,315329358
Indonesia,2048,ID,IDN,SEA,10396641,21555131,31951772,21763507,22505217,22890546,20643517,17981014,20220813,126004614,9852270,20462600,30314870,20710027,21512574,21990778,20038894,18125987,25388328,127766588,253771202,316037840,316037840
Indonesia,2049,ID,IDN,SEA,10313563,21480375,31793938,21725701,22301644,23040565,20712527,17983849,20659465,126423751,9772818,20390478,30163296,20675424,21317363,22140405,20110486,18118894,25925439,128288011,254711762,316669001,316669001
Indonesia,2050,ID,IDN,SEA,10232934,21389006,31621940,21690865,22123374,23133146,20787595,18027996,21057775,126820751,9695675,20302661,29998336,20643088,21145711,22234788,20186626,18157633,26416335,128784181,255604932,317225213,317225213
India,1970,IN,IND,SEA,45118011,73166602,118284613,53740097,37591479,30523908,22833332,15164450,10154520,170007786,42474466,68054914,110529380,49676682,35601476,28102723,20768095,14477238,10053299,158679513,328687299,557501301,557501301
India,1971,IN,IND,SEA,45985696,74558756,120544452,55873135,38184875,31010687,23285272,15460024,10460497,174274490,43276334,69384935,112661269,51492176,36082633,28697810,21145389,14757502,10343459,162518969,336793459,569999178,569999178
India,1972,IN,IND,SEA,46883481,75963459,122846940,58044307,38815207,31517287,23748599,15755364,10801673,178682437,44097667,70723670,114821337,53331842,36599432,29319802,21535643,15017608,10682934,166487261,345169698,582837973,582837973
India,1973,IN,IND,SEA,47790484,77414204,125204688,60216558,39547862,32035953,24225535,16060943,11173922,183260773,44923825,72098425,117022250,55204390,37181495,29947916,21948132,15271764,11066083,170619780,353880553,596107483,596107483
India,1974,IN,IND,SEA,48739506,78902949,127642455,62076141,40669079,32533858,24709938,16387859,11564737,187941612,45787458,73499721,119287179,56884402,38037856,30524030,22390729,15538389,11475300,174850706,362792318,609721951,609721951
India,1975,IN,IND,SEA,49672315,80408171,130080486,63647960,42171661,33001502,25197703,16737336,11964305,192720467,46631980,74908943,121540923,58360540,39201755,31030433,22866553,15823892,11899171,179182344,371902811,623524219,623524219
India,1976,IN,IND,SEA,50558307,81951545,132509852,65188316,43784477,33446750,25683633,17102291,12362272,197567739,47426653,76347379,123774032,59811622,40477173,31484361,23372080,16124353,12330246,183599835,381167574,637451448,637451448
India,1977,IN,IND,SEA,51383853,83551957,134935810,66719629,45538088,33904935,26172753,17480298,12744813,202560516,48159902,77834039,125993941,61266005,41897273,31920782,23913423,16441149,12756731,188195363,390755879,651685628,651685628
India,1978,IN,IND,SEA,52122668,85214388,137337056,68248284,47443392,34399619,26666928,17868192,13106139,207732554,48806423,79377458,128183881,62732690,43475482,32366933,24490690,16774793,13173679,193014267,400746821,666267760,666267760
India,1979,IN,IND,SEA,52878281,86947434,139825715,69741163,49459744,34930570,27159313,18260498,13449326,213000614,49460550,80982770,130443320,64176233,45171047,32833779,25090445,17122785,13584445,197978734,410979348,681248383,681248383
India,1980,IN,IND,SEA,53787085,88717512,142504597,71201970,51568877,35517767,27649859,18656640,13775618,218370731,50245543,82612413,132857956,65598922,46964796,33350964,25701985,17487696,13990731,203095094,421465825,696828385,696828385
India,1981,IN,IND,SEA,54823032,90527353,145350385,72631780,53723658,36152604,28145796,19059102,14086520,223799460,51142255,84264540,135406795,66995944,48805687,33913401,26332376,17870339,14394914,208312661,432112121,712869298,712869298
India,1982,IN,IND,SEA,55921160,92322053,148243213,74060693,55905523,36816787,28656552,19471330,14388423,229299308,52108915,85887729,137996644,68389128,50669182,34508144,26990056,18270529,14803270,213630309,442929617,729169466,729169466
India,1983,IN,IND,SEA,57094462,94054514,151148976,75537986,58087392,37570832,29174754,19895824,14686508,234953296,53161109,87443380,140604489,69821693,52571247,35157944,27653118,18695346,15220444,219119792,454073088,745826546,745826546
India,1984,IN,IND,SEA,58290997,95839238,154130235,77051177,59981991,38708327,29678853,20331314,14983598,240735260,54244404,89038415,143282819,71278214,54312512,36079242,28274490,19154032,15648351,224746841,465482101,762895156,762895156
India,1985,IN,IND,SEA,59395775,97753553,157149328,78569895,61603713,40222613,30161128,20776023,15283723,246617095,55260554,90737969,145998523,72728033,55870828,37303224,28836711,19648746,16089594,230477136,477094231,780242084,780242084
India,1986,IN,IND,SEA,60430700,99754031,160184731,80116130,63198358,41860147,30633666,21228181,15590469,252626951,56230081,92503625,148733706,74189861,57413339,38649354,29358197,20176258,16546599,236333608,488960559,797878993,797878993
India,1987,IN,IND,SEA,61406273,101769183,163175456,81710925,64753797,43616331,31113612,21684857,15905550,258785072,57132645,94287778,151420423,75683395,58928170,40114256,29855664,20733809,17019883,242335177,501120249,815716125,815716125
India,1988,IN,IND,SEA,62266327,103783010,166049337,83377046,66279614,45492285,31617977,22144268,16233855,265145045,57917157,96081723,153998880,77236277,60423879,41699926,30348473,21316696,17511163,248536414,513681459,833729681,833729681
India,1989,IN,IND,SEA,62996426,105831239,168827665,85129008,67774003,47474532,32158194,22604671,16583221,271723629,58598665,97915875,156514540,78861056,61896644,43392910,30856936,21915345,18023951,254946842,526670471,852012673,852012673
India,1990,IN,IND,SEA,63584111,107934818,171518929,86929741,69232132,49534577,32746947,23063065,16958673,278465135,59147728,99815271,158962999,80518791,63339358,45165202,31403642,22517663,18560449,261505105,539970240,870452165,870452165
India,1991,IN,IND,SEA,64066184,110094245,174160429,88755528,70646994,51631072,33378105,23527020,17364337,285303056,59561839,101782487,161344326,82181815,64740666,46974657,31986406,23131781,19118616,268133941,553436997,888941756,888941756
India,1992,IN,IND,SEA,64537929,112268757,176806686,90559194,72065360,53760814,34041258,24007645,17805138,292239409,59932989,103767311,163700300,83809313,66140163,48814253,32599549,23768270,19696105,274827653,567067062,907574049,907574049
India,1993,IN,IND,SEA,65019396,114415272,179434668,92311998,73537437,55888059,34787168,24495524,18281123,299301309,60274335,105727739,166002074,85384127,67581036,50690069,33258863,24405369,20293786,281613250,580914559,926351297,926351297
India,1994,IN,IND,SEA,65508445,116457711,181966156,94121783,75051831,57740735,35894068,24971915,18788915,306569247,60553538,107611525,168165063,87007139,69050500,52413542,34172778,25001879,20915655,288561493,595130740,945261958,945261958
India,1995,IN,IND,SEA,66076556,118274880,184351436,96054004,76575467,59336157,37356923,25431423,19327053,314081027,60846968,109299513,170146481,88731235,70517469,53968591,35374807,25544361,21563717,295700180,609781207,964279129,964279129
India,1996,IN,IND,SEA,66617872,119920815,186538687,98061994,78125142,60908223,38935699,25884892,19894524,321810474,61113579,110807781,171921360,90513538,71996759,55516974,36694966,26050821,22237647,303010705,624821179,983281218,983281218
India,1997,IN,IND,SEA,67072583,121500809,188573392,100090576,79729623,62446650,40628289,26346576,20488515,329730229,61321066,112213249,173534315,92322214,73516588,57048957,38134020,26537194,22938323,310497296,640227525,1002335230,1002335230
India,1998,IN,IND,SEA,67509757,122978738,190488495,102115446,81385875,63937247,42425749,26826533,21108072,337798922,61533404,113477826,175011230,94137542,75077922,58549639,39686453,27017928,23666445,318135929,655934851,1021434576,1021434576
India,1999,IN,IND,SEA,67887247,124332227,192219474,104162345,83096277,65369221,44310716,27333006,21753324,346024889,61747524,114574211,176321735,95978042,76681765,60006405,41336775,27510436,24420532,325933955,671958844,1040500054,1040500054
India,2000,IN,IND,SEA,68232005,125622332,193854337,106251265,84826358,66739205,46254763,27877680,22419969,354369240,61990416,115554836,177545252,97867943,78292883,61413061,43058276,28036071,25196608,333864842,688234082,1059633675,1059633675
India,2001,IN,IND,SEA,68653757,126782979,195436736,108391183,86585985,68073246,48230489,28463968,23109730,362854601,62341686,116381853,178723539,99820243,79919312,62789859,44822369,28600482,26003765,341956030,704810631,1078970907,1078970907
India,2002,IN,IND,SEA,69056765,127844372,196901137,110543072,88328132,69418725,50231067,29087941,23824798,371433735,62711762,117109214,179820976,101789753,81519461,64175156,46619342,29202202,26851270,350157184,721590919,1098313039,1098313039
India,2003,IN,IND,SEA,69313848,128894716,198208564,112661355,90005549,70806725,52212018,29794621,24547411,380027679,62960741,117815908,180776649,103734928,83055470,65591698,48443695,29854387,27722056,358402234,738429913,1117415123,1117415123
India,2004,IN,IND,SEA,69431378,129897998,199329376,114677226,91735386,72233014,53928595,30835285,25251480,388660986,63077531,118464106,181541637,105612415,84636643,67032413,50118783,30751302,28581022,366732578,755393564,1136264583,1136264583
India,2005,IN,IND,SEA,69307835,130945077,200252912,116452866,93572106,73666113,55400818,32204835,25928018,397224756,62982549,119149327,182131876,107284957,86304767,68467950,51631700,31925490,29414307,375029171,772253927,1154638713,1154638713
India,2006,IN,IND,SEA,68845552,132035168,200880720,118034269,95461819,75119527,56846064,33683504,26585487,405730670,62583875,119912025,182495900,108758113,88009584,69911119,53136970,33219094,30231608,383266488,788997158,1172373788,1172373788
India,2007,IN,IND,SEA,68227475,133016636,201244111,119544935,97353033,76610524,58257616,35259949,27236109,414262166,62028978,120638467,182667445,110125430,89721426,71379364,54624220,34628564,31039077,391518081,805780247,1189691809,1189691809
India,2008,IN,IND,SEA,67644270,133828656,201472926,120956205,99229304,78138359,59631331,36917893,27896002,422769094,61499254,121257481,182756735,111353718,91429159,72877395,56084186,36146041,31845551,399736050,822505144,1206734806,1206734806
India,2009,IN,IND,SEA,67147005,134445778,201592783,122260233,101134259,79717532,60967513,38635310,28584773,431299620,61055314,121744835,182800149,112427804,93169697,74418151,57511074,37754069,32666813,407947608,839247228,1223640160,1223640160
India,2010,IN,IND,SEA,66762871,134802023,201564894,123554189,103128970,81337711,62272858,40383313,29324092,440001133,60708486,122052498,182760984,113438378,95008404,75986723,58904544,39423313,33525238,416286600,856287733,1240613620,1240613620
India,2011,IN,IND,SEA,66474692,134906156,201380848,124775311,105229919,83015156,63569879,42136762,30136510,448863537,60446589,122172443,182619032,114352288,96964460,77592907,60280108,41120687,34447316,424757766,873621303,1257621191,1257621191
India,2012,IN,IND,SEA,66183817,134841683,201025500,125920639,107372807,84697299,64891585,43892550,31039060,457813940,60202030,122160151,182362181,115188736,98965070,79183471,61662901,42828890,35456527,433285595,891099535,1274487215,1274487215
India,2013,IN,IND,SEA,65804976,134668742,200473718,127058429,109501782,86339532,66258075,45621730,32069617,466849165,59904034,122059340,181963374,116007161,100955974,80716573,63065636,44535571,36564891,441845806,908694971,1291132063,1291132063
India,2014,IN,IND,SEA,65168127,134444055,199612182,128141326,111537039,88049273,67656244,47132058,33421238,475937178,59387137,121905853,181292990,116757895,102879645,82290230,64473531,46082199,37920661,450404161,926341339,1307246509,1307246509
India,2015,IN,IND,SEA,64354206,134088812,198443018,129251953,113356127,89896526,69064114,48454488,35076981,485100189,58723396,121626760,180350156,117527616,104614817,83964350,65866869,47462893,39536585,458973130,944073319,1322866505,1322866505
India,2016,IN,IND,SEA,63629059,133493878,197122937,130435637,115062504,91862611,70514231,49778789,36846714,494500486,58153664,121128282,179281946,118406083,106227880,85726934,67278560,48821889,41269631,467730977,962231463,1338636340,1338636340
India,2017,IN,IND,SEA,62896956,132738202,195635158,131524832,116743757,93867544,72017278,51094642,38704683,503952736,57577817,120484396,178062213,119261223,107778667,87527246,68724968,50153956,43099520,476545580,980498316,1354195680,1354195680
India,2018,IN,IND,SEA,62141421,131913322,194054743,132387914,118289027,95848017,73560529,52390025,40618975,513094487,56980557,119795868,176776425,119944741,109153839,89317928,70205216,51456484,44999440,485077648,998172135,1369003306,1369003306
India,2019,IN,IND,SEA,61477642,130905731,192383373,133021814,119693346,97839559,75159757,53661179,42566025,521941680,56478244,118963642,175441886,120455232,110341526,91132445,71735104,52731467,46949332,493345106,1015286786,1383112050,1383112050
India,2020,IN,IND,SEA,60771734,129827609,190599343,133434638,121095614,99895135,76778411,54847880,44346418,530398096,55952175,118077744,174029919,120819927,111464542,93025155,73280453,53944686,48824993,501359756,1031757852,1396387127,1396387127
India,2021,IN,IND,SEA,59967171,128911644,188878815,133594288,122376710,101964720,78327264,55818418,45543210,537624610,55340255,117350172,172690427,120991319,112441657,94965021,74773725,54992444,50205820,508369986,1045994596,1407563842,1407563842
India,2022,IN,IND,SEA,59256095,127961082,187217177,133527629,123497216,103996940,79796269,56701303,46443962,543963319,54808228,116608844,171417072,120970411,113262954,96888956,76192915,55969788,51290575,514575599,1058538918,1417173173,1417173173
India,2023,IN,IND,SEA,58663972,126894127,185558099,133354021,124618560,106069773,81353714,57874126,48023244,551293438,54385167,115789762,170174929,120863596,114067105,98835085,77652477,57172070,53010872,521601205,1072894643,1428627663,1428627663
India,2024,IN,IND,SEA,58221720,125660525,183882245,133143346,125711062,108110577,83080714,59285239,50179380,559510318,54104743,114848095,168952838,120721402,114824838,100756450,79236211,58558922,55276632,529374455,1088884773,1441719852,1441719852
India,2025,IN,IND,SEA,58014250,124194308,182208558,132806288,126837688,109951308,84934026,60704418,52361447,567595175,54041560,113721724,167763284,120459061,115610319,102507439,80925993,59955965,57580927,537039704,1104634879,1454606724,1454606724
India,2026,IN,IND,SEA,57882165,122692110,180574275,132227018,127998919,111646630,86877417,62153410,54578932,575482326,54047804,112576865,166624669,119975800,116463867,104104390,82688457,61381907,59935513,544549934,1120032260,1467231210,1467231210
India,2027,IN,IND,SEA,57732548,121273124,179005672,131485585,129044720,113293139,88844864,63644284,56826006,583138598,54035280,111504346,165539626,119346863,117271024,105615451,84477758,62846068,62337465,551894629,1135033227,1479578522,1479578522
India,2028,IN,IND,SEA,57564222,119961347,177525569,130683872,129915496,114855505,90817070,65181063,59099587,590552593,53996725,110530334,164527059,118683540,117961404,107001503,86280279,64352961,64786129,559065816,1149618409,1491671049,1491671049
India,2029,IN,IND,SEA,57351453,118891304,176242757,129704547,130586598,116312741,92824557,66775150,61393216,597596809,53905705,109790483,163696188,117882105,118510441,108233629,88121818,65910428,67276426,565934847,1163531656,1503470597,1503470597
India,2030,IN,IND,SEA,57112259,118001120,175113379,128646610,130989552,117717972,94882459,68397530,63691111,604325234,53781128,109229978,163011106,117018789,118866699,109356785,90023470,67485326,69793295,572544364,1176869598,1514994080,1514994080
India,1950,IN,IND,SEA,27330184,41476030,68806214,35309586,28199773,21601541,15177221,8893991,5448763,114630875,26240907,40314963,66555870,33293159,25791397,19958926,13843749,8516735,5624168,107028134,221659009,357021100,357021100
India,1951,IN,IND,SEA,28702955,42050457,70753412,35807276,28718747,22010096,15558450,9168490,5602785,116865844,27349913,40783732,68133645,33927745,26213597,20333090,14189656,8737257,5768113,109169458,226035302,364922360,364922360
India,1952,IN,IND,SEA,30120329,42655981,72776310,36306803,29231028,22398323,15918114,9448767,5808127,119111162,28491434,41285557,69776991,34574742,26634962,20661993,14515254,8969876,5975893,111332720,230443882,372997188,372997188
India,1953,IN,IND,SEA,31564012,43349956,74913968,36781378,29720786,22770629,16264588,9738944,6039993,121316318,29687849,41839867,71527716,35192587,27051100,20955949,14835515,9216088,6218459,113469698,234786016,381227705,381227705
India,1954,IN,IND,SEA,32743653,44470758,77214411,37219406,30196766,23152100,16616568,10046451,6260373,123491664,30737608,42710861,73448469,35739287,27486826,21248782,15177204,9480495,6444263,115576857,239068521,389731406,389731406
India,1955,IN,IND,SEA,33657920,46019915,79677835,37629929,30672255,23556940,16983984,10371469,6457669,125672246,31602437,43945270,75547707,36211910,27960434,21559323,15548595,9762277,6637675,117680214,243352460,398577992,398577992
India,1956,IN,IND,SEA,34545952,47710689,82256641,38025840,31143683,23979209,17362877,10711058,6628428,127851095,32442207,45329114,77771321,36629684,28464698,21882872,15948400,10052153,6799729,119777536,247628631,407656597,407656597
India,1957,IN,IND,SEA,35394876,49532612,84927488,38427269,31610364,24418374,17752077,11056241,6773486,130037811,33243854,46851301,80095155,37010847,28996320,22220819,16372899,10353171,6920896,121874952,251912763,416935399,416935399
India,1958,IN,IND,SEA,36183588,51471194,87654782,38836382,32056203,24863660,18140024,11395429,6917225,132208923,33991114,48496307,82487421,37359928,29533758,22564890,16798384,10661678,7025993,123944631,256153554,426295763,426295763
India,1959,IN,IND,SEA,36910620,53513566,90424186,39292306,32506141,25321487,18522322,11726167,7092823,134461246,34683203,50248355,84931558,37730906,30092370,22922773,17202789,10965759,7168754,126083351,260544597,435900352,435900352
India,1960,IN,IND,SEA,37628588,55632761,93261349,39830896,32980316,25799121,18902059,12049548,7312291,136874231,35366605,52075697,87442302,38175876,30682061,23305465,17579500,11267650,7366150,128376702,265250933,445954579,445954579
India,1961,IN,IND,SEA,38370252,57795564,96165816,40427086,33467777,26285158,19275053,12365264,7574422,139394760,36073794,53936857,90010651,38674656,31294772,23702012,17925651,11565737,7617821,130780649,270175409,456351876,456351876
India,1962,IN,IND,SEA,39131231,59999112,99130343,41055968,33970131,26773890,19638454,12675968,7881117,141995528,36801314,55820580,92621894,39210011,31934525,24105648,18237502,11859363,7929385,133276434,275271962,467024193,467024193
India,1963,IN,IND,SEA,39927499,62195970,102123469,41763844,34463681,27259088,20000262,12987822,8215122,144689819,37561889,57725272,95287161,39789786,32562875,24519130,18527570,12159083,8274722,135833166,280522985,477933619,477933619
India,1964,IN,IND,SEA,40771907,64083698,104855605,42870495,34922857,27737042,20373698,13306141,8547096,147757329,38367892,59439256,97807148,40656207,33124329,24953700,18818095,12476893,8610008,138639232,286396561,489059309,489059309
India,1965,IN,IND,SEA,41546359,65672865,107219224,44377403,35345099,28203898,20755332,13622114,8850416,151154262,39105723,60937194,100042917,41852971,33605377,25413687,19114123,12805445,8906338,141697941,292852203,500114346,500114346
India,1966,IN,IND,SEA,42208560,67231987,109440547,46007069,35740937,28658651,21140716,13931928,9121756,154601057,39733330,62409953,102143283,43174594,34022222,25896258,19413457,13142701,9158488,144807720,299408777,510992617,510992617
India,1967,IN,IND,SEA,42849335,68760283,111609618,47762185,36139612,29111420,21538527,14241803,9367809,158161356,40339008,63857846,104196854,44622729,34400640,26407808,19724989,13490848,9372224,148019238,306180594,521987069,521987069
India,1968,IN,IND,SEA,43553434,70265811,113819245,49648905,36571440,29574102,21956647,14554637,9611502,161917233,41005614,65288210,106293824,46203021,34772627,26953301,20056229,13840867,9575560,151401605,313318838,533431909,533431909
India,1969,IN,IND,SEA,44320201,71741966,116062167,51649533,37047720,30045817,22390432,14864388,9874153,165872043,41729343,66694429,108423772,47895749,35160593,27522274,20404338,14173534,9800202,154956690,320828733,545314670,545314670
India,2031,IN,IND,SEA,56857098,117073999,173931097,127744574,131133968,119003226,96996114,70055356,65995711,610928949,53631946,108639051,162270997,116307905,119024178,110331136,91993869,69081692,72339069,579077849,1190006798,1526208890,1526208890
India,2032,IN,IND,SEA,56591948,116227758,172819706,126814046,131108093,120191038,99127263,71710521,68332978,617283939,53461377,108116504,161577881,115589492,119044946,111204033,93987392,70662290,74938352,585426505,1202710444,1537108035,1537108035
India,2033,IN,IND,SEA,56308538,115489369,171797907,125768733,130973675,121358855,101233122,73324406,70714875,623373666,53261502,107684110,160945612,114793037,118975791,112046959,95963639,72193678,77599545,591572649,1214946315,1547689835,1547689835
India,2034,IN,IND,SEA,56008708,114855794,170864502,124555257,130788092,122470517,103251466,74991879,73124739,629181950,53036044,107338349,160374393,113870469,118854781,112822214,97879818,73768815,80302862,597498959,1226680909,1557919806,1557919806
India,2035,IN,IND,SEA,55685200,114428437,170113637,123109618,130476397,123614094,105078847,76779249,75559429,634617634,52778766,107173612,159952378,112762843,118612912,113623605,99629831,75446231,83043183,603118605,1237736239,1567802259,1567802259
India,2036,IN,IND,SEA,55336004,114058977,169394981,121627535,129924304,124790882,106768509,78654835,78048317,639814382,52490888,107051656,159542544,111635766,118150351,114491193,101229825,77195450,85848325,608550910,1248365292,1577302813,1577302813
India,2037,IN,IND,SEA,54968770,113661111,168629881,120227918,129211059,125854011,108412684,80557075,80597419,644860166,52182929,106888157,159071086,110580084,117542159,115312213,102746137,78972833,88724063,613877489,1258737655,1586438621,1586438621
India,2038,IN,IND,SEA,54599307,113225982,167825289,118934896,128437432,126744639,109977211,82468255,83207094,649769527,51869447,106668509,158537956,109622116,116898913,116016858,104140319,80765135,91669668,619113009,1268882536,1595245783,1595245783
India,2039,IN,IND,SEA,54214887,112729983,166944870,117881996,127487244,127439267,111443432,84417530,85881521,654550990,51536645,106370341,157906986,108896768,116117677,116581055,105384961,82597084,94684474,624262019,1278813009,1603664860,1603664860
India,2040,IN,IND,SEA,53804659,112183512,165988171,117007719,126458561,127870737,112861965,86415012,88580305,659194299,51174214,106005942,157180156,108349573,115274341,116954093,106523955,84486426,97725318,629313706,1288508005,1611676333,1611676333
India,2041,IN,IND,SEA,53403286,111595258,164998544,116096906,125583748,128047778,114167275,88466445,91313905,663676057,50814823,105585354,156400177,107772024,114581754,117129678,107518600,86441841,100799679,634243576,1297919633,1619318360,1619318360
India,2042,IN,IND,SEA,52998985,110978578,163977563,115266449,124680209,128057231,115380295,90535155,94074804,667994143,50446733,105122282,155569015,107262292,113881107,117169324,108414591,88418976,103898369,639044659,1307038802,1626585377,1626585377
India,2043,IN,IND,SEA,52550790,110340989,162891779,114543143,123663500,127960920,116574554,92578354,96837186,672157657,50033009,104623818,154656827,106842065,113103387,117120412,109281316,90377812,106999270,643724262,1315881919,1633430529,1633430529
India,2044,IN,IND,SEA,52078042,109671921,161749963,113923891,122481017,127815575,117715573,94543101,99671744,676150901,49593978,104080184,153674162,106507791,112200949,117020879,110082447,92280687,110169995,648262748,1324413649,1639837771,1639837771
India,2045,IN,IND,SEA,51614780,108953187,160567967,113509361,121068682,127547772,118888575,96337629,102639574,679991593,49160830,103474714,152635544,106353245,111114428,116802087,110909263,94028107,113460952,652668082,1332659675,1645863187,1645863187
India,2046,IN,IND,SEA,51145421,108217397,159362818,113152205,119620502,127045470,120096095,98012799,105738722,683665793,48717893,102841146,151559039,106240950,110008481,116365592,111801815,95636328,116872948,656926114,1340591907,1651513758,1651513758
India,2047,IN,IND,SEA,50668349,107460267,158128616,112766589,118254043,126385208,121195478,99651964,108920030,687173312,48265592,102178142,150443734,106086965,108973214,115785109,112649324,97167412,120369362,661031386,1348204698,1656777045,1656777045
India,2048,IN,IND,SEA,50231683,106656470,156888153,112343676,116993105,125665128,122128023,101221662,112169051,690520645,47849958,101463344,149313302,105876726,108034702,115169464,113381819,98583332,123937513,664983556,1355504201,1661705662,1661705662
India,2049,IN,IND,SEA,49833878,105812816,155646694,111860003,115969743,124770468,122871313,102706759,115515648,693693934,47470040,100703445,148173485,105588009,107327054,114416564,113975881,99859500,127603882,668770890,1362464824,1666284995,1666284995
India,2050,IN,IND,SEA,49438419,104952376,154390795,111325898,115123028,123797584,123360378,104153521,118932835,696693244,47093361,99919314,147012675,105233063,106796184,113601555,114381922,101037502,131343647,672393873,1369087117,1670490596,1670490596
Ireland,1970,IE,IRL,EUR,158458,307012,465470,244549,159583,148448,160020,145745,150424,1008769,150612,294947,445559,234074,154984,148149,159607,141389,179643,1017846,2026615,2937637,2937637
Ireland,1971,IE,IRL,EUR,161005,310475,471480,247491,166033,149297,157716,146666,151427,1018630,153106,297891,450997,237089,160267,147780,158633,142703,181823,1028295,2046925,2969397,2969397
Ireland,1972,IE,IRL,EUR,164710,314044,478754,253025,174944,150231,156433,147380,151980,1033993,156625,300635,457260,242670,167975,147438,158355,144055,183497,1043990,2077983,3013998,3013998
Ireland,1973,IE,IRL,EUR,168768,318030,486798,258155,185545,151025,156214,147354,151981,1050274,160402,303967,464369,247662,177948,146940,158412,145010,184612,1060584,2110858,3062023,3062023
Ireland,1974,IE,IRL,EUR,172102,322793,494895,264389,194106,152578,155202,147642,152602,1066519,163609,308275,471884,253730,186095,147387,157118,146557,185902,1076789,2143308,3110099,3110099
Ireland,1975,IE,IRL,EUR,173930,328126,502056,271139,202229,154379,153536,147585,154824,1083692,165341,313126,478467,260473,193791,148553,154627,148045,188218,1093707,2177399,3157919,3157919
Ireland,1976,IE,IRL,EUR,174556,333761,508317,276691,212613,156483,151535,146425,158083,1101830,165894,318343,484237,265858,203983,150089,151560,148515,191358,1111363,2213193,3205753,3205753
Ireland,1977,IE,IRL,EUR,174614,339769,514383,282404,222461,160115,149963,145012,160786,1120741,165879,323963,489842,271068,213750,152848,149170,148243,194617,1129696,2250437,3254662,3254662
Ireland,1978,IE,IRL,EUR,174635,345231,519866,288826,230508,165525,149633,143987,162451,1140930,166290,329075,495365,276866,221683,157301,148074,147838,197647,1149409,2290339,3305571,3305571
Ireland,1979,IE,IRL,EUR,175576,348851,524427,294955,236444,171575,149543,142976,163563,1159056,167453,332328,499781,282896,227848,162562,147203,147322,200805,1168636,2327692,3351898,3351898
Ireland,1980,IE,IRL,EUR,177967,351018,528985,299678,239881,178029,149722,141481,164824,1173615,169330,333775,503105,287951,231971,168489,146451,147022,203807,1185691,2359306,3391387,3391387
Ireland,1981,IE,IRL,EUR,180352,352140,532492,302984,241323,185071,150674,139873,165954,1185879,171350,334457,505807,291551,234494,174930,146458,147074,206142,1200649,2386528,3424827,3424827
Ireland,1982,IE,IRL,EUR,181338,352683,534021,304322,242147,192494,151440,139381,166153,1195937,172444,334965,507409,293382,236513,182097,146410,147639,207814,1213855,2409792,3451212,3451212
Ireland,1983,IE,IRL,EUR,180610,353593,534203,304894,242477,200475,151803,139499,165803,1204951,171438,336172,507610,294481,237730,190716,146065,148087,209069,1226148,2431099,3472903,3472903
Ireland,1984,IE,IRL,EUR,176914,355327,532241,305968,244736,205731,152764,138577,166688,1214464,167279,338056,505335,295896,240880,196939,146565,146907,211705,1238892,2453356,3490931,3490931
Ireland,1985,IE,IRL,EUR,170624,357203,527827,307943,247659,210087,153677,136969,168308,1224643,161301,339608,500909,297913,245087,202224,147505,144428,215229,1252386,2477029,3505769,3505769
Ireland,1986,IE,IRL,EUR,164380,357696,522076,309412,247935,216841,154521,135022,169582,1233313,155587,339921,495508,299267,247223,209997,148409,141570,218302,1264768,2498081,3515669,3515669
Ireland,1987,IE,IRL,EUR,158786,355539,514325,308187,245397,223132,156319,133495,170817,1237347,150327,337944,488271,298471,247396,217146,150119,139411,221213,1273756,2511103,3513700,3513700
Ireland,1988,IE,IRL,EUR,152828,351339,504167,304276,240432,227460,158995,132939,171970,1236072,144907,333754,478661,295251,246206,222214,153143,138327,223996,1279137,2515209,3498030,3498030
Ireland,1989,IE,IRL,EUR,146881,346876,493757,301302,236943,230293,162829,132861,172659,1236887,139783,328858,468641,291318,245563,226040,157354,137634,226123,1284032,2520919,3483314,3483314
Ireland,1990,IE,IRL,EUR,141894,342833,484727,302765,237575,231382,168765,133637,172896,1247020,135052,324818,459870,290374,246322,228562,162933,137476,228092,1293759,2540779,3485374,3485374
Ireland,1991,IE,IRL,EUR,138373,339599,477972,307422,240352,231467,176463,135357,173111,1264172,131400,321676,453076,292980,248252,230466,169581,138141,230162,1309582,2573754,3504805,3504805
Ireland,1992,IE,IRL,EUR,135838,335952,471790,312082,242466,232457,184845,137035,173538,1282423,128857,318091,446948,296298,250022,232832,177266,138706,232083,1327207,2609630,3528367,3528367
Ireland,1993,IE,IRL,EUR,133734,330446,464180,315274,243795,233763,193371,138421,173806,1298430,126400,312701,439101,299433,251238,234671,186206,139079,233357,1343984,2642414,3545700,3545700
Ireland,1994,IE,IRL,EUR,131617,323048,454665,317236,246219,236770,199065,140102,174143,1313535,124047,305553,429600,302771,253134,238502,192821,140124,234251,1361603,2675138,3559398,3559398
Ireland,1995,IE,IRL,EUR,129365,314962,444327,320240,250034,241486,203985,141853,174985,1332583,122011,298314,420325,306737,256279,244077,198566,141505,235090,1382254,2714837,3579482,3579482
Ireland,1996,IE,IRL,EUR,127691,307771,435462,323748,254488,245547,211256,143662,175898,1354599,120527,291885,412412,310124,260434,248948,206457,142860,235427,1404250,2758849,3606728,3606728
Ireland,1997,IE,IRL,EUR,127877,300910,428787,325760,260123,249869,218653,146433,177020,1377858,120467,285633,406100,312146,265163,254173,214333,145378,236216,1427409,2805267,3640150,3640150
Ireland,1998,IE,IRL,EUR,130096,294158,424254,326272,266626,254964,224902,150767,178370,1401901,122265,279422,401687,313221,270278,259303,221038,149507,237472,1450819,2852720,3678667,3678667
Ireland,1999,IE,IRL,EUR,133185,288481,421666,325409,274233,260155,230138,156192,179481,1425608,125105,274189,399294,313326,276182,264571,226519,154489,238251,1473338,2898946,3719912,3719912
Ireland,2000,IE,IRL,EUR,136464,284022,420486,323958,284313,265551,234192,162923,181214,1452151,128514,269848,398362,312527,284232,270242,230574,160668,239706,1497949,2950100,3768950,3768950
Ireland,2001,IE,IRL,EUR,139174,280744,419918,323137,296594,271247,236793,171081,183949,1482801,131941,266511,398452,312359,296099,275421,233542,167889,242533,1527843,3010644,3829018,3829018
Ireland,2002,IE,IRL,EUR,141719,279104,420823,322146,308101,277201,239230,179950,186896,1513524,135138,265086,400224,313162,308130,280586,236732,175652,245426,1559688,3073212,3894258,3894258
Ireland,2003,IE,IRL,EUR,144868,279537,424405,319937,317186,284287,241990,188797,190175,1542372,138382,265372,403754,312503,317663,286207,239783,184076,247941,1588173,3130545,3958705,3958705
Ireland,2004,IE,IRL,EUR,148123,281369,429492,317935,328962,293109,247509,194897,194502,1576914,141496,266513,408009,310787,327867,292274,245003,190523,251090,1617544,3194458,4031954,4031954
Ireland,2005,IE,IRL,EUR,151229,283778,435007,318491,347649,302451,254426,199779,198504,1621300,144424,268661,413085,310383,341889,298610,251624,195777,253542,1651825,3273125,4121216,4121216
Ireland,2006,IE,IRL,EUR,154914,287238,442152,324286,369340,312923,260461,206665,202110,1675785,147507,272780,420287,315905,359021,306250,257675,202850,254888,1696589,3372374,4234806,4234806
Ireland,2007,IE,IRL,EUR,160087,292971,453058,330637,384457,324100,266504,214116,207333,1727147,152163,279189,431352,324761,374622,315989,264259,210405,258249,1748285,3475432,4359834,4359834
Ireland,2008,IE,IRL,EUR,166027,299908,465935,328284,387641,332488,271944,220411,214699,1755467,158237,286081,444318,326252,383872,325008,270443,216800,264300,1786675,3542142,4452392,4452392
Ireland,2009,IE,IRL,EUR,171929,306076,478005,316545,381759,337788,276648,225060,223376,1761176,164121,291676,455797,316797,386021,331729,276406,222066,271793,1804812,3565988,4499792,4499792
Ireland,2010,IE,IRL,EUR,177360,311463,488823,301230,373391,342255,280761,228021,232699,1758357,169419,296543,465962,299817,385117,337751,282076,226002,280680,1811443,3569800,4524585,4524585
Ireland,2011,IE,IRL,EUR,180706,316523,497229,288884,363925,346313,284550,229784,243032,1756488,173030,301358,474388,284756,381677,343740,287004,228835,290383,1816395,3572883,4544501,4544501
Ireland,2012,IE,IRL,EUR,180717,321548,502265,283512,352192,349668,288099,231461,254121,1759053,173513,306529,480042,277318,373682,349128,291097,231675,300283,1823183,3582236,4564550,4564550
Ireland,2013,IE,IRL,EUR,178022,326953,504975,283617,339676,353006,292044,233361,265534,1767238,171169,312194,483363,275212,362767,355291,294953,234406,310627,1833256,3600494,4588832,4588832
Ireland,2014,IE,IRL,EUR,174329,332747,507076,286177,327098,357030,296648,237551,275257,1779761,167598,317940,485538,275854,351994,363162,299662,239537,319577,1849786,3629547,4622167,4622167
Ireland,2015,IE,IRL,EUR,170944,338389,509333,288631,318239,362176,301933,243596,284135,1798710,163777,323552,487329,277449,342836,370752,305131,246399,327824,1870391,3669101,4665760,4665760
Ireland,2016,IE,IRL,EUR,167759,343284,511043,291511,312454,367562,307915,249258,294101,1822801,160144,328560,488704,280562,334056,377783,311329,252437,337069,1893236,3716037,4715788,4715788
Ireland,2017,IE,IRL,EUR,164535,347531,512066,298098,306854,372034,314249,254397,304686,1850318,157088,332529,489617,287057,324798,385058,317844,258159,346930,1919846,3770164,4771854,4771854
Ireland,2018,IE,IRL,EUR,161929,351152,513081,306030,303227,375432,321027,259437,316071,1881224,154732,335169,489901,295458,316792,391537,324420,264121,357970,1950298,3831522,4834507,4834507
Ireland,2019,IE,IRL,EUR,159532,353222,512754,312835,301903,377471,327833,264652,327689,1912383,152511,336373,488884,302892,311237,395971,331523,270732,369643,1981998,3894381,4896019,4896019
Ireland,2020,IE,IRL,EUR,157572,353386,510958,319573,300331,376534,334704,269496,338730,1939368,150655,336407,487062,309173,306128,397118,338874,276791,380653,2008737,3948105,4946119,4946119
Ireland,2021,IE,IRL,EUR,155815,352505,508320,326072,299110,372782,341855,274076,348703,1962598,148874,335782,484656,314921,301560,395468,346351,281903,390749,2030952,3993550,4986526,4986526
Ireland,2022,IE,IRL,EUR,153611,349983,503594,332056,300549,367061,348796,278543,358889,1985894,146502,333639,480141,320322,299623,391531,354005,286581,401418,2053480,4039374,5023109,5023109
Ireland,2023,IE,IRL,EUR,151517,345358,496875,337653,303273,360378,355633,282894,369970,2009801,144082,329517,473599,325487,299531,385372,362276,290918,413073,2076657,4086458,5056935,5056935
Ireland,2024,IE,IRL,EUR,149639,339518,489157,343365,306459,352263,362947,287682,381283,2033999,141979,324131,466110,330672,300859,376488,371526,295499,425170,2100214,4134213,5089478,5089478
Ireland,2025,IE,IRL,EUR,147663,333386,481049,349048,310031,342587,370080,293470,392739,2057955,140002,318117,458119,335758,303492,365329,380481,300931,437749,2123740,4181695,5120867,5120867
Ireland,2026,IE,IRL,EUR,145696,327398,473094,354079,314126,333568,375531,299681,404329,2081314,138104,312076,450180,340134,307149,354067,387946,307011,450502,2146809,4228123,5151399,5151399
Ireland,2027,IE,IRL,EUR,144213,321630,465843,357771,319289,325754,378849,306050,415845,2103558,136668,306365,443033,342964,312150,343018,393854,313390,463328,2168704,4272262,5181143,5181143
Ireland,2028,IE,IRL,EUR,143192,316373,459565,360058,324960,319365,380021,312616,427449,2124469,135677,301329,437006,344380,317873,332685,397803,319858,476553,2189152,4313621,5210188,5210188
Ireland,2029,IE,IRL,EUR,142707,311684,454391,361043,330835,314427,379274,319143,439291,2144013,135197,296947,432144,344986,323253,324185,399276,326375,490119,2208194,4352207,5238739,5238739
Ireland,2030,IE,IRL,EUR,142731,307706,450437,360786,336669,310637,376852,325930,451255,2162129,135199,293151,428350,344859,328139,317207,398837,333220,503704,2225966,4388095,5266881,5266881
Ireland,1950,IE,IRL,EUR,158729,266254,424983,219327,194186,193620,162833,126636,156930,1053532,151186,255886,407072,203065,192401,182060,156567,124294,162642,1021029,2074561,2906599,2906599
Ireland,1951,IE,IRL,EUR,158093,271319,429412,223770,192337,194808,163957,126618,156118,1057608,150684,260012,410696,207166,191362,183813,157535,124771,162342,1026989,2084597,2924705,2924705
Ireland,1952,IE,IRL,EUR,155612,275508,431120,225059,190833,194544,164850,126523,155199,1057008,148621,263110,411731,209226,190484,184275,158143,125046,162356,1029530,2086538,2929379,2929379
Ireland,1953,IE,IRL,EUR,152755,278137,430892,220430,189048,192778,165201,126662,155121,1049240,145835,265272,411107,206419,188857,183410,158248,125180,163678,1025792,2075032,2917037,2917037
Ireland,1954,IE,IRL,EUR,151833,279806,431639,214895,185958,191208,165228,127622,154642,1039553,144898,266773,411671,202754,185405,183390,157779,125950,164628,1019906,2059459,2902780,2902780
Ireland,1955,IE,IRL,EUR,151631,282200,433831,207829,181771,188594,164160,130901,153886,1027141,145079,268756,413835,198038,180595,183157,155326,129543,164898,1011557,2038698,2886368,2886368
Ireland,1956,IE,IRL,EUR,150354,287431,437785,199917,176507,184393,164375,133913,153827,1012932,144024,273641,417665,192265,174966,181595,153879,132864,165698,1001267,2014199,2869649,2869649
Ireland,1957,IE,IRL,EUR,149613,292258,441871,193707,170547,180335,167036,134121,153580,999326,143302,278372,421674,186891,169539,179366,156021,133303,166336,991456,1990782,2854323,2854323
Ireland,1958,IE,IRL,EUR,148704,295314,444018,190687,164594,177199,168689,133794,152417,987380,142612,281362,423974,183584,164754,177377,158108,133347,166212,983382,1970762,2838758,2838758
Ireland,1959,IE,IRL,EUR,148114,296623,444737,190904,157957,173629,169711,133419,151203,976823,142375,282586,424961,183066,159384,174946,159692,133608,166248,976944,1953767,2823465,2823465
Ireland,1960,IE,IRL,EUR,149164,295798,444962,194629,150613,168952,170451,132879,150904,968428,143456,281711,425167,185691,153274,172032,160714,133769,167027,972507,1940935,2811067,2811067
Ireland,1961,IE,IRL,EUR,150717,292856,443573,201954,145898,164564,170658,132740,150876,966690,144788,279094,423882,191501,148942,169416,161219,133663,168116,972857,1939547,2807005,2807005
Ireland,1962,IE,IRL,EUR,151608,290099,441707,210141,144930,162299,170595,133512,149740,971217,145454,277081,422535,198733,146858,167914,161725,133865,168513,977608,1948825,2813067,2813067
Ireland,1963,IE,IRL,EUR,153054,288513,441567,217360,145008,161413,169916,134700,148407,976804,146659,275989,422648,205998,145364,166880,161770,134487,168580,983079,1959883,2824089,2824089
Ireland,1964,IE,IRL,EUR,155062,290192,445254,221263,145561,159449,169638,135664,148152,979727,148554,277906,426460,210194,144657,164333,162660,134732,169423,985999,1965726,2837436,2837436
Ireland,1965,IE,IRL,EUR,157049,293523,450572,224399,145536,156855,168691,136079,150135,981695,150527,281595,432122,213314,144298,160748,163380,133439,172838,988017,1969712,2852401,2852401
Ireland,1966,IE,IRL,EUR,158414,295495,453909,230432,145441,153993,166496,137522,151614,985498,151679,283797,435476,219361,144113,156779,163089,132823,175957,992122,1977620,2867003,2867003
Ireland,1967,IE,IRL,EUR,158487,297482,455969,236342,147008,151388,164511,140713,151329,991291,151358,285731,437089,225421,144995,153441,162453,135128,176961,998399,1989690,2882745,2882745
Ireland,1968,IE,IRL,EUR,157799,300178,457977,240287,150311,149768,163396,142985,150989,997736,150298,288278,438576,229514,147377,151249,161936,137619,177652,1005347,2003083,2899643,2899643
Ireland,1969,IE,IRL,EUR,157470,303524,460994,242950,154705,148662,162087,144513,150399,1003316,149764,291562,441326,232349,150899,149452,160897,139703,178252,1011552,2014868,2917184,2917184
Ireland,2031,IE,IRL,EUR,143161,303862,447023,359759,342277,308684,372864,332893,463098,2179575,135593,289355,424948,344073,332954,311895,396908,340503,516854,2243187,4422762,5294736,5294736
Ireland,2032,IE,IRL,EUR,143995,300113,444108,357179,347848,309765,367120,339756,474755,2196423,136371,285488,421859,341860,337909,309585,392866,348052,529697,2259969,4456392,5322355,5322355
Ireland,2033,IE,IRL,EUR,145143,297003,442146,352572,353456,312516,360612,346591,486423,2212170,137448,282079,419527,337745,343075,309518,386795,356273,542412,2275818,4487988,5349663,5349663
Ireland,2034,IE,IRL,EUR,146490,294650,441140,346755,359176,315722,352694,353905,498598,2226850,138717,279499,418216,332364,348263,310862,378027,365461,555501,2290478,4517328,5376684,5376684
Ireland,2035,IE,IRL,EUR,147920,292701,440621,340645,364865,319316,343247,361063,511742,2240878,140070,277527,417597,326363,353353,313512,367007,374375,569642,2304252,4545130,5403354,5403354
Ireland,2036,IE,IRL,EUR,149367,291166,440533,334681,369902,323425,334449,366571,525309,2254337,141442,276028,417470,320336,357732,317172,355887,381833,584389,2317349,4571686,5429691,5429691
Ireland,2037,IE,IRL,EUR,150832,290523,441355,328933,373607,328596,326825,369986,538872,2266819,142828,275374,418202,314627,360565,322173,344980,387755,599313,2329413,4596232,5455791,5455791
Ireland,2038,IE,IRL,EUR,152220,290652,442872,323695,375911,334267,320603,371294,552634,2278404,144142,275462,419604,309600,361987,327899,334781,391747,614547,2340561,4618965,5481441,5481441
Ireland,2039,IE,IRL,EUR,153479,291518,444997,319021,376916,340143,315806,370727,566530,2289143,145324,276252,421576,305224,362602,333277,326401,393298,630047,2350849,4639992,5506567,5506567
Ireland,2040,IE,IRL,EUR,154640,292971,447611,315056,376687,345974,312145,368524,580767,2299153,146420,277607,424027,301438,362483,338166,319527,392972,645799,2360385,4659538,5531181,5531181
Ireland,2041,IE,IRL,EUR,155614,294853,450467,311230,375688,351583,310292,364792,595052,2308637,147332,279375,426707,297644,361702,342981,314307,391178,661537,2369349,4677986,5555162,5555162
Ireland,2042,IE,IRL,EUR,156277,297153,453430,307495,373144,357157,311436,359333,609089,2317654,147950,281541,429491,293784,359501,347939,312068,387302,677223,2377817,4695471,5578394,5578394
Ireland,2043,IE,IRL,EUR,156683,299692,456375,304397,368576,362772,314227,353136,623166,2326274,148323,283935,432258,290382,355396,353112,312058,381434,693447,2385829,4712103,5600737,5600737
Ireland,2044,IE,IRL,EUR,156830,302297,459127,302048,362803,368495,317479,345585,638232,2334642,148452,286389,434841,287806,350035,358302,313447,372933,711014,2393537,4728179,5622145,5622145
Ireland,2045,IE,IRL,EUR,156614,304891,461505,300116,356737,374190,321105,336568,654121,2342837,148239,288839,437078,285839,344051,363395,316127,362236,729379,2401027,4743864,5642439,5642439
Ireland,2046,IE,IRL,EUR,156066,307317,463383,298594,350815,379234,325239,328186,668860,2350928,147717,291121,438838,284345,338035,367782,319813,351445,746946,2408366,4759294,5661520,5661520
Ireland,2047,IE,IRL,EUR,155275,309446,464721,297959,345109,382952,330418,320926,681619,2358983,146963,293126,440089,283696,332347,370627,324826,340856,763263,2415615,4774598,5679407,5679407
Ireland,2048,IE,IRL,EUR,154232,311244,465476,298096,339912,385273,336095,315025,692570,2366971,145977,294816,440793,283788,327336,372060,330552,330960,778043,2422739,4789710,5695971,5695971
Ireland,2049,IE,IRL,EUR,152909,312645,465554,298966,335272,386305,341965,310507,701884,2374899,144729,296129,440858,284580,322969,372690,335933,322840,790739,2429751,4804650,5711065,5711065
Ireland,2050,IE,IRL,EUR,151414,313592,465006,300428,331340,386104,347793,307090,709977,2382732,143316,297013,440329,285939,319196,372584,340824,316205,801874,2436622,4819354,5724686,5724686
Iran (Islamic Republic of),1970,IR,IRN,EMR,2533260,3946663,6479923,2695874,1762689,1499095,1068671,656150,502282,8184761,2367141,3656305,6023446,2512064,1687374,1419099,1002965,610548,529517,7761567,15946328,28449705,28449705
Iran (Islamic Republic of),1971,IR,IRN,EMR,2591616,4054814,6646430,2836711,1791389,1526129,1111503,665471,512327,8443530,2428086,3753253,6181339,2635126,1715731,1446040,1046967,617085,541437,8002386,16445916,29273682,29273682
Iran (Islamic Republic of),1972,IR,IRN,EMR,2643063,4164343,6807406,2980193,1827436,1556912,1153439,674711,522891,8715582,2480112,3852707,6332819,2760665,1751083,1476383,1088825,624530,554275,8255761,16971343,30111574,30111574
Iran (Islamic Republic of),1973,IR,IRN,EMR,2691749,4273909,6965658,3128317,1874922,1589483,1194167,685714,533878,9006481,2525796,3955140,6480936,2892620,1795923,1508542,1128679,635310,567744,8528818,17535299,30981898,30981898
Iran (Islamic Republic of),1974,IR,IRN,EMR,2747240,4383527,7130767,3259950,1954011,1618392,1232139,702061,545274,9311827,2573647,4061292,6634939,3014362,1866069,1537513,1166165,652887,581006,8818002,18129829,31895534,31895534
Iran (Islamic Republic of),1975,IR,IRN,EMR,2814665,4495823,7310488,3374190,2065639,1643173,1267669,725022,557170,9632863,2631425,4171189,6802614,3119211,1959709,1560654,1200919,677678,592835,9111006,18743869,32856976,32856976
Iran (Islamic Republic of),1976,IR,IRN,EMR,2903330,4611555,7514885,3478726,2178128,1661367,1298179,753742,569227,9939369,2711731,4283960,6995691,3214770,2054527,1577766,1231378,709334,603333,9391108,19330477,33841060,33841060
Iran (Islamic Republic of),1977,IR,IRN,EMR,3018577,4726769,7745346,3578616,2293336,1675371,1323555,788503,581358,10240739,2821681,4396009,7217690,3307530,2153714,1592155,1257715,748656,612936,9672706,19913445,34876497,34876497
Iran (Islamic Republic of),1978,IR,IRN,EMR,3156696,4841728,7998424,3683231,2419876,1691117,1347090,827460,593228,10562002,2959910,4506651,7466561,3402384,2260987,1607071,1281854,792775,621604,9966675,20528677,35993661,35993661
Iran (Islamic Republic of),1979,IR,IRN,EMR,3319079,4965623,8284702,3788032,2552332,1709795,1371288,867276,605290,10894013,3129915,4625061,7754976,3497159,2373822,1624544,1306585,837363,631845,10271318,21165331,37205013,37205013
Iran (Islamic Republic of),1980,IR,IRN,EMR,3498261,5103021,8601282,3894940,2689510,1734905,1397229,906360,618217,11241161,3325932,4757630,8083562,3594894,2492493,1648494,1333052,880550,645175,10594658,21835819,38520664,38520664
Iran (Islamic Republic of),1981,IR,IRN,EMR,3684424,5272206,8956630,4116729,2954039,1828818,1451821,955417,638021,11944845,3538241,4920933,8459174,3760867,2681431,1709483,1373814,926938,663066,11115599,23060444,40476251,40476251
Iran (Islamic Republic of),1982,IR,IRN,EMR,3878493,5460552,9339045,4321048,3218225,1931065,1509701,1002859,657014,12639912,3762783,5105793,8868576,3923206,2876613,1779419,1418623,971883,682756,11652500,24292412,42500030,42500030
Iran (Islamic Republic of),1983,IR,IRN,EMR,4068866,5657272,9726138,4396596,3358848,1983160,1542687,1037327,669850,12988468,3982475,5303240,9285715,4017761,3014374,1829325,1453325,1010323,702559,12027667,25016135,44027986,44027986
Iran (Islamic Republic of),1984,IR,IRN,EMR,4238858,5886235,10125093,4479930,3488742,2068478,1574489,1070984,687578,13370201,4177246,5534340,9711586,4115853,3142704,1903878,1485131,1046892,727074,12421532,25791733,45628402,45628402
Iran (Islamic Republic of),1985,IR,IRN,EMR,4383956,6143793,10527749,4570485,3601720,2184085,1602997,1103608,710728,13773623,4338437,5800423,10138860,4216869,3255369,2002932,1512349,1081762,756649,12825930,26599553,47266160,47266160
Iran (Islamic Republic of),1986,IR,IRN,EMR,4503787,6420034,10923821,4665618,3707864,2306643,1628758,1133826,738725,14181434,4464099,6095298,10559397,4325439,3367702,2111608,1537565,1114599,791683,13248596,27430030,48913237,48913237
Iran (Islamic Republic of),1987,IR,IRN,EMR,4573422,6729127,11302549,4761520,3808389,2435225,1652880,1161081,771752,14590847,4532507,6430352,10962859,4437058,3480382,2228839,1562061,1144679,832212,13685231,28276078,50541490,50541490
Iran (Islamic Republic of),1988,IR,IRN,EMR,4586659,7067776,11654435,4857859,3902164,2568379,1676597,1186402,807571,14998972,4538851,6799647,11338498,4545810,3587443,2351317,1586311,1172876,876196,14119953,29118925,52111868,52111868
Iran (Islamic Republic of),1989,IR,IRN,EMR,4561526,7410219,11971745,4968553,3994408,2707781,1704227,1213097,844262,15432328,4501705,7175868,11677573,4660874,3688367,2478411,1612945,1201537,920960,14563094,29995422,53644736,53644736
Iran (Islamic Republic of),1990,IR,IRN,EMR,4523904,7758902,12282806,5193464,4193214,2904217,1760939,1251011,886029,16188874,4449801,7558407,12008208,4892026,3892090,2657652,1664286,1238516,969167,15313737,31502611,55793629,55793629
Iran (Islamic Republic of),1991,IR,IRN,EMR,4478298,8079848,12558146,5439061,4406286,3111481,1828094,1292736,927858,17005516,4389118,7911374,12300492,5144409,4111561,2848443,1725639,1278915,1017768,16126735,33132251,57990883,57990883
Iran (Islamic Republic of),1992,IR,IRN,EMR,4398688,8339076,12737764,5581603,4497666,3263087,1877540,1326864,962146,17508906,4294387,8199676,12494063,5284554,4210052,2988825,1772607,1314026,1061217,16631281,34140187,59372016,59372016
Iran (Islamic Republic of),1993,IR,IRN,EMR,4257963,8527590,12785553,5617092,4442142,3345118,1905013,1348087,987309,17644761,4141556,8410767,12552323,5307468,4161646,3066907,1799926,1338854,1097996,16772797,34417558,59755430,59755430
Iran (Islamic Republic of),1994,IR,IRN,EMR,4057317,8659705,12717022,5699691,4377583,3405165,1958366,1365598,1013111,17819514,3934949,8556793,12491742,5379783,4104753,3129132,1848141,1359804,1135855,16957468,34776982,59985749,59985749
Iran (Islamic Republic of),1995,IR,IRN,EMR,3817704,8755683,12573387,5935389,4425592,3498260,2061817,1389516,1047171,18357745,3695052,8656532,12351584,5621443,4160218,3225307,1939802,1384686,1180637,17512093,35869838,60794809,60794809
Iran (Islamic Republic of),1996,IR,IRN,EMR,3540498,8813625,12354123,6210814,4492214,3592027,2175207,1413552,1082624,18966438,3421537,8706209,12127746,5914594,4232605,3323521,2041820,1408301,1229237,18150078,37116516,61598378,61598378
Iran (Islamic Republic of),1997,IR,IRN,EMR,3256878,8807357,12064235,6545733,4584122,3692718,2300071,1439812,1120095,19682551,3143996,8683655,11827651,6277186,4329006,3429480,2155348,1432847,1282226,18906093,38588644,62480533,62480533
Iran (Islamic Republic of),1998,IR,IRN,EMR,3009550,8713022,11722572,6931522,4702336,3801157,2436146,1469144,1160155,20500460,2902992,8569985,11472977,6697854,4449317,3542781,2279487,1459704,1336264,19765407,40265867,63461421,63461421
Iran (Islamic Republic of),1999,IR,IRN,EMR,2832054,8525139,11357193,7324186,4841235,3909518,2579094,1502506,1201641,21358180,2729928,8363443,11093371,7129525,4587757,3655866,2410698,1490048,1392104,20665998,42024178,64474745,64474745
Iran (Islamic Republic of),2000,IR,IRN,EMR,2730789,8251630,10982419,7710997,5007258,4020119,2727854,1542505,1244363,22253096,2630475,8074418,10704893,7556007,4752545,3770549,2547868,1526625,1450381,21603975,43857071,65544383,65544383
Iran (Islamic Republic of),2001,IR,IRN,EMR,2686270,7926760,10613030,8070074,5208819,4135077,2880904,1589802,1288708,23173384,2585869,7736832,10322701,7953482,4953507,3889482,2689757,1570366,1509146,22565740,45739124,66674851,66674851
Iran (Islamic Republic of),2002,IR,IRN,EMR,2667760,7563082,10230842,8306114,5362232,4212575,3019839,1636898,1330604,23868262,2565849,7362132,9927981,8218624,5106348,3974180,2820507,1615100,1565269,23300028,47168290,67327117,67327117
Iran (Islamic Republic of),2003,IR,IRN,EMR,2666231,7195389,9861620,8498403,5549969,4291405,3161408,1692824,1373689,24567698,2562159,6985767,9547926,8413560,5273477,4051639,2952122,1665303,1621359,23977460,48545158,67954699,67954699
Iran (Islamic Republic of),2004,IR,IRN,EMR,2687724,6850587,9538311,8709652,5857568,4411528,3306171,1782798,1422195,25489912,2581066,6636892,9217958,8606237,5542288,4158900,3085686,1742396,1679998,24815505,50305417,69061674,69061674
Iran (Islamic Republic of),2005,IR,IRN,EMR,2721549,6522310,9243859,8854231,6193799,4534751,3433662,1899260,1471414,26387117,2611616,6308446,8920062,8727180,5849940,4269559,3206510,1843034,1735326,25631549,52018666,70182594,70182594
Iran (Islamic Republic of),2006,IR,IRN,EMR,2768157,6206799,8974956,8940841,6538341,4658648,3554088,2022232,1521274,27235424,2653945,5995150,8649095,8787897,6183134,4381460,3323228,1950896,1789670,26416285,53651709,71275760,71275760
Iran (Islamic Republic of),2007,IR,IRN,EMR,2833085,5917773,8750858,8938022,6895965,4776551,3667264,2149196,1572544,27999542,2713358,5709821,8423179,8762733,6546792,4488794,3435115,2064247,1848153,27145834,55145376,72319418,72319418
Iran (Islamic Republic of),2008,IR,IRN,EMR,2917809,5679274,8597083,8826982,7263643,4890438,3774206,2279683,1626367,28661319,2791314,5474830,8266144,8634520,6934294,4592897,3542223,2182641,1907276,27793851,56455170,73318394,73318394
Iran (Islamic Republic of),2009,IR,IRN,EMR,3015117,5519525,8534642,8618414,7626342,5014413,3876316,2414371,1683455,29233311,2880994,5316311,8197305,8411858,7321663,4704793,3644189,2305994,1968923,28357420,57590731,74322685,74322685
Iran (Islamic Republic of),2010,IR,IRN,EMR,3118368,5445225,8563593,8328916,7978523,5157006,3976254,2551659,1745162,29737520,2976564,5240030,8216594,8110821,7697199,4833227,3743211,2433264,2038431,28856153,58593673,75373855,75373855
Iran (Islamic Republic of),2011,IR,IRN,EMR,3223776,5435256,8659032,7968211,8273176,5312997,4070227,2687007,1812684,30124302,3074328,5225510,8299838,7746095,8020433,4978547,3838361,2561512,2114853,29259801,59384103,76342971,76342971
Iran (Islamic Republic of),2012,IR,IRN,EMR,3339485,5482462,8821947,7574404,8505131,5488981,4161568,2823101,1887046,30440231,3181770,5265830,8447600,7355848,8286360,5147629,3932215,2692154,2200463,29614669,60054900,77324451,77324451
Iran (Islamic Republic of),2013,IR,IRN,EMR,3470456,5573192,9043648,7196499,8694336,5697423,4254588,2961849,1969992,30774687,3303520,5347644,8651164,6983524,8505636,5349839,4027975,2827769,2294685,29989428,60764115,78458928,78458928
Iran (Islamic Republic of),2014,IR,IRN,EMR,3622503,5765875,9388378,6869752,8824779,5963424,4347250,3087210,2075268,31167683,3445796,5529884,8975680,6661593,8634851,5631077,4143009,2954585,2404820,30429935,61597618,79961672,79961672
Iran (Islamic Republic of),2015,IR,IRN,EMR,3772113,6041812,9813925,6610795,8903103,6267930,4461123,3196460,2201405,31640816,3584914,5796920,9381834,6407412,8679800,5972517,4293606,3068990,2531939,30954264,62595080,81790841,81790841
Iran (Islamic Republic of),2016,IR,IRN,EMR,3883012,6250618,10133630,6356159,8920855,6553510,4601980,3301334,2333170,32067008,3685720,5997012,9682732,6160778,8683928,6280399,4449610,3180112,2668047,31422874,63489882,83306231,83306231
Iran (Islamic Republic of),2017,IR,IRN,EMR,3953737,6411845,10365582,6113742,8866391,6835460,4734850,3403475,2470456,32424374,3749262,6145155,9894417,5927390,8636524,6571608,4582130,3289350,2813700,31820702,64245076,84505076,84505076
Iran (Islamic Republic of),2018,IR,IRN,EMR,3964284,6600510,10564794,5925964,8729081,7139033,4858435,3503377,2613267,32769157,3756906,6317391,10074297,5746106,8504983,6887229,4707082,3396048,2967868,32209316,64978473,85617562,85617562
Iran (Islamic Republic of),2019,IR,IRN,EMR,3881463,6804798,10686261,5795740,8494935,7464211,4992926,3596642,2761442,33105896,3677065,6504010,10181075,5617876,8279406,7225450,4841385,3497506,3129345,32590968,65696864,86564202,86564202
Iran (Islamic Republic of),2020,IR,IRN,EMR,3724599,7004475,10729074,5722993,8177222,7782510,5139097,3673637,2910354,33405813,3528510,6685499,10214009,5541834,7973084,7559049,4981793,3591611,3293933,32941304,66347117,87290193,87290193
Iran (Islamic Republic of),2021,IR,IRN,EMR,3540615,7187893,10728508,5715832,7823573,8072187,5297824,3747902,3040961,33698279,3355426,6851614,10207040,5526744,7634283,7864028,5130672,3690423,3443448,33289598,66987877,87923432,87923432
Iran (Islamic Republic of),2022,IR,IRN,EMR,3344030,7352192,10696222,5763975,7478961,8316717,5469148,3826336,3163233,34018370,3171309,7000043,10171352,5564107,7303468,8123657,5294524,3792131,3586743,33664630,67683000,88550570,88550570
Iran (Islamic Republic of),2023,IR,IRN,EMR,3159012,7472025,10631037,5835369,7143800,8506829,5653076,3917823,3314450,34371347,2998750,7106264,10105014,5625426,6979827,8325698,5474083,3899794,3760535,34065363,68436710,89172767,89172767
Iran (Islamic Republic of),2024,IR,IRN,EMR,3027238,7508509,10535747,5926797,6811665,8649077,5857543,4029312,3489101,34763495,2876510,7134197,10010707,5709732,6657872,8475999,5677073,4019732,3959427,34499835,69263330,89809781,89809781
Iran (Islamic Republic of),2025,IR,IRN,EMR,2942158,7470903,10413061,6038058,6493471,8726114,6090699,4150236,3665518,35164096,2797963,7092996,9890959,5814599,6347228,8561906,5912243,4144572,4161991,34942539,70106635,90410659,90410659
Iran (Islamic Republic of),2026,IR,IRN,EMR,2871373,7389399,10260772,6170362,6200356,8732436,6346100,4285735,3840785,35575774,2732555,7011923,9744478,5938018,6060288,8577583,6173480,4281058,4364769,35395196,70970970,90976221,90976221
Iran (Islamic Republic of),2027,IR,IRN,EMR,2806916,7262313,10069229,6330383,5953816,8671944,6620527,4415221,4016545,36008436,2672807,6890094,9562901,6084742,5818861,8523305,6458973,4411402,4569006,35866289,71874725,91506852,91506852
Iran (Islamic Republic of),2028,IR,IRN,EMR,2747876,7088337,9836213,6518479,5766157,8533845,6917372,4535970,4193840,36465663,2617798,6725537,9343335,6256345,5634430,8389000,6770046,4534669,4775400,36359890,72825553,92005102,92005102
Iran (Islamic Republic of),2029,IR,IRN,EMR,2695458,6875010,9570468,6722737,5639294,8304334,7237204,4667903,4369579,36941051,2568757,6524539,9093296,6442977,5506917,8164524,7105265,4667911,4982955,36870549,73811600,92475363,92475363
Iran (Islamic Republic of),2030,IR,IRN,EMR,2650021,6636210,9286231,6924317,5579083,8004039,7557294,4816067,4541305,37422105,2526204,6300366,8826570,6626704,5441965,7870555,7441751,4811117,5194015,37386107,74808212,92921017,92921017
Iran (Islamic Republic of),1950,IR,IRN,EMR,1323727,1814316,3138043,1635830,1258679,899208,671594,511238,457622,5434171,1279898,1778182,3058080,1594637,1201776,820759,672696,492200,420466,5202534,10636705,16832834,16832834
Iran (Islamic Republic of),1951,IR,IRN,EMR,1422694,1835328,3258022,1654235,1303211,907364,688497,503536,462141,5518984,1363037,1796319,3159356,1611290,1247240,823659,683151,493307,424620,5283267,10802251,17219627,17219627
Iran (Islamic Republic of),1952,IR,IRN,EMR,1516967,1864312,3381279,1675590,1345973,914792,706011,494992,467043,5604401,1441852,1822263,3264115,1630526,1289149,827035,693984,494856,429106,5364656,10969057,17614454,17614454
Iran (Islamic Republic of),1953,IR,IRN,EMR,1607993,1903467,3511460,1696351,1385585,923546,722977,487310,471674,5687443,1519237,1856174,3375411,1648854,1326484,833497,703855,497126,433412,5443228,11130671,18017545,18017545
Iran (Islamic Republic of),1954,IR,IRN,EMR,1676261,1976568,3652829,1711627,1420461,938451,738069,483369,474779,5766756,1580005,1917434,3497439,1661620,1359120,847808,711439,500676,437196,5517859,11284615,18434881,18434881
Iran (Islamic Republic of),1955,IR,IRN,EMR,1725121,2082960,3808081,1720380,1450684,961134,750898,484082,475956,5843134,1625612,2007276,3632888,1667938,1387803,871372,716429,505761,440454,5589757,11432891,18873864,18873864
Iran (Islamic Republic of),1956,IR,IRN,EMR,1776622,2198413,3975035,1725041,1475394,991401,761566,489024,475440,5917866,1673406,2106043,3779449,1670141,1411538,903911,719191,512109,443173,5660063,11577929,19332414,19332414
Iran (Islamic Republic of),1957,IR,IRN,EMR,1831342,2321997,4153339,1726075,1492529,1028983,770039,498088,473376,5989090,1723879,2212408,3936287,1668881,1428237,945425,719752,519552,445344,5727191,11716281,19805912,19805912
Iran (Islamic Republic of),1958,IR,IRN,EMR,1889868,2453185,4343053,1725289,1503709,1070887,776729,510219,470468,6057301,1777722,2325725,4103447,1665885,1439259,992099,718705,527836,447534,5791318,11848619,20295117,20295117
Iran (Islamic Republic of),1959,IR,IRN,EMR,1951594,2590739,4542333,1729884,1516383,1114406,783303,523743,467513,6135232,1834308,2445069,4279377,1668283,1451671,1039367,718354,536767,450464,5864906,12000138,20821847,20821847
Iran (Islamic Republic of),1960,IR,IRN,EMR,2011042,2732789,4743831,1745326,1534031,1158385,791301,537652,464998,6231693,1888444,2568443,4456887,1681675,1468567,1085227,720793,545979,454161,5956402,12188095,21388806,21388806
Iran (Islamic Republic of),1961,IR,IRN,EMR,2063854,2877201,4941055,1771374,1557410,1202721,800383,552301,462885,6347074,1935907,2693721,4629628,1705809,1490646,1129841,725231,555825,458508,6065860,12412934,21983622,21983622
Iran (Islamic Republic of),1962,IR,IRN,EMR,2111506,3023446,5134952,1807644,1587200,1247162,809589,567558,460654,6479807,1978015,2820288,4798303,1739997,1518758,1172945,730812,566204,463281,6191997,12671804,22605050,22605050
Iran (Islamic Republic of),1963,IR,IRN,EMR,2155595,3172306,5327901,1855984,1620124,1290817,821061,582834,459279,6630099,2016092,2950835,4966927,1784304,1550022,1214205,740284,576455,468896,6334166,12964265,23259094,23259094
Iran (Islamic Republic of),1964,IR,IRN,EMR,2197001,3304071,5501072,1938525,1651023,1332197,839182,597286,460158,6818371,2050793,3070243,5121036,1856281,1579536,1253394,757805,585458,475664,6508138,13326509,23948624,23948624
Iran (Islamic Republic of),1965,IR,IRN,EMR,2241230,3415615,5656845,2053079,1677576,1370645,864876,610194,463262,7039632,2087226,3173506,5260732,1955234,1604886,1290240,784010,592363,483074,6709807,13749439,24667026,24667026
Iran (Islamic Republic of),1966,IR,IRN,EMR,2292991,3523811,5816802,2173277,1698832,1403917,897409,621461,468369,7263265,2130986,3273236,5404222,2059499,1625162,1322706,818356,597500,491186,6914409,14177674,25398700,25398700
Iran (Islamic Republic of),1967,IR,IRN,EMR,2350116,3630270,5980386,2296568,1713935,1430291,936671,631085,475435,7483985,2181882,3370745,5552627,2165994,1639667,1349064,860971,600853,499792,7116341,14600326,26133341,26133341
Iran (Islamic Republic of),1968,IR,IRN,EMR,2409360,3735694,6145054,2424085,1725995,1452323,980304,639351,483767,7705825,2238448,3466594,5705042,2275888,1651418,1371571,908810,602923,508766,7319376,15025201,26875302,26875302
Iran (Islamic Republic of),1969,IR,IRN,EMR,2471105,3840461,6311566,2557112,1740535,1474594,1024816,647307,492761,7937125,2301611,3561184,5862795,2391095,1665602,1394383,956895,605578,518645,7532198,15469323,27643685,27643685
Iran (Islamic Republic of),2031,IR,IRN,EMR,2611753,6383761,8995514,7108894,5578462,7664071,7848631,4978271,4719384,37897713,2490319,6063949,8554268,6794234,5432124,7540008,7748579,4963419,5417687,37896051,75793764,93343543,93343543
Iran (Islamic Republic of),2032,IR,IRN,EMR,2581838,6123326,8705164,7272758,5623365,7322967,8090592,5149978,4902958,38362618,2462240,5820446,8282686,6942119,5464666,7207846,8005719,5127699,5647286,38395335,76757953,93745796,93745796
Iran (Islamic Republic of),2033,IR,IRN,EMR,2560511,5880606,8441117,7393091,5696094,6995399,8280123,5331861,5095758,38792326,2442312,5593935,8036247,7048739,5526544,6887560,8207156,5306464,5884332,38860795,77653121,94130484,94130484
Iran (Islamic Republic of),2034,IR,IRN,EMR,2547601,5697496,8245097,7430244,5788228,6670184,8421877,5531755,5305095,39147383,2430395,5423451,7853846,7077132,5611079,6568670,8356747,5507077,6134728,39255433,78402816,94501761,94501761
Iran (Islamic Republic of),2035,IR,IRN,EMR,2542035,5567845,8109880,7393593,5900013,6358639,8500192,5759688,5523828,39435953,2425348,5302992,7728340,7036566,5716085,6260988,8442797,5739361,6391224,39587021,79022974,94861188,94861188
Iran (Islamic Republic of),2036,IR,IRN,EMR,2543445,5459558,8003003,7313271,6032655,6071728,8509628,6009525,5754201,39691008,2426907,5202259,7629166,6956214,5839566,5976826,8459505,5997370,6656816,39886297,79577305,95209476,95209476
Iran (Islamic Republic of),2037,IR,IRN,EMR,2551321,5365886,7917207,7187700,6192779,5830630,8453635,6277222,5978878,39920844,2434616,5114942,7549558,6835233,5986257,5737817,8406989,6278807,6915742,40160845,80081689,95548456,95548456
Iran (Islamic Republic of),2038,IR,IRN,EMR,2564954,5286162,7851116,7015623,6380748,5647464,8321602,6565886,6196416,40127739,2447698,5040463,7488161,6671642,6157738,5555375,8275280,6584899,7167816,40412750,80540489,95879769,95879769
Iran (Islamic Republic of),2039,IR,IRN,EMR,2581897,5221415,7803312,6804531,6584773,5524174,8100234,6876791,6422491,40312994,2463863,4979915,7443778,6471725,6344202,5429437,8054474,6914654,7428492,40642984,80955978,96203069,96203069
Iran (Islamic Republic of),2040,IR,IRN,EMR,2601367,5170941,7772308,6568185,6786220,5466580,7809578,7188034,6659729,40478326,2482463,4932688,7415151,6248689,6527787,5365627,7764946,7245600,7700160,40852809,81331135,96518596,96518596
Iran (Islamic Republic of),2041,IR,IRN,EMR,2623125,5134564,7757689,6318299,6970883,5467774,7479958,7471851,6915707,40624472,2503235,4898698,7401933,6013422,6695250,5356559,7439184,7547476,7990547,41042438,81666910,96826532,96826532
Iran (Islamic Republic of),2042,IR,IRN,EMR,2646583,5112954,7759537,6060485,7135081,5513891,7148950,7708015,7185314,40751736,2525627,4878624,7404251,5771059,6843148,5389590,7111727,7800481,8296061,41212066,81963802,97127583,97127583
Iran (Islamic Republic of),2043,IR,IRN,EMR,2670584,5105646,7776230,5820232,7256169,5587503,6831039,7893789,7472778,40861510,2548608,4872038,7420646,5545603,6949925,5451784,6795961,7998848,8620983,41363104,82224614,97421494,97421494
Iran (Islamic Republic of),2044,IR,IRN,EMR,2694527,5110027,7804554,5639082,7294797,5680318,6515519,8034380,7792294,40956390,2571499,4876516,7448015,5375970,6978737,5536503,6481628,8146769,8978230,41497837,82454227,97706793,97706793
Iran (Islamic Republic of),2045,IR,IRN,EMR,2717119,5124240,7841359,5510960,7260228,5792572,6213384,8114759,8146465,41038368,2593033,4890272,7483305,5256179,6938805,5641574,6178410,8232841,9370157,41617966,82656334,97981000,97981000
Iran (Islamic Republic of),2046,IR,IRN,EMR,2736190,5147698,7883888,5404022,7182325,5925484,5935344,8129572,8531611,41108358,2611213,4912783,7523996,5156042,6859211,5765019,5898480,8251356,9794154,41724262,82832620,98240506,98240506
Iran (Islamic Republic of),2047,IR,IRN,EMR,2748100,5179295,7927395,5311582,7059496,6085625,5702053,8081400,8927660,41167816,2622584,4943048,7565632,5069266,6739110,5911568,5663197,8202094,10232959,41818194,82986010,98479032,98479032
Iran (Islamic Republic of),2048,IR,IRN,EMR,2749297,5217173,7966470,5232986,6890456,6273383,5525362,7960041,9336041,41218269,2623621,4979259,7602880,4995277,6576537,6082794,5483819,8075299,10687463,41901189,83119458,98688811,98688811
Iran (Islamic Republic of),2049,IR,IRN,EMR,2738338,5258286,7996624,5169265,6682597,6477098,5407231,7753292,9772668,41262151,2613001,5018454,7631455,4935172,6377739,6268939,5360303,7861630,11171512,41975295,83237446,98865529,98865529
Iran (Islamic Republic of),2050,IR,IRN,EMR,2715446,5300568,8016014,5119720,6449556,6678297,5353409,7480029,10219097,41300108,2591047,5058717,7649764,4888339,6155881,6452231,5298225,7580865,11665778,42041319,83341427,99007204,99007204
Iraq,1970,IQ,IRQ,EMR,955065,1214475,2169540,885115,595826,424911,342328,264646,178756,2691582,912683,1175565,2088248,873000,606952,453819,370442,303296,254465,2861974,5553556,9811347,9811347
Iraq,1971,IQ,IRQ,EMR,989953,1281562,2271515,912690,615016,435598,343708,268441,187269,2762722,945688,1239467,2185155,901242,622430,465671,372539,307589,266056,2935527,5698249,10154928,10154928
Iraq,1972,IQ,IRQ,EMR,1024178,1362055,2386233,932552,633263,447006,344986,272178,195802,2825787,978193,1316369,2294562,921821,636786,478055,374593,312179,277298,3000732,5826519,10507315,10507315
Iraq,1973,IQ,IRQ,EMR,1057143,1457547,2514690,941492,653814,459348,346728,275849,204237,2881468,1009564,1407831,2417395,930484,654657,491100,377234,316894,288219,3058588,5940056,10872139,10872139
Iraq,1974,IQ,IRQ,EMR,1087819,1552892,2640711,953704,675239,472117,349268,278862,212217,2941407,1038760,1499086,2537846,941992,675716,504531,381089,321035,298817,3123180,6064587,11243146,11243146
Iraq,1975,IQ,IRQ,EMR,1116185,1646944,2763129,971831,694921,485146,352780,281126,219651,3005455,1065709,1589070,2654779,959904,696463,518067,386290,324440,309097,3194261,6199716,11617622,11617622
Iraq,1976,IQ,IRQ,EMR,1142517,1737767,2880284,995083,717860,499067,357847,283184,227009,3080050,1090685,1675892,2766577,981436,720151,531548,392896,327242,319158,3272431,6352481,11999342,11999342
Iraq,1977,IQ,IRQ,EMR,1168398,1814522,2982920,1032883,748296,514563,365000,285321,234327,3180390,1115219,1749050,2864269,1015906,750968,545538,401429,329722,329055,3372618,6553008,12400190,12400190
Iraq,1978,IQ,IRQ,EMR,1194674,1881580,3076254,1081263,784182,531605,373740,287382,241377,3299549,1140095,1812789,2952884,1060687,787599,560404,411635,332036,338668,3491029,6790578,12819707,12819707
Iraq,1979,IQ,IRQ,EMR,1219230,1946492,3165722,1130734,820335,549250,382825,288972,247949,3420065,1163302,1874397,3037699,1106772,824584,575318,422147,333891,347631,3610343,7030408,13233830,13233830
Iraq,1980,IQ,IRQ,EMR,1244633,2011429,3256062,1187188,849122,566669,391922,290141,253817,3538859,1187335,1935913,3123248,1162122,856830,590805,433230,335940,356280,3735207,7274066,13653369,13653369
Iraq,1981,IQ,IRQ,EMR,1271642,2074730,3346372,1248223,868955,581762,400307,290386,258420,3648053,1212910,1995900,3208810,1225703,884859,606061,444716,338075,364607,3864021,7512074,14067260,14067260
Iraq,1982,IQ,IRQ,EMR,1299231,2133459,3432690,1319518,878094,593950,408161,289861,262175,3751759,1239022,2051579,3290601,1300671,904234,619444,456104,339804,372374,3992631,7744390,14467682,14467682
Iraq,1983,IQ,IRQ,EMR,1331361,2193396,3524757,1407481,877962,608780,417267,290123,266038,3867651,1269464,2108440,3377904,1391694,913080,637108,468701,342492,380352,4133427,8001078,14903737,14903737
Iraq,1984,IQ,IRQ,EMR,1369061,2253915,3622976,1497998,883036,625809,427624,291693,269630,3995790,1305203,2165934,3471137,1484660,926202,658910,482395,346824,388137,4287128,8282918,15377032,15377032
Iraq,1985,IQ,IRQ,EMR,1399197,2296698,3695895,1577496,888176,637353,435520,292310,270786,4101641,1333735,2206322,3540057,1566052,939143,675801,492822,350010,392434,4416262,8517903,15753856,15753856
Iraq,1986,IQ,IRQ,EMR,1430050,2340425,3770475,1655683,897895,651201,443992,294256,271715,4214742,1362962,2247571,3610533,1645430,956370,696058,503508,354743,396367,4552476,8767218,16148221,16148221
Iraq,1987,IQ,IRQ,EMR,1465135,2391540,3856675,1724260,922290,671893,454184,298318,273107,4344052,1396277,2295848,3692125,1713966,988331,724576,515616,361902,400774,4705165,9049217,16598019,16598019
Iraq,1988,IQ,IRQ,EMR,1495094,2434561,3929655,1774614,950579,692693,462698,301540,272143,4454267,1424840,2336364,3761204,1765228,1025494,755086,525877,368462,402067,4842214,9296481,16987346,16987346
Iraq,1989,IQ,IRQ,EMR,1529595,2487413,4017008,1832738,985701,716494,473485,305876,271001,4585295,1457916,2386238,3844154,1822146,1068117,788936,538202,376279,402450,4996130,9581425,17442590,17442590
Iraq,1990,IQ,IRQ,EMR,1544026,2504291,4048317,1866023,1017251,725966,478341,306259,265883,4659723,1472100,2401460,3873560,1850718,1103092,805804,542783,378580,395799,5076776,9736499,17658381,17658381
Iraq,1991,IQ,IRQ,EMR,1561628,2513671,4075299,1892576,1054579,730193,482175,306765,261088,4727376,1489497,2409434,3898931,1871267,1141827,816046,545717,380514,389402,5144773,9872149,17846378,17846378
Iraq,1992,IQ,IRQ,EMR,1614702,2568985,4183687,1952669,1124924,742485,494745,314328,263084,4892235,1540671,2461526,4002197,1922213,1211706,833204,557635,390225,392569,5307552,10199787,18385673,18385673
Iraq,1993,IQ,IRQ,EMR,1701550,2675371,4376921,2047679,1231751,760286,518802,328699,270916,5158133,1623787,2562965,4186752,2006637,1317363,854479,583326,407820,404388,5574013,10732146,19295818,19295818
Iraq,1994,IQ,IRQ,EMR,1788780,2791122,4579902,2141559,1342532,782939,544845,344034,279297,5435206,1707005,2673797,4380802,2091162,1424814,880072,612769,426248,417103,5852168,11287374,20248073,20248073
Iraq,1995,IQ,IRQ,EMR,1846805,2877729,4724534,2204615,1439019,800648,563003,355388,284234,5646907,1762142,2756882,4519024,2146528,1514612,899795,633911,439158,424385,6058389,11705296,20948858,20948858
Iraq,1996,IQ,IRQ,EMR,1895506,2969467,4864973,2264246,1533843,821479,582669,366792,289460,5858489,1808216,2844805,4653021,2199475,1600664,922150,657346,451563,431643,6262841,12121330,21639332,21639332
Iraq,1997,IQ,IRQ,EMR,1940082,3065139,5005221,2322089,1615937,853303,606751,378363,294942,6071385,1850228,2936461,4786689,2251508,1671429,955614,686445,463563,438917,6467476,12538861,22330770,22330770
Iraq,1998,IQ,IRQ,EMR,1985880,3166828,5152708,2381849,1690152,894557,634709,390744,300809,6292820,1893377,3033953,4927330,2306118,1732773,998420,720543,476019,446754,6680627,12973447,23053488,23053488
Iraq,1999,IQ,IRQ,EMR,2034067,3273333,5307400,2446365,1766644,939895,663998,404351,307367,6528620,1938632,3136424,5075056,2366093,1796427,1044720,756608,489798,456003,6909649,13438269,23820734,23820734
Iraq,2000,IQ,IRQ,EMR,2085744,3382573,5468317,2514787,1844102,995138,689698,419000,314761,6777486,1986847,3241896,5228743,2430756,1861613,1100943,788996,504901,467096,7154305,13931791,24628858,24628858
Iraq,2001,IQ,IRQ,EMR,2135709,3489224,5624933,2581470,1917989,1058318,711511,433357,322408,7025053,2033211,3344797,5378008,2494181,1923861,1164312,816968,519677,478670,7397669,14422722,25425663,25425663
Iraq,2002,IQ,IRQ,EMR,2183672,3602599,5786271,2651840,1991102,1135557,727862,447285,330739,7284385,2077519,3453831,5531350,2561532,1986406,1241347,838661,534083,491304,7653333,14937718,26255343,26255343
Iraq,2003,IQ,IRQ,EMR,2226114,3715778,5941892,2721364,2056864,1224698,734188,461967,338953,7538034,2116373,3562333,5678706,2630478,2045320,1330774,848360,551065,504193,7910190,15448224,27068823,27068823
Iraq,2004,IQ,IRQ,EMR,2267513,3822687,6090200,2790978,2112628,1312808,742362,476794,346996,7782566,2154332,3664427,5818759,2702477,2099220,1418635,859806,570199,517087,8167424,15949990,27858948,27858948
Iraq,2005,IQ,IRQ,EMR,2312662,3930442,6243104,2871514,2166569,1402707,756765,491313,355978,8044846,2196370,3766905,5963275,2785785,2154365,1507576,878506,589917,531308,8447457,16492303,28698684,28698684
Iraq,2006,IQ,IRQ,EMR,2307638,3944070,6251708,2894788,2168156,1458656,757633,496275,357231,8132739,2191219,3778863,5970082,2814746,2161460,1560265,881354,599216,534037,8551078,16683817,28905607,28905607
Iraq,2007,IQ,IRQ,EMR,2271247,3888404,6159651,2876885,2132661,1477183,756939,497101,353052,8093821,2156676,3724177,5880853,2804089,2134800,1573077,881697,604410,528481,8526554,16620375,28660887,28660887
Iraq,2008,IQ,IRQ,EMR,2302065,3935172,6237237,2944472,2159170,1526177,785314,514435,359410,8288978,2186141,3767416,5953557,2872541,2167665,1616834,914163,629575,537836,8738614,17027592,29218381,29218381
Iraq,2009,IQ,IRQ,EMR,2374799,4048056,6422855,3065735,2228193,1602029,829637,540965,372946,8639505,2255208,3873587,6128795,2988145,2238215,1686769,962939,665235,556578,9097881,17737386,30289040,30289040
Iraq,2010,IQ,IRQ,EMR,2447956,4144083,6592039,3174756,2291186,1671312,878999,561655,385748,8963656,2324485,3963397,6287882,3089874,2300276,1748573,1015688,693494,573395,9421300,18384956,31264875,31264875
Iraq,2011,IQ,IRQ,EMR,2546555,4252908,6799463,3293193,2362473,1743968,938866,581303,400054,9319857,2417946,4065273,6483219,3200713,2369629,1814072,1078740,720260,592117,9775531,19095388,32378061,32378061
Iraq,2012,IQ,IRQ,EMR,2680612,4406748,7087360,3448923,2460990,1832938,1020487,601842,418356,9783536,2545121,4209848,6754969,3347607,2464952,1896936,1164741,747906,616427,10238569,20022105,33864447,33864447
Iraq,2013,IQ,IRQ,EMR,2819647,4576234,7395881,3618808,2572451,1925810,1118969,616984,439773,10292795,2677165,4368960,7046125,3508360,2572277,1984592,1268047,767879,645844,10746999,21039794,35481800,35481800
Iraq,2014,IQ,IRQ,EMR,2919039,4704241,7623280,3749798,2664890,1996220,1209587,629409,458478,10708382,2771854,4488094,7259948,3631230,2659376,2049738,1359682,783032,671821,11154879,21863261,36746488,36746488
Iraq,2015,IQ,IRQ,EMR,2973765,4812883,7786648,3851352,2748441,2051342,1294648,643032,474805,11063620,2824296,4588618,7412914,3724852,2735915,2099477,1442166,798609,693615,11494634,22558254,37757813,37757813
Iraq,2016,IQ,IRQ,EMR,2986347,4936928,7923275,3938733,2834493,2101878,1377632,659840,492933,11405509,2836676,4704088,7540764,3807555,2817246,2146985,1521163,817331,718115,11828395,23233904,38697943,38697943
Iraq,2017,IQ,IRQ,EMR,2968605,5076297,8044902,4018555,2925442,2151915,1450698,687613,515672,11749895,2820235,4834720,7654955,3884275,2905034,2195970,1587904,848293,749932,12171408,23921303,39621162,39621162
Iraq,2018,IQ,IRQ,EMR,2944357,5220735,8165092,4102388,3027491,2206994,1518835,725347,543122,12124177,2797596,4970643,7768239,3960680,2999912,2248741,1646875,889246,787734,12533188,24657365,40590700,40590700
Iraq,2019,IQ,IRQ,EMR,2921327,5356387,8277714,4188650,3132202,2264857,1587414,766098,571771,12510992,2776018,5098527,7874545,4037235,3095348,2303457,1705458,932193,826579,12900270,25411262,41563520,41563520
Iraq,2020,IQ,IRQ,EMR,2911206,5482799,8394005,4280177,3238705,2325939,1654923,812040,591784,12903568,2766533,5217829,7984362,4119104,3192803,2361595,1763724,981448,856375,13275049,26178617,42556984,42556984
Iraq,2021,IQ,IRQ,EMR,2917856,5587765,8505621,4371857,3344670,2387648,1719324,863238,605052,13291789,2772839,5316945,8089784,4201253,3289756,2419953,1819747,1036327,879368,13646404,26938193,43533592,43533592
Iraq,2022,IQ,IRQ,EMR,2939396,5666659,8606055,4460832,3450971,2450193,1781044,925136,616130,13684306,2793236,5391506,8184742,4281034,3387009,2478270,1873688,1102025,898983,14021009,27705315,44496122,44496122
Iraq,2023,IQ,IRQ,EMR,2971577,5734711,8706288,4552753,3561088,2518597,1841748,999529,626493,14100208,2824269,5456150,8280419,4364035,3488238,2541744,1927417,1180533,915671,14417638,28517846,45504560,45504560
Iraq,2024,IQ,IRQ,EMR,3002599,5792806,8795405,4650106,3668580,2593832,1899564,1076764,643586,14532432,2854802,5511764,8366566,4452636,3587048,2611325,1979119,1259688,939433,14829249,29361681,46523657,46523657
Iraq,2025,IQ,IRQ,EMR,3032972,5836254,8869226,4759765,3771402,2677254,1954871,1155116,664589,14982997,2884960,5553555,8438515,4553545,3681163,2688324,2029378,1338237,968161,15258808,30241805,47549546,47549546
Iraq,2026,IQ,IRQ,EMR,3064019,5858638,8922657,4889326,3867128,2768978,2009067,1233125,689998,15457622,2915969,5575230,8491199,4674201,3768307,2772795,2079545,1414847,1002348,15712043,31169665,48583520,48583520
Iraq,2027,IQ,IRQ,EMR,3094553,5867514,8962067,5032919,3955930,2866929,2063123,1302657,727327,15948885,2946466,5584170,8530636,4809002,3848596,2862826,2130399,1479798,1051250,16181871,32130756,49623459,49623459
Iraq,2028,IQ,IRQ,EMR,3126212,5875509,9001721,5176245,4040561,2969275,2117862,1365760,773974,16443677,2977680,5592797,8570477,4944246,3924560,2956849,2182526,1536193,1111356,16655730,33099407,50671593,50671593
Iraq,2029,IQ,IRQ,EMR,3161727,5884632,9046359,5312136,4126604,3073025,2174774,1428967,823215,16938721,3012205,5602915,8615120,5072834,4001706,3052205,2237107,1592667,1174041,17130560,34069281,51730760,51730760
Iraq,2030,IQ,IRQ,EMR,3199950,5903578,9103528,5434612,4214869,3176410,2233760,1491457,875291,17426399,3049168,5622514,8671682,5188901,4081144,3147352,2293714,1648653,1239458,17599222,35025621,52800825,52800825
Iraq,1950,IQ,IRQ,EMR,453962,648463,1102425,481032,411465,363842,259745,125831,72451,1714366,430721,635950,1066671,486884,411745,364270,282751,142212,85149,1773011,3487377,5656471,5656471
Iraq,1951,IQ,IRQ,EMR,465401,667630,1133031,491394,411032,366499,267834,134292,72702,1743753,444528,651280,1095808,498542,412963,368116,290991,153797,86973,1811382,3555135,5783972,5783972
Iraq,1952,IQ,IRQ,EMR,486431,685695,1172126,502575,410523,369049,275902,143177,72981,1774207,467802,665492,1133294,510815,414176,372339,298712,165933,88751,1850726,3624933,5930350,5930350
Iraq,1953,IQ,IRQ,EMR,511375,705704,1217079,514446,410312,371352,283607,152210,73611,1805538,493249,682870,1176119,523420,415742,376520,305720,178227,90889,1890518,3696056,6089258,6089258
Iraq,1954,IQ,IRQ,EMR,535091,727509,1262600,527243,411405,373153,290604,161004,75195,1838604,516094,703446,1219540,536378,418644,380033,311939,190089,94215,1931298,3769902,6252041,6252041
Iraq,1955,IQ,IRQ,EMR,552812,748647,1301459,541007,414160,374480,296859,169446,77891,1873843,532999,723898,1256897,549634,423214,382857,317510,201293,98987,1973495,3847338,6405686,6405686
Iraq,1956,IQ,IRQ,EMR,562763,772568,1335331,555411,418595,375397,302374,177484,81622,1910883,542113,747622,1289735,562977,429446,385069,322370,211816,105175,2016853,3927736,6552801,6552801
Iraq,1957,IQ,IRQ,EMR,556142,802895,1359037,570592,424866,376025,307088,185062,86430,1950063,535131,778129,1313260,576401,437445,386713,326479,221566,112838,2061442,4011505,6683798,6683798
Iraq,1958,IQ,IRQ,EMR,534000,837894,1371894,586698,432498,376297,311084,192320,92030,1990927,513289,813585,1326874,589987,446720,387834,330040,230565,121644,2106790,4097717,6796490,6796490
Iraq,1959,IQ,IRQ,EMR,518988,874132,1393120,603963,440885,376361,314738,199522,97964,2033433,498345,850396,1348741,604387,456921,388935,333689,239082,131013,2154027,4187460,6929323,6929323
Iraq,1960,IQ,IRQ,EMR,517078,905661,1422739,622666,450357,376777,318424,206861,104110,2079195,496013,882727,1378740,619752,468038,390521,337733,247258,140701,2204003,4283198,7084678,7084678
Iraq,1961,IQ,IRQ,EMR,527588,933391,1460979,641946,460984,377495,322039,214329,110511,2127304,505662,911265,1416927,635335,479986,392429,342011,255033,150719,2255513,4382817,7260714,7260714
Iraq,1962,IQ,IRQ,EMR,568583,953681,1522264,660287,472382,378161,325597,221815,117047,2175289,544601,932449,1477050,650017,492659,394418,346723,262417,160986,2307220,4482509,7481832,7481832
Iraq,1963,IQ,IRQ,EMR,634564,962655,1597219,680780,484564,379175,328985,229042,123740,2226286,607566,941384,1548950,668132,505900,396920,351546,269308,171552,2363358,4589644,7735824,7735824
Iraq,1964,IQ,IRQ,EMR,697053,975935,1672988,703166,497711,381383,331882,235684,130716,2280542,667214,953222,1620436,689528,519585,400745,355769,275562,182508,2423697,4704239,7997655,7997655
Iraq,1965,IQ,IRQ,EMR,756834,996364,1753198,725029,511860,385148,334346,241754,138058,2336195,724299,971825,1696124,710832,533569,406143,359318,281262,193894,2485018,4821213,8270544,8270544
Iraq,1966,IQ,IRQ,EMR,813545,1021139,1834684,749574,526571,390409,336379,247251,145746,2395930,778468,994353,1772821,735327,547611,413096,362258,286392,205767,2550451,4946381,8553883,8553883
Iraq,1967,IQ,IRQ,EMR,855067,1058790,1913857,780507,542157,397385,338119,252126,153747,2464041,818047,1029115,1847162,766490,561712,421711,364619,290873,218037,2623442,5087483,8848502,8848502
Iraq,1968,IQ,IRQ,EMR,886550,1106163,1992713,816474,558984,405815,339653,256540,161996,2539462,847922,1073307,1921229,802875,576193,431708,366588,294965,230399,2702728,5242190,9156132,9156132
Iraq,1969,IQ,IRQ,EMR,920090,1155742,2075832,853336,576885,414988,340950,260663,170334,2617156,879654,1119870,1999524,840409,591296,442465,368411,299062,242577,2784220,5401376,9476737,9476737
Iraq,2031,IQ,IRQ,EMR,3239060,5940747,9179807,5537478,4304455,3280100,2294186,1552306,930368,17898893,3086902,5659556,8746458,5286541,4162187,3243027,2351384,1703569,1307629,18054337,35953230,53879499,53879499
Iraq,2032,IQ,IRQ,EMR,3280199,5994488,9274687,5619159,4394798,3386498,2356717,1610963,988689,18356824,3126503,5712432,8838935,5364273,4244319,3341497,2410573,1757161,1378645,18496468,36853292,54966918,54966918
Iraq,2033,IQ,IRQ,EMR,3321792,6058067,9379859,5686698,4485662,3494816,2423272,1666979,1050701,18808128,3166409,5774783,8941192,5428862,4327095,3441896,2473205,1809032,1453010,18933100,37741228,56062270,56062270
Iraq,2034,IQ,IRQ,EMR,3361030,6124709,9485739,5744539,4582266,3600850,2496453,1720079,1116836,19261023,3204027,5840144,9044171,5484555,4415534,3540005,2541835,1858852,1531253,19372034,38633057,57162965,57162965
Iraq,2035,IQ,IRQ,EMR,3397937,6193407,9591344,5787902,4691038,3702325,2577610,1771070,1186489,19716434,3239370,5907548,9146918,5526472,4516205,3633487,2617751,1907430,1612801,19814146,39530580,58268847,58268847
Iraq,2036,IQ,IRQ,EMR,3431790,6263677,9695467,5810459,4819479,3796865,2666856,1821237,1258817,20173713,3271703,5976559,9248262,5548379,4636494,3720095,2701002,1956021,1696815,20258806,40432519,59376243,59376243
Iraq,2037,IQ,IRQ,EMR,3462202,6335471,9797673,5819701,4961770,3884623,2762164,1871439,1333210,20632907,3300717,6046918,9347635,5557615,4770822,3799937,2789711,2005344,1782847,20706276,41339183,60484498,60484498
Iraq,2038,IQ,IRQ,EMR,3488690,6408833,9897523,5828116,5103782,3968297,2861722,1922405,1409106,21093428,3325973,6118293,9444266,5566552,4905563,3875506,2882338,2055965,1870530,21156454,42249882,61591674,61591674
Iraq,2039,IQ,IRQ,EMR,3511562,6483699,9995261,5837686,5238454,4053399,2962665,1975558,1486359,21554121,3347780,6190668,9538448,5576976,5033679,3952259,2976284,2109007,1959874,21608079,43162200,62695913,62695913
Iraq,2040,IQ,IRQ,EMR,3531353,6558943,10090296,5857024,5359889,4140707,3063246,2030758,1564442,22016066,3366636,6263190,9629826,5596840,5149332,4031280,3070023,2164051,2050405,22061931,44077997,63798124,63798124
Iraq,2041,IQ,IRQ,EMR,3549701,6632049,10181750,5894427,5461968,4229335,3164071,2087333,1642626,22479760,3384020,6333480,9717500,5634079,5246658,4111905,3164257,2220138,2141551,22518588,44998348,64897603,64897603
Iraq,2042,IQ,IRQ,EMR,3565140,6703763,10268903,5948256,5543153,4318756,3267488,2145872,1720619,22944144,3398643,6402326,9800969,5687074,5324195,4193629,3261211,2277693,2233097,22976899,45921043,65990902,65990902
Iraq,2043,IQ,IRQ,EMR,3579100,6772031,10351131,6011829,5610399,4408737,3372777,2208181,1798394,23410317,3411891,6467727,9879618,5749504,5388673,4276022,3360068,2338558,2325046,23437871,46848188,67078936,67078936
Iraq,2044,IQ,IRQ,EMR,3591744,6834376,10426120,6078474,5668123,4504423,3475943,2276727,1876120,23879810,3423885,6527401,9951286,5814936,5444332,4364055,3456737,2405226,2417591,23902877,47782687,68160087,68160087
Iraq,2045,IQ,IRQ,EMR,3601692,6891337,10493029,6147183,5711599,4612156,3574807,2352767,1953961,24352473,3433402,6581858,10015260,5882417,5486341,4464242,3548952,2478929,2510944,24371825,48724298,69232581,69232581
Iraq,2046,IQ,IRQ,EMR,3612772,6943830,10556602,6217466,5734568,4739321,3667082,2436413,2032321,24827171,3443983,6631839,10075822,5951499,5508509,4583888,3634518,2559738,2605468,24843620,49670791,70303215,70303215
Iraq,2047,IQ,IRQ,EMR,3624341,6990016,10614357,6289286,5744418,4880171,3752906,2525757,2111544,25304082,3454882,6675754,10130636,6021932,5518128,4717453,3713515,2645821,2701384,25318233,50622315,71367305,71367305
Iraq,2048,IQ,IRQ,EMR,3634632,7030846,10665478,6362687,5753477,5020760,3834881,2619085,2191822,25782712,3464508,6714554,10179062,6093374,5527458,4851412,3788381,2735690,2798842,25795157,51577869,72422410,72422410
Iraq,2049,IQ,IRQ,EMR,3646456,7066772,10713228,6437583,5763691,5154138,3918358,2713757,2274271,26261798,3475428,6748655,10224083,6165815,5538279,4978813,3864481,2826892,2899015,26273295,52535093,73472404,73472404
Iraq,2050,IQ,IRQ,EMR,3659461,7096950,10756411,6512865,5783564,5274479,4004036,2808085,2358449,26741478,3487277,6777333,10264610,6238404,5558477,5093855,3942840,2917917,3001143,26752636,53494114,74515140,74515140
Iceland,1970,IS,ISL,EUR,10887,23272,34159,19292,12503,11636,9940,7583,8284,69238,10366,22200,32566,17996,12097,11215,9680,7846,9675,68509,137747,204468,204468
Iceland,1971,IS,ISL,EUR,10569,23325,33894,19721,12910,11521,10076,7656,8435,70319,10077,22193,32270,18451,12354,11225,9828,7930,9895,69683,140002,206171,206171
Iceland,1972,IS,ISL,EUR,10594,23246,33840,20302,13498,11489,10228,7771,8570,71858,10067,22208,32275,19056,12791,11209,9992,8050,10124,71222,143080,209191,209191
Iceland,1973,IS,ISL,EUR,10805,23084,33889,20816,14128,11430,10418,7919,8694,73405,10275,22054,32329,19519,13389,11176,10112,8184,10370,72750,146155,212374,212374
Iceland,1974,IS,ISL,EUR,10942,22868,33810,21272,14827,11366,10634,8000,8862,74961,10388,21840,32228,19936,14051,11108,10274,8283,10625,74277,149238,215281,215281
Iceland,1975,IS,ISL,EUR,11048,22507,33555,21698,15655,11242,10832,8104,9086,76617,10445,21570,32015,20415,14679,10983,10518,8417,10871,75883,152500,218070,218070
Iceland,1976,IS,ISL,EUR,11086,22199,33285,22004,16303,11068,10950,8303,9304,77932,10478,21257,31735,20688,15263,10897,10701,8598,11147,77294,155226,220244,220244
Iceland,1977,IS,ISL,EUR,10857,22055,32912,22203,16756,11071,11050,8483,9496,79059,10285,21098,31383,20844,15706,10967,10783,8754,11476,78530,157589,221887,221887
Iceland,1978,IS,ISL,EUR,10541,21931,32472,22364,17247,11251,11117,8636,9721,80336,10042,20964,31006,21080,16055,11189,10807,8913,11791,79835,160171,223641,223641
Iceland,1979,IS,ISL,EUR,10495,21758,32253,22482,17751,11546,11122,8791,9928,81620,10058,20692,30750,21335,16459,11447,10826,9049,12110,81226,162846,225853,225853
Iceland,1980,IS,ISL,EUR,10674,21515,32189,22577,18165,11969,11078,8974,10094,82857,10216,20429,30645,21467,16923,11731,10897,9153,12400,82571,165428,228263,228263
Iceland,1981,IS,ISL,EUR,10829,21331,32160,22673,18625,12478,11011,9150,10236,84173,10312,20266,30578,21548,17479,12056,10949,9319,12618,83969,168142,230882,230882
Iceland,1982,IS,ISL,EUR,11046,21239,32285,22676,19196,13041,10984,9318,10396,85611,10460,20132,30592,21684,18061,12483,10938,9492,12847,85505,171116,233995,233995
Iceland,1983,IS,ISL,EUR,11259,21187,32446,22606,19698,13669,10922,9495,10557,86947,10679,20139,30818,21653,18546,13091,10890,9617,13128,86925,173872,237131,237131
Iceland,1984,IS,ISL,EUR,11227,21275,32502,22383,20122,14345,10822,9684,10711,88067,10682,20269,30951,21484,18972,13728,10812,9792,13371,88159,176226,239677,239677
Iceland,1985,IS,ISL,EUR,10890,21515,32405,22001,20434,15118,10690,9879,10919,89041,10434,20490,30924,21189,19370,14311,10691,10038,13605,89204,178245,241577,241577
Iceland,1986,IS,ISL,EUR,10514,21713,32227,21723,20667,15841,10570,10031,11197,90029,10184,20671,30855,20921,19626,14948,10616,10233,13892,90236,180265,243357,243357
Iceland,1987,IS,ISL,EUR,10374,21792,32166,21700,20996,16462,10632,10170,11449,91409,10053,20674,30727,20961,19978,15544,10697,10332,14221,91733,183142,246032,246032
Iceland,1988,IS,ISL,EUR,10520,21787,32307,21860,21449,17149,10882,10252,11631,93223,10067,20696,30763,21182,20538,16062,10959,10363,14513,93617,186840,249917,249917
Iceland,1989,IS,ISL,EUR,10733,21715,32448,21802,21713,17760,11218,10285,11842,94620,10239,20727,30966,21056,20947,16573,11265,10404,14768,95013,189633,253042,253042
Iceland,1990,IS,ISL,EUR,11011,21522,32533,21512,21743,18194,11653,10283,12094,95479,10502,20630,31132,20695,21083,17047,11564,10480,15012,95881,191360,255019,255019
Iceland,1991,IS,ISL,EUR,11433,21316,32749,21375,21890,18646,12194,10234,12324,96663,10800,20540,31340,20599,21264,17634,11906,10520,15318,97241,193904,257991,257991
Iceland,1992,IS,ISL,EUR,11767,21425,33192,21258,21917,19114,12754,10197,12575,97815,11107,20550,31657,20516,21422,18191,12329,10502,15636,98596,196411,261262,261262
Iceland,1993,IS,ISL,EUR,11853,21767,33620,21114,21759,19504,13322,10159,12884,98742,11297,20690,31987,20415,21296,18618,12910,10447,15898,99584,198326,263932,263932
Iceland,1994,IS,ISL,EUR,11824,21916,33740,21168,21488,19865,13952,10106,13185,99764,11285,20780,32065,20445,21085,19030,13531,10370,16196,100657,200421,266224,266224
Iceland,1995,IS,ISL,EUR,11682,21880,33562,21339,20979,20116,14692,10002,13494,100622,11070,20760,31830,20588,20750,19410,14106,10258,16556,101668,202290,267681,267681
Iceland,1996,IS,ISL,EUR,11465,21873,33338,21525,20574,20329,15411,9900,13786,101525,10845,20794,31639,20767,20415,19667,14716,10195,16871,102631,204156,269137,269137
Iceland,1997,IS,ISL,EUR,11279,21912,33191,21668,20470,20591,16000,9967,14048,102744,10698,20874,31572,20816,20329,19956,15295,10288,17166,103850,206594,271356,271356
Iceland,1998,IS,ISL,EUR,11119,22024,33143,21697,20584,20856,16621,10205,14261,104224,10550,21023,31573,20829,20395,20340,15824,10516,17448,105352,209576,274285,274285
Iceland,1999,IS,ISL,EUR,10979,22240,33219,21732,20744,21086,17223,10536,14435,105756,10480,21270,31750,20955,20394,20743,16351,10793,17665,106901,212657,277626,277626
Iceland,2000,IS,ISL,EUR,10915,22583,33498,21742,20924,21356,17712,10977,14666,107377,10528,21521,32049,21138,20441,21082,16895,11104,17878,108538,215915,281462,281462
Iceland,2001,IS,ISL,EUR,10863,22965,33828,21644,21096,21585,18214,11524,14888,108951,10516,21778,32294,21202,20522,21318,17506,11454,18166,110168,219119,285238,285238
Iceland,2002,IS,ISL,EUR,10732,23137,33869,21649,21033,21537,18706,12099,15100,110124,10410,21982,32392,21116,20439,21454,18076,11883,18450,111418,221542,287798,287798
Iceland,2003,IS,ISL,EUR,10644,23041,33685,21837,20873,21417,19142,12685,15333,111287,10351,21969,32320,21080,20388,21390,18547,12478,18631,112514,223801,289801,289801
Iceland,2004,IS,ISL,EUR,10662,22875,33537,21978,20999,21377,19638,13338,15555,112885,10333,21839,32172,21086,20501,21236,19011,13128,18807,113769,226654,292361,292361
Iceland,2005,IS,ISL,EUR,10729,22718,33447,22223,21774,21562,20376,14183,15757,115875,10343,21721,32064,21262,20939,21110,19517,13764,19054,115646,231521,297029,297029
Iceland,2006,IS,ISL,EUR,10838,22554,33392,22672,23104,22325,21459,15067,16000,120627,10439,21632,32071,21608,21565,21105,19945,14426,19327,117976,238603,304070,304070
Iceland,2007,IS,ISL,EUR,11127,22388,33515,23319,24514,23115,22295,15770,16348,125361,10665,21591,32256,22162,22158,21327,20393,15019,19666,120725,246086,311853,311853
Iceland,2008,IS,ISL,EUR,11537,22280,33817,23946,25201,23184,22393,16336,16759,127819,10993,21519,32512,22818,22704,21551,20910,15550,20044,123577,251396,317715,317715
Iceland,2009,IS,ISL,EUR,11855,22127,33982,23989,24581,22530,22069,16783,17209,127161,11246,21356,32602,23024,22818,21381,21290,16111,20424,125048,252209,318800,318800
Iceland,2010,IS,ISL,EUR,12042,21948,33990,23913,23656,21833,21822,17168,17732,126124,11402,21197,32599,22902,22576,21094,21503,16646,20899,125620,251744,318333,318333
Iceland,2011,IS,ISL,EUR,12112,21836,33948,24092,23125,21473,21720,17623,18338,126371,11451,21076,32527,22923,22351,20896,21652,17209,21415,126446,252817,319293,319293
Iceland,2012,IS,ISL,EUR,12075,21835,33910,24220,22964,21260,21515,18106,19056,127121,11422,21079,32501,22964,22254,20745,21776,17758,21949,127446,254567,320979,320979
Iceland,2013,IS,ISL,EUR,11927,22058,33985,24220,23346,21285,21338,18542,19787,128518,11400,21284,32684,22963,22448,20858,21737,18247,22582,128835,257353,324024,324024
Iceland,2014,IS,ISL,EUR,11667,22452,34119,24189,23728,21609,21221,18983,20520,130250,11260,21553,32813,22980,22711,21142,21587,18754,23286,130460,260710,327644,327644
Iceland,2015,IS,ISL,EUR,11320,22776,34096,24117,24135,22164,21064,19399,21359,132238,10950,21747,32697,22954,22910,21530,21401,19273,23956,132024,264262,331060,331060
Iceland,2016,IS,ISL,EUR,10999,23045,34044,24098,25028,22945,21191,19826,22126,135214,10678,21975,32653,22962,23225,21977,21308,19651,24643,133766,268980,335675,335675
Iceland,2017,IS,ISL,EUR,10855,23433,34288,24283,26740,24071,21816,20346,22877,140133,10532,22307,32839,23096,24009,22381,21494,20044,25344,136368,276501,343632,343632
Iceland,2018,IS,ISL,EUR,10887,23757,34644,24447,28828,25256,22564,20807,23773,145675,10364,22617,32981,23297,25171,22803,21760,20515,26099,139645,285320,352946,352946
Iceland,2019,IS,ISL,EUR,10989,23936,34925,24506,30459,26186,23089,21128,24687,150055,10303,22795,33098,23422,26275,23298,21822,20942,26929,142688,292743,360774,360774
Iceland,2020,IS,ISL,EUR,11175,24083,35258,24485,31345,26698,23314,21374,25610,152826,10412,22930,33342,23400,27085,23766,21896,21270,27825,145242,298068,366669,366669
Iceland,2021,IS,ISL,EUR,11434,24045,35479,24229,31651,26921,23431,21575,26536,154343,10569,22941,33510,23182,27550,24050,21981,21503,28738,147004,301347,370335,370335
Iceland,2022,IS,ISL,EUR,11622,23830,35452,23888,31673,27347,23615,21656,27502,155681,10744,22739,33483,22928,27812,24236,21977,21682,29647,148282,303963,372899,372899
Iceland,2023,IS,ISL,EUR,11735,23603,35338,23731,31310,28021,23812,21682,28482,157038,10931,22444,33375,22820,27809,24548,22117,21693,30593,149580,306618,375318,375318
Iceland,2024,IS,ISL,EUR,11777,23340,35117,23840,30636,28664,24180,21682,29469,158471,11015,22154,33169,22859,27568,24905,22408,21617,31576,150933,309404,377689,377689
Iceland,2025,IS,ISL,EUR,11757,23096,34853,24038,29825,29211,24730,21614,30500,159918,11037,21897,32934,22947,27181,25296,22814,21503,32572,152313,312231,380010,380010
Iceland,2026,IS,ISL,EUR,11693,22976,34669,24169,28912,29811,25238,21673,31445,161248,11041,21726,32767,23048,26673,25745,23184,21432,33498,153580,314828,382260,382260
Iceland,2027,IS,ISL,EUR,11625,22920,34545,24350,27870,30390,25625,21893,32343,162471,10984,21661,32645,23184,26095,26188,23338,21533,34427,154765,317236,384427,384427
Iceland,2028,IS,ISL,EUR,11535,22954,34489,24485,26818,30918,25925,22163,33272,163581,10905,21589,32494,23326,25404,26686,23447,21649,35425,155937,319518,386498,386498
Iceland,2029,IS,ISL,EUR,11428,23018,34446,24507,25938,31373,26235,22398,34166,164617,10810,21553,32363,23391,24758,27183,23665,21602,36445,157044,321661,388471,388471
Iceland,2030,IS,ISL,EUR,11302,23084,34386,24462,25292,31701,26545,22575,35044,165619,10695,21597,32292,23360,24262,27574,23877,21558,37414,158045,323664,390338,390338
Iceland,1950,IS,ISL,EUR,9320,13001,22321,12304,10721,8808,7266,5289,4623,49011,8725,12638,21363,11905,10390,8638,7268,5656,6096,49953,98964,142650,142650
Iceland,1951,IS,ISL,EUR,9598,13548,23146,12270,10877,8866,7401,5462,4746,49622,9045,13030,22075,11900,10542,8716,7323,5814,6243,50538,100160,145394,145394
Iceland,1952,IS,ISL,EUR,9803,14145,23948,12167,10973,8909,7504,5671,4870,50094,9299,13520,22819,11768,10595,8784,7385,5990,6368,50890,100984,147749,147749
Iceland,1953,IS,ISL,EUR,10070,14825,24895,12134,11179,9083,7587,5844,5002,50829,9451,14228,23679,11643,10681,8916,7450,6174,6465,51329,102158,150738,150738
Iceland,1954,IS,ISL,EUR,10349,15583,25932,12120,11466,9247,7744,5984,5137,51698,9641,14977,24618,11585,10908,9071,7550,6317,6586,52017,103715,154263,154263
Iceland,1955,IS,ISL,EUR,10542,16445,26987,12016,11703,9429,7907,6132,5254,52441,9895,15675,25570,11490,11179,9242,7636,6470,6726,52743,105184,157735,157735
Iceland,1956,IS,ISL,EUR,10798,17246,28044,11871,11845,9683,8048,6227,5438,53112,10150,16373,26523,11410,11353,9412,7750,6563,6893,53381,106493,161059,161059
Iceland,1957,IS,ISL,EUR,11152,17901,29053,11914,12050,9909,8186,6272,5671,54002,10434,16961,27395,11561,11497,9607,7938,6572,7099,54274,108276,164732,164732
Iceland,1958,IS,ISL,EUR,11380,18558,29938,12169,12195,10141,8278,6350,5930,55063,10721,17440,28161,11891,11576,9826,8101,6610,7313,55317,110380,168472,168472
Iceland,1959,IS,ISL,EUR,11574,19192,30766,12503,12205,10362,8342,6480,6172,56064,10972,17966,28938,12216,11606,9978,8235,6679,7518,56232,112296,172000,172000
Iceland,1960,IS,ISL,EUR,11832,19728,31560,12955,12188,10551,8432,6621,6383,57130,11183,18515,29698,12562,11675,10111,8354,6734,7742,57178,114308,175566,175566
Iceland,1961,IS,ISL,EUR,11953,20256,32209,13517,12150,10695,8525,6767,6614,58268,11284,19096,30380,13008,11700,10233,8453,6778,7995,58167,116435,179022,179022
Iceland,1962,IS,ISL,EUR,11923,20823,32746,14129,12116,10828,8661,6867,6874,59475,11322,19668,30990,13552,11662,10351,8579,6868,8193,59205,118680,182415,182415
Iceland,1963,IS,ISL,EUR,11962,21309,33271,14757,12045,11004,8822,6917,7124,60669,11365,20087,31452,14238,11558,10475,8725,6984,8388,60368,121037,185766,185766
Iceland,1964,IS,ISL,EUR,11959,21758,33717,15477,11957,11208,8929,7017,7286,61874,11433,20486,31919,14970,11445,10645,8834,7106,8577,61577,123451,189095,189095
Iceland,1965,IS,ISL,EUR,11864,22167,34031,16346,11808,11397,9063,7147,7418,63179,11409,20937,32346,15616,11334,10897,8971,7171,8766,62755,125934,192309,192309
Iceland,1966,IS,ISL,EUR,11873,22511,34384,17143,11683,11547,9279,7262,7556,64470,11392,21257,32649,16278,11304,11078,9151,7276,8941,64028,128498,195530,195530
Iceland,1967,IS,ISL,EUR,11862,22846,34708,17787,11753,11702,9478,7394,7685,65799,11377,21558,32935,16842,11418,11148,9303,7473,9103,65287,131086,198726,198726
Iceland,1968,IS,ISL,EUR,11654,23101,34755,18395,11972,11787,9641,7494,7864,67153,11164,21875,33039,17267,11695,11179,9459,7624,9297,66521,133674,201471,201471
Iceland,1969,IS,ISL,EUR,11311,23211,34522,18913,12227,11752,9793,7543,8084,68312,10783,22121,32904,17669,11932,11186,9589,7744,9476,67596,135908,203337,203337
Iceland,2031,IS,ISL,EUR,11169,23210,34379,24308,24810,31908,26792,22755,35941,166514,10573,21697,32270,23253,23857,27896,24027,21574,38344,158951,325465,392103,392103
Iceland,2032,IS,ISL,EUR,11043,23325,34368,24087,24454,31914,27210,22944,36742,167351,10457,21811,32268,23047,23577,28138,24210,21579,39229,159780,327131,393776,393776
Iceland,2033,IS,ISL,EUR,10923,23351,34274,23866,24296,31557,27887,23154,37475,168235,10345,21918,32263,22750,23474,28134,24521,21721,39967,160567,328802,395352,395352
Iceland,2034,IS,ISL,EUR,10816,23289,34105,23603,24410,30891,28529,23525,38187,169145,10246,21908,32154,22463,23514,27899,24883,22018,40650,161427,330572,396829,396829
Iceland,2035,IS,ISL,EUR,10725,23140,33865,23360,24607,30089,29081,24077,38852,170066,10164,21815,31979,22205,23603,27512,25275,22427,41278,162300,332366,398209,398209
Iceland,2036,IS,ISL,EUR,10645,22946,33591,23237,24742,29185,29684,24589,39538,170975,10090,21699,31789,22038,23703,27008,25727,22798,41868,163142,334117,399498,399498
Iceland,2037,IS,ISL,EUR,10575,22752,33327,23186,24928,28152,30264,24983,40317,171830,10026,21522,31548,21972,23843,26437,26171,22960,42618,164001,335831,400700,400700
Iceland,2038,IS,ISL,EUR,10513,22541,33054,23221,25064,27105,30794,25297,41159,172640,9967,21334,31301,21902,23983,25748,26670,23076,43424,164803,337443,401804,401804
Iceland,2039,IS,ISL,EUR,10453,22328,32781,23291,25087,26232,31253,25612,41924,173399,9911,21141,31052,21867,24047,25104,27168,23301,44082,165569,338968,402812,402812
Iceland,2040,IS,ISL,EUR,10398,22114,32512,23351,25046,25595,31585,25927,42619,174123,9860,20942,30802,21911,24020,24613,27558,23518,44679,166299,340422,403737,403737
Iceland,2041,IS,ISL,EUR,10348,21899,32247,23480,24894,25121,31791,26185,43330,174801,9812,20749,30561,22010,23910,24209,27880,23676,45284,166969,341770,404576,404576
Iceland,2042,IS,ISL,EUR,10298,21705,32003,23594,24674,24771,31803,26606,43966,175414,9762,20566,30328,22123,23710,23938,28125,23860,45838,167594,343008,405341,405341
Iceland,2043,IS,ISL,EUR,10249,21524,31773,23621,24456,24620,31454,27278,44548,175977,9718,20397,30115,22231,23413,23833,28128,24177,46386,168168,344145,406027,406027
Iceland,2044,IS,ISL,EUR,10201,21356,31557,23558,24197,24732,30799,27921,45265,176472,9676,20243,29919,22219,23129,23874,27894,24541,47014,168671,345143,406626,406626
Iceland,2045,IS,ISL,EUR,10153,21209,31362,23415,23956,24935,30007,28479,46127,176919,9630,20111,29741,22127,22870,23963,27512,24940,47710,169122,346041,407149,407149
Iceland,2046,IS,ISL,EUR,10107,21078,31185,23217,23838,25068,29120,29088,46981,177312,9584,19988,29572,22011,22702,24067,27016,25395,48335,169526,346838,407601,407601
Iceland,2047,IS,ISL,EUR,10054,20957,31011,23026,23784,25257,28105,29671,47826,177669,9538,19874,29412,21837,22638,24207,26450,25841,48913,169886,347555,407977,407977
Iceland,2048,IS,ISL,EUR,10011,20849,30860,22816,23823,25393,27072,30206,48663,177973,9496,19774,29270,21652,22568,24349,25769,26345,49529,170212,348185,408304,408304
Iceland,2049,IS,ISL,EUR,9970,20742,30712,22606,23892,25418,26213,30669,49440,178238,9458,19673,29131,21452,22530,24413,25139,26843,50109,170486,348724,408575,408575
Iceland,2050,IS,ISL,EUR,9931,20641,30572,22391,23953,25379,25587,30999,50164,178473,9420,19578,28998,21257,22577,24389,24651,27237,50633,170744,349217,408783,408783
Israel,1970,IL,ISR,EUR,172387,307896,480283,296720,174410,149145,133653,122340,97719,973987,165372,294744,460116,286299,175293,160263,142114,126568,102386,992923,1966910,2907307,2907307
Israel,1971,IL,ISR,EUR,183338,317078,500416,307797,185309,152237,136809,122883,103842,1008877,176172,303131,479303,296662,185513,162268,147215,129719,108600,1029977,2038854,3018583,3018583
Israel,1972,IL,ISR,EUR,193211,325403,518614,315636,197845,155113,139777,122469,110412,1041252,185954,310774,496728,303730,197531,164002,152136,131440,115519,1064358,2105610,3120950,3120950
Israel,1973,IL,ISR,EUR,201640,333411,535051,320995,211092,157606,142234,121587,117333,1070847,194222,318265,512487,308393,210333,165325,156450,132309,123082,1095892,2166739,3214274,3214274
Israel,1974,IL,ISR,EUR,210015,341339,551354,324661,224984,159656,143857,121022,124346,1098526,202255,325997,528252,311461,223814,166235,159958,132979,131142,1125589,2224115,3303720,3303720
Israel,1975,IL,ISR,EUR,216696,349523,566219,327481,239121,161269,144809,121032,131196,1124908,208640,334197,542837,313678,237744,166962,162595,133671,139470,1154120,2279028,3388086,3388086
Israel,1976,IL,ISR,EUR,221302,359402,580704,329049,252943,162622,145508,121428,137635,1149185,213048,344219,557267,314651,251702,167640,164587,134445,147934,1180959,2330144,3468120,3468120
Israel,1977,IL,ISR,EUR,224717,369024,593741,328914,266395,164018,146184,122215,143587,1171313,216289,354048,570337,314120,265399,168491,165737,135796,156437,1205980,2377293,3541374,3541374
Israel,1978,IL,ISR,EUR,226289,377836,604125,329102,278240,166351,146778,123468,149148,1193087,217764,363233,580997,313754,277909,170430,165657,138192,164577,1230519,2423606,3608733,3608733
Israel,1979,IL,ISR,EUR,226011,387487,613498,331154,287225,170195,147654,125178,154124,1215530,217536,373379,590915,315021,288077,174184,165213,141201,172151,1255847,2471377,3675789,3675789
Israel,1980,IL,ISR,EUR,225139,397309,622448,334562,293433,175975,149407,127484,158149,1239010,216831,383662,600493,317661,295795,180224,165369,145071,178540,1282660,2521670,3744608,3744608
Israel,1981,IL,ISR,EUR,223740,408276,632016,337784,297091,184907,151752,130463,161391,1263388,215501,394761,610262,320405,301076,189511,166426,149999,183666,1311083,2574471,3816745,3816745
Israel,1982,IL,ISR,EUR,223391,419326,642717,340923,299318,195977,154381,133825,164224,1288648,215034,405572,620606,323365,304784,201243,168066,155261,188151,1340870,2629518,3892839,3892839
Israel,1983,IL,ISR,EUR,226486,429140,655626,345199,302614,207312,157120,137033,167431,1316709,217762,414884,632646,327746,309622,213411,169800,160259,193279,1374117,2690826,3979093,3979093
Israel,1984,IL,ISR,EUR,231465,438662,670127,350852,306769,219803,159836,139547,171933,1348740,222183,423723,645906,334071,314950,226829,171530,164729,200112,1412221,2760961,4077001,4077001
Israel,1985,IL,ISR,EUR,236601,447524,684125,358025,311213,234402,162489,141464,177411,1385004,226813,431930,658743,342094,320187,242513,173672,168509,207836,1454811,2839815,4182681,4182681
Israel,1986,IL,ISR,EUR,242104,455166,697270,368294,315314,250581,165100,143179,182973,1425441,232008,438824,670832,353265,324787,260040,175954,172000,215815,1501861,2927302,4295405,4295405
Israel,1987,IL,ISR,EUR,246939,463335,710274,380273,318207,267798,168068,144901,188528,1467775,236875,446175,683050,365915,328190,278574,178340,174945,224969,1550933,3018708,4412030,4412030
Israel,1988,IL,ISR,EUR,251012,473093,724105,393163,321863,284357,172431,146661,194347,1512822,241139,455023,696162,379164,332070,296682,182121,176487,235782,1602306,3115128,4535396,4535396
Israel,1989,IL,ISR,EUR,255259,482558,737817,407934,327560,298710,178670,148980,200426,1562280,245580,463492,709072,394158,337620,312576,188289,177762,247207,1657612,3219892,4666782,4666782
Israel,1990,IL,ISR,EUR,259846,491192,751038,423789,334495,310311,187341,152332,206640,1614908,250321,471172,721493,409929,344257,325626,197325,180034,258639,1715810,3330718,4803254,4803254
Israel,1991,IL,ISR,EUR,264963,499252,764215,441238,341024,318718,199420,156362,212488,1669250,255243,478781,734024,426649,350540,335222,209936,183482,269490,1775319,3444569,4942812,4942812
Israel,1992,IL,ISR,EUR,269724,507240,776964,458576,347479,325039,213207,160627,217850,1722778,259604,486602,746206,442918,356523,342309,224621,187418,279640,1833429,3556207,5079389,5079389
Israel,1993,IL,ISR,EUR,272891,516576,789467,474134,354840,331933,226858,164530,223233,1775528,262488,495430,757918,457217,363107,350212,239088,190740,289718,1890082,3665610,5212998,5212998
Israel,1994,IL,ISR,EUR,275301,526256,801557,488428,362835,339260,241522,167673,229166,1828884,264678,504606,769284,469994,370691,357829,254837,193025,300190,1946566,3775450,5346292,5346292
Israel,1995,IL,ISR,EUR,278414,535145,813559,500899,371886,345992,258204,170062,235123,1882166,267446,513255,780701,481075,379154,364227,272885,195129,309838,2002308,3884474,5478734,5478734
Israel,1996,IL,ISR,EUR,283341,543954,827295,511112,383570,351202,276276,171901,240750,1934811,271807,521629,793436,490258,390022,368867,292360,196803,318656,2056966,3991777,5612494,5612494
Israel,1997,IL,ISR,EUR,289881,551068,840949,520665,397048,354144,294706,173848,245888,1986299,277772,528538,806310,498900,402303,371191,312161,197675,327498,2109728,4096027,5743283,5743283
Israel,1998,IL,ISR,EUR,297452,555200,852652,530494,411400,356822,311709,176854,250330,2037609,284852,533021,817873,507852,415131,373048,330687,199277,335364,2161359,4198968,5869504,5869504
Israel,1999,IL,ISR,EUR,305710,558361,864071,538530,427185,360887,325691,181324,255073,2088690,292569,536570,829139,515389,429442,375935,345977,202893,342548,2212184,4300874,5994088,5994088
Israel,2000,IL,ISR,EUR,313646,562402,876048,544411,443663,365873,336015,188013,260471,2138446,299957,540832,840789,520866,444544,379628,357487,209152,349992,2261669,4400115,6116958,6116958
Israel,2001,IL,ISR,EUR,319586,568756,888342,548686,461184,370460,342082,198133,266320,2186865,305465,546907,852372,525226,460383,383103,364441,219048,358199,2310400,4497265,6237982,6237982
Israel,2002,IL,ISR,EUR,324849,576946,901795,552116,478430,374821,344912,210168,272629,2233076,310460,554349,864809,529324,475987,386241,367339,231377,366743,2357011,4590087,6356693,6356693
Israel,2003,IL,ISR,EUR,331269,585213,916482,556838,493175,379944,348140,221657,278740,2278494,316668,562027,878695,534269,489682,389964,370714,243045,374574,2402248,4680742,6475913,6475913
Israel,2004,IL,ISR,EUR,337658,593700,931358,561610,506278,386017,352505,233277,284540,2324227,322769,569979,892748,539232,501762,395019,375040,254972,381632,2447657,4771884,6595986,6595986
Israel,2005,IL,ISR,EUR,342975,602997,945972,565273,517633,393051,356746,246806,289944,2369453,327859,578380,906239,543234,512215,401061,378982,269064,387902,2492458,4861911,6714124,6714124
Israel,2006,IL,ISR,EUR,348439,612380,960819,569347,525851,402979,359390,262188,294732,2414487,332979,586817,919796,547266,519900,410193,381294,285207,393106,2536966,4951453,6832077,6832077
Israel,2007,IL,ISR,EUR,355160,622890,978050,572796,532783,414729,359998,278713,298968,2457987,339104,596652,935756,550736,526552,421138,381574,302839,397377,2580216,5038203,6952003,6952003
Israel,2008,IL,ISR,EUR,361863,635692,997555,574101,540460,426868,360506,294962,303419,2500316,345264,609086,954350,552236,533865,432588,381528,320579,401507,2622303,5122619,7074522,7074522
Israel,2009,IL,ISR,EUR,368692,649785,1018477,574511,546530,440092,362921,308603,309795,2542452,351815,622307,974122,553026,539861,445519,382811,335968,407462,2664647,5207099,7199703,7199703
Israel,2010,IL,ISR,EUR,377933,663215,1041148,576253,551380,453762,367021,318971,318079,2585466,360666,634498,995164,554701,544105,459051,385273,348158,415382,2706670,5292136,7328445,7328445
Israel,2011,IL,ISR,EUR,388352,675086,1063438,580602,555783,468789,371082,325521,329298,2631075,370491,645291,1015782,558456,547169,473425,387888,355774,426736,2749448,5380523,7459749,7459749
Israel,2012,IL,ISR,EUR,397942,687541,1085483,586923,559455,484338,374802,328466,343565,2677549,379544,656707,1036251,564123,549733,488134,390217,358486,442124,2792817,5470366,7592106,7592106
Israel,2013,IL,ISR,EUR,407232,700313,1107545,593984,565112,497872,378923,331403,357933,2725227,387854,668861,1056715,570667,553648,501357,392968,361021,457525,2837186,5562413,7726676,7726676
Israel,2014,IL,ISR,EUR,416984,712281,1129265,601731,571154,509920,384228,335772,371778,2774583,396236,680459,1076695,577971,557992,512815,397142,365185,472193,2883298,5657881,7863846,7863846
Israel,2015,IL,ISR,EUR,427325,726161,1153486,610631,575917,520959,390658,340615,385950,2824730,405424,693766,1099190,586105,561457,522854,402312,369978,487681,2930387,5755117,8007778,8007778
Israel,2016,IL,ISR,EUR,438039,742137,1180176,620228,581131,529396,400321,343872,401276,2876224,415129,708782,1123911,595046,565096,530307,410786,373055,504418,2978708,5854932,8159009,8159009
Israel,2017,IL,ISR,EUR,446442,758374,1204816,631377,586000,537106,412360,344766,417600,2929209,422723,723759,1146482,605815,568676,536699,421693,373649,522218,3028750,5957959,8309257,8309257
Israel,2018,IL,ISR,EUR,451677,773761,1225438,644624,589321,546357,424960,345428,433605,2984295,427687,737648,1165335,618994,571145,543979,433579,373784,539930,3081411,6065706,8456483,8456483
Israel,2019,IL,ISR,EUR,457836,788883,1246719,658950,592042,554768,438679,347988,448433,3040860,433872,751311,1185183,632828,573386,550516,446858,375193,556380,3135161,6176021,8607919,8607919
Israel,2020,IL,ISR,EUR,460154,807629,1267783,672809,595533,561429,452755,352118,461827,3096471,436484,768615,1205099,645636,576411,555608,460653,377771,572056,3188135,6284606,8757489,8757489
Israel,2021,IL,ISR,EUR,456483,828937,1285420,685257,601199,566654,467998,356156,474471,3151735,433384,788327,1221711,657057,581496,559460,475315,380547,587318,3241193,6392928,8900059,8900059
Israel,2022,IL,ISR,EUR,453816,847010,1300826,697714,608271,570921,483627,359904,486834,3207271,431101,805051,1236152,668476,587943,562600,490211,383009,601823,3294062,6501333,9038309,9038309
Israel,2023,IL,ISR,EUR,453202,861506,1314708,709950,615427,576841,497141,364182,500051,3263592,430505,818293,1248798,680049,594591,566788,503495,385892,616596,3347411,6611003,9174520,9174520
Israel,2024,IL,ISR,EUR,450532,877363,1327895,721417,623130,583093,509197,369713,514707,3321257,427798,832814,1260612,691089,601857,571342,515009,390205,632387,3401889,6723146,9311652,9311652
Israel,2025,IL,ISR,EUR,448345,889939,1338284,734836,631799,587973,520252,376361,530517,3381738,425540,844530,1270070,703885,609754,574911,525080,395514,649541,3458685,6840423,9448781,9448781
Israel,2026,IL,ISR,EUR,449158,896849,1346007,750397,640912,593109,528668,386074,545764,3444924,426154,851003,1277157,718432,618184,578464,532510,404026,666258,3517874,6962798,9585962,9585962
Israel,2027,IL,ISR,EUR,450552,902495,1353047,766266,651328,597677,536253,397933,559284,3508741,427334,856207,1283541,732993,628184,581739,538779,414824,681179,3577698,7086439,9723035,9723035
Israel,2028,IL,ISR,EUR,452369,907068,1359437,781336,663628,600483,545253,410226,572314,3573240,428946,860521,1289467,746522,640364,583685,545819,426491,695129,3638010,7211250,9860161,9860161
Israel,2029,IL,ISR,EUR,454601,910474,1365075,796186,676886,602523,553360,423568,586006,3638529,430975,863911,1294886,759876,653070,585225,552052,439495,709164,3698882,7337411,9997364,9997364
Israel,2030,IL,ISR,EUR,457177,910494,1367671,814691,689651,605201,559676,437250,600561,3707030,433343,864161,1297504,776928,664711,587413,556798,453004,723896,3762750,7469780,10134951,10134951
Israel,1950,IL,ISR,EUR,93405,117412,210817,112719,105335,103373,68960,34161,24161,448709,87804,110385,198189,107289,100521,98625,59610,33172,27230,426447,875156,1284157,1284157
Israel,1951,IL,ISR,EUR,98309,123975,222284,113771,107753,104655,74018,37110,25962,463269,92752,116580,209332,108367,104087,101303,63861,35708,29424,442750,906019,1337630,1337630
Israel,1952,IL,ISR,EUR,102333,132274,234607,115069,110188,105091,79249,40456,27928,477981,96812,124626,221438,109490,107900,102884,68469,38628,31797,459168,937149,1393191,1393191
Israel,1953,IL,ISR,EUR,105112,142283,247395,116616,112472,104994,84777,44156,30020,493035,99794,134331,234125,110738,111697,103765,73542,41904,34260,475906,968941,1450457,1450457
Israel,1954,IL,ISR,EUR,105540,154092,259632,118346,114363,105013,90445,48115,32177,508459,100582,145717,246299,112165,115184,104449,79036,45468,36711,493013,1001472,1507412,1507412
Israel,1955,IL,ISR,EUR,105482,166252,271734,120219,115928,105539,95952,52296,34440,524374,100707,157596,258303,113841,118222,105306,84807,49246,39126,510548,1034922,1564960,1564960
Israel,1956,IL,ISR,EUR,106426,178309,284735,122442,117314,106634,101135,56688,36774,540987,101590,169536,271126,115945,120827,106521,90845,53236,41451,528825,1069812,1625669,1625669
Israel,1957,IL,ISR,EUR,106768,191104,297872,125262,118637,108236,105952,61279,39168,558534,101941,182111,284052,118741,123041,108261,97141,57359,43685,548228,1106762,1688678,1688678
Israel,1958,IL,ISR,EUR,107005,204080,311085,129055,120013,110357,110246,66061,41750,577482,102199,194800,296999,122541,125023,110776,103270,61580,46024,569214,1146696,1754788,1754788
Israel,1959,IL,ISR,EUR,108794,215967,324761,134199,121733,113018,113820,71011,44673,598454,103924,206365,310289,127706,127132,114122,108840,65872,48677,592349,1190803,1825847,1825847
Israel,1960,IL,ISR,EUR,111853,226471,338324,141260,124079,116111,116528,76125,47987,622090,106921,216603,323524,134760,129588,118357,113537,70263,51812,618317,1240407,1902247,1902247
Israel,1961,IL,ISR,EUR,114641,236276,350917,150877,126959,119591,118338,81408,51767,648940,109702,226163,335865,144243,132481,123340,117117,74819,55598,647598,1296538,1983319,1983319
Israel,1962,IL,ISR,EUR,117703,244930,362633,163073,130303,123350,119366,86895,56075,679062,112718,234596,347314,156309,135669,128775,119606,79716,60008,680083,1359145,2069091,2069091
Israel,1963,IL,ISR,EUR,121685,252660,374345,177437,134066,127154,119896,92648,60803,712004,116540,242283,358823,170509,139066,134298,121417,85035,64918,715243,1427247,2160420,2160420
Israel,1964,IL,ISR,EUR,126583,260045,386628,193870,138166,130682,120509,98532,65770,747529,121172,249713,370885,186663,142650,139609,123037,90768,70130,752857,1500386,2257903,2257903
Israel,1965,IL,ISR,EUR,132447,267926,400373,211433,142522,133915,121580,104198,70858,784506,126708,257478,384186,203913,146501,144522,124775,96839,75477,792027,1576533,2361088,2361088
Israel,1966,IL,ISR,EUR,139401,275705,415106,229542,147180,137026,123139,109353,76045,822285,133312,264972,398284,221705,150683,148941,126843,103182,80841,832195,1654480,2467863,2467863
Israel,1967,IL,ISR,EUR,146843,282598,429441,248291,152350,140081,125170,113918,81286,861096,140407,271552,411959,239924,155295,152701,129511,109743,86121,873295,1734391,2575793,2575793
Israel,1968,IL,ISR,EUR,154598,289679,444277,266651,158411,143023,127679,117736,86564,900064,147871,278146,426017,257617,160671,155668,133060,116128,91348,914492,1814556,2684849,2684849
Israel,1969,IL,ISR,EUR,162979,298209,461188,283011,165626,146005,130564,120599,91989,937794,156084,285932,442016,273282,167174,158105,137305,121908,96705,954479,1892273,2795472,2795472
Israel,2031,IL,ISR,EUR,460153,907507,1367660,835793,701024,609938,564537,452046,615088,3778426,436096,861539,1297635,796417,674962,591537,560268,467344,738835,3829363,7607789,10273091,10273091
Israel,2032,IL,ISR,EUR,463580,906176,1369756,853774,712964,616542,568663,467264,628793,3848000,439293,860363,1299656,813038,685809,597483,563225,481965,752821,3894341,7742341,10411756,10411756
Israel,2033,IL,ISR,EUR,467350,907398,1374748,868273,725219,623730,574634,480464,642571,3914891,442823,861386,1304209,826287,697383,604144,567446,495064,766677,3957001,7871892,10550851,10550851
Israel,2034,IL,ISR,EUR,471458,906974,1378432,884131,736695,631456,580919,492255,657868,3983324,446664,860722,1307386,840806,708425,611418,572022,506426,782128,4021225,8004549,10690361,10690361
Israel,2035,IL,ISR,EUR,475835,907380,1383215,896712,750119,640145,585853,503118,675053,4051000,450754,860841,1311595,852525,721221,619325,575626,516398,799625,4084720,8135720,10830531,10830531
Israel,2036,IL,ISR,EUR,480386,911178,1391564,903630,765682,649272,591033,511468,694370,4115455,455018,864215,1319233,859001,735767,627765,579214,523811,819544,4145102,8260557,10971355,10971355
Israel,2037,IL,ISR,EUR,485112,916009,1401121,909284,781546,659690,595644,519007,713904,4179075,459467,868603,1328070,864215,750331,637765,582521,530083,839707,4204622,8383697,11112888,11112888
Israel,2038,IL,ISR,EUR,490043,921607,1411650,913871,796615,671990,598520,527921,733217,4242134,464113,873749,1337862,868534,763860,649943,584506,537113,859556,4263512,8505646,11255159,11255159
Israel,2039,IL,ISR,EUR,495240,927953,1423193,917283,811462,685242,600647,536005,754038,4304677,469023,879630,1348653,871930,777214,662645,586098,543368,880560,4321815,8626492,11398331,11398331
Israel,2040,IL,ISR,EUR,500553,934914,1435467,917322,829961,697996,603402,542379,775904,4366964,474055,886093,1360148,872187,794261,674282,588333,548177,902542,4379782,8746746,11542358,11542358
Israel,2041,IL,ISR,EUR,505935,942447,1448382,914356,851052,709367,608201,547363,798708,4429047,479157,893114,1372271,869578,813747,684538,592498,551747,925383,4437491,8866538,11687189,11687189
Israel,2042,IL,ISR,EUR,511249,950603,1461852,913045,869024,721300,614838,551615,821087,4490909,484176,900768,1384944,868409,830368,695383,598470,554802,947477,4494909,8985818,11832611,11832611
Israel,2043,IL,ISR,EUR,516360,959312,1475672,914283,883520,733546,622057,557615,841661,4552682,488998,908947,1397945,869444,843618,706957,605153,559079,967947,4552198,9104880,11978499,11978499
Israel,2044,IL,ISR,EUR,521020,968620,1489640,913877,899372,745027,629817,563927,862387,4614407,493390,917705,1411095,868784,858135,718004,612447,563716,988326,4609412,9223819,12124556,12124556
Israel,2045,IL,ISR,EUR,525012,978317,1503329,914301,911955,758449,638527,568949,884067,4676248,497146,926830,1423976,868917,869857,730797,620372,567404,1009375,4666722,9342970,12270281,12270281
Israel,2046,IL,ISR,EUR,528439,988258,1516697,918113,918891,773998,647674,574202,905426,4738304,500365,936205,1436570,872295,876342,745341,628834,571071,1030399,4724282,9462586,12415856,12415856
Israel,2047,IL,ISR,EUR,531392,998298,1529690,922955,924563,789849,658088,578878,926262,4800595,503139,945671,1448810,876688,881562,759900,638839,574458,1050688,4782135,9582730,12561227,12561227
Israel,2048,IL,ISR,EUR,533647,1008343,1541990,928564,929170,804907,670359,581893,948276,4863169,505271,955149,1460420,881843,885891,773429,651005,576546,1071553,4840267,9703436,12705844,12705844
Israel,2049,IL,ISR,EUR,535094,1018204,1553298,934918,932605,819745,683570,584208,971008,4926054,506650,964449,1471099,887726,889294,786787,663695,578255,1092984,4898741,9824795,12849190,12849190
Israel,2050,IL,ISR,EUR,536231,1027514,1563745,941886,932674,838223,696284,587128,993167,4989362,507737,973247,1480984,894196,889568,803830,675320,580608,1114182,4957704,9947066,12991790,12991790
Italy,1970,IT,ITA,EUR,2326031,4423750,6749781,3902003,3554739,3574304,2851981,2830121,2459724,19172872,2214043,4207848,6421891,3842871,3679699,3726953,3140610,3146163,3443197,20979493,40152365,53324036,53324036
Italy,1971,IT,ITA,EUR,2281652,4499280,6780932,3913925,3543217,3577655,2928181,2805654,2532457,19301089,2166847,4275430,6442277,3848393,3662601,3720442,3210750,3130557,3539062,21111805,40412894,53636099,53636099
Italy,1972,IT,ITA,EUR,2254721,4559466,6814187,3906701,3577382,3575850,3059563,2722904,2601416,19443816,2137737,4334205,6471942,3831274,3689198,3715408,3339526,3053506,3636571,21265483,40709299,53995422,53995422
Italy,1973,IT,ITA,EUR,2240042,4607734,6847776,3900391,3622318,3581903,3221096,2603511,2663622,19592841,2123631,4385250,6508881,3815114,3722895,3722740,3499987,2937345,3732007,21430088,41022929,54379582,54379582
Italy,1974,IT,ITA,EUR,2224025,4642612,6866637,3908893,3647109,3604655,3366376,2493169,2729481,19749683,2108193,4424223,6532416,3815146,3734748,3745812,3643512,2830739,3831992,21601949,41351632,54750683,54750683
Italy,1975,IT,ITA,EUR,2202055,4654768,6856823,3943987,3660279,3621352,3439405,2461255,2793755,19920033,2086858,4441424,6528282,3846389,3731835,3761012,3705377,2812269,3931973,21788855,41708888,55093989,55093989
Italy,1976,IT,ITA,EUR,2160160,4658268,6818428,3993263,3683330,3620609,3462519,2480690,2853179,20093590,2047158,4448506,6495664,3897397,3735854,3757028,3709123,2853197,4028624,21981223,42074813,55388902,55388902
Italy,1977,IT,ITA,EUR,2096668,4662650,6759318,4059019,3713835,3609354,3473620,2499377,2914172,20269377,1987055,4453399,6440454,3963203,3752987,3741222,3701677,2891206,4130231,22180526,42449903,55649667,55649667
Italy,1978,IT,ITA,EUR,2019890,4652801,6672691,4141155,3745089,3595606,3472866,2522993,2976808,20454517,1914493,4442362,6356855,4040943,3779171,3721994,3685877,2926823,4238151,22392959,42847476,55877016,55877016
Italy,1979,IT,ITA,EUR,1930697,4620569,6551266,4234220,3781783,3579199,3473063,2553408,3035561,20657234,1829118,4409604,6238722,4128053,3815509,3697858,3677015,2960494,4344528,22623457,43280691,56070678,56070678
Italy,1980,IT,ITA,EUR,1840924,4574329,6415253,4353311,3859511,3577643,3486615,2597761,3069183,20944024,1742559,4362992,6105551,4230746,3875934,3672250,3674361,3000519,4410851,22864661,43808685,56329482,56329482
Italy,1981,IT,ITA,EUR,1754152,4509684,6263836,4460499,3909266,3612457,3495578,2670098,3072646,21220544,1660529,4298158,5958687,4324241,3907757,3682685,3667323,3070722,4437109,23089837,44310381,56532910,56532910
Italy,1982,IT,ITA,EUR,1682393,4417379,6099772,4526211,3892042,3659764,3487815,2786894,3048644,21401370,1594629,4209564,5804193,4386599,3889292,3721881,3653706,3195438,4433588,23280504,44681874,56585843,56585843
Italy,1983,IT,ITA,EUR,1631552,4310945,5942497,4578553,3870958,3693041,3493648,2929229,2997076,21562505,1547629,4110843,5658472,4434017,3863930,3749655,3655324,3347061,4394063,23444050,45006555,56607516,56607516
Italy,1984,IT,ITA,EUR,1588310,4189817,5778127,4620519,3869198,3704820,3517438,3052865,2961607,21726447,1507037,3998034,5505071,4473060,3855986,3756399,3675303,3475262,4374578,23610588,45337035,56620238,56620238
Italy,1985,IT,ITA,EUR,1555826,4057313,5613139,4645330,3894963,3700700,3535405,3119285,2996902,21892585,1476997,3873835,5350832,4496425,3875025,3746732,3688238,3532355,4441134,23779909,45672494,56636465,56636465
Italy,1986,IT,ITA,EUR,1524919,3919215,5444134,4655735,3943508,3705244,3532899,3143515,3075974,22056875,1448010,3744822,5192832,4503886,3917850,3746436,3679782,3535540,4561711,23945205,46002080,56639054,56639054
Italy,1987,IT,ITA,EUR,1489785,3780263,5270048,4657075,4010534,3723103,3523503,3156250,3157174,22227639,1413227,3615792,5029019,4500735,3980480,3760855,3663726,3525651,4686376,24117823,46345462,56644530,56644530
Italy,1988,IT,ITA,EUR,1462721,3645363,5108084,4643199,4086286,3745628,3513008,3164100,3244375,22396596,1386611,3488183,4874794,4483683,4054097,3779452,3647159,3513763,4813262,24291416,46688012,56670888,56670888
Italy,1989,IT,ITA,EUR,1445520,3506136,4951656,4604257,4176026,3781253,3496146,3172880,3336123,22566685,1370530,3354395,4724925,4445179,4140325,3813358,3623658,3507983,4937747,24468250,47034935,56711524,56711524
Italy,1990,IT,ITA,EUR,1432747,3370964,4803711,4545865,4267936,3834411,3469129,3184437,3428191,22729969,1358891,3225229,4584120,4388745,4228032,3866971,3588720,3507144,5059149,24638761,47368730,56756561,56756561
Italy,1991,IT,ITA,EUR,1385168,3219703,4604871,4484724,4371157,3865861,3495494,3199721,3522829,22939786,1315412,3081306,4396718,4332089,4327275,3897373,3606483,3508720,5181172,24853112,47792898,56794489,56794489
Italy,1992,IT,ITA,EUR,1358563,3085056,4443619,4403261,4462142,3858404,3562144,3210369,3616054,23112374,1290844,2951291,4242135,4254688,4412486,3888761,3665921,3508491,5304712,25035059,48147433,56833185,56833185
Italy,1993,IT,ITA,EUR,1379909,3001285,4381194,4296155,4521828,3839297,3600060,3226743,3701678,23185761,1310166,2867432,4177598,4150450,4465432,3868666,3699846,3518490,5422012,25124896,48310657,56869454,56869454
Italy,1994,IT,ITA,EUR,1386505,2938673,4325178,4172558,4572303,3837546,3615114,3260141,3783001,23240663,1314821,2804711,4119532,4031892,4510830,3865260,3712064,3545251,5533150,25198447,48439110,56883819,56883819
Italy,1995,IT,ITA,EUR,1386136,2894285,4280421,4038083,4605206,3860804,3613223,3287000,3872794,23277110,1312443,2760054,4072497,3902680,4540160,3887239,3706744,3564604,5653671,25255098,48532208,56885126,56885126
Italy,1996,IT,ITA,EUR,1384612,2863230,4247842,3902946,4623510,3906559,3618277,3292307,3964734,23308333,1309782,2726997,4036779,3772876,4554452,3931592,3709322,3562539,5775240,25306021,48614354,56898973,56898973
Italy,1997,IT,ITA,EUR,1374517,2849993,4224510,3769170,4630050,3972350,3634744,3287700,4043542,23337556,1299832,2710213,4010045,3644421,4557923,3995780,3725366,3551407,5878793,25353690,48691246,56925800,56925800
Italy,1998,IT,ITA,EUR,1357570,2845978,4203548,3639954,4617458,4047953,3655226,3279989,4116602,23357182,1283620,2703919,3987539,3518210,4545218,4071279,3744925,3538520,5972311,25390463,48747645,56938738,56938738
Italy,1999,IT,ITA,EUR,1349829,2837303,4187132,3510798,4578303,4137770,3687107,3265177,4190167,23369322,1276755,2694043,3970798,3389263,4510381,4158261,3778203,3517913,6063802,25417823,48787145,56945068,56945068
Italy,2000,IT,ITA,EUR,1348986,2826476,4175462,3390849,4520395,4230599,3735791,3239773,4269152,23386559,1276733,2681079,3957812,3268249,4458175,4245703,3830686,3484622,6159131,25446566,48833125,56966397,56966397
Italy,2001,IT,ITA,EUR,1345955,2817825,4163780,3288176,4449295,4317519,3753445,3254456,4347255,23410146,1275041,2670622,3945663,3163148,4392634,4327415,3848957,3492146,6251112,25475412,48885558,56994993,56994993
Italy,2002,IT,ITA,EUR,1351183,2815440,4166623,3195436,4375750,4404487,3743130,3315242,4431223,23465268,1280738,2667391,3948129,3069320,4325985,4407651,3834626,3544898,6345077,25527557,48992825,57107577,57107577
Italy,2003,IT,ITA,EUR,1368875,2813736,4182611,3130855,4336262,4501091,3745599,3367020,4532903,23613730,1296971,2664313,3961284,3000803,4284356,4504103,3839751,3589404,6449136,25667553,49281283,57425175,57425175
Italy,2004,IT,ITA,EUR,1388279,2814614,4202893,3095535,4304659,4601305,3769446,3398380,4650247,23819572,1314643,2662569,3977212,2958925,4239108,4605325,3871335,3615669,6570626,25860988,49680560,57860661,57860661
Italy,2005,IT,ITA,EUR,1404346,2821259,4225605,3065364,4230015,4674821,3816417,3414048,4771293,23971958,1328394,2665636,3994030,2928850,4162298,4673955,3918894,3624702,6699586,26008285,49980243,58199876,58199876
Italy,2006,IT,ITA,EUR,1416624,2825286,4241910,3041455,4117572,4720007,3881866,3435516,4871999,24068415,1338051,2667075,4005126,2907397,4064343,4716364,3981553,3640601,6804199,26114457,50182872,58429903,58429903
Italy,2007,IT,ITA,EUR,1431036,2831524,4262560,3040823,4015723,4764486,3970764,3468081,4951556,24211433,1349664,2671246,4020910,2905539,3980676,4765565,4075944,3671997,6883861,26283582,50495015,58778482,58778482
Italy,2008,IT,ITA,EUR,1445375,2847824,4293199,3057581,3929748,4800540,4073194,3505265,5023716,24390044,1362369,2684036,4046405,2919048,3908655,4811621,4193232,3711170,6950870,26494596,50884640,59224228,59224228
Italy,2009,IT,ITA,EUR,1452594,2869668,4322262,3067205,3819815,4800346,4186400,3553066,5091586,24518418,1368860,2702479,4071339,2924238,3810067,4824066,4317858,3765688,7008903,26650820,51169238,59562841,59562841
Italy,2010,IT,ITA,EUR,1451060,2889907,4340967,3070766,3705366,4772359,4299478,3616026,5151182,24615177,1367389,2719329,4086718,2921721,3706148,4812842,4441542,3841263,7056078,26779594,51394771,59822450,59822450
Italy,2011,IT,ITA,EUR,1440748,2905625,4346373,3074600,3606934,4725029,4402262,3647428,5245827,24702080,1358568,2732224,4090792,2919597,3611149,4778914,4553990,3882860,7140190,26886700,51588780,60025952,60025952
Italy,2012,IT,ITA,EUR,1426494,2918100,4344594,3076916,3533479,4668057,4497964,3644559,5372726,24793701,1346315,2743927,4090242,2916698,3528470,4721996,4651457,3886447,7256546,26961614,51755315,60190145,60190145
Italy,2013,IT,ITA,EUR,1406464,2926863,4333327,3067645,3483734,4606431,4586540,3644136,5493769,24882255,1328259,2753749,4082008,2902994,3463525,4651835,4737435,3891710,7367507,27015006,51897261,60312599,60312599
Italy,2014,IT,ITA,EUR,1375001,2929118,4304119,3048943,3435234,4517369,4660288,3659282,5608873,24929989,1298769,2757444,4056213,2879937,3404081,4556333,4807716,3910769,7473637,27032473,51962462,60322791,60322791
Italy,2015,IT,ITA,EUR,1337833,2921453,4259286,3034645,3392625,4411130,4712091,3697840,5703196,24951527,1264022,2750918,4014940,2856581,3349055,4442991,4854168,3952787,7551566,27007148,51958675,60232906,60232906
Italy,2016,IT,ITA,EUR,1299155,2905084,4204239,3030463,3363224,4300692,4748476,3756966,5782416,24982237,1228426,2736721,3965147,2833368,3300739,4322475,4882894,4015011,7612511,26966998,51949235,60118626,60118626
Italy,2017,IT,ITA,EUR,1260441,2886070,4146511,3036012,3339802,4184261,4774873,3835369,5851176,25021493,1192395,2720320,3912715,2810726,3255836,4198042,4899448,4095160,7664103,26923315,51944808,60004032,60004032
Italy,2018,IT,ITA,EUR,1221455,2862380,4083835,3042142,3316878,4070481,4787324,3924993,5918354,25060172,1155102,2698476,3853578,2796120,3212641,4074492,4900367,4185226,7710992,26879838,51940010,59877425,59877425
Italy,2019,IT,ITA,EUR,1182678,2830476,4013154,3039030,3284598,3948489,4775142,4030468,5999377,25077104,1118972,2667699,3786671,2792464,3168939,3944704,4881163,4288131,7775602,26851003,51928107,59727932,59727932
Italy,2020,IT,ITA,EUR,1144466,2791249,3935715,3028120,3250548,3824044,4741639,4137126,6070724,25052201,1083472,2631401,3714873,2789572,3123348,3816197,4843068,4389806,7835795,26797786,51849987,59500579,59500579
Italy,2021,IT,ITA,EUR,1110310,2744328,3854638,3015033,3228680,3713513,4692935,4232938,6135510,25018609,1050608,2589745,3640353,2784697,3081960,3698882,4787753,4480609,7892823,26726724,51745333,59240329,59240329
Italy,2022,IT,ITA,EUR,1082535,2690840,3773375,3003150,3215741,3618766,4629700,4322307,6225835,25015499,1023952,2541177,3565129,2783873,3048664,3596344,4715269,4564529,7974785,26683464,51698963,59037474,59037474
Italy,2023,IT,ITA,EUR,1062732,2629537,3692269,2990733,3204348,3544002,4556976,4405894,6330628,25032581,1005263,2483752,3489015,2786979,3015203,3513212,4631131,4641025,8069337,26656887,51689468,58870762,58870762
Italy,2024,IT,ITA,EUR,1052974,2558676,3611650,2976814,3192449,3486135,4467332,4480313,6442199,25045242,995465,2417574,3413039,2788869,2982525,3446470,4531052,4707049,8171840,26627805,51673047,58697744,58697744
Italy,2025,IT,ITA,EUR,1049040,2484510,3533550,2960916,3180663,3441862,4367376,4537021,6563760,25051598,991192,2349035,3340227,2784416,2956188,3392328,4420454,4754435,8285649,26593470,51645068,58518843,58518843
Italy,2026,IT,ITA,EUR,1045247,2415969,3461216,2942879,3165697,3406566,4262155,4578827,6692520,25048644,987698,2285123,3272821,2774277,2932946,3345177,4304834,4785793,8408784,26551811,51600455,58334490,58334490
Italy,2027,IT,ITA,EUR,1041795,2353491,3395286,2925767,3144745,3375703,4151146,4610551,6827981,25035893,984548,2226394,3210942,2761948,2908691,3300799,4185747,4805723,8540081,26502989,51538882,58145107,58145107
Italy,2028,IT,ITA,EUR,1038671,2297928,3336599,2902671,3126481,3346373,4038659,4626392,6971556,25012132,981730,2174003,3155733,2742288,2890520,3258164,4064694,4809692,8680214,26445572,51457704,57950037,57950037
Italy,2029,IT,ITA,EUR,1035512,2249091,3284603,2869995,3117880,3317497,3919301,4618915,7134123,24977711,978862,2128064,3106926,2712572,2884539,3215154,3936115,4792067,8839232,26379679,51357390,57748925,57748925
Italy,2030,IT,ITA,EUR,1033433,2205329,3238762,2831177,3111385,3292423,3801781,4592445,7305403,24934614,976985,2086787,3063772,2677542,2883792,3172446,3810577,4756344,9006411,26307112,51241726,57544258,57544258
Italy,1950,IT,ITA,EUR,2236431,4066687,6303118,4039862,3144988,3201960,2415822,1729583,1706982,16239197,2131347,3926175,6057522,4017762,3379201,3467002,2727441,2153713,2046982,17792101,34031298,46391938,46391938
Italy,1951,IT,ITA,EUR,2229993,4075741,6305734,4022767,3201150,3224288,2503821,1753059,1737634,16442719,2124392,3925696,6050088,4000776,3442306,3451919,2767407,2189200,2100605,17952213,34394932,46750760,46750760
Italy,1952,IT,ITA,EUR,2169659,4113304,6282963,3986710,3316743,3173125,2586988,1783277,1764582,16611425,2066536,3960360,6026896,3975279,3564249,3368760,2809408,2224583,2152914,18095193,34706618,47016485,47016485
Italy,1953,IT,ITA,EUR,2113496,4131554,6245050,3976152,3499650,3061217,2675010,1819635,1797784,16829448,2013014,3980984,5993998,3974211,3741017,3261599,2879312,2264773,2222729,18343641,35173089,47412139,47412139
Italy,1954,IT,ITA,EUR,2077707,4129897,6207604,3974505,3666245,2952412,2767646,1862401,1835611,17058820,1980646,3981218,5961864,3985246,3897541,3159658,2959483,2304555,2299004,18605487,35664307,47833768,47833768
Italy,1955,IT,ITA,EUR,2063251,4109326,6172577,3951721,3738912,2910358,2845052,1910311,1871104,17227458,1970741,3958583,5929324,3977349,3953444,3130425,3028188,2342688,2369279,18801373,36028831,48130728,48130728
Italy,1956,IT,ITA,EUR,2064721,4101240,6165961,3910265,3747979,2922805,2915638,1961887,1896584,17355158,1974967,3943439,5918406,3949597,3945248,3163437,3095579,2381808,2428251,18963920,36319078,48403438,48403438
Italy,1957,IT,ITA,EUR,2079008,4113148,6192156,3859986,3736463,2931168,2983184,2010779,1919448,17441028,1989413,3946911,5936324,3909901,3921353,3192580,3164740,2418103,2484071,19090748,36531776,48660253,48660253
Italy,1958,IT,ITA,EUR,2093506,4135611,6229117,3810888,3706878,2939565,3052933,2061960,1950277,17522501,2003414,3960207,5963621,3868769,3886854,3214291,3239577,2454822,2550912,19215225,36737726,48930469,48930469
Italy,1959,IT,ITA,EUR,2109416,4166381,6275797,3765041,3670711,2954886,3109890,2121748,1985015,17607291,2015650,3985263,6000913,3824493,3857130,3233531,3303798,2495810,2625907,19340669,36947960,49224675,49224675
Italy,1960,IT,ITA,EUR,2128647,4205894,6334541,3726053,3625789,2986610,3137614,2191101,2012607,17679774,2028449,4021464,6049913,3779003,3828245,3265176,3341051,2542586,2697419,19453480,37133254,49517707,49517707
Italy,1961,IT,ITA,EUR,2148152,4213354,6361506,3737017,3573631,3055886,3118057,2261273,2040597,17786461,2042959,4025287,6068246,3774487,3795584,3335220,3331338,2590313,2769569,19596511,37382972,49812730,49812730
Italy,1962,IT,ITA,EUR,2181195,4171150,6352345,3797625,3544177,3182958,3038263,2332023,2070433,17965479,2073484,3984686,6058170,3811471,3771158,3463114,3257666,2642666,2840167,19786242,37751721,50162245,50162245
Italy,1963,IT,ITA,EUR,2229995,4118716,6348711,3844548,3557823,3344160,2916451,2408903,2096018,18167903,2121093,3937791,6058884,3838808,3771434,3620828,3140533,2706928,2901098,19979629,38147532,50555128,50555128
Italy,1964,IT,ITA,EUR,2290912,4089016,6379928,3855106,3595057,3488882,2798103,2492027,2131850,18361025,2180424,3909881,6090305,3840169,3788028,3759569,3027655,2782599,2968508,20166528,38527553,50997776,50997776
Italy,1965,IT,ITA,EUR,2344721,4091444,6436165,3848921,3624887,3557304,2757687,2569177,2178176,18536152,2233727,3911582,6145309,3823204,3799917,3813077,3000210,2856344,3042479,20335231,38871383,51452854,51452854
Italy,1966,IT,ITA,EUR,2379914,4116789,6496703,3849653,3632360,3574897,2768958,2638053,2230008,18693929,2269249,3938255,6207504,3807078,3794893,3806605,3031758,2925399,3118701,20484434,39178363,51882571,51882571
Italy,1967,IT,ITA,EUR,2399676,4167149,6566825,3856868,3625649,3582528,2777429,2703607,2286850,18832931,2288413,3986691,6275104,3802261,3777079,3788400,3059059,2994143,3198645,20619587,39452518,52294442,52294442
Italy,1968,IT,ITA,EUR,2395522,4241442,6636964,3863422,3611894,3578932,2789879,2765736,2339895,18949758,2283210,4051854,6335064,3805236,3753494,3761869,3082386,3062701,3273599,20739285,39689043,52661070,52661070
Italy,1969,IT,ITA,EUR,2368655,4332432,6701087,3875532,3589550,3575087,2812266,2811147,2394279,19057861,2256798,4129453,6386251,3817423,3722007,3741135,3105721,3117363,3352655,20856304,39914165,53001503,53001503
Italy,2031,IT,ITA,EUR,1032076,2168171,3200247,2785285,3103658,3275752,3696182,4550089,7470542,24881508,975774,2051189,3026963,2636953,2884359,3135859,3696837,4704965,9167827,26226800,51108308,57335522,57335522
Italy,2032,IT,ITA,EUR,1031132,2137390,3168522,2732351,3094504,3265669,3604843,4492202,7629392,24818961,974917,2021807,2996724,2588924,2886220,3105166,3596736,4635991,9325620,26138657,50957618,57122854,57122854
Italy,2033,IT,ITA,EUR,1031162,2114505,3145667,2671205,3082324,3254645,3531879,4423828,7781317,24745198,974947,2000336,2975283,2531576,2889405,3071963,3514819,4554872,9478166,26040801,50785999,56906954,56906954
Italy,2034,IT,ITA,EUR,1032064,2101626,3133690,2600518,3068642,3243112,3475552,4338964,7931234,24658022,975784,1987697,2963481,2465484,2891373,3039544,3449134,4458037,9628326,25931898,50589920,56687086,56687086
Italy,2035,IT,ITA,EUR,1032530,2095637,3128167,2526527,3052977,3231680,3432583,4243951,8073690,24561408,976188,1981575,2957763,2397030,2887000,3013445,3395906,4350773,9770988,25815142,50376550,56462486,56462486
Italy,2036,IT,ITA,EUR,1032320,2090510,3122830,2458151,3035168,3217069,3398434,4143743,8208601,24461166,975959,1976893,2952852,2333195,2876950,2990435,3349587,4238529,9906757,25695453,50156619,56232293,56232293
Italy,2037,IT,ITA,EUR,1031625,2086143,3117768,2395829,3018272,3196486,3368648,4038023,8340515,24357773,975316,1972909,2948225,2274541,2864704,2966410,3306002,4122906,10038615,25573178,49930951,55996946,55996946
Italy,2038,IT,ITA,EUR,1030628,2083074,3113702,2340414,2995405,3178569,3340337,3930902,8465163,24250790,974408,1970142,2944550,2222218,2845137,2948444,3264111,4005317,10162577,25447804,49698594,55756846,55756846
Italy,2039,IT,ITA,EUR,1029038,2080838,3109876,2291715,2962981,3170258,3312401,3817192,8585735,24140282,972940,1968133,2941073,2176343,2815522,2942628,3221801,3880351,10282993,25319638,49459920,55510870,55510870
Italy,2040,IT,ITA,EUR,1026837,2079249,3106086,2248081,2924418,3164026,3288195,3705292,8696239,24026251,970893,1966679,2937572,2135125,2780591,2942027,3179762,3758367,10392683,25188555,49214806,55258472,55258472
Italy,2041,IT,ITA,EUR,1024187,2077700,3101887,2211037,2878799,3156573,3272265,3604781,8785388,23908843,968413,1965257,2933670,2099582,2740111,2942732,3143787,3647868,10480583,25054663,48963506,54999062,54999062
Italy,2042,IT,ITA,EUR,1020236,2076087,3096323,2180364,2826150,3147693,3262828,3517942,8853303,23788280,964675,1963775,2928450,2070249,2692192,2944730,3113652,3550690,10547040,24918553,48706833,54731605,54731605
Italy,2043,IT,ITA,EUR,1015054,2075135,3090189,2157569,2765304,3135803,3252491,3448933,8904167,23664267,959758,1962914,2922672,2048819,2634966,2948048,3081045,3471363,10595347,24779588,48443855,54456717,54456717
Italy,2044,IT,ITA,EUR,1008627,2074464,3083091,2144756,2694929,3122415,3241654,3395990,8936926,23536670,953666,1962301,2915967,2036215,2568999,2950143,3049217,3407935,10624436,24636945,48173615,54172671,54172671
Italy,2045,IT,ITA,EUR,1000705,2072747,3073452,2138823,2621251,3107040,3230907,3355908,8952644,23406573,946175,1960676,2906851,2030122,2500667,2945913,3023668,3356655,10634563,24491588,47898161,53878465,53878465
Italy,2046,IT,ITA,EUR,991674,2069909,3061583,2133749,2553172,3089522,3216995,3324326,8956132,23273896,937649,1957978,2895627,2025465,2436949,2936002,3001184,3312107,10631699,24343406,47617302,53574516,53574516
Italy,2047,IT,ITA,EUR,981888,2065280,3047168,2129430,2491129,3072891,3197134,3296941,8951203,23138728,928410,1953619,2882029,2021505,2378406,2923901,2977680,3270238,10621069,24192799,47331527,53260724,53260724
Italy,2048,IT,ITA,EUR,970667,2059118,3029785,2126412,2435967,3050296,3179889,3270902,8937591,23001057,917808,1947811,2865619,2018767,2326184,2904480,2960193,3229982,10600071,24039677,47040734,52936136,52936136
Italy,2049,IT,ITA,EUR,958396,2051118,3009514,2124227,2387494,3018171,3172128,3245071,8913305,22860396,906194,1940266,2846460,2016782,2280398,2875026,2954769,3189206,10566937,23883118,46743514,52599485,52599485
Italy,2050,IT,ITA,EUR,945256,2041016,2986272,2122681,2344069,2979928,3166418,3222810,8880634,22716540,893773,1930742,2824515,2015357,2239265,2840261,2954511,3148647,10525108,23723149,46439689,52250484,52250484
Jamaica,1970,JM,JAM,AMR,158284,267460,425744,150477,92759,67410,59383,55271,48614,473914,154212,265042,419254,156544,97801,76504,78964,67439,62928,540180,1014094,1859091,1859091
Jamaica,1971,JM,JAM,AMR,158046,273024,431070,154991,95630,67765,58310,55529,50301,482526,153857,270440,424297,161432,99872,75588,77200,68709,65448,548249,1030775,1886143,1886143
Jamaica,1972,JM,JAM,AMR,157236,277814,435050,160021,99091,68621,57693,55823,51770,493019,152972,275071,428043,167176,102947,75460,75491,70082,68032,559188,1052207,1915299,1915299
Jamaica,1973,JM,JAM,AMR,156248,281827,438075,166748,102284,69646,57314,56013,53001,505006,151913,278816,430729,174358,106085,75646,73752,71362,70306,571509,1076515,1945320,1945320
Jamaica,1974,JM,JAM,AMR,155051,285054,440105,174838,104534,70956,57246,55923,54337,517834,150655,281704,432359,182699,108684,76100,72201,72282,72614,584580,1102414,1974880,1974880
Jamaica,1975,JM,JAM,AMR,153699,286906,440605,183472,106629,72639,57468,55483,55870,531561,149261,283189,432450,191619,111316,76830,70914,72714,75089,598482,1130043,2003094,2003094
Jamaica,1976,JM,JAM,AMR,151982,287908,439890,191306,109343,74594,58048,54736,57622,545649,147518,283864,431382,199795,114636,77804,69903,72676,77750,612564,1158213,2029486,2029486
Jamaica,1977,JM,JAM,AMR,150301,289312,439613,197965,111890,76708,59037,53700,59656,558956,145798,284966,430764,206710,117973,78985,69206,72171,80552,625597,1184553,2054927,2054927
Jamaica,1978,JM,JAM,AMR,149237,290301,439538,204252,114358,79105,60254,52513,61750,572232,144662,285692,430354,213133,121351,80507,68747,71298,83329,638365,1210597,2080485,2080485
Jamaica,1979,JM,JAM,AMR,148828,290256,439084,210682,117321,81997,61385,51457,63605,586447,144139,285430,429569,219524,125281,82600,68361,70199,85881,651846,1238293,2106937,2106937
Jamaica,1980,JM,JAM,AMR,149253,289458,438711,217330,120995,85335,62334,50693,65058,601745,144428,284417,428845,225969,129893,85269,68024,68995,88093,666243,1267988,2135546,2135546
Jamaica,1981,JM,JAM,AMR,150612,288089,438701,223963,125584,88885,63230,50166,66165,617993,145650,282814,428464,232270,135327,88353,67859,67689,89992,681490,1299483,2166657,2166657
Jamaica,1982,JM,JAM,AMR,152334,286600,438934,230217,131297,92453,64192,49818,67006,634983,147258,281077,428335,238054,141756,91685,67934,66242,91689,697360,1332343,2199606,2199606
Jamaica,1983,JM,JAM,AMR,154026,285783,439809,235771,137953,95418,65211,49648,67486,651487,148879,279944,428823,242949,149074,94731,68199,64728,92982,712663,1364150,2232782,2232782
Jamaica,1984,JM,JAM,AMR,155682,285333,441015,240531,145313,97087,66351,49717,67682,666681,150519,279162,429681,246942,157019,96870,68580,63354,93953,726718,1393399,2264095,2264095
Jamaica,1985,JM,JAM,AMR,156965,284838,441803,243429,152963,98453,67739,50026,67864,680474,151826,278437,430263,249162,165217,98841,69117,62193,94958,739488,1419962,2292030,2292030
Jamaica,1986,JM,JAM,AMR,157703,284201,441904,244922,159638,100266,69273,50628,68089,692816,152606,277696,430302,250156,172398,101295,69765,61261,95973,750848,1443664,2315871,2315871
Jamaica,1987,JM,JAM,AMR,157917,283447,441364,246333,165065,101801,70875,51581,68376,704031,152868,276930,429798,251227,178136,103616,70507,60598,96973,761057,1465088,2336245,2336245
Jamaica,1988,JM,JAM,AMR,157601,283040,440641,247103,170129,103175,72692,52710,68689,714498,152619,276562,429181,251766,183339,105886,71502,60129,97864,770486,1484984,2354805,2354805
Jamaica,1989,JM,JAM,AMR,156834,283311,440145,246797,175295,104952,74944,53708,68994,724690,151920,276869,428789,251289,188509,108629,72995,59696,98621,779739,1504429,2373365,2373365
Jamaica,1990,JM,JAM,AMR,155283,284302,439585,245757,180563,107320,77588,54470,69284,734982,150449,277869,428318,250067,193723,111959,74987,59262,99146,789144,1524126,2392030,2392030
Jamaica,1991,JM,JAM,AMR,153599,286009,439608,244207,185706,110474,80397,55111,69429,745324,148848,279542,428390,248279,198795,116014,77300,58898,99256,798542,1543866,2411867,2411867
Jamaica,1992,JM,JAM,AMR,153018,288931,441949,243303,189958,114183,83011,55608,69141,755204,148223,282205,430428,246442,202956,120811,79780,58634,98374,806997,1562201,2434574,2434574
Jamaica,1993,JM,JAM,AMR,153257,292441,445698,243633,192938,118668,85067,56080,68548,764934,148319,285295,433614,245201,205729,126543,82135,58525,96678,814811,1579745,2459062,2459062
Jamaica,1994,JM,JAM,AMR,153730,295369,449099,244613,195460,124302,86100,56774,68045,775294,148663,287887,436550,244660,207793,133287,83844,58652,95013,823249,1598543,2484182,2484182
Jamaica,1995,JM,JAM,AMR,154581,297106,451687,246410,197131,130538,86905,57777,67651,786412,149412,289353,438765,245033,208772,140660,85557,59046,93437,832505,1618917,2509372,2509372
Jamaica,1996,JM,JAM,AMR,154394,298142,452536,248863,198541,136239,88244,58995,67431,798313,149196,290121,439317,246208,209318,147496,87955,59704,92047,842728,1641041,2532894,2532894
Jamaica,1997,JM,JAM,AMR,152545,299427,451972,251743,200880,141055,89373,60323,67400,810774,147387,291104,438491,247983,210626,153295,90385,60575,90854,853718,1664492,2554954,2554954
Jamaica,1998,JM,JAM,AMR,150034,300703,450737,255136,203220,145695,90332,61848,67389,823620,144948,292065,437013,250438,211791,158728,92830,61737,89670,865194,1688814,2576567,2576567
Jamaica,1999,JM,JAM,AMR,146466,301687,448153,259028,204761,150436,91619,63713,67166,836723,141489,292752,434241,253551,212065,164080,95700,63345,88407,877148,1713871,2596271,2596271
Jamaica,2000,JM,JAM,AMR,141194,302139,443333,263284,205630,155172,93386,65856,66741,850069,136388,292940,429328,257159,211573,169284,99048,65353,87062,889479,1739548,2612205,2612205
Jamaica,2001,JM,JAM,AMR,135737,301233,436970,267833,205959,159648,95803,68046,66205,863494,131120,291850,422970,261160,210483,174098,102975,67577,85677,901970,1765464,2625405,2625405
Jamaica,2002,JM,JAM,AMR,131060,299294,430354,272142,206291,163679,99057,70088,65592,876849,126605,289788,416393,265020,209365,178293,107692,69899,84382,914651,1791500,2638244,2638244
Jamaica,2003,JM,JAM,AMR,126566,297151,423717,275790,207179,166930,103398,71679,65054,890030,122258,287557,409815,268296,208818,181502,113436,72093,83315,927460,1817490,2651027,2651027
Jamaica,2004,JM,JAM,AMR,123110,294172,417282,278824,208589,169652,108754,72311,64841,902971,118910,284551,403461,271040,208842,183954,120128,73695,82653,940312,1843283,2664024,2664024
Jamaica,2005,JM,JAM,AMR,121383,289861,411244,280661,210695,171467,114647,72775,65077,915322,117230,280297,397527,272638,209651,185261,127416,75324,82481,952771,1868093,2676863,2676863
Jamaica,2006,JM,JAM,AMR,120835,284330,405165,281803,213368,172974,120025,73795,65748,927713,116688,274906,391594,273530,211141,186045,134151,77601,82718,965186,1892899,2689660,2689660
Jamaica,2007,JM,JAM,AMR,119682,277902,397584,283207,216421,175351,124561,74710,66843,941093,115569,268666,384235,274649,213155,187496,139835,79906,83269,978310,1919403,2701221,2701221
Jamaica,2008,JM,JAM,AMR,117656,270988,388644,284633,220010,177762,128978,75589,68298,955270,113607,261956,375563,275771,215850,188792,145145,82226,84107,991891,1947161,2711373,2711373
Jamaica,2009,JM,JAM,AMR,115458,264071,379529,285883,224230,179495,133588,76870,70033,970099,111466,255244,366710,276727,219323,189269,150420,84989,85336,1006064,1976163,2722401,2722401
Jamaica,2010,JM,JAM,AMR,112774,257224,369998,286783,229063,180739,138315,78682,71927,985509,108838,248596,357434,277380,223524,189129,155638,88274,87008,1020953,2006462,2733896,2733896
Jamaica,2011,JM,JAM,AMR,109661,251413,361074,286536,234493,181642,142935,81174,73911,1000691,105790,242959,348749,276978,228411,188555,160580,92168,88960,1035652,2036343,2746169,2746169
Jamaica,2012,JM,JAM,AMR,107266,245811,353077,285385,239957,182745,147294,84547,75891,1015819,103445,237527,340972,275732,233401,188090,164975,96813,90943,1049954,2065773,2759817,2759817
Jamaica,2013,JM,JAM,AMR,105397,239538,344935,284027,244903,184520,151028,88973,77685,1031136,101608,231446,333054,274304,237933,188255,168415,102371,92735,1064013,2095149,2773129,2773129
Jamaica,2014,JM,JAM,AMR,102953,234123,337076,281728,249255,186834,154264,94268,78893,1045242,99233,226178,325411,271990,241961,189008,171099,108729,94027,1076814,2122056,2784543,2784543
Jamaica,2015,JM,JAM,AMR,101008,229922,330930,277968,252364,189797,156556,99948,80066,1056699,97350,222071,319421,268311,244840,190563,172657,115573,95454,1087398,2144097,2794445,2794445
Jamaica,2016,JM,JAM,AMR,99408,226441,325849,272881,254711,193258,158429,105034,81666,1065979,95808,218650,314458,263389,246986,192811,173704,121885,97633,1096408,2162387,2802695,2802695
Jamaica,2017,JM,JAM,AMR,96968,223053,320021,266810,257232,197056,161027,109189,83203,1074517,93461,215326,308787,257528,249297,195597,175390,127177,100061,1105050,2179567,2808376,2808376
Jamaica,2018,JM,JAM,AMR,94069,219309,313378,260176,259659,201335,163582,113116,84766,1082634,90670,211672,302342,251124,251539,199061,176927,132108,102727,1113486,2196120,2811835,2811835
Jamaica,2019,JM,JAM,AMR,91310,214806,306116,253470,261717,206124,165426,117155,86650,1090542,88015,207287,295302,244643,253434,203206,177639,136976,105916,1121814,2212356,2813773,2813773
Jamaica,2020,JM,JAM,AMR,88652,210438,299090,247592,264062,211748,166883,121310,88991,1100586,85467,203031,288498,239038,255667,208301,177827,141791,109646,1132270,2232856,2820436,2820436
Jamaica,2021,JM,JAM,AMR,86167,206020,292187,243013,265460,217934,167953,125199,91208,1110767,83088,198735,281823,234733,257030,214037,177520,146198,113404,1142922,2253689,2827695,2827695
Jamaica,2022,JM,JAM,AMR,84235,201316,285551,237661,264896,223511,168875,128552,93327,1116822,81233,194158,275391,229573,256492,219302,177051,149911,117278,1149607,2266429,2827377,2827377
Jamaica,2023,JM,JAM,AMR,82823,196619,279442,231188,263626,228332,170388,131455,96567,1121556,79883,189596,269479,223265,255265,223914,177226,152936,122462,1155068,2276624,2825544,2825544
Jamaica,2024,JM,JAM,AMR,81706,191515,273221,225570,261425,232620,172534,134125,100603,1126877,78826,184658,263484,217767,253143,228072,178087,155486,128600,1161155,2288032,2824738,2824738
Jamaica,2025,JM,JAM,AMR,80655,186864,267519,221168,257776,235750,175379,136095,105127,1131295,77833,180173,258006,213426,249630,231117,179752,157072,135385,1166382,2297677,2823199,2823199
Jamaica,2026,JM,JAM,AMR,79597,182630,262227,217496,252796,238183,178776,137831,109818,1134900,76835,176106,252941,209785,244845,233457,182124,158237,142390,1170838,2305738,2820904,2820904
Jamaica,2027,JM,JAM,AMR,78614,178251,256865,213946,246824,240824,182553,140241,113836,1138224,75907,171899,247806,206269,239078,235979,185037,159987,148685,1175035,2313259,2817930,2817930
Jamaica,2028,JM,JAM,AMR,77711,174013,251724,210081,240271,243415,186822,142639,117732,1140960,75047,167824,242871,202464,232718,238441,188623,161608,154830,1178684,2319644,2814231,2814231
Jamaica,2029,JM,JAM,AMR,76784,170216,247000,205512,233614,245672,191600,144455,122002,1142855,74162,164187,238349,197976,226223,240575,192880,162499,161348,1181501,2324356,2809707,2809707
Jamaica,2030,JM,JAM,AMR,75838,166428,242266,200975,226919,247331,196755,145791,126578,1144349,73254,160565,233819,193513,219668,242141,197659,162788,168155,1183924,2328273,2804356,2804356
Jamaica,1950,JM,JAM,AMR,94906,157427,252333,132622,100512,85679,60501,30474,22037,431825,94475,158347,252822,132837,114671,92282,62175,36648,31873,470486,902311,1407470,1407470
Jamaica,1951,JM,JAM,AMR,98397,160364,258761,137508,103595,88414,63118,32119,22861,447615,97624,161334,258958,136228,116165,95405,64800,37856,32605,483059,930674,1448396,1448396
Jamaica,1952,JM,JAM,AMR,102251,163567,265818,140149,105194,90320,65067,33742,23372,457844,101143,164488,265631,138623,116681,98278,67203,39041,33167,492993,950837,1482284,1482284
Jamaica,1953,JM,JAM,AMR,106540,166890,273430,140902,105418,91308,66445,35380,23701,463154,105086,167700,272786,140163,116370,100740,69415,40278,33661,500627,963781,1509993,1509993
Jamaica,1954,JM,JAM,AMR,111939,169805,281744,140196,104478,91172,67476,37083,24027,464432,110091,170544,280635,140948,115544,102497,71496,41680,34246,506411,970843,1533217,1533217
Jamaica,1955,JM,JAM,AMR,117394,173211,290605,138510,102544,89885,68281,38833,24438,462491,115272,173764,289036,141169,114392,103436,73488,43284,34985,510754,973245,1552883,1552883
Jamaica,1956,JM,JAM,AMR,122119,177929,300048,136151,99902,87563,68831,40679,24957,458083,119881,178109,297990,140987,113039,103598,75355,45081,35868,513928,972011,1570048,1570048
Jamaica,1957,JM,JAM,AMR,127017,183083,310100,133491,96902,84335,69175,42658,25645,452206,124674,182897,307571,140598,111668,103073,77090,47116,36986,516531,968737,1586411,1586411
Jamaica,1958,JM,JAM,AMR,132241,188639,320880,131164,93656,80528,69381,44651,26470,445850,129788,188091,317879,140398,110352,102056,78765,49323,38272,519166,965016,1603775,1603775
Jamaica,1959,JM,JAM,AMR,136990,194947,331937,129803,90053,76592,69402,46425,27328,439603,134440,194039,328479,140789,109004,100715,80466,51505,39551,522030,961633,1622047,1622047
Jamaica,1960,JM,JAM,AMR,141650,200279,341929,130285,87941,73784,69448,47999,28600,438057,139091,199162,338253,141384,107254,98845,81910,53497,41204,524094,962151,1642331,1642331
Jamaica,1961,JM,JAM,AMR,145796,204816,350612,132111,87575,72153,69592,49379,30252,441062,143282,203609,346891,141965,105255,96476,83066,55288,43137,525187,966249,1663754,1663754
Jamaica,1962,JM,JAM,AMR,148238,210535,358773,134075,87272,70697,69666,50399,31830,443939,145739,209189,354928,142814,103488,93881,84236,56906,44794,526119,970058,1683761,1683761
Jamaica,1963,JM,JAM,AMR,149621,217600,367221,135846,87123,69444,69594,51157,33445,446609,147066,216056,363122,143677,101983,91170,85274,58409,46396,526909,973518,1703868,1703868
Jamaica,1964,JM,JAM,AMR,151048,225825,376873,136779,87209,68470,69151,51875,35289,448773,148326,224029,372355,144015,100662,88559,85872,59857,48212,527177,975950,1725181,1725181
Jamaica,1965,JM,JAM,AMR,152056,234484,386540,137701,87576,67739,68235,52620,37355,451226,149101,232580,381681,144487,99510,86107,85872,61275,50278,527529,978755,1746977,1746977
Jamaica,1966,JM,JAM,AMR,152933,242293,395226,139438,88089,67309,66866,53329,39640,454671,149734,240407,390141,145834,98485,83838,85304,62643,52655,528759,983430,1768803,1768803
Jamaica,1967,JM,JAM,AMR,154769,248895,403664,141259,88640,67256,65049,53984,42138,458326,151319,246996,398315,147455,97559,81801,84186,63914,55348,530263,988589,1790580,1790580
Jamaica,1968,JM,JAM,AMR,156650,255074,411724,143323,89421,67409,62970,54553,44605,462281,152959,253094,406053,149454,96935,79946,82637,65088,58103,532163,994444,1812209,1812209
Jamaica,1969,JM,JAM,AMR,157794,261254,419048,146293,90765,67480,61000,54981,46772,467291,153905,259093,412998,152415,96966,78164,80841,66252,60639,535277,1002568,1834615,1834615
Jamaica,2031,JM,JAM,AMR,74879,162704,237583,196360,221143,247585,202222,146754,131297,1145361,72332,157011,229343,188985,214001,242350,202859,162611,175071,1185877,2331238,2798160,2798160
Jamaica,2032,JM,JAM,AMR,73829,159734,233563,191622,215491,246726,207513,147826,136068,1145246,71325,154175,225500,184356,208446,241483,207971,162495,181972,1186723,2331969,2791030,2791030
Jamaica,2033,JM,JAM,AMR,72676,157429,230105,186961,209151,245555,212232,149455,140737,1144091,70218,151978,222196,179811,202201,240322,212583,162961,188651,1186529,2330620,2782912,2782912
Jamaica,2034,JM,JAM,AMR,71490,155400,226890,181898,203644,243448,216406,151586,145230,1142212,69080,150044,219124,174892,196748,238254,216706,163996,195024,1185620,2327832,2773843,2773843
Jamaica,2035,JM,JAM,AMR,70220,153413,223633,177277,199329,239913,219468,154354,149509,1139850,67856,148151,216007,170423,192447,234803,219739,165786,201019,1184217,2324067,2763714,2763714
Jamaica,2036,JM,JAM,AMR,68867,151409,220276,173079,195729,235067,221870,157638,153691,1137074,66550,146243,212793,166376,188835,230086,222093,168243,206754,1182387,2319461,2752526,2752526
Jamaica,2037,JM,JAM,AMR,67486,149384,216870,168738,192252,229259,224494,161271,157843,1133857,65217,144314,209531,162180,185350,224405,224632,171209,212298,1180074,2313931,2740318,2740318
Jamaica,2038,JM,JAM,AMR,66108,147335,213443,164533,188463,222893,227082,165347,161830,1130148,63883,142357,206240,158122,181571,218137,227122,174801,217491,1177244,2307392,2727072,2727072
Jamaica,2039,JM,JAM,AMR,64717,145236,209953,160767,183977,216429,229355,169867,165603,1125998,62538,140344,202882,154501,177119,211746,229298,179019,222293,1173976,2299974,2712812,2712812
Jamaica,2040,JM,JAM,AMR,63354,143029,206383,157010,179524,209935,231058,174713,169196,1121436,61219,138220,199439,150895,172692,205295,230918,183715,226756,1170271,2291707,2697534,2697534
Jamaica,2041,JM,JAM,AMR,62012,140728,202740,153322,174999,204337,231407,179823,172578,1116466,59919,136000,195919,147354,168196,199722,231207,188791,230850,1166120,2282586,2681237,2681237
Jamaica,2042,JM,JAM,AMR,60683,138314,198997,150384,170344,198856,230686,184762,176082,1111114,58635,133667,192302,144531,163599,194258,230442,193777,234949,1161556,2272670,2663963,2663963
Jamaica,2043,JM,JAM,AMR,59364,135791,195155,148101,165761,192699,229663,189193,179961,1105378,57359,131233,188592,142343,159088,188107,229389,198289,239374,1156590,2261968,2645711,2645711
Jamaica,2044,JM,JAM,AMR,58046,133227,191273,146090,160785,187358,227738,193137,184129,1099237,56079,128757,184836,140419,154201,182743,227441,202346,244017,1151167,2250404,2626505,2626505
Jamaica,2045,JM,JAM,AMR,56765,130605,187370,144123,156247,183175,224406,196068,188668,1092687,54837,126224,181061,138535,149761,178507,224123,205368,249016,1145310,2237997,2606421,2606421
Jamaica,2046,JM,JAM,AMR,55509,127918,183427,142135,152119,179681,219808,198416,193567,1085726,53621,123625,177246,136635,145741,174949,219558,207755,254405,1139043,2224769,2585443,2585443
Jamaica,2047,JM,JAM,AMR,54287,125222,179509,140133,147852,176310,214309,201005,198748,1078357,52436,121015,173451,134714,141577,171515,214066,210342,260114,1132328,2210685,2563640,2563640
Jamaica,2048,JM,JAM,AMR,53132,122536,175668,138105,143719,172634,208297,203586,204203,1070544,51315,118410,169725,132767,137545,167795,208014,212893,266136,1125150,2195694,2541082,2541082
Jamaica,2049,JM,JAM,AMR,52044,119835,171879,136024,140019,168274,202214,205901,209879,1062311,50257,115793,166050,130758,133949,163404,201851,215152,272432,1117546,2179857,2517798,2517798
Jamaica,2050,JM,JAM,AMR,51004,117200,168204,133836,136329,163946,196108,207710,215718,1053647,49251,113238,162489,128642,130364,159039,195632,216890,278916,1109483,2163130,2493823,2493823
Jordan,1970,JO,JOR,EMR,166986,234701,401687,138985,101209,65002,38115,26642,24996,394949,157440,222639,380079,131658,94857,63681,41247,25690,23533,380666,775615,1557374,1557374
Jordan,1971,JO,JOR,EMR,174441,249413,423854,147078,104144,69467,39898,27210,25479,413276,164117,236441,400558,139425,97798,67155,43474,26590,24189,398631,811907,1636320,1636320
Jordan,1972,JO,JOR,EMR,180750,262318,443068,154556,106229,73624,41506,27587,25817,429319,169671,248470,418141,146575,99920,70390,45342,27309,24730,414266,843585,1704787,1704787
Jordan,1973,JO,JOR,EMR,186314,274069,460383,161749,108059,77501,43072,27870,26060,444311,174536,259350,433886,153456,101799,73458,46977,27949,25191,428830,873141,1767414,1767414
Jordan,1974,JO,JOR,EMR,191604,284969,476573,169065,109925,81051,44721,28148,26247,459157,179223,269365,448588,160456,103714,76339,48493,28637,25628,443267,902424,1827584,1827584
Jordan,1975,JO,JOR,EMR,196825,295129,491954,176784,111922,84153,46518,28477,26383,474237,183950,278596,462546,167821,105746,78918,49953,29437,26024,457899,932136,1886636,1886636
Jordan,1976,JO,JOR,EMR,201745,304815,506560,184930,114274,86747,48490,28885,26482,489808,188519,287284,475803,175585,108102,81136,51373,30377,26391,472964,962772,1945141,1945141
Jordan,1977,JO,JOR,EMR,206500,314464,520964,193601,117250,88934,50689,29408,26558,506440,193103,295880,488983,183831,111028,83109,52815,31500,26744,489027,995467,2005418,2005418
Jordan,1978,JO,JOR,EMR,211230,324313,535543,202864,120978,90860,53158,30082,26637,524579,197819,304661,502480,192616,114647,84945,54352,32815,27124,506499,1031078,2069104,2069104
Jordan,1979,JO,JOR,EMR,216147,334650,550797,212840,125537,92679,55917,30924,26795,544692,202819,313936,516755,202060,119037,86754,56123,34267,27593,525834,1070526,2138078,2138078
Jordan,1980,JO,JOR,EMR,221814,346189,568003,223947,131157,94588,59112,31991,27076,567871,208568,324391,532959,212540,124427,88677,58364,35845,28218,548071,1115942,2216903,2216903
Jordan,1981,JO,JOR,EMR,228262,359156,587418,236227,137873,96681,62820,33315,27508,594424,215062,336258,551320,224089,130872,90787,61165,37552,29027,573492,1167916,2306655,2306655
Jordan,1982,JO,JOR,EMR,235309,373472,608781,249493,145567,99119,66945,34882,28090,624096,222094,349511,571605,236522,138257,93238,64459,39382,30015,601873,1225969,2406349,2406349
Jordan,1983,JO,JOR,EMR,243080,388732,631812,263577,154110,102069,71326,36679,28793,656554,229749,363818,593567,249676,146455,96169,68098,41306,31155,632859,1289413,2514785,2514785
Jordan,1984,JO,JOR,EMR,251373,404730,656103,278098,163507,105475,75753,38722,29600,691155,237840,378990,616830,263178,155472,99537,71881,43322,32459,665849,1357004,2629939,2629939
Jordan,1985,JO,JOR,EMR,259951,421620,681571,292960,173953,109347,80065,41054,30519,727898,246053,395158,641211,276920,165473,103350,75653,45453,33956,700805,1428703,2751492,2751492
Jordan,1986,JO,JOR,EMR,268996,439024,708020,308349,185462,113873,84175,43696,31560,767115,254685,411957,666642,291055,176481,107772,79337,47717,35665,738027,1505142,2879799,2879799
Jordan,1987,JO,JOR,EMR,278378,456767,735145,324333,197949,119188,88068,46653,32732,808923,263768,429214,692982,305677,188411,112930,82926,50103,37593,777640,1586563,3014694,3014694
Jordan,1988,JO,JOR,EMR,287943,475244,763187,340986,211437,125407,91809,49953,34061,853653,273072,447273,720345,320910,201264,118930,86484,52648,39756,819992,1673645,3157177,3157177
Jordan,1989,JO,JOR,EMR,297966,495045,793011,358691,226126,132678,95566,53639,35582,902282,282908,466647,749555,337145,215251,125916,90132,55502,42159,866105,1768387,3310954,3310954
Jordan,1990,JO,JOR,EMR,306253,512668,818921,381080,247464,143536,100126,57988,37458,967652,291267,483804,775071,355209,232246,134556,93758,58608,44561,918938,1886590,3480587,3480587
Jordan,1991,JO,JOR,EMR,313137,527376,840513,407714,276265,158516,105726,63088,39737,1051046,298257,498160,796417,374674,252421,144991,97397,61999,46918,978400,2029446,3666379,3666379
Jordan,1992,JO,JOR,EMR,321629,542044,863673,434758,308077,175751,112088,68708,42338,1141720,306614,512660,819274,394608,274220,156791,101396,65813,49386,1042214,2183934,3866887,3866887
Jordan,1993,JO,JOR,EMR,331893,556646,888539,460419,341346,194561,119200,74580,45177,1235283,316635,527153,843788,414011,296834,169610,105877,69879,51939,1108150,2343433,4075759,4075759
Jordan,1994,JO,JOR,EMR,343578,570961,914539,481780,372432,213510,126450,80252,48088,1322512,328035,541478,869513,431340,318340,182834,110601,73933,54553,1171601,2494113,4278166,4278166
Jordan,1995,JO,JOR,EMR,356128,584258,940386,496442,397602,231079,133126,85271,50926,1394446,340325,554898,895223,445336,336787,195836,115274,77705,57199,1228137,2622583,4458195,4458195
Jordan,1996,JO,JOR,EMR,367775,597362,965137,503773,415317,246491,139069,89415,53630,1447695,351799,568043,919842,455475,351429,208254,119916,81055,59871,1276000,2723695,4608676,4608676
Jordan,1997,JO,JOR,EMR,376480,611506,987986,505868,426511,260079,144638,92763,56253,1486112,360397,582120,942517,462761,362761,220168,124729,84028,62603,1317050,2803162,4733665,4733665
Jordan,1998,JO,JOR,EMR,381382,626931,1008313,506473,433579,272941,150424,95608,58973,1517998,365252,597383,962635,469270,371963,232022,129990,86749,65459,1355453,2873451,4844403,4844403
Jordan,1999,JO,JOR,EMR,382770,643643,1026413,508195,438414,285939,156851,98219,61906,1549524,366609,613918,980527,476401,379997,244183,135878,89322,68534,1394315,2943839,4950775,4950775
Jordan,2000,JO,JOR,EMR,381559,661053,1042612,511797,441614,299241,164032,100685,65134,1582503,365360,631299,996659,484421,387195,256695,142450,91752,71880,1434393,3016896,5056174,5056174
Jordan,2001,JO,JOR,EMR,379047,678206,1057253,517855,443699,312847,172032,103103,68712,1618248,362893,648389,1011282,493783,393844,269489,149739,94099,75568,1476522,3094770,5163310,5163310
Jordan,2002,JO,JOR,EMR,377368,694193,1071561,526367,445278,326655,180839,105702,72592,1657433,361334,664113,1025447,504542,400323,282436,157685,96550,79551,1521087,3178520,5275532,5275532
Jordan,2003,JO,JOR,EMR,378266,708231,1086497,537444,446931,340686,190485,108748,76710,1701004,362384,677815,1040199,516658,406898,295495,166275,99337,83745,1568408,3269412,5396117,5396117
Jordan,2004,JO,JOR,EMR,381937,720960,1102897,551823,450388,355261,201405,112458,81074,1752409,366225,690129,1056354,530760,414651,308812,175813,102602,88124,1620762,3373171,5532423,5532423
Jordan,2005,JO,JOR,EMR,387639,732614,1120253,567603,455517,369691,213575,116733,85519,1808638,372092,701378,1073470,545468,423545,321949,186338,106309,92562,1676171,3484809,5678534,5678534
Jordan,2006,JO,JOR,EMR,412204,774326,1186530,608732,480614,399248,236044,126688,93707,1945033,396068,741531,1137599,584367,451147,348639,205946,115206,101086,1806391,3751424,6075548,6075548
Jordan,2007,JO,JOR,EMR,438445,813284,1251729,650758,505825,427628,259449,137336,101828,2082824,421595,779145,1200740,624075,478721,374678,226393,124722,109577,1938166,4020990,6473457,6473457
Jordan,2008,JO,JOR,EMR,449758,819160,1268918,669331,512768,439002,274581,143809,106229,2145720,432645,785154,1217799,641329,488785,386242,239574,130391,114122,2000443,4146163,6632873,6632873
Jordan,2009,JO,JOR,EMR,460850,821961,1282811,687155,520168,447795,289577,150731,110390,2205816,443215,788206,1231421,658150,498628,396059,252680,136475,118460,2060452,4266268,6780493,6780493
Jordan,2010,JO,JOR,EMR,471889,824158,1296047,705402,529454,455177,305082,158460,114607,2268182,453442,790645,1244087,675786,509446,405200,266277,143300,122934,2122943,4391125,6931258,6931258
Jordan,2011,JO,JOR,EMR,483203,830506,1313709,725812,542741,462977,321993,167559,119404,2340486,463738,797090,1260828,695657,523364,415285,281184,151389,128078,2194957,4535443,7109980,7109980
Jordan,2012,JO,JOR,EMR,485964,830989,1316953,736905,551783,464805,335485,175584,123191,2387753,465750,797936,1263686,706500,532623,420514,293162,158512,132159,2243470,4631223,7211863,7211863
Jordan,2013,JO,JOR,EMR,509489,880518,1390007,798800,612244,497018,358226,185278,127310,2578876,489360,849675,1339035,747925,574030,447192,313219,167916,136622,2386904,4965780,7694814,7694814
Jordan,2014,JO,JOR,EMR,562272,990068,1552340,914316,732239,569803,397040,198844,133044,2945286,541246,964269,1505515,827664,653223,502933,346456,181803,142792,2654871,5600157,8658026,8658026
Jordan,2015,JO,JOR,EMR,601814,1086459,1688273,997363,825921,631827,440308,218268,142745,3256432,577913,1063617,1641530,898017,719408,553750,382951,200652,153227,2908005,6164437,9494246,9494246
Jordan,2016,JO,JOR,EMR,613505,1140420,1753925,1028180,872221,664140,475138,238894,153352,3431925,586965,1116989,1703954,937272,756481,584275,412276,219940,164604,3074848,6506773,9964656,9964656
Jordan,2017,JO,JOR,EMR,612066,1167457,1779523,1032578,900207,682519,499784,256446,161375,3532909,584520,1142946,1727466,952690,778046,602447,432898,236225,173182,3175488,6708397,10215381,10215381
Jordan,2018,JO,JOR,EMR,611439,1190250,1801689,1036049,928019,701366,522865,275371,170209,3633879,583905,1163253,1747158,967294,800352,620662,452693,253372,182755,3277128,6911007,10459865,10459865
Jordan,2019,JO,JOR,EMR,609591,1211169,1820760,1039360,955275,720894,544065,295199,180053,3734846,582308,1180913,1763221,981484,823408,639023,471445,270945,193552,3379857,7114703,10698683,10698683
Jordan,2020,JO,JOR,EMR,608571,1228060,1836631,1043613,980350,741308,563349,315539,189983,3834142,581491,1194747,1776238,995096,846448,657481,488998,288877,204813,3481713,7315855,10928721,10928721
Jordan,2021,JO,JOR,EMR,611119,1238487,1849606,1049494,1001876,762854,580822,336218,199279,3930543,583979,1201766,1785745,1009590,868470,675948,505516,307017,215833,3582374,7512917,11148278,11148278
Jordan,2022,JO,JOR,EMR,610140,1234596,1844736,1054754,1011515,780121,593154,355171,207471,4002186,583063,1194310,1777373,1022479,882484,689620,518082,323182,225733,3661580,7663766,11285869,11285869
Jordan,2023,JO,JOR,EMR,604190,1216873,1821063,1060336,1007145,792061,600472,372257,215646,4047917,577359,1173108,1750467,1033679,887133,697648,526542,337273,235327,3717602,7765519,11337052,11337052
Jordan,2024,JO,JOR,EMR,598065,1197994,1796059,1069140,997358,803937,607282,389680,226118,4093515,571483,1150975,1722458,1046122,888929,704857,534569,351575,246833,3772885,7866400,11384922,11384922
Jordan,2025,JO,JOR,EMR,592694,1178136,1770830,1079691,987688,816497,614394,407316,238713,4144299,566351,1128733,1695084,1058752,891653,712255,542883,366124,260232,3831899,7976198,11442114,11442114
Jordan,2026,JO,JOR,EMR,588537,1160359,1748896,1090966,978396,830514,622242,424909,252876,4199903,562363,1109383,1671746,1070420,895245,721010,551888,380755,275180,3894498,8094401,11515043,11515043
Jordan,2027,JO,JOR,EMR,585815,1146826,1732641,1101754,968224,846084,631335,442129,268882,4258408,559730,1095386,1655116,1080428,897314,731797,561794,395316,291830,3958479,8216887,11604646,11604646
Jordan,2028,JO,JOR,EMR,584119,1135770,1719889,1109992,959078,862612,641801,458272,286707,4318462,558082,1084821,1642903,1086444,900087,744385,572496,409415,310013,4022840,8341302,11704094,11704094
Jordan,2029,JO,JOR,EMR,583110,1125376,1708486,1117998,951604,879647,653751,473039,306057,4382096,557090,1075084,1632174,1091447,903901,758699,584049,422843,329508,4090447,8472543,11813211,11813211
Jordan,2030,JO,JOR,EMR,582669,1118015,1700684,1123927,947028,895774,667555,486664,326845,4447793,556629,1068245,1624874,1094575,908785,774112,596539,435643,350383,4160037,8607830,11933395,11933395
Jordan,1950,JO,JOR,EMR,38126,59355,97481,40429,24838,19646,16981,14401,11792,128087,36539,56107,92646,39486,26751,18002,13719,11974,10248,120180,248267,438386,438386
Jordan,1951,JO,JOR,EMR,41361,63107,104468,44595,26812,20640,17685,15078,12337,137147,39632,59697,99329,43026,29009,19185,14469,12537,10789,129015,266162,469962,469962
Jordan,1952,JO,JOR,EMR,44946,67197,112143,49145,29009,21710,18508,15773,12945,147090,43057,63611,106668,46956,31412,20458,15372,13097,11372,138667,285757,504576,504576
Jordan,1953,JO,JOR,EMR,48786,71669,120455,53928,31418,22848,19403,16452,13594,157643,46729,67890,114619,51142,33920,21834,16380,13625,11992,148893,306536,541616,541616
Jordan,1954,JO,JOR,EMR,53002,76430,129432,58789,34064,24067,20319,17097,14278,168614,50755,72446,123201,55438,36521,23357,17437,14136,12659,159548,328162,580796,580796
Jordan,1955,JO,JOR,EMR,57696,81496,139192,63576,36965,25374,21224,17699,15000,179838,55222,77287,132509,59715,39233,25048,18492,14631,13359,170478,350316,622010,622010
Jordan,1956,JO,JOR,EMR,62748,87024,149772,68180,40125,26777,22107,18240,15738,191167,60024,82566,142590,63887,42011,26911,19544,15095,14098,181546,372713,665071,665071
Jordan,1957,JO,JOR,EMR,68096,93075,161171,72551,43535,28283,22970,18710,16512,202561,65100,88327,153427,67931,44830,28972,20577,15513,14872,192695,395256,709849,709849
Jordan,1958,JO,JOR,EMR,73689,99601,173290,76640,47168,29877,23800,19112,17290,213887,70414,94530,164944,71785,47681,31180,21583,15904,15661,203794,417681,755904,755904
Jordan,1959,JO,JOR,EMR,79451,106484,185935,80374,50941,31522,24562,19471,18016,224886,75887,101065,176952,75353,50587,33411,22550,16299,16393,214593,439479,802351,802351
Jordan,1960,JO,JOR,EMR,85270,113550,198820,83593,54804,33172,25231,19784,18620,235204,81403,107771,189174,78447,53584,35539,23468,16701,16998,224737,459941,847936,847936
Jordan,1961,JO,JOR,EMR,91067,120645,211712,86237,58719,34790,25785,20057,19087,244675,86886,114510,201396,81022,56653,37504,24311,17116,17457,234063,478738,891848,891848
Jordan,1962,JO,JOR,EMR,96822,127740,224562,88581,62606,36400,26255,20326,19437,253605,92311,121261,213572,83325,59765,39328,25089,17576,17794,242877,496482,934615,934615
Jordan,1963,JO,JOR,EMR,102693,135110,237803,91079,66491,38114,26734,20632,19731,262781,97826,128281,226107,85784,62953,41111,25891,18125,18056,251920,514701,978607,978607
Jordan,1964,JO,JOR,EMR,109224,143664,252888,94265,70594,40202,27400,21059,20088,273608,103946,136430,240376,88896,66442,43103,26936,18798,18397,262572,536180,1029447,1029447
Jordan,1965,JO,JOR,EMR,117069,154469,271538,98713,75211,42942,28450,21703,20635,287654,111280,146692,257972,93195,70496,45590,28427,19661,18938,276307,563961,1093474,1093474
Jordan,1966,JO,JOR,EMR,126286,167867,294153,104784,80426,46440,29934,22579,21410,305573,119869,159416,279285,99020,75203,48669,30429,20738,19702,293761,599334,1172770,1172770
Jordan,1967,JO,JOR,EMR,136648,183602,320250,112426,86101,50661,31811,23646,22354,326999,129499,174346,303845,106323,80443,52246,32928,21996,20654,314590,641589,1265680,1265680
Jordan,1968,JO,JOR,EMR,147612,200841,348453,121162,91832,55391,33945,24782,23362,350474,139669,190669,330338,114651,85829,56104,35768,23323,21698,337373,687847,1366644,1366644
Jordan,1969,JO,JOR,EMR,158026,218254,376280,130233,97053,60268,36105,25824,24287,373770,149269,207131,356400,123285,90802,59965,38633,24589,22699,359973,733743,1466428,1466428
Jordan,2031,JO,JOR,EMR,582948,1116344,1699292,1125419,946019,909747,683518,499477,349020,4513200,556861,1066725,1623586,1092915,916198,789690,609957,448113,372559,4229432,8742632,12065504,12065504
Jordan,2032,JO,JOR,EMR,583858,1117221,1701079,1122624,952939,919814,701178,511861,372644,4581060,557712,1067598,1625310,1086558,930098,804094,623886,460615,395971,4301222,8882282,12208667,12208667
Jordan,2033,JO,JOR,EMR,584867,1119268,1704135,1116604,969082,924420,719889,524108,397667,4651770,558655,1069556,1628211,1076747,950860,816490,637867,473242,420572,4375778,9027548,12359896,12359896
Jordan,2034,JO,JOR,EMR,586120,1122362,1708482,1110958,989661,924880,739372,536333,423460,4724664,559827,1072492,1632319,1067501,974070,827106,651831,485956,446034,4452498,9177162,12517964,12517964
Jordan,2035,JO,JOR,EMR,587922,1126430,1714352,1104309,1011880,925445,759464,548717,449853,4799668,561523,1076363,1637886,1058102,997419,838625,665945,498881,472321,4531293,9330961,12683203,12683203
Jordan,2036,JO,JOR,EMR,589686,1131464,1721150,1098576,1033787,925501,780316,561390,476975,4876545,563180,1081143,1644323,1050463,1018862,850237,680814,512083,499496,4611955,9488500,12853969,12853969
Jordan,2037,JO,JOR,EMR,590939,1137398,1728337,1095636,1053944,923586,801874,574719,504680,4954439,564344,1086781,1651125,1046768,1037468,859372,696959,525666,527445,4693678,9648117,13027576,13027576
Jordan,2038,JO,JOR,EMR,591726,1143481,1735207,1094216,1070675,921990,823856,589043,532513,5032293,565062,1092548,1657610,1045569,1051306,868595,714419,539726,555847,4775462,9807755,13200576,13200576
Jordan,2039,JO,JOR,EMR,591947,1149382,1741329,1092318,1086112,921202,845685,604351,559901,5109569,565243,1098135,1663378,1044085,1063191,878108,733017,554230,584228,4856859,9966428,13371140,13371140
Jordan,2040,JO,JOR,EMR,591209,1155226,1746435,1092113,1098282,922295,865855,620905,586907,5186357,564504,1103646,1668150,1044193,1072117,887810,752035,569188,612599,4937942,10124299,13538887,13538887
Jordan,2041,JO,JOR,EMR,589713,1160631,1750344,1096197,1104810,925877,883124,638982,613728,5262718,563041,1108739,1671780,1048264,1075139,899113,770510,584562,641135,5018723,10281441,13703556,13703556
Jordan,2042,JO,JOR,EMR,587587,1165215,1752802,1101552,1105948,936353,895807,658183,640837,5338680,560982,1113053,1674035,1053475,1072441,916013,787166,599988,670121,5099204,10437884,13864721,13864721
Jordan,2043,JO,JOR,EMR,584997,1168773,1753770,1107027,1102956,955163,902500,677993,668509,5414148,558478,1116384,1674862,1058741,1065453,939034,801294,615085,699682,5179289,10593437,14022069,14022069
Jordan,2044,JO,JOR,EMR,581790,1171523,1753313,1112624,1099544,977661,904574,698164,696316,5488883,555385,1118944,1674329,1064088,1058281,963868,813177,629837,729484,5258735,10747618,14175260,14175260
Jordan,2045,JO,JOR,EMR,577782,1173410,1751192,1118307,1094362,1001099,906253,718548,724320,5562889,551543,1120674,1672217,1069509,1050247,988241,825494,644407,759630,5337528,10900417,14323826,14323826
Jordan,2046,JO,JOR,EMR,573197,1174123,1747320,1124187,1089439,1023626,907001,739344,752802,5636399,547152,1121282,1668434,1075085,1043343,1010194,837508,659436,790287,5415853,11052252,14468011,14468011
Jordan,2047,JO,JOR,EMR,568389,1173428,1741817,1130433,1086837,1043971,905518,760627,782062,5709448,542548,1120542,1663090,1080990,1039929,1028945,846803,675525,821548,5493740,11203188,14608090,14608090
Jordan,2048,JO,JOR,EMR,563783,1171689,1735472,1136590,1085553,1060734,904265,782248,812115,5781505,538139,1118805,1656944,1086813,1038817,1042797,856084,692832,853326,5570669,11352174,14744593,14744593
Jordan,2049,JO,JOR,EMR,559394,1168754,1728148,1142546,1083773,1076195,903828,803721,842548,5852611,533921,1115931,1649852,1092422,1037396,1054691,865657,711245,885225,5646636,11499247,14877252,14877252
Jordan,2050,JO,JOR,EMR,555381,1164061,1719442,1148442,1083674,1088404,905263,823609,873706,5923098,530039,1111381,1641420,1097957,1037564,1063639,875428,730079,917312,5721979,11645077,15005941,15005941
Japan,1970,JP,JPN,WPR,4489525,8180763,12670288,10040734,9086765,7970487,4910819,3876369,3325222,39210396,4270918,7865787,12136705,9884820,8997986,7889592,5913869,4450826,4262363,41399456,80609852,105416839,105416839
Japan,1971,JP,JPN,WPR,4662381,8175475,12837856,10017781,9080877,8124121,5155148,3939896,3418909,39736732,4430853,7850654,12281507,9842303,8981119,8018471,6106376,4587283,4397710,41933262,81669994,106789355,106789355
Japan,1972,JP,JPN,WPR,4843897,8224209,13068106,9766490,9263708,8248974,5432146,3983503,3534644,40229465,4600973,7889309,12490282,9578582,9143342,8135518,6307832,4705613,4561679,42432566,82662031,108220404,108220404
Japan,1973,JP,JPN,WPR,4942461,8384318,13326779,9341455,9647177,8326004,5731207,4000083,3662821,40708747,4693706,8033656,12727362,9141874,9499100,8215787,6520884,4789724,4749209,42916578,83625325,109679470,109679470
Japan,1974,JP,JPN,WPR,5046806,8519329,13566135,8924970,10065374,8352561,6047332,4009183,3790135,41189555,4797208,8149437,12946645,8715197,9885619,8249270,6742432,4862517,4942642,43397677,84587232,111100023,111100023
Japan,1975,JP,JPN,WPR,5089962,8671588,13761550,8595194,10349598,8399302,6353485,4038606,3921603,41657788,4841684,8283674,13125358,8378500,10137678,8304203,6933506,4967916,5145138,43866941,85524729,112411640,112411640
Japan,1976,JP,JPN,WPR,5052695,8850658,13903353,8387597,10431199,8511255,6656855,4082829,4055789,42125524,4808496,8446283,13254779,8158534,10195589,8424645,7109450,5095515,5357472,44341205,86466729,113624865,113624865
Japan,1977,JP,JPN,WPR,4943653,9049353,13993006,8253734,10414598,8643838,6963718,4130121,4197263,42603272,4705759,8631924,13337683,8006115,10159227,8564460,7295098,5215197,5587455,44827552,87430824,114761516,114761516
Japan,1978,JP,JPN,WPR,4770757,9256875,14027632,8189423,10339480,8768080,7240153,4208591,4342520,43088247,4541484,8827713,13369197,7923292,10065162,8693266,7466470,5350846,5825417,45324453,88412700,115809525,115809525
Japan,1979,JP,JPN,WPR,4565686,9437025,14002711,8193835,10221965,8877109,7466242,4334819,4489402,43583372,4346167,8996780,13342947,7911318,9932601,8803598,7619698,5501235,6068030,45836480,89419852,116765509,116765509
Japan,1980,JP,JPN,WPR,4372272,9540548,13912820,8248933,10159388,8891224,7643540,4519128,4628899,44091112,4162395,9092023,13254418,7952038,9858126,8817863,7757192,5671985,6308644,46365848,90456960,117624196,117624196
Japan,1981,JP,JPN,WPR,4195524,9673877,13869401,8239057,10108156,8849568,7791542,4753450,4758941,44500714,3995374,9218536,13213910,7930312,9803967,8773858,7884684,5863942,6544936,46801699,91302413,118385723,118385723
Japan,1982,JP,JPN,WPR,4034623,9739623,13774246,8286715,9826426,9007473,7910623,5017550,4887380,44936167,3844243,9280669,13124912,7967504,9530277,8917732,7995902,6064237,6787171,47262823,92198990,119098142,119098142
Japan,1983,JP,JPN,WPR,3899591,9658924,13558515,8445321,9370718,9380909,7982535,5299864,5003042,45482389,3717422,9203390,12920812,8112066,9083936,9269829,8069273,6275041,7021893,47832038,93314427,119793752,119793752
Japan,1984,JP,JPN,WPR,3790060,9553617,13343677,8579472,8926830,9794531,8010828,5594504,5111041,46017206,3614907,9106202,12721109,8230279,8646695,9663313,8101064,6492115,7255272,48388738,94405944,120470727,120470727
Japan,1985,JP,JPN,WPR,3699934,9401255,13101189,8733242,8574613,10069098,8070866,5878712,5238678,46565209,3531035,8963316,12494351,8369624,8298308,9919296,8163986,6678142,7528930,48958286,95523495,121119031,121119031
Japan,1986,JP,JPN,WPR,3621095,9188125,12809220,8912748,8348290,10130584,8200894,6160570,5381271,47134357,3456086,8761875,12217961,8536043,8066701,9967840,8297701,6849889,7830602,49548776,96683133,121710305,121710305
Japan,1987,JP,JPN,WPR,3552426,8918857,12471283,9111172,8201933,10093559,8347521,6444861,5533854,47732900,3389138,8507318,11896456,8723549,7908544,9918434,8445599,7031604,8140521,50168251,97901151,122268885,122268885
Japan,1988,JP,JPN,WPR,3482952,8611055,12094007,9320194,8131264,10017182,8476850,6700665,5710167,48356322,3322342,8215597,11537939,8921742,7827439,9826706,8571770,7200256,8462131,50810044,99166366,122798302,122798302
Japan,1989,JP,JPN,WPR,3395704,8296677,11692381,9501501,8131318,9926152,8576240,6913115,5926009,48974335,3239171,7918861,11158032,9092100,7819734,9720385,8666071,7352789,8794810,51445889,100420224,123270648,123270648
Japan,1990,JP,JPN,WPR,3296041,8013408,11309449,9611177,8175553,9907331,8574412,7085252,6189101,49542826,3144913,7653162,10798075,9192426,7858485,9688475,8656714,7492293,9147579,52035972,101578798,123686321,123686321
Japan,1991,JP,JPN,WPR,3214859,7759211,10974070,9749759,8156084,9892705,8529757,7233219,6486526,50048050,3068958,7414191,10483149,9321516,7836125,9670896,8600441,7622989,9516759,52568726,102616776,124073993,124073993
Japan,1992,JP,JPN,WPR,3150869,7531987,10682856,9813773,8202597,9633398,8696746,7354670,6798507,50499691,3008240,7200123,10208363,9377909,7879786,9419487,8748165,7736077,9892361,53053785,103553476,124444693,124444693
Japan,1993,JP,JPN,WPR,3088700,7329225,10417925,9731732,8360848,9191861,9081267,7431606,7108657,50905971,2948879,7009848,9958727,9294129,8030879,8986422,9111057,7809905,10264560,53496952,104402923,124779576,124779576
Japan,1994,JP,JPN,WPR,3056119,7133158,10189277,9627266,8493791,8757056,9501816,7472465,7424339,51276733,2918037,6827673,9745710,9191981,8155081,8557877,9513721,7845567,10643322,53907549,105184282,125119269,125119269
Japan,1995,JP,JPN,WPR,3047378,6945183,9992561,9476194,8643989,8411437,9778049,7548808,7742385,51600862,2910827,6652819,9563646,9044963,8298516,8217191,9773732,7915990,11026498,54276890,105877752,125433969,125433969
Japan,1996,JP,JPN,WPR,3038496,6788799,9827295,9263523,8819512,8190226,9840566,7694539,8072678,51881044,2904259,6504259,9408518,8839807,8467309,7993909,9825262,8057146,11425927,54609360,106490404,125726223,125726223
Japan,1997,JP,JPN,WPR,3031352,6659351,9690703,8994541,9015419,8047592,9804425,7856022,8418795,52136794,2899891,6378094,9277985,8582681,8655919,7844925,9779292,8211563,11848128,54922508,107059302,126027985,126027985
Japan,1998,JP,JPN,WPR,3027766,6530376,9558142,8687092,9220032,7978632,9728299,7996085,8764781,52374921,2898030,6253156,9151186,8289669,8853290,7772437,9691151,8343125,12274474,55224146,107599067,126308390,126308390
Japan,1999,JP,JPN,WPR,3013743,6413248,9426991,8374695,9394921,7978628,9639839,8099878,9104917,52592878,2884502,6140761,9025263,7992638,9021246,7772137,9592759,8438532,12692617,55509929,108102807,126555063,126555063
Japan,2000,JP,JPN,WPR,3002915,6308267,9311182,8095786,9500451,8018257,9624526,8101242,9456100,52796362,2872126,6041551,8913677,7726971,9120706,7814459,9571212,8428105,13121187,55782640,108579002,126803861,126803861
Japan,2001,JP,JPN,WPR,2996939,6222366,9219305,7846178,9633620,7994118,9610322,8064518,9832973,52981729,2864447,5961536,8825983,7488555,9247750,7795535,9559690,8375415,13571768,56038713,109020442,127065731,127065731
Japan,2002,JP,JPN,WPR,2978608,6154877,9133485,7622909,9691450,8037123,9355441,8235677,10204886,53147486,2845600,5898598,8744198,7275861,9300464,7843754,9314233,8528513,14013751,56276576,109424062,127301750,127301750
Japan,2003,JP,JPN,WPR,2952394,6093242,9045636,7424026,9607280,8188933,8925598,8614725,10535723,53296285,2819288,5839824,8659112,7088151,9216452,7996457,8889999,8895332,14414927,56501318,109797603,127502352,127502352
Japan,2004,JP,JPN,WPR,2918633,6051779,8970412,7232655,9503964,8315957,8506356,9024000,10833187,53416119,2787675,5798140,8585815,6910015,9117178,8121678,8471891,9299145,14779040,56698947,110115066,127671288,127671288
Japan,2005,JP,JPN,WPR,2872851,6037487,8910338,7049516,9357624,8463333,8177191,9293380,11159137,53500181,2745949,5781603,8527552,6739728,8977538,8266131,8142252,9561689,15172969,56860307,110360488,127798373,127798373
Japan,2006,JP,JPN,WPR,2827748,6027654,8855402,6896690,9153088,8638983,7969671,9360950,11551000,53570382,2704160,5770895,8475055,6595842,8783978,8435535,7928559,9619881,15637541,57001336,110571718,127902167,127902167
Japan,2007,JP,JPN,WPR,2800122,6006425,8806547,6770429,8895304,8836354,7838784,9336396,11961875,53639142,2677856,5750275,8428131,6474606,8540505,8624250,7788486,9581086,16123672,57132605,110771747,128006426,128006426
Japan,2008,JP,JPN,WPR,2783863,5979372,8763235,6646008,8600788,9044144,7780926,9273800,12342739,53688405,2662116,5723801,8385917,6355009,8261142,8821996,7723739,9498749,16579442,57240077,110928482,128077633,128077633
Japan,2009,JP,JPN,WPR,2773376,5932956,8706332,6535557,8300580,9223401,7791562,9200324,12686184,53737608,2651490,5679395,8330885,6249108,7975584,8990115,7728446,9405695,16993269,57342217,111079825,128117042,128117042
Japan,2010,JP,JPN,WPR,2765969,5876983,8642952,6437673,8031523,9334706,7839604,9193966,12934599,53772071,2642707,5624761,8267468,6156010,7718360,9089984,7771651,9387962,17298967,57422934,111195005,128105431,128105431
Japan,2011,JP,JPN,WPR,2752180,5825164,8577344,6357813,7789320,9472550,7823148,9183868,13144411,53771110,2627589,5573993,8201582,6080186,7484789,9216721,7750577,9376065,17548889,57457227,111228337,128007257,128007257
Japan,2012,JP,JPN,WPR,2724365,5776804,8501169,6296532,7572001,9533861,7873044,8945865,13535932,53757235,2600845,5526029,8126874,6020818,7274977,9268415,7795344,9132114,17976744,57468412,111225647,127853688,127853688
Japan,2013,JP,JPN,WPR,2691729,5731194,8422923,6240578,7379541,9453758,8029852,8544907,14088428,53737064,2570028,5480417,8050445,5965131,7089413,9183751,7943869,8712587,18573743,57468494,111205558,127678924,127678924
Japan,2014,JP,JPN,WPR,2655573,5683926,8339499,6202219,7195645,9353778,8161278,8155269,14641335,53709524,2534872,5434922,7969794,5924726,6911815,9083838,8063681,8299458,19174399,57457917,111167441,127476735,127476735
Japan,2015,JP,JPN,WPR,2618208,5628212,8246420,6188058,7020051,9210975,8311433,7850292,15100174,53680983,2499293,5381409,7880702,5907949,6740385,8943245,8201811,7974220,19675213,57442823,111123806,127250933,127250933
Japan,2016,JP,JPN,WPR,2579457,5566875,8146332,6175750,6874127,9009371,8487197,7660158,15437395,53643998,2463402,5321752,7785154,5895708,6593993,8747695,8365369,7763398,20052210,57418373,111062371,126993857,126993857
Japan,2017,JP,JPN,WPR,2522600,5509000,8031600,6150232,6754344,8753763,8682654,7543218,15698670,53582881,2410115,5265751,7675866,5872167,6470322,8500841,8548902,7625366,20354526,57372124,110955005,126662472,126662472
Japan,2018,JP,JPN,WPR,2443980,5457978,7901958,6117989,6636853,8460837,8887901,7496193,15898679,53498452,2335688,5216848,7552536,5841648,6350136,8217504,8741309,7560972,20591354,57302923,110801375,126255866,126255866
Japan,2019,JP,JPN,WPR,2354314,5410388,7764702,6065167,6533728,8162003,9063752,7515090,16054231,53393971,2250946,5169987,7420933,5792432,6245066,7927999,8904616,7564621,20777341,57212075,110606046,125791677,125791677
Japan,2020,JP,JPN,WPR,2266489,5364998,7631487,6005114,6449554,7899245,9172553,7566185,16157467,53250118,2167333,5124978,7292311,5736454,6161469,7669182,9004933,7604887,20893916,57070841,110320959,125244761,125244761
Japan,2021,JP,JPN,WPR,2191758,5311920,7503678,5951507,6389150,7669385,9310726,7552116,16190999,53063883,2094545,5073613,7168158,5686431,6103878,7439539,9136037,7583475,20927447,56876807,109940690,124612530,124612530
Japan,2022,JP,JPN,WPR,2140220,5228652,7368872,5898959,6346065,7467259,9376278,7602578,16179855,52870994,2043063,4994632,7037695,5636974,6064375,7237108,9193140,7630388,20912142,56674127,109545121,123951692,123951692
Japan,2023,JP,JPN,WPR,2112808,5120710,7233518,5846699,6306948,7293963,9303953,7755932,16172712,52680207,2014248,4892742,6906990,5588142,6028749,7062489,9114428,7780964,20899027,56473799,109154006,123294513,123294513
Japan,2024,JP,JPN,WPR,2101793,5001759,7103552,5791376,6281670,7135238,9213827,7882587,16175075,52479773,2001491,4779956,6781447,5537704,6005307,6901887,9019354,7904587,20897820,56266659,108746432,122631432,122631432
Japan,2025,JP,JPN,WPR,2097074,4882708,6979782,5727798,6276609,6988900,9082671,8024608,16167786,52268372,1996246,4666753,6662999,5478951,6001634,6752147,8884093,8044910,20887520,56049255,108317627,121960408,121960408
Japan,2026,JP,JPN,WPR,2091904,4772654,6864558,5658131,6273436,6871062,8893512,8192470,16155649,52044260,1991615,4561260,6552875,5413585,6003166,6626427,8695233,8209035,20873355,55820801,107865061,121282488,121282488
Japan,2027,JP,JPN,WPR,2091197,4668640,6759837,5591420,6259456,6775288,8650702,8382328,16148021,51807215,1991176,4460476,6451652,5351842,5996591,6518977,8457119,8393172,20864194,55581895,107389110,120600599,120600599
Japan,2028,JP,JPN,WPR,2091956,4567185,6659141,5532870,6240548,6677895,8372067,8583083,16155939,51562402,1992077,4361485,6353562,5298808,5983491,6412699,8183533,8587906,20870697,55337134,106899536,119912238,119912238
Japan,2029,JP,JPN,WPR,2092378,4472722,6565100,5480077,6201590,6592816,8088324,8757079,16187620,51307506,1992584,4269922,6262506,5249743,5950264,6322236,7902961,8756811,20899976,55081991,106389497,119217097,119217097
Japan,2030,JP,JPN,WPR,2093290,4384235,6477525,5433088,6149877,6519091,7835888,8867048,16237966,51042958,1993516,4184886,6178402,5204430,5903195,6247706,7650503,8861682,20948404,54815920,105858878,118514802,118514802
Japan,1950,JP,JPN,WPR,5785472,9318255,15103727,8332686,5305372,4644468,3746053,2481748,1719681,26230008,5579529,9162948,14742477,8332370,6278004,4992155,3672098,2595908,2406306,28276841,54506849,84353049,84353049
Japan,1951,JP,JPN,WPR,5939000,9241668,15180668,8463861,5543563,4696510,3799036,2558868,1763734,26825572,5724233,9079483,14803716,8436852,6457561,5123722,3735586,2659061,2460736,28873518,55699090,85683474,85683474
Japan,1952,JP,JPN,WPR,5816207,9380074,15196281,8565263,5825267,4723596,3865167,2634726,1820808,27434827,5610302,9198034,14808336,8530223,6652967,5231019,3820629,2721795,2525691,29482324,56917151,86921764,86921764
Japan,1953,JP,JPN,WPR,5449253,9749618,15198871,8617363,6137769,4715996,3940545,2705006,1887504,28004183,5257186,9540349,14797535,8586324,6865741,5295601,3930372,2781494,2597015,30056547,58060730,88057140,88057140
Japan,1954,JP,JPN,WPR,5023925,10163634,15187559,8621677,6467816,4699580,4013642,2771712,1960692,28535119,4844631,9926894,14771525,8599774,7085338,5348372,4050435,2838826,2676075,30598820,59133939,89093019,89093019
Japan,1955,JP,JPN,WPR,4678279,10431176,15109455,8652235,6785654,4707475,4079314,2849733,2037836,29112247,4511187,10169514,14680701,8640095,7269958,5438371,4168896,2908747,2761810,31187877,60300124,90090281,90090281
Japan,1956,JP,JPN,WPR,4448760,10475110,14923870,8750119,7102464,4732853,4127170,2949228,2101526,29763360,4288859,10198425,14487284,8744342,7438690,5552627,4275338,3006764,2829290,31847051,61610411,91021560,91021560
Japan,1957,JP,JPN,WPR,4256176,10416013,14672189,8862418,7423534,4761480,4168971,3047421,2156495,30420319,4099932,10131571,14231503,8860026,7614370,5659745,4383790,3111059,2884659,32513649,62933968,91837665,91837665
Japan,1958,JP,JPN,WPR,4122852,10317358,14440210,8956335,7709052,4827168,4215446,3136554,2220094,31064649,3968833,10027379,13996212,8956658,7772439,5784436,4497127,3210271,2949300,33170231,64234880,92671295,92671295
Japan,1959,JP,JPN,WPR,4055530,10201869,14257399,9028491,7935720,4949952,4275293,3212288,2294428,31696172,3904231,9904630,13808861,9031116,7912389,5922793,4624699,3295582,3026978,33813557,65509729,93575985,93575985
Japan,1960,JP,JPN,WPR,4007025,10150126,14157151,9011425,8107616,5140191,4338947,3270129,2369469,32237777,3859984,9844598,13704582,9015228,8036237,6083291,4757256,3364512,3108800,34365324,66603101,94464839,94464839
Japan,1961,JP,JPN,WPR,3981210,10108003,14089213,8950162,8247753,5387634,4397279,3321330,2445356,32749514,3834859,9801695,13636554,8950480,8153409,6268260,4888929,3426607,3192503,34880188,67629702,95355458,95355458
Japan,1962,JP,JPN,WPR,4001786,9828084,13829870,9098853,8359423,5671303,4429604,3383043,2522392,33464618,3851115,9531597,13382712,9085785,8260773,6463353,4996485,3506947,3277342,35590685,69055303,96267883,96267883
Japan,1963,JP,JPN,WPR,4042630,9366163,13408793,9472880,8428443,5980814,4429328,3453895,2608978,34374338,3886115,9079884,12965999,9441801,8334336,6672534,5064481,3611338,3373088,36497578,70871916,97246712,97246712
Japan,1964,JP,JPN,WPR,4094444,8912680,13007124,9895840,8457391,6307518,4422309,3524401,2704494,35311953,3932100,8634733,12566833,9846885,8368568,6889392,5122394,3727745,3478453,37433437,72745390,98319344,98319344
Japan,1965,JP,JPN,WPR,4187819,8554153,12741972,10184460,8515612,6624036,4439216,3588640,2798900,36150864,4018836,8284596,12303432,10116625,8432214,7074847,5217836,3844115,3586831,38272468,74423332,99468746,99468746
Japan,1966,JP,JPN,WPR,4199826,8329945,12529771,10259635,8640215,6940705,4474222,3639851,2906110,36860738,4024761,8059031,12083792,10177386,8561582,7248235,5339685,3952568,3713156,38992612,75853350,100466907,100466907
Japan,1967,JP,JPN,WPR,4223925,8187288,12411213,10234424,8782970,7262599,4515179,3689947,3024535,37509654,4043681,7906310,11949991,10139107,8706151,7432091,5457636,4066649,3855360,39656994,77166648,101527852,101527852
Japan,1968,JP,JPN,WPR,4342157,8119121,12461278,10166865,8917061,7551822,4591533,3744528,3136676,38108485,4151916,7826257,11978173,10055220,8838706,7600984,5593868,4185216,3997347,40271341,78379826,102819279,102819279
Japan,1969,JP,JPN,WPR,4425797,8122111,12547908,10074691,9042425,7786881,4720039,3809106,3235637,38668779,4220896,7817857,12038753,9942627,8959923,7752990,5743651,4315676,4131764,40846631,79515410,104102077,104102077
Japan,2031,JP,JPN,WPR,2094200,4304714,6398914,5380572,6098808,6461333,7611514,9001071,16213176,50766474,1994452,4107839,6102291,5153635,5855762,6192519,7424746,8992278,20919061,54538001,105304475,117805680,117805680
Japan,2032,JP,JPN,WPR,2093297,4252717,6346014,5297720,6047650,6419803,7413940,9064593,16217790,50461496,1993733,4056179,6049912,5075006,5807646,6154428,7225419,9049832,20920327,54232658,104694154,117090083,117090083
Japan,2033,JP,JPN,WPR,2091594,4226142,6317736,5190064,5995980,6381565,7244764,8997596,16319762,50129731,1992271,4028336,6020607,4973283,5759115,6119356,7053350,8974684,21020326,53900114,104029845,116368193,116368193
Japan,2034,JP,JPN,WPR,2089777,4215613,6305390,5071405,5941250,6357044,7089806,8912788,16408326,49780619,1990658,4016150,6006808,4860664,5708972,6096403,6895093,8883205,21103925,53548262,103328881,115641077,115641077
Japan,2035,JP,JPN,WPR,2086853,4211863,6298716,4952641,5878283,6352583,6946864,8788174,16504942,49423487,1987985,4011896,5999881,4747630,5650521,6093125,6747499,8752147,21194056,53184978,102608465,114907058,114907058
Japan,2036,JP,JPN,WPR,2081827,4207660,6289487,4842863,5809233,6349970,6831892,8607758,16624991,49066707,1983285,4008255,5991540,4642289,5585464,6095018,6623643,8568391,21302410,52817215,101883922,114164955,114164955
Japan,2037,JP,JPN,WPR,2075142,4206101,6281243,4739126,5743113,6336595,6738598,8376110,16774282,48707824,1976926,4007149,5984075,4541659,5524011,6088806,6517858,8336339,21434923,52443596,101151420,113416742,113416742
Japan,2038,JP,JPN,WPR,2067173,4205209,6272382,4637953,5685108,6318273,6643704,8110813,16953435,48349286,1969324,4006636,5975960,4442822,5471245,6076068,6413243,8069665,21593896,52066939,100416225,112664566,112664566
Japan,2039,JP,JPN,WPR,2057935,4203856,6261791,4543772,5632826,6280010,6561047,7841159,17135205,47994019,1960522,4005577,5966099,4351406,5422431,6043255,6324357,7796210,21751146,51688805,99682824,111910716,111910716
Japan,2040,JP,JPN,WPR,2048166,4201896,6250062,4455575,5586314,6229054,6489607,7601575,17280601,47642726,1951187,4003882,5955069,4266517,5377359,5996634,6251273,7550251,21867318,51309352,98952078,111157201,111157201
Japan,2041,JP,JPN,WPR,2038428,4197830,6236258,4376328,5534278,6178715,6433833,7388593,17384368,47296115,1941872,4000168,5942040,4189610,5326803,5949647,6197355,7330313,21937064,50930792,98226907,110405207,110405207
Japan,2042,JP,JPN,WPR,2027753,4190287,6218040,4324549,5451994,6128298,6394064,7201197,17456020,46956122,1931676,3993138,5924814,4138062,5248447,5901980,6160394,7136218,21970566,50555667,97511789,109654640,109654640
Japan,2043,JP,JPN,WPR,2014169,4180665,6194834,4298128,5344969,6077371,6357555,7041115,17503323,46622461,1918726,3984116,5902842,4110309,5147020,5853903,6126429,6968869,21977291,50183821,96806282,108903960,108903960
Japan,2044,JP,JPN,WPR,1997683,4169655,6167338,4287713,5226966,6023391,6334517,6894477,17528654,46295718,1903020,3973749,5876769,4098192,5034707,5804210,6104444,6814944,21959225,49815722,96111440,108155545,108155545
Japan,2045,JP,JPN,WPR,1978944,4157012,6135956,4284063,5108858,5961214,6331191,6759080,17531786,45976192,1885214,3961789,5847003,4093994,4921971,5746227,6101951,6671338,21917661,49453142,95429334,107412293,107412293
Japan,2046,JP,JPN,WPR,1958125,4142292,6100417,4279956,4999703,5892980,6329652,6650491,17511012,45663794,1865444,3947816,5813260,4090419,4816920,5681644,6104557,6550979,21852367,49096886,94760680,106674353,106674353
Japan,2047,JP,JPN,WPR,1935871,4124977,6060848,4278488,4896556,5827632,6317401,6562734,17475271,45358082,1844329,3931307,5775636,4089363,4716560,5620641,6099056,6448341,21774011,48747972,94106054,105942538,105942538
Japan,2048,JP,JPN,WPR,1913192,4103477,6016669,4277681,4795961,5770337,6300151,6473412,17440613,45058155,1822833,3910799,5733632,4088903,4617991,5568288,6087017,6346826,21699140,48408165,93466320,105216618,105216618
Japan,2049,JP,JPN,WPR,1890066,4077801,5967867,4276412,4702323,5718706,6263173,6396148,17407221,44763983,1800900,3886336,5687236,4087900,4526830,5519860,6055021,6260877,21627701,48078189,92842172,104497283,104497283
Japan,2050,JP,JPN,WPR,1866442,4049344,5915786,4274532,4614645,5672792,6213592,6329761,17368286,44473608,1778461,3859240,5637701,4086261,4442183,5475148,6009284,6190498,21553885,47757259,92230867,103784357,103784357
Kazakhstan,1970,KZ,KAZ,EUR,729380,1556873,2286253,1064734,852827,785140,380395,305989,246954,3636039,699972,1523307,2223279,1037211,871368,807783,517702,494830,390830,4119724,7755763,12265305,12265305
Kazakhstan,1971,KZ,KAZ,EUR,723786,1568685,2292471,1128218,813844,807267,411450,303441,249604,3713824,694703,1535000,2229703,1096748,840101,820189,549665,494413,407218,4208334,7922158,12444338,12444338
Kazakhstan,1972,KZ,KAZ,EUR,726280,1566354,2292634,1178935,787813,824124,449542,298529,252894,3791837,698032,1531849,2229881,1142434,817161,834337,591914,489248,422551,4297645,8089482,12611997,12611997
Kazakhstan,1973,KZ,KAZ,EUR,735450,1553084,2288534,1227860,772928,837944,492017,292531,256574,3879854,707046,1518660,2225706,1188446,799548,850471,638148,481228,438042,4395883,8275737,12789985,12789985
Kazakhstan,1974,KZ,KAZ,EUR,749051,1531886,2280937,1275021,767396,850113,534341,286396,260435,3973702,719665,1498270,2217935,1234381,789616,866801,681160,472797,455170,4499925,8473627,12972497,12972497
Kazakhstan,1975,KZ,KAZ,EUR,763381,1508289,2271670,1321970,775319,856729,571597,281356,264361,4071332,732769,1475650,2208419,1280495,793070,879154,714776,466081,473945,4607521,8678853,13158942,13158942
Kazakhstan,1976,KZ,KAZ,EUR,776070,1486055,2262125,1369266,797746,857209,600337,277342,268468,4170368,744676,1453761,2198437,1326596,811795,886487,736862,459941,493565,4715246,8885614,13346173,13346173
Kazakhstan,1977,KZ,KAZ,EUR,786617,1470001,2256618,1412540,834255,857382,620640,273854,272863,4271534,753919,1438344,2192263,1370398,844871,894833,745306,453220,514473,4823101,9094635,13543521,13543521
Kazakhstan,1978,KZ,KAZ,EUR,796010,1460263,2256273,1450283,890023,845684,636195,273473,277197,4372855,761711,1429058,2190769,1410530,897988,891993,744447,450124,535311,4930393,9303248,13750291,13750291
Kazakhstan,1979,KZ,KAZ,EUR,807064,1455361,2262425,1481538,958905,813355,652428,281477,280253,4467956,771867,1423238,2195105,1444524,964954,867567,745735,457007,552519,5032306,9500262,13957795,13957795
Kazakhstan,1980,KZ,KAZ,EUR,819367,1457612,2276979,1503929,1029435,772471,672721,298742,281042,4558340,783462,1423806,2207268,1470559,1033543,832778,753650,474805,564785,5130120,9688460,14172710,14172710
Kazakhstan,1981,KZ,KAZ,EUR,834370,1466095,2300465,1516196,1088251,738925,695739,325635,280054,4644800,797660,1430119,2227779,1487068,1089374,804403,766880,503951,572663,5224339,9869139,14397391,14397391
Kazakhstan,1982,KZ,KAZ,EUR,853983,1480086,2334069,1517406,1134516,719974,717503,359936,278139,4727474,816211,1441539,2257750,1492478,1132534,786201,784771,542710,576193,5314887,10042361,14634179,14634179
Kazakhstan,1983,KZ,KAZ,EUR,877336,1500422,2377758,1508113,1180177,711161,735862,397363,275970,4808646,838255,1458825,2297080,1487193,1176528,772945,804239,584902,576674,5402481,10211127,14885966,14885966
Kazakhstan,1984,KZ,KAZ,EUR,902946,1526677,2429623,1491315,1224704,710942,752417,434490,274436,4888304,862458,1481310,2343768,1474261,1220669,766908,823578,623742,576737,5485895,10374199,15147590,15147590
Kazakhstan,1985,KZ,KAZ,EUR,930093,1554216,2484309,1472062,1269035,722703,763185,467172,274063,4968220,888207,1504863,2393070,1458254,1265085,773388,838534,653644,578805,5567710,10535930,15413315,15413315
Kazakhstan,1986,KZ,KAZ,EUR,950002,1582626,2532628,1458512,1326100,755879,766676,487078,271301,5065546,915461,1540912,2456373,1442706,1322923,800305,845995,670733,584080,5666742,10732288,15721289,15721289
Kazakhstan,1987,KZ,KAZ,EUR,961972,1609653,2571625,1453982,1390342,811996,765676,493804,265805,5181605,944402,1589749,2534151,1431183,1389528,849798,847639,674539,592407,5785094,10966699,16072478,16072478
Kazakhstan,1988,KZ,KAZ,EUR,973781,1630565,2604346,1456971,1443153,886301,757949,496405,262263,5303042,975087,1637240,2612327,1427645,1446416,920686,838896,671885,605350,5910878,11213920,16430590,16430590
Kazakhstan,1989,KZ,KAZ,EUR,986035,1651534,2637569,1457911,1466688,959557,741916,502146,266112,5394330,991506,1673637,2665143,1426463,1475050,994845,820924,668329,622338,6007949,11402279,16704993,16704993
Kazakhstan,1990,KZ,KAZ,EUR,992490,1673419,2665909,1456908,1463849,1018314,720104,512610,276943,5448728,986781,1697972,2684753,1427336,1478151,1057458,798888,665843,639495,6067171,11515899,16866563,16866563
Kazakhstan,1991,KZ,KAZ,EUR,986030,1695522,2681552,1462541,1453120,1070233,695841,525549,290826,5498110,969752,1722583,2692335,1435919,1473800,1113241,773948,667622,657271,6121801,11619911,16993792,16993792
Kazakhstan,1992,KZ,KAZ,EUR,966211,1715544,2681755,1465680,1431026,1108742,671100,540333,306557,5523438,940069,1744558,2684627,1444478,1456562,1155552,749091,673698,674227,6153608,11677046,17043417,17043417
Kazakhstan,1993,KZ,KAZ,EUR,933886,1727952,2661838,1459909,1397090,1130062,648675,552964,321760,5510460,898859,1758165,2657024,1448281,1424182,1181150,727588,680843,688333,6150377,11660837,16979697,16979697
Kazakhstan,1994,KZ,KAZ,EUR,890292,1724924,2615216,1438594,1347284,1133310,627517,558081,333053,5437839,852511,1750896,2603407,1439551,1373743,1190303,708213,683958,694925,6090693,11528532,16747151,16747151
Kazakhstan,1995,KZ,KAZ,EUR,842526,1711775,2554301,1410525,1291278,1128059,612277,557019,339456,5338614,807152,1729193,2536345,1423621,1316468,1192089,695438,684627,692819,6005062,11343676,16434324,16434324
Kazakhstan,1996,KZ,KAZ,EUR,785049,1690885,2475934,1386933,1245249,1124399,612986,552417,343412,5265396,754808,1701715,2456523,1406996,1271395,1195907,699751,685032,687321,5946402,11211798,16144247,16144247
Kazakhstan,1997,KZ,KAZ,EUR,719260,1653004,2372264,1363813,1206723,1115981,627030,540094,343884,5197525,696542,1660276,2356818,1384255,1238433,1195790,719866,678012,677467,5893823,11091348,15820432,15820432
Kazakhstan,1998,KZ,KAZ,EUR,661857,1599363,2261220,1342831,1174366,1100001,648644,518909,340088,5124839,644494,1606742,2251236,1360561,1213290,1188393,750914,660805,662990,5836953,10961792,15474254,15474254
Kazakhstan,1999,KZ,KAZ,EUR,623559,1558168,2181727,1333116,1149712,1089210,682140,495291,337927,5087396,606088,1565428,2171516,1349099,1191407,1183959,796482,640612,654057,5815616,10903012,15256255,15256255
Kazakhstan,2000,KZ,KAZ,EUR,605173,1532910,2138083,1345286,1140598,1089324,723892,473859,343093,5116052,583443,1537722,2121165,1362242,1180767,1187743,850148,622204,657839,5860943,10976995,15236253,15236253
Kazakhstan,2001,KZ,KAZ,EUR,596284,1496812,2093096,1372879,1145031,1089249,761289,454463,355177,5178088,570901,1498270,2069171,1391985,1184345,1190578,897377,604744,671904,5940933,11119021,15281285,15281285
Kazakhstan,2002,KZ,KAZ,EUR,594457,1451568,2046025,1405928,1153909,1085648,792106,439563,372080,5249234,567004,1448147,2015151,1427069,1193346,1188815,935515,591298,692510,6028553,11277787,15338963,15338963
Kazakhstan,2003,KZ,KAZ,EUR,600169,1403511,2003680,1440647,1165823,1079331,819584,430846,390014,5326245,571971,1393669,1965640,1463924,1205988,1182723,968589,583627,716292,6121143,11447388,15416712,15416712
Kazakhstan,2004,KZ,KAZ,EUR,614877,1357502,1972379,1474200,1178438,1072151,846619,428939,405033,5405380,586000,1341766,1927766,1498752,1219889,1174000,1000571,582625,740552,6216389,11621769,15521923,15521923
Kazakhstan,2005,KZ,KAZ,EUR,638508,1316402,1954910,1505015,1191198,1065876,873118,434140,415414,5484761,608361,1295898,1904259,1529921,1234491,1164831,1031734,589536,761804,6312317,11797078,15656248,15656248
Kazakhstan,2006,KZ,KAZ,EUR,672591,1280851,1953442,1530562,1206225,1061791,898632,446714,420164,5564088,640494,1255465,1895959,1555984,1251243,1157541,1061771,605920,776795,6409254,11973342,15822748,15822748
Kazakhstan,2007,KZ,KAZ,EUR,716621,1251720,1968341,1545755,1224458,1059403,922361,467525,417849,5637351,681926,1221323,1903249,1571257,1270118,1152359,1089651,634074,779736,6497195,12134546,16006136,16006136
Kazakhstan,2008,KZ,KAZ,EUR,765774,1232502,1998276,1547640,1246216,1059035,942319,496632,409079,5700921,728093,1196969,1925062,1572142,1291838,1149539,1113159,674951,770628,6572257,12273178,16196517,16196517
Kazakhstan,2009,KZ,KAZ,EUR,814183,1226137,2040320,1538369,1273147,1063176,957158,532187,397320,5761357,773451,1185103,1958554,1560701,1319204,1151036,1130440,725676,755082,6642139,12403496,16402369,16402369
Kazakhstan,2010,KZ,KAZ,EUR,857487,1235021,2092508,1518723,1306516,1072850,967433,569045,388317,5822884,813878,1187967,2001845,1537892,1353952,1157790,1141808,777414,741751,6710607,12533491,16627837,16627837
Kazakhstan,2011,KZ,KAZ,EUR,893535,1261853,2155388,1486630,1344700,1086421,973938,602218,386268,5880175,847369,1208785,2056154,1501466,1393822,1169085,1148242,822188,738392,6773195,12653370,16864917,16864917
Kazakhstan,2012,KZ,KAZ,EUR,921882,1305208,2227090,1443730,1384569,1101904,976441,630904,391136,5928684,873503,1247129,2120632,1452573,1435160,1183467,1149525,859158,746573,6826456,12755140,17102864,17102864
Kazakhstan,2013,KZ,KAZ,EUR,942731,1361235,2303966,1397087,1423426,1118571,976030,657917,401727,5974758,892420,1299127,2191547,1398371,1475364,1199597,1146085,892015,764031,6875463,12850221,17345732,17345732
Kazakhstan,2014,KZ,KAZ,EUR,960597,1425087,2385684,1351054,1457992,1133990,974320,685416,416016,6018788,908410,1358983,2267393,1345225,1510110,1214746,1139256,923926,787173,6920436,12939224,17592298,17592298
Kazakhstan,2015,KZ,KAZ,EUR,978542,1491810,2470352,1308183,1486047,1146901,972261,712592,432398,6058382,924396,1421335,2345731,1296349,1537189,1227772,1130844,954873,814423,6961450,13019832,17835909,17835909
Kazakhstan,2016,KZ,KAZ,EUR,994805,1561165,2555970,1270768,1506907,1160040,971224,738967,450399,6098305,938646,1485989,2424635,1252892,1556899,1240629,1123039,984034,842147,6999640,13097945,18078553,18078553
Kazakhstan,2017,KZ,KAZ,EUR,1005424,1632860,2638284,1239945,1518025,1176612,971615,763845,469170,6139212,947499,1552699,2500198,1216028,1566409,1255979,1117369,1011165,870174,7037124,13176336,18314814,18314814
Kazakhstan,2018,KZ,KAZ,EUR,1011890,1702249,2714139,1217904,1516315,1197674,973886,785236,488387,6179402,952594,1617028,2569622,1187882,1562150,1275629,1114672,1034540,900057,7074930,13254332,18538099,18538099
Kazakhstan,2019,KZ,KAZ,EUR,1016563,1767803,2784366,1207608,1501839,1222804,979336,801341,508449,6221377,956238,1677530,2633768,1171167,1543951,1300244,1115786,1051758,931836,7114742,13336119,18754258,18754258
Kazakhstan,2020,KZ,KAZ,EUR,1024971,1828462,2853433,1214255,1476665,1252369,987708,810401,525227,6266625,963664,1733277,2696941,1171172,1514016,1330786,1120853,1061903,963511,7162241,13428866,18979243,18979243
Kazakhstan,2021,KZ,KAZ,EUR,1035346,1880190,2915536,1240426,1440085,1285967,998139,813486,536758,6314861,973328,1780357,2753685,1190979,1471432,1365920,1129471,1065280,989308,7212390,13527251,19196465,19196465
Kazakhstan,2022,KZ,KAZ,EUR,1041567,1918798,2960365,1284344,1395122,1322572,1010882,813489,548326,6374735,979315,1814881,2794196,1229717,1418763,1403611,1141373,1063347,1011887,7268698,13643433,19397998,19397998
Kazakhstan,2023,KZ,KAZ,EUR,1043637,1946269,2989906,1342316,1348588,1359235,1025677,812445,566032,6454293,981508,1838957,2820465,1283739,1363153,1441179,1155626,1058281,1039994,7341972,13796265,19606633,19606633
Kazakhstan,2024,KZ,KAZ,EUR,1038668,1969344,3008012,1407945,1303846,1392664,1040716,812683,593194,6551048,977290,1859085,2836375,1345623,1310215,1474569,1170180,1052653,1079497,7432737,13983785,19828165,19828165
Kazakhstan,2025,KZ,KAZ,EUR,1024115,1996217,3020332,1476342,1263878,1421141,1054703,814176,625423,6655663,964147,1883019,2847166,1409998,1263514,1501998,1183816,1047091,1126277,7532694,14188357,20055854,20055854
Kazakhstan,2026,KZ,KAZ,EUR,1005535,2023171,3028706,1546992,1229463,1442440,1068790,816167,657292,6761144,947165,1907254,2854419,1476326,1222544,1522212,1197384,1042031,1173026,7633523,14394667,20277784,20277784
Kazakhstan,2027,KZ,KAZ,EUR,992142,2040239,3032381,1619639,1201904,1454383,1086025,818932,687681,6868564,935071,1922359,2857430,1544397,1188647,1532611,1213519,1038751,1218285,7736210,14604774,20494584,20494584
Kazakhstan,2028,KZ,KAZ,EUR,982820,2049114,3031934,1689987,1184898,1455795,1108292,823351,715657,6977980,926762,1930054,2856816,1610058,1165539,1531403,1234709,1038251,1260686,7840646,14818626,20707376,20707376
Kazakhstan,2029,KZ,KAZ,EUR,977653,2049548,3027201,1756518,1180907,1446673,1135213,830677,740564,7090552,922203,1930247,2852450,1671878,1155414,1518332,1261608,1041465,1299170,7947867,15038419,20918059,20918059
Kazakhstan,2030,KZ,KAZ,EUR,976455,2043960,3020415,1817703,1191834,1425968,1166022,841001,762367,7204895,921272,1925099,2846371,1728432,1160020,1492388,1293788,1048509,1333399,8056536,15261431,21128221,21128221
Kazakhstan,1950,KZ,KAZ,EUR,445379,731478,1176857,651861,319993,351676,266443,241646,200826,2032445,429325,712840,1142165,628197,415069,464255,341715,225408,229561,2304205,4336650,6655675,6655675
Kazakhstan,1951,KZ,KAZ,EUR,496402,701155,1197557,690250,363248,354388,273347,236211,206019,2123463,476943,691936,1168879,654228,456170,468064,359317,224504,235786,2398069,4521532,6887970,6887970
Kazakhstan,1952,KZ,KAZ,EUR,527557,685728,1213285,726224,417633,354580,281140,229905,211796,2221278,505522,680943,1186465,684164,509409,468259,374948,223322,242936,2503038,4724316,7124072,7124072
Kazakhstan,1953,KZ,KAZ,EUR,551942,679959,1231901,756828,476865,352812,289794,223581,217450,2317330,528706,674125,1202831,714389,567496,465524,389382,223407,250033,2610231,4927561,7362289,7362289
Kazakhstan,1954,KZ,KAZ,EUR,572459,682804,1255263,784850,536399,350398,299153,218735,221881,2411416,549059,674603,1223662,743902,622846,462202,403614,227171,255868,2715603,5127019,7605944,7605944
Kazakhstan,1955,KZ,KAZ,EUR,593145,699546,1292691,806725,590844,349021,308730,215975,224679,2495974,569395,688819,1258214,769021,669056,460588,417919,235204,260067,2811855,5307829,7858733,7858733
Kazakhstan,1956,KZ,KAZ,EUR,617809,732063,1349872,822385,636438,348519,318686,215160,226042,2567230,592919,719165,1312084,789176,703874,459361,432384,247418,262772,2894985,5462215,8124175,8124175
Kazakhstan,1957,KZ,KAZ,EUR,648020,779040,1427060,835504,671477,347938,329318,216334,226102,2626673,621748,763885,1385633,808924,724915,457020,447232,264177,264033,2966301,5592974,8405659,8405659
Kazakhstan,1958,KZ,KAZ,EUR,682849,846875,1529724,832825,699366,350473,339427,219092,225234,2666417,655000,829308,1484308,815242,735579,458128,461042,283647,264655,3018293,5684710,8698748,8698748
Kazakhstan,1959,KZ,KAZ,EUR,719249,930699,1649948,807834,728370,364043,347095,222971,224085,2694398,689778,910417,1600195,799861,748135,470655,471656,302782,265762,3058851,5753249,9003391,9003391
Kazakhstan,1960,KZ,KAZ,EUR,755193,1017574,1772767,771683,760021,389714,351259,228629,223748,2725054,724633,993778,1718411,771989,764967,495454,479354,322692,268599,3103055,5828109,9319283,9319283
Kazakhstan,1961,KZ,KAZ,EUR,786655,1092661,1879316,741558,792089,427859,352207,235895,224322,2773930,755554,1064583,1820137,748591,784004,532816,484624,343113,272772,3165920,5939850,9639302,9639302
Kazakhstan,1962,KZ,KAZ,EUR,808208,1154447,1962655,727352,822509,476651,350989,243831,225129,2846461,776682,1122956,1899638,735914,807522,581874,486024,362012,277321,3250667,6097128,9959414,9959414
Kazakhstan,1963,KZ,KAZ,EUR,818714,1215015,2033729,723897,848815,530531,348359,252465,226209,2930276,786880,1181843,1968723,728273,832506,635929,484635,380355,283360,3345058,6275334,10277790,10277790
Kazakhstan,1964,KZ,KAZ,EUR,819286,1273733,2093019,729789,873408,584980,345482,261586,227716,3022961,787387,1240263,2027650,728431,857737,687397,482761,398995,291981,3447302,6470263,10590934,10590934
Kazakhstan,1965,KZ,KAZ,EUR,810950,1331864,2142814,749838,892729,634759,343818,270755,229874,3121773,779397,1298172,2077569,742544,879383,729821,482553,417979,303209,3555489,6677262,10897644,10897644
Kazakhstan,1966,KZ,KAZ,EUR,796220,1389493,2185713,785173,906518,676235,343185,280009,232608,3223728,765237,1355255,2120492,772576,896769,760993,482679,437218,317393,3667628,6891356,11197568,11197568
Kazakhstan,1967,KZ,KAZ,EUR,778962,1443257,2222219,834321,918399,707796,342727,289540,235903,3328686,748609,1408739,2157348,816827,914387,778625,481689,456737,334703,3782968,7111654,11491228,11491228
Kazakhstan,1968,KZ,KAZ,EUR,760506,1491169,2251675,903586,916526,733284,345534,298467,239853,3437250,730850,1456531,2187381,881866,920081,786624,484112,475015,353848,3901546,7338796,11777849,11777849
Kazakhstan,1969,KZ,KAZ,EUR,742574,1530053,2272627,985980,892243,758851,357910,304482,243903,3543369,713402,1495659,2209061,960829,903380,795418,496212,488670,372921,4017430,7560799,12042478,12042478
Kazakhstan,2031,KZ,KAZ,EUR,978100,2036157,3014257,1869629,1220378,1392966,1200203,853591,781579,7318346,922988,1918175,2841163,1775956,1182607,1452726,1330020,1059203,1363534,8164046,15482392,21337806,21337806
Kazakhstan,2032,KZ,KAZ,EUR,982570,2029282,3011852,1908289,1265319,1350961,1236566,867864,799168,7428167,927339,1912374,2839713,1810734,1222887,1402291,1368398,1072933,1390507,8267750,15695917,21547475,21547475
Kazakhstan,2033,KZ,KAZ,EUR,989726,2022093,3011819,1935655,1322670,1306167,1272131,883194,816394,7536211,934195,1906351,2840546,1834830,1276764,1347565,1405930,1088345,1416121,8369555,15905766,21758123,21758123
Kazakhstan,2034,KZ,KAZ,EUR,998745,2012046,3010791,1958719,1387651,1263310,1304387,897893,834071,7646031,942803,1897651,2840454,1854995,1338477,1295488,1439101,1103291,1441472,8472824,16118855,21970104,21970104
Kazakhstan,2035,KZ,KAZ,EUR,1008853,1996401,3005254,1985604,1455376,1225153,1331720,911206,852226,7761285,952431,1883641,2836072,1878962,1402651,1249556,1466221,1116904,1466704,8580998,16342283,22183607,22183607
Kazakhstan,2036,KZ,KAZ,EUR,1020128,1979574,2999702,2012569,1525289,1192380,1352180,924694,870485,7877597,963156,1868434,2831590,1903233,1468765,1209290,1486231,1130495,1491941,8689955,16567552,22398846,22398846
Kazakhstan,2037,KZ,KAZ,EUR,1032560,1970752,3003312,2029689,1597157,1166266,1363809,941045,888252,7986218,974962,1860742,2835704,1918385,1536608,1176025,1496628,1146591,1517121,8791358,16777576,22616594,22616594
Kazakhstan,2038,KZ,KAZ,EUR,1045662,1968664,3014326,2038658,1666767,1150444,1365578,961933,905520,8088900,987390,1859335,2846725,1926138,1602063,1153451,1495690,1167582,1541994,8886918,16975818,22836868,22836868
Kazakhstan,2039,KZ,KAZ,EUR,1059201,1972580,3031781,2039224,1732630,1147316,1357527,987069,922875,8186641,1000216,1863425,2863641,1926398,1663699,1143733,1483192,1194076,1566515,8977613,17164254,23059676,23059676
Kazakhstan,2040,KZ,KAZ,EUR,1073223,1981544,3054767,2033796,1793235,1158682,1338644,1015754,940446,8280557,1013476,1872151,2885627,1921328,1720099,1148600,1458132,1225654,1590640,9064453,17345010,23285398,23285398
Kazakhstan,2041,KZ,KAZ,EUR,1087824,1994509,3082333,2026152,1844716,1187148,1308241,1047475,958147,8371879,1027242,1884613,2911855,1914481,1767508,1171256,1419669,1261114,1614497,9148525,17520404,23514590,23514590
Kazakhstan,2042,KZ,KAZ,EUR,1102280,2011445,3113725,2019422,1883113,1231548,1269470,1081141,976311,8461005,1040886,1900791,2941677,1908742,1802236,1211419,1370701,1298629,1638579,9230306,17691311,23746703,23746703
Kazakhstan,2043,KZ,KAZ,EUR,1116404,2031726,3148130,2012366,1910387,1288035,1228211,1114101,995513,8548613,1054213,1920087,2974300,1902776,1826328,1265044,1317575,1335311,1663380,9310414,17859027,23981452,23981452
Kazakhstan,2044,KZ,KAZ,EUR,1129700,2054300,3184000,2002478,1933451,1351937,1188868,1143972,1015127,8635833,1066712,1941531,3008243,1894151,1846522,1326418,1267053,1367705,1688026,9389875,18025708,24217948,24217948
Kazakhstan,2045,KZ,KAZ,EUR,1140804,2078446,3219250,1987053,1960304,1418443,1153978,1169186,1034548,8723512,1077185,1964430,3041615,1880228,1870501,1390203,1222546,1394129,1711973,9469580,18193092,24453953,24453953
Kazakhstan,2046,KZ,KAZ,EUR,1149260,2104336,3253596,1970474,1987231,1487004,1124154,1188075,1054738,8811676,1085192,1988924,3074116,1865114,1894776,1455882,1183572,1413621,1736614,9549579,18361255,24688978,24688978
Kazakhstan,2047,KZ,KAZ,EUR,1155115,2131231,3286346,1961847,2004400,1557399,1100614,1199060,1077374,8900694,1090714,2014379,3105093,1857497,1909960,1523243,1151454,1423875,1764232,9630261,18530955,24922400,24922400
Kazakhstan,2048,KZ,KAZ,EUR,1158117,2158466,3316583,1959917,2013504,1625579,1086855,1201413,1103796,8991064,1093529,2040134,3133663,1856146,1917766,1588227,1129828,1423354,1796850,9712171,18703235,25153483,25153483
Kazakhstan,2049,KZ,KAZ,EUR,1159179,2185314,3344493,1963962,2014314,1690133,1085198,1195256,1134194,9083057,1094511,2065461,3159972,1860282,1918115,1649433,1120837,1411886,1834988,9795541,18878598,25383063,25383063
Kazakhstan,2050,KZ,KAZ,EUR,1158931,2210453,3369384,1973026,2009209,1749596,1097290,1179646,1167979,9176746,1094225,2089194,3183419,1869048,1913155,1705459,1126147,1388510,1878109,9880428,19057174,25609978,25609978
Kenya,1970,KE,KEN,AFR,1246027,1723803,2969830,1041780,605682,434848,300707,181964,137973,2702954,1236083,1727303,2963386,1015370,730642,520297,295078,159574,115958,2836919,5539873,11473087,11473087
Kenya,1971,KE,KEN,AFR,1286486,1804713,3091199,1082441,630876,442858,307782,188201,139368,2791526,1275823,1807314,3083137,1059080,737568,542918,307671,167120,118243,2932600,5724126,11898457,11898457
Kenya,1972,KE,KEN,AFR,1326737,1884876,3211613,1122811,658985,448856,314071,194580,140979,2880282,1315327,1886573,3201900,1106197,742874,563148,320575,175222,121089,3029105,5909387,12322903,12322903
Kenya,1973,KE,KEN,AFR,1366213,1964899,3331112,1164629,693443,453937,320289,201199,143116,2976613,1354142,1965669,3319811,1157614,751253,580954,334475,183916,124665,3132877,6109490,12760405,12760405
Kenya,1974,KE,KEN,AFR,1404764,2045863,3450627,1205701,732647,457963,326765,207511,145761,3076348,1392254,2045670,3437924,1209831,762741,595533,349481,192723,128729,3239038,6315386,13203949,13203949
Kenya,1975,KE,KEN,AFR,1443408,2127868,3571276,1258709,761989,461411,333527,213478,148734,3177848,1430657,2126610,3557267,1267891,771046,606812,365464,201428,132869,3345510,6523358,13651908,13651908
Kenya,1976,KE,KEN,AFR,1482743,2210028,3692771,1324888,779500,464652,339765,219298,151844,3279947,1469824,2207637,3677461,1332352,776068,614688,381738,210224,137021,3452091,6732038,14102268,14102268
Kenya,1977,KE,KEN,AFR,1523878,2291747,3815625,1395649,801223,469775,345705,224742,155418,3392512,1510893,2288246,3799139,1401746,788305,620266,398610,219322,141830,3570079,6962591,14577346,14577346
Kenya,1978,KE,KEN,AFR,1568663,2372533,3941196,1471059,829181,477801,351923,229729,159679,3519372,1555721,2368003,3923724,1476280,810047,624008,416658,228689,147451,3703133,7222505,15087423,15087423
Kenya,1979,KE,KEN,AFR,1617404,2452725,4070129,1547859,860544,488799,358300,234744,164278,3654524,1604468,2447324,4051792,1552373,838001,626392,435713,238298,153399,3844176,7498700,15620613,15620613
Kenya,1980,KE,KEN,AFR,1669191,2532964,4202155,1628053,895903,505243,365094,240281,169135,3803709,1656231,2526786,4183017,1631998,872681,629901,455721,248390,159559,3998250,7801959,16187124,16187124
Kenya,1981,KE,KEN,AFR,1724043,2614198,4338241,1710005,934258,527240,371958,246344,174635,3964440,1711043,2607266,4318309,1713586,913852,634735,476307,259542,166957,4164979,8129419,16785962,16785962
Kenya,1982,KE,KEN,AFR,1781734,2697568,4479302,1791462,975368,554663,378310,252465,180759,4133027,1768734,2689899,4458633,1794830,961653,640721,496009,271698,175620,4340531,8473558,17411491,17411491
Kenya,1983,KE,KEN,AFR,1840308,2784029,4624337,1874658,1020571,589249,384174,258560,187166,4314378,1827462,2775678,4603140,1877850,1016268,650523,513596,284646,184718,4527601,8841979,18069461,18069461
Kenya,1984,KE,KEN,AFR,1899900,2873793,4773693,1959154,1067231,629873,389683,265080,193574,4504595,1887399,2864904,4752303,1962049,1073989,664872,528826,298793,194057,4722586,9227181,18753176,18753176
Kenya,1985,KE,KEN,AFR,1960991,2966336,4927327,2043255,1125779,662126,395076,271972,199867,4698075,1948923,2957181,4906104,2045687,1138170,677486,541624,314116,203576,4920659,9618734,19452161,19452161
Kenya,1986,KE,KEN,AFR,2021898,3062387,5084285,2125670,1197072,684563,400994,278719,206263,4893281,2010121,3053172,5063293,2127405,1208857,688477,551895,329951,213435,5120020,10013301,20160879,20160879
Kenya,1987,KE,KEN,AFR,2082213,3162475,5244688,2206059,1270131,709586,408039,284997,212788,5091600,2070538,3153368,5223906,2206853,1281390,704755,559177,345927,223795,5321897,10413497,20882094,20882094
Kenya,1988,KE,KEN,AFR,2141045,3266110,5407155,2286428,1346456,738947,416942,291020,219275,5299068,2129328,3257343,5386671,2286447,1357502,728436,563836,362433,234577,5533231,10832299,21626122,21626122
Kenya,1989,KE,KEN,AFR,2194769,3373934,5568703,2367465,1425244,772095,428697,296978,225646,5516125,2182777,3365695,5548472,2367032,1436350,758690,567355,379637,245440,5754504,11270629,22387803,22387803
Kenya,1990,KE,KEN,AFR,2241196,3485358,5726554,2449156,1506682,807872,444711,302679,231956,5743056,2228562,3477879,5706441,2448554,1518138,794434,571425,397249,256425,5986225,11729281,23162269,23162269
Kenya,1991,KE,KEN,AFR,2278379,3598193,5876572,2528234,1585751,844070,464415,307593,238121,5968184,2264908,3591588,5856496,2527370,1597839,834139,575437,414422,267773,6216980,12185164,23918235,23918235
Kenya,1992,KE,KEN,AFR,2306672,3711903,6018575,2606410,1660935,881058,487914,311356,243939,6191612,2292318,3706223,5998541,2605229,1673909,878522,579584,430002,279749,6446995,12638607,24655723,24655723
Kenya,1993,KE,KEN,AFR,2330858,3823437,6154295,2686994,1734708,919109,516356,313933,249391,6420491,2315456,3818766,6134222,2685594,1748622,926747,586200,443099,292550,6682812,13103303,25391830,25391830
Kenya,1994,KE,KEN,AFR,2355614,3929640,6285254,2770943,1808746,957423,549474,315941,254890,6657417,2339034,3925952,6264986,2769390,1823367,976701,596543,453777,306316,6926094,13583511,26133744,26133744
Kenya,1995,KE,KEN,AFR,2385394,4029040,6414434,2856704,1881681,1006429,574549,317929,260534,6897826,2367809,4026143,6393952,2855104,1896697,1032301,605079,462136,320812,7172129,14069955,26878347,26878347
Kenya,1996,KE,KEN,AFR,2422868,4119050,6541918,2943351,1950651,1066263,590104,320286,265903,7136558,2404675,4116621,6521296,2941631,1965749,1093198,611808,468065,335508,7415959,14552517,27615736,27615736
Kenya,1997,KE,KEN,AFR,2468789,4200404,6669193,3034228,2017452,1127560,607858,323506,270709,7381313,2450093,4198156,6648249,3032526,2032299,1155744,623435,471297,350215,7665516,15046829,28364264,28364264
Kenya,1998,KE,KEN,AFR,2525225,4276585,6801810,3129628,2082805,1189796,628488,327927,275139,7633783,2505856,4274194,6780050,3128129,2096929,1219148,640684,471746,365095,7921731,15555514,29137373,29137373
Kenya,1999,KE,KEN,AFR,2590986,4349549,6940535,3234443,2152353,1254476,652506,334867,279857,7908502,2570818,4346614,6917432,3233633,2165359,1284534,663522,471182,380430,8198660,16107162,29965129,29965129
Kenya,2000,KE,KEN,AFR,2662884,4422147,7085031,3348336,2227648,1322527,679208,345558,284852,8208129,2641632,4418449,7060081,3348872,2239000,1352466,690970,471069,395984,8498361,16706490,30851606,30851606
Kenya,2001,KE,KEN,AFR,2742492,4496575,7239067,3468801,2309574,1393478,708615,360228,289898,8530594,2719619,4492119,7211738,3471201,2318875,1422501,723402,471571,411397,8818947,17349541,31800343,31800343
Kenya,2002,KE,KEN,AFR,2826715,4573057,7399772,3590248,2394858,1463986,740315,378588,294376,8862371,2801899,4567646,7369545,3594364,2402032,1491780,760988,472889,426086,9148139,18010510,32779823,32779823
Kenya,2003,KE,KEN,AFR,2907447,4657372,7564819,3706723,2481669,1533185,773165,400960,298256,9193958,2880853,4650546,7531399,3712187,2486829,1559607,801859,476664,439799,9476945,18670903,33767122,33767122
Kenya,2004,KE,KEN,AFR,2986158,4752650,7738808,3819053,2574753,1604558,807265,427367,302386,9535382,2957943,4743958,7701901,3826023,2578452,1629390,844923,484099,452856,9815743,19351125,34791836,34791836
Kenya,2005,KE,KEN,AFR,3066064,4859457,7925521,3923004,2670856,1677198,851420,447617,307131,9877226,3036033,4848514,7884547,3931246,2673884,1700423,893964,490781,465413,10155711,20032937,35843010,35843010
Kenya,2006,KE,KEN,AFR,3145073,4982062,8127135,4016762,2770593,1750630,906831,461211,312868,10218895,3113257,4968568,8081825,4025973,2774028,1772681,949983,497267,477470,10497402,20716297,36925253,36925253
Kenya,2007,KE,KEN,AFR,3225255,5118440,8343695,4100595,2873748,1823928,964757,477282,319415,10559725,3191666,5102160,8293826,4110602,2878557,1845032,1008696,508439,488221,10839547,21399272,38036793,38036793
Kenya,2008,KE,KEN,AFR,3308931,5263415,8572346,4180374,2981594,1897658,1024561,496128,326999,10907314,3272710,5244242,8516952,4190987,2988606,1918174,1069657,524959,497897,11190280,22097594,39186895,39186895
Kenya,2009,KE,KEN,AFR,3388100,5415699,8803799,4257894,3095021,1972674,1085473,517260,336224,11264546,3348425,5393398,8741823,4268855,3105429,1993751,1132457,546250,507532,11554274,22818820,40364444,40364444
Kenya,2010,KE,KEN,AFR,3447503,5572400,9019903,4326220,3207456,2047472,1148214,542174,351459,11622995,3405621,5547623,8953244,4341325,3219263,2067049,1196476,573752,523893,11921758,23544753,41517895,41517895
Kenya,2011,KE,KEN,AFR,3479014,5731273,9210287,4384346,3316990,2123354,1213514,572427,375033,11985664,3437080,5705702,9142782,4411482,3326666,2136945,1261534,609387,550392,12296406,24282070,42635144,42635144
Kenya,2012,KE,KEN,AFR,3485618,5894707,9380325,4439679,3424742,2201265,1279038,605707,402824,12353255,3444379,5868778,9313157,4482248,3432879,2207013,1326061,650495,580374,12679070,25032325,43725806,43725806
Kenya,2013,KE,KEN,AFR,3472070,6057380,9529450,4501471,3528178,2282058,1344627,640292,433188,12729814,3432250,6030844,9463094,4559788,3536517,2278353,1389605,694155,611595,13070013,25799827,44792368,44792368
Kenya,2014,KE,KEN,AFR,3446376,6210185,9656561,4570711,3623341,2365995,1411533,675692,466200,13113472,3408961,6183525,9592486,4646077,3633519,2351043,1453761,739551,645391,13469342,26582814,45831863,45831863
Kenya,2015,KE,KEN,AFR,3423914,6344010,9767924,4648058,3708105,2452014,1479524,718461,494452,13500614,3389030,6318626,9707656,4742121,3722134,2424395,1518693,789908,678036,13875287,27375901,46851488,46851488
Kenya,2016,KE,KEN,AFR,3419294,6454290,9873584,4748372,3783789,2541478,1546844,768350,517633,13906466,3384330,6429480,9813810,4854462,3807168,2502816,1583095,844143,709122,14300806,28207272,47894670,47894670
Kenya,2017,KE,KEN,AFR,3425348,6542736,9968084,4868453,3850093,2634575,1613214,819191,542521,14328047,3388868,6517887,9906755,4981524,3887682,2586967,1646992,899691,742393,14745249,29073296,48948137,48948137
Kenya,2018,KE,KEN,AFR,3430098,6608935,10039033,4989007,3905502,2729406,1680309,872112,569416,14745752,3394219,6586457,9980676,5115139,3956215,2670113,1710348,957774,778252,15187841,29933593,49953304,49953304
Kenya,2019,KE,KEN,AFR,3441716,6658945,10100661,5123080,3956398,2827174,1746664,923545,594666,15171527,3405120,6637701,10042821,5256841,4024311,2758450,1772690,1013675,810477,15636444,30807971,50951450,50951450
Kenya,2020,KE,KEN,AFR,3461843,6700481,10162324,5281661,4009090,2927111,1810414,972153,617941,15618370,3421062,6677036,10098098,5408873,4101772,2856871,1833986,1066222,839261,16106985,31725355,51985780,51985780
Kenya,2021,KE,KEN,AFR,3478511,6732446,10210957,5449277,4061385,3026121,1872880,1018967,639594,16068224,3434595,6706033,10140628,5567503,4179156,2958497,1895073,1117809,867760,16585798,32654022,53005614,53005614
Kenya,2022,KE,KEN,AFR,3502577,6750255,10252832,5625960,4116250,3124787,1935864,1063193,658663,16524717,3455691,6720046,10175737,5733115,4258362,3064321,1957612,1167221,893574,17074205,33598922,54027487,54027487
Kenya,2023,KE,KEN,AFR,3543595,6754013,10297608,5809678,4183418,3222756,2002504,1107812,680424,17006592,3491756,6719312,10211068,5900634,4348618,3174726,2023689,1216180,921470,17585317,34591909,55100586,55100586
Kenya,2024,KE,KEN,AFR,3590041,6753036,10343077,5985158,4264098,3317006,2074713,1155398,707519,17503892,3534494,6713352,10247846,6060446,4447098,3284408,2094247,1267173,954839,18108211,35612103,56203030,56203030
Kenya,2025,KE,KEN,AFR,3637507,6760025,10397532,6141853,4358892,3404778,2151258,1205420,739358,18001559,3580365,6713801,10294166,6203606,4554308,3391084,2168693,1319898,993094,18630683,36632242,57323930,57323930
Kenya,2026,KE,KEN,AFR,3687464,6779523,10466987,6270712,4472266,3483320,2231936,1256922,774750,18489906,3629326,6726356,10355682,6321610,4674640,3491992,2247418,1373757,1035382,19144799,37634705,58457378,58457378
Kenya,2027,KE,KEN,AFR,3736615,6815600,10552215,6374414,4603223,3552869,2316568,1308890,812685,18968649,3678158,6755101,10433259,6416568,4807139,3587003,2330780,1427875,1080942,19650307,38618956,59604431,59604431
Kenya,2028,KE,KEN,AFR,3782169,6869269,10651438,6457693,4746565,3616362,2404137,1360860,852878,19438495,3724344,6800829,10525173,6492769,4947257,3678337,2418196,1481780,1129475,20147814,39586309,60762923,60762923
Kenya,2029,KE,KEN,AFR,3828078,6934460,10762538,6520832,4900760,3675137,2495003,1413358,894973,19900063,3770761,6858602,10629363,6550204,5094209,3766177,2510573,1536135,1180594,20637892,40537955,61929863,61929863
Kenya,2030,KE,KEN,AFR,3873343,7004660,10878003,6568085,5065347,3732073,2588627,1466791,939188,20360111,3816284,6922399,10738683,6592906,5248198,3852254,2607986,1591275,1234518,21127137,41487248,63103942,63103942
Kenya,1950,KE,KEN,AFR,598455,677293,1275748,512723,376589,254066,171664,137962,173809,1626813,547857,809562,1357419,597210,353493,206461,130921,94786,131202,1514073,3140886,5774050,5774050
Kenya,1951,KE,KEN,AFR,602426,708900,1311326,523178,385741,262622,174531,135454,169005,1650531,559040,820614,1379654,624048,368685,216060,134455,93423,127597,1564268,3214799,5905774,5905774
Kenya,1952,KE,KEN,AFR,607067,746675,1353742,532390,394109,271380,177535,133369,164438,1673221,573990,832668,1406658,649174,384478,226323,137990,92920,124222,1615107,3288328,6048730,6048730
Kenya,1953,KE,KEN,AFR,611853,791154,1403007,539988,401645,279998,180668,131869,160123,1694291,591370,847880,1439250,671120,401050,237074,141562,93498,121098,1665402,3359693,6201950,6201950
Kenya,1954,KE,KEN,AFR,617308,842102,1459410,547182,409746,288258,184388,130984,156189,1716747,610643,868166,1478809,690261,419233,248088,145608,94800,118237,1716227,3432974,6371191,6371191
Kenya,1955,KE,KEN,AFR,637865,884318,1522183,555200,418889,296395,188743,130603,152593,1742423,638048,887614,1525662,707357,439383,259459,150329,96471,115611,1768610,3511033,6558870,6558870
Kenya,1956,KE,KEN,AFR,674121,916426,1590547,565000,428340,304770,193315,130824,149279,1771528,673468,906546,1580014,722522,460723,271370,155486,98559,113195,1821855,3593383,6763941,6763941
Kenya,1957,KE,KEN,AFR,712252,952202,1664454,577442,437918,313015,198671,131812,146312,1805170,710704,932276,1642980,735103,482672,283660,161494,101089,110963,1874981,3680151,6987580,6987580
Kenya,1958,KE,KEN,AFR,751104,992118,1743222,591759,446706,320211,205039,133332,143650,1840697,748789,965584,1714373,743863,504434,295629,168400,103931,108911,1925168,3765865,7223458,7223458
Kenya,1959,KE,KEN,AFR,789494,1035412,1824906,610046,455821,327426,211928,135196,141184,1881601,786528,1005400,1791928,751919,527518,307957,175894,106970,107049,1977307,3858908,7475752,7475752
Kenya,1960,KE,KEN,AFR,827260,1080362,1907622,635344,466515,335782,219276,137419,138942,1933278,823740,1050046,1873786,762559,553034,321504,184068,110076,105509,2036750,3970028,7751435,7751435
Kenya,1961,KE,KEN,AFR,865549,1126668,1992217,667163,477556,344629,227073,139929,136994,1993344,861489,1099690,1961179,774904,579246,335996,192962,113199,104425,2100732,4094076,8047470,8047470
Kenya,1962,KE,KEN,AFR,904932,1174699,2079631,705441,488325,353418,235397,142734,135449,2060764,900302,1155031,2055333,788887,604497,351394,202628,116434,104010,2167850,4228614,8363578,8363578
Kenya,1963,KE,KEN,AFR,945178,1223290,2168468,750735,498402,362155,244016,145892,134420,2135620,939992,1213907,2153899,806560,627451,367914,212966,119873,104440,2239204,4374824,8697200,8697200
Kenya,1964,KE,KEN,AFR,986796,1271132,2257928,802427,508322,371605,252447,149621,133823,2218245,981020,1273812,2254832,829243,648147,386141,223653,123804,105391,2316379,4534624,9047387,9047387
Kenya,1965,KE,KEN,AFR,1030776,1331828,2362604,845969,519247,382141,260813,153867,133532,2295569,1024316,1340375,2364691,851182,667241,406345,234705,128306,106558,2394337,4689906,9417207,9417207
Kenya,1966,KE,KEN,AFR,1075618,1407190,2482808,879476,531558,392893,269364,158291,133679,2365261,1068460,1414609,2483069,872154,684304,427605,246230,133172,108001,2471466,4836727,9802605,9802605
Kenya,1967,KE,KEN,AFR,1119243,1484862,2604105,916041,545780,403392,277646,163323,134342,2440524,1111403,1491176,2602579,899189,698673,449391,258082,138777,109741,2553853,4994377,10201068,10201068
Kenya,1968,KE,KEN,AFR,1161968,1563839,2725807,956258,562370,413936,285334,169298,135358,2522554,1153429,1569151,2722580,933238,710386,472147,270127,145323,111705,2642926,5165480,10613877,10613877
Kenya,1969,KE,KEN,AFR,1204509,1643306,2847815,998868,582055,424626,292955,175642,136602,2610748,1195271,1647694,2842965,972682,720709,496034,282450,152328,113815,2738018,5348766,11039551,11039551
Kenya,2031,KE,KEN,AFR,3916895,7074859,10991754,6604770,5238674,3789803,2683773,1521951,985457,20824428,3859998,6987868,10847866,6624926,5408693,3938165,2709587,1647926,1291129,21620426,42444854,64284466,64284466
Kenya,2032,KE,KEN,AFR,3957017,7151083,11108100,6626261,5419456,3849950,2779744,1579493,1033223,21288127,3900321,7060548,10960869,6641521,5575654,4024249,2815145,1706848,1349750,22113167,43401294,65470260,65470260
Kenya,2033,KE,KEN,AFR,3992000,7237377,11229377,6631080,5600605,3918779,2873520,1639791,1082433,21746208,3935564,7143428,11078992,6642254,5742769,4115518,2921967,1768519,1410329,22601356,44347564,66655944,66655944
Kenya,2034,KE,KEN,AFR,4022345,7328782,11351127,6631083,5773165,3999252,2962299,1703168,1133302,22202269,3966229,7232642,11198871,6637651,5901940,4214017,3027340,1833396,1473081,23087425,45289694,67839692,67839692
Kenya,2035,KE,KEN,AFR,4047467,7420914,11468381,6639157,5927695,4093103,3044846,1769400,1185822,22660023,3991617,7324340,11315957,6639524,6044933,4321006,3129857,1901412,1537884,23574616,46234639,69018977,69018977
Kenya,2036,KE,KEN,AFR,4063958,7514324,11578282,6659735,6055490,4204839,3119280,1839036,1240243,23118623,4008339,7417702,11426041,6653491,6163505,4440888,3227248,1973313,1605056,24063501,47182124,70186445,70186445
Kenya,2037,KE,KEN,AFR,4072653,7603519,11676172,6696658,6158820,4333192,3185760,1912150,1296407,23582987,4017361,7507552,11524913,6683460,6259476,4572507,3319294,2049491,1674392,24558620,48141607,71342689,71342689
Kenya,2038,KE,KEN,AFR,4079316,7684041,11763357,6750919,6242246,4473186,3246884,1987762,1353771,24054768,4024422,7589733,11614155,6730232,6337029,4711485,3408039,2129357,1745232,25061374,49116142,72493659,72493659
Kenya,2039,KE,KEN,AFR,4082442,7760332,11842774,6816503,6306068,4623423,3303946,2066198,1412495,24528633,4027959,7667636,11695595,6788906,6396182,4857105,3493709,2213747,1817768,25567417,50096050,73634414,73634414
Kenya,2040,KE,KEN,AFR,4079764,7830805,11910569,6887016,6354542,4783580,3359659,2147088,1473084,25004969,4025824,7739411,11765235,6853532,6440948,5009614,3577960,2302732,1892412,26077198,51082167,74757978,74757978
Kenya,2041,KE,KEN,AFR,4076193,7891022,11967215,6957550,6392895,4952117,3416428,2229423,1536128,25484541,4022838,7800786,11823624,6919827,6475339,5168528,3662330,2395631,1969787,26591442,52075983,75866827,75866827
Kenya,2042,KE,KEN,AFR,4071510,7940093,12011603,7034023,6416589,5127833,3475751,2312639,1601733,25968568,4018643,7851140,11869783,6993257,6494667,5333812,3747147,2492255,2050075,27111213,53079781,76961167,76961167
Kenya,2043,KE,KEN,AFR,4062173,7982040,12044213,7120374,6424086,5303995,3543246,2394140,1670124,26455965,4009879,7894484,11904363,7076764,6498427,5499364,3837062,2590154,2133541,27635312,54091277,78039853,78039853
Kenya,2044,KE,KEN,AFR,4051364,8015885,12067249,7211727,6426877,5471971,3621501,2471558,1741702,26945336,3999759,7929773,11929532,7166516,6496910,5657281,3933937,2686908,2220797,28162349,55107685,79104471,79104471
Kenya,2045,KE,KEN,AFR,4043516,8038808,12082324,7303749,6437444,5622660,3711984,2543775,1816215,27435827,3992554,7954189,11946743,7258690,6501642,5799493,4038884,2781222,2311786,28691717,56127544,80156601,80156601
Kenya,2046,KE,KEN,AFR,4036928,8052307,12089235,7396981,6460048,5747793,3818780,2609255,1894224,27927081,3986639,7969138,11955777,7352471,6518104,5918009,4156012,2871062,2407264,29222922,57150003,81195005,81195005
Kenya,2047,KE,KEN,AFR,4031307,8056968,12088275,7486025,6498486,5849578,3940715,2668235,1975740,28418779,3981690,7975222,11956912,7442762,6550212,6014624,4284239,2956291,2507426,29755554,58174333,82219527,82219527
Kenya,2048,KE,KEN,AFR,4027131,8054986,12082117,7566486,6553761,5932324,4073186,2722884,2059639,28908280,3978006,7974778,11952784,7525432,6598759,6093340,4419401,3038705,2611256,30286893,59195173,83230070,83230070
Kenya,2049,KE,KEN,AFR,4024161,8048040,12072201,7642726,6619957,5996368,4214947,2774407,2146242,29394647,3975422,7969455,11944877,7603825,6658906,6154177,4560844,3118583,2719594,30815929,60210576,84227657,84227657
Kenya,2050,KE,KEN,AFR,4021202,8038292,12059494,7713174,6690892,6045904,4365804,2825192,2235617,29876583,3972777,7961399,11934176,7676116,6724855,6201119,4708884,3197538,2832976,31341488,61218071,85211739,85211739
Kyrgyzstan,1970,KG,KGZ,EUR,220879,392727,613606,259470,193484,188120,84715,63684,60034,849507,213388,382795,596183,252649,195719,194999,113919,102288,97514,957088,1806595,3016384,3016384
Kyrgyzstan,1971,KG,KGZ,EUR,223699,402707,626406,272877,191091,193519,92558,63097,59781,872923,216056,392347,608403,266781,192594,199255,121128,101266,100103,981127,1854050,3088869,3088869
Kyrgyzstan,1972,KG,KGZ,EUR,227739,410844,638583,284379,188802,197629,102747,62179,59437,895173,219907,400091,619998,279674,188520,203067,130676,99751,102120,1003808,1898981,3157564,3157564
Kyrgyzstan,1973,KG,KGZ,EUR,232383,417000,649383,296921,186096,200645,114199,61097,59091,918049,224356,405898,630254,292717,184652,206313,141544,97994,103872,1027092,1945141,3224775,3224775
Kyrgyzstan,1974,KG,KGZ,EUR,236620,421779,658399,310817,184613,202145,125103,60168,58911,941757,228428,410340,638768,306082,183057,208024,151719,96406,105857,1051145,1992902,3290068,3290068
Kyrgyzstan,1975,KG,KGZ,EUR,240208,425988,666196,323663,186906,202128,134705,59775,58920,966097,231883,414219,646102,318363,185159,208291,160235,95368,108034,1075450,2041547,3353850,3353850
Kyrgyzstan,1976,KG,KGZ,EUR,243449,429994,673443,335396,191342,201958,143089,59748,59165,990698,235014,417900,652914,329389,189435,208489,167139,94662,110368,1099482,2090180,3416536,3416536
Kyrgyzstan,1977,KG,KGZ,EUR,246558,434277,680835,347539,199022,200103,150136,59936,59665,1016401,238033,421848,659881,340859,196904,207097,172224,94254,113053,1124391,2140792,3481509,3481509
Kyrgyzstan,1978,KG,KGZ,EUR,249929,438695,688624,359866,212639,193819,156006,60922,60208,1043460,241328,425950,667278,352579,210176,201405,175920,94811,115780,1150671,2194131,3550021,3550021
Kyrgyzstan,1979,KG,KGZ,EUR,253811,443099,696910,371666,229077,184590,161259,63589,60514,1070695,245111,430054,675165,363818,226115,192777,179303,97191,117870,1177074,2247769,3619838,3619838
Kyrgyzstan,1980,KG,KGZ,EUR,257694,448028,705722,382622,243483,177382,166106,68104,60438,1098135,248895,434702,683597,374286,240311,185713,182792,101531,119112,1203745,2301880,3691209,3691209
Kyrgyzstan,1981,KG,KGZ,EUR,261932,453974,715906,392285,254505,173535,170296,74517,60039,1125177,253031,440371,693402,383521,252028,180937,186132,107916,119485,1230019,2355196,3764503,3764503
Kyrgyzstan,1982,KG,KGZ,EUR,267282,461093,728375,400236,264656,170657,173779,82993,59403,1151724,258241,447187,705428,391065,263557,176076,189418,116459,118853,1255428,2407152,3840959,3840959
Kyrgyzstan,1983,KG,KGZ,EUR,273926,469146,743072,406429,276449,167867,176520,92534,58684,1178483,264745,454926,719671,396892,275903,171891,192370,126191,117794,1281041,2459524,3922269,3922269
Kyrgyzstan,1984,KG,KGZ,EUR,281188,474103,755291,408800,290463,165314,176615,101504,58467,1201163,273110,461567,734677,400406,290358,168983,192700,135896,118270,1306613,2507776,3997749,3997749
Kyrgyzstan,1985,KG,KGZ,EUR,288874,475097,763971,407241,304519,165229,174090,109207,59026,1219312,283280,466893,750173,401149,305889,168700,190276,144598,120781,1331393,2550705,4064852,4064852
Kyrgyzstan,1986,KG,KGZ,EUR,297250,476087,773337,403806,318120,167835,171185,115568,59923,1236437,294271,473104,767375,399922,321333,171703,186976,151642,124055,1355631,2592068,4132785,4132785
Kyrgyzstan,1987,KG,KGZ,EUR,305498,478318,783816,399645,331435,173528,166557,120463,61114,1252742,305242,480654,785896,398333,337143,178702,181115,156762,127955,1380010,2632752,4202467,4202467
Kyrgyzstan,1988,KG,KGZ,EUR,311969,482862,794831,395918,342841,184107,158717,123811,62905,1268299,314869,489944,804813,397369,351776,191479,171512,159485,133071,1404692,2672991,4272633,4272633
Kyrgyzstan,1989,KG,KGZ,EUR,316831,489961,806792,393466,349628,198628,149439,125795,65355,1282311,320825,500310,821135,396876,361987,207986,161547,159131,138037,1425564,2707875,4335803,4335803
Kyrgyzstan,1990,KG,KGZ,EUR,321541,500325,821866,395480,353097,213357,140231,126561,68100,1296826,323129,512571,835700,398759,367657,223988,152423,156781,140728,1440336,2737162,4394734,4394734
Kyrgyzstan,1991,KG,KGZ,EUR,324614,513566,838180,401956,355879,225525,132372,126629,71347,1313708,322700,527262,849962,404149,371379,237257,144107,154906,142444,1454242,2767950,4456094,4456094
Kyrgyzstan,1992,KG,KGZ,EUR,324978,526911,851889,408272,356386,233915,125900,125570,75196,1325239,319656,542552,862208,409552,372152,246635,136987,152558,144039,1461923,2787162,4501260,4501260
Kyrgyzstan,1993,KG,KGZ,EUR,322858,537497,860355,412543,353749,237555,118655,122072,78998,1323572,314743,555866,870609,412875,368651,251076,129139,147279,144081,1453101,2776673,4507633,4507633
Kyrgyzstan,1994,KG,KGZ,EUR,318140,550188,868328,417670,352140,243972,114278,119099,82841,1330000,308354,569525,877879,418415,365211,258311,124498,143227,145029,1454691,2784691,4530895,4530895
Kyrgyzstan,1995,KG,KGZ,EUR,312894,566973,879867,424151,353178,255690,114972,118000,86450,1352441,301966,584933,886899,427233,363939,270921,125367,142054,147735,1477249,2829690,4596456,4596456
Kyrgyzstan,1996,KG,KGZ,EUR,307206,582606,889812,431127,354601,268275,118392,116865,89077,1378337,295229,598361,893590,436610,363603,284401,129609,140686,149932,1504841,2883178,4666585,4666585
Kyrgyzstan,1997,KG,KGZ,EUR,299356,596223,895579,439658,357343,281105,125088,114625,91137,1408956,286865,608846,895711,446769,365432,298419,137999,137853,151676,1538148,2947104,4738386,4738386
Kyrgyzstan,1998,KG,KGZ,EUR,291438,606326,897764,449924,361507,292892,135787,110123,92917,1443150,278897,615429,894326,458229,368727,311734,151008,132568,152916,1575182,3018332,4810412,4810412
Kyrgyzstan,1999,KG,KGZ,EUR,284742,611760,896502,462056,366566,302677,149605,103667,94403,1478974,272397,616797,889194,472096,372608,323214,167254,125577,153488,1614237,3093211,4878911,4878911
Kyrgyzstan,2000,KG,KGZ,EUR,276641,614666,891307,475392,370984,309758,163758,96862,95973,1512727,264954,615033,879987,487765,375793,332086,183498,118259,153768,1651169,3163896,4935182,4935182
Kyrgyzstan,2001,KG,KGZ,EUR,268399,614299,882698,489928,374930,314365,176106,91537,98040,1544906,257578,610165,867743,504386,378928,338341,197506,112127,154820,1686108,3231014,4981444,4981444
Kyrgyzstan,2002,KG,KGZ,EUR,263762,608695,872457,506355,378970,317064,186789,88320,100422,1577920,253564,600020,853584,523231,382612,342193,209638,107967,157037,1722678,3300598,5026641,5026641
Kyrgyzstan,2003,KG,KGZ,EUR,262823,600364,863187,523660,383460,318738,197517,86703,102847,1612925,252739,587101,839840,543327,387340,344140,221820,105635,160058,1762320,3375245,5078276,5078276
Kyrgyzstan,2004,KG,KGZ,EUR,265075,589471,854546,541891,388918,319729,208909,86504,105042,1650993,254648,573546,828194,562553,393870,344201,234686,105051,162944,1803305,3454298,5137040,5137040
Kyrgyzstan,2005,KG,KGZ,EUR,270041,575987,846028,560700,393172,319421,220115,87926,106422,1687756,259162,559466,818628,580131,400215,342173,247204,106450,164529,1840702,3528458,5193114,5193114
Kyrgyzstan,2006,KG,KGZ,EUR,277433,562093,839526,577800,396869,318059,230955,90941,106598,1721222,266099,545476,811575,595068,405915,339665,259301,110133,164375,1874457,3595679,5246785,5246785
Kyrgyzstan,2007,KG,KGZ,EUR,286666,548810,835476,592179,400239,316015,240433,95673,105118,1749657,274933,532987,807920,606222,410359,337402,270131,116399,161199,1901712,3651369,5294766,5294766
Kyrgyzstan,2008,KG,KGZ,EUR,298228,537687,835915,602881,405107,314387,248204,103002,101429,1775010,285887,523156,809043,613435,415700,335675,279557,126189,154888,1925444,3700454,5345415,5345415
Kyrgyzstan,2009,KG,KGZ,EUR,312835,530245,843080,609445,414386,314471,254941,112963,96199,1802405,299456,516714,816170,616349,425887,335286,288339,139273,147297,1952431,3754836,5414085,5414085
Kyrgyzstan,2010,KG,KGZ,EUR,329168,525080,854248,613173,424456,314732,259552,123396,91164,1826473,314893,512636,827529,615559,437683,334961,294844,152639,139835,1975521,3801994,5483774,5483774
Kyrgyzstan,2011,KG,KGZ,EUR,346316,523276,869592,613285,434858,315284,261993,132587,87910,1845917,331342,511889,843231,611026,449704,335358,298728,164263,134523,1993602,3839519,5552336,5552336
Kyrgyzstan,2012,KG,KGZ,EUR,363517,527531,891048,608609,448526,316632,263276,140841,86858,1864742,347689,516638,864327,601812,465194,336944,300918,174622,132349,2011839,3876581,5631950,5631950
Kyrgyzstan,2013,KG,KGZ,EUR,379600,537038,916638,601347,464195,318017,263618,149206,87217,1883600,362785,526097,888882,590203,482837,339026,301292,184921,132166,2030445,3914045,5719560,5719560
Kyrgyzstan,2014,KG,KGZ,EUR,393493,551576,945069,591367,481927,320005,263301,158148,88524,1903272,375639,540049,915688,578018,500696,342390,299902,195775,133606,2050387,3953659,5814417,5814417
Kyrgyzstan,2015,KG,KGZ,EUR,404149,571781,975930,578542,501582,322287,262656,167551,90924,1923542,385291,559173,944464,565000,518493,346718,297365,206911,136553,2071040,3994582,5914980,5914980
Kyrgyzstan,2016,KG,KGZ,EUR,410691,596738,1007429,565016,520755,325697,261905,177165,93900,1944438,391023,582627,973650,551691,535160,351804,295301,218279,140540,2092775,4037213,6018299,6018299
Kyrgyzstan,2017,KG,KGZ,EUR,413629,624380,1038009,551865,537825,331011,261575,186238,97205,1965719,393521,608425,1001946,539350,549078,357746,294609,229427,145379,2115589,4081308,6121261,6121261
Kyrgyzstan,2018,KG,KGZ,EUR,415680,653128,1068808,540641,550678,338243,261702,194002,100993,1986259,395416,635108,1030524,529219,558716,365010,294497,239491,150976,2137909,4124168,6223494,6223494
Kyrgyzstan,2019,KG,KGZ,EUR,416676,681801,1098477,532797,558335,347760,262145,200185,105334,2006556,396514,661666,1058180,522309,562866,375125,294481,248091,157553,2160425,4166981,6323643,6323643
Kyrgyzstan,2020,KG,KGZ,EUR,415190,709634,1124824,527404,564740,360205,263683,204714,109510,2030256,395154,687169,1082323,517954,565040,388846,295727,255201,164699,2187467,4217723,6424874,6424874
Kyrgyzstan,2021,KG,KGZ,EUR,412409,734889,1147298,525606,569053,375457,266677,207733,113633,2058159,392381,710078,1102459,517104,565158,405181,299066,260688,172622,2219819,4277978,6527743,6527743
Kyrgyzstan,2022,KG,KGZ,EUR,408997,756567,1165564,529197,568462,393476,270313,209755,118761,2089964,388907,729518,1118425,521170,560370,424551,303582,264592,182413,2256678,4346642,6630623,6630623
Kyrgyzstan,2023,KG,KGZ,EUR,403083,776757,1179840,537351,565365,413203,274140,211245,125339,2126643,383136,747318,1130454,529320,553256,445818,308775,266961,194284,2298414,4425057,6735347,6735347
Kyrgyzstan,2024,KG,KGZ,EUR,395107,794182,1189289,550330,558940,434338,278447,212495,133691,2168241,375662,762486,1138148,541677,545025,466712,314914,267650,207961,2343939,4512180,6839606,6839606
Kyrgyzstan,2025,KG,KGZ,EUR,388299,805379,1193678,568848,549103,456796,282864,213585,143246,2214442,369410,771762,1141172,559002,535462,487041,321695,267201,222987,2393388,4607830,6942679,6942679
Kyrgyzstan,2026,KG,KGZ,EUR,383031,810569,1193600,592039,537986,478235,288045,214504,153212,2264021,364673,775382,1140055,580558,525082,505724,328871,267047,238733,2446015,4710036,7043698,7043698
Kyrgyzstan,2027,KG,KGZ,EUR,378848,811387,1190235,617944,526728,497628,294994,215812,162908,2316014,360922,775057,1135979,604421,515222,521675,336770,268211,254527,2500826,4816840,7143047,7143047
Kyrgyzstan,2028,KG,KGZ,EUR,375906,809093,1184999,645122,516915,513572,304050,217704,171854,2369217,358233,772057,1130290,629227,507204,534067,346175,270229,269765,2556667,4925884,7241167,7241167
Kyrgyzstan,2029,KG,KGZ,EUR,374169,804263,1178432,672594,509922,525164,315606,220069,179962,2423317,356612,766911,1123523,654128,501901,541810,358571,272641,284148,2613199,5036516,7338473,7338473
Kyrgyzstan,2030,KG,KGZ,EUR,373579,797650,1171229,699585,504528,534149,329230,223087,187276,2477855,356070,760256,1116326,678442,498047,546394,373741,275735,297614,2669973,5147828,7435378,7435378
Kyrgyzstan,1950,KG,KGZ,EUR,108324,165442,273766,178166,86491,85773,79951,74396,63760,568537,100623,161202,261825,175547,110696,117831,100598,67646,74774,647092,1215629,1751225,1751225
Kyrgyzstan,1951,KG,KGZ,EUR,118398,162719,281117,182615,94912,84427,79497,72099,64657,578207,111659,157646,269305,178399,117756,116163,104149,66850,75707,659024,1237231,1787656,1787656
Kyrgyzstan,1952,KG,KGZ,EUR,126457,161401,287858,185845,106241,82675,78862,69619,65635,588877,121485,154497,275982,181011,127424,113996,106857,66097,76804,672189,1261066,1824912,1824912
Kyrgyzstan,1953,KG,KGZ,EUR,134663,160487,295150,187935,119067,80666,78145,67243,66529,599585,130579,152459,283038,183060,138422,111511,108792,65760,77826,685371,1284956,1863141,1863141
Kyrgyzstan,1954,KG,KGZ,EUR,143258,161665,304923,188642,131292,78773,77564,65269,67060,608600,139019,153611,292630,183701,148619,109114,110267,66450,78505,696656,1305256,1902805,1902805
Kyrgyzstan,1955,KG,KGZ,EUR,150164,167578,317742,188151,142086,77544,77143,63812,67155,615891,145783,159403,305186,183246,157085,107313,111441,68292,78800,706177,1322068,1944992,1944992
Kyrgyzstan,1956,KG,KGZ,EUR,155751,176442,332193,188028,151581,76754,76953,62858,66898,623072,151131,168210,319341,183244,163923,105881,112333,71305,78748,715434,1338506,1990046,1990046
Kyrgyzstan,1957,KG,KGZ,EUR,161889,188932,350821,186473,159589,76167,77032,62418,66296,627975,157015,180552,337567,181960,168827,104712,112955,75553,78406,722413,1350388,2038787,2038787
Kyrgyzstan,1958,KG,KGZ,EUR,168935,207596,376531,180354,166119,76559,77110,62298,65472,627912,163773,198782,362555,176408,172113,104545,113127,80432,77857,724482,1352394,2091474,2091474
Kyrgyzstan,1959,KG,KGZ,EUR,176847,229300,406147,171702,172170,79383,76895,62228,64634,627012,171381,219826,391207,168530,175353,106651,112763,85003,77364,725664,1352676,2150037,2150037
Kyrgyzstan,1960,KG,KGZ,EUR,185249,248580,433829,166157,178398,85137,76350,62134,63887,632063,179473,238849,418322,163363,179429,111456,111934,88881,77248,732311,1364374,2216530,2216530
Kyrgyzstan,1961,KG,KGZ,EUR,193746,264028,457774,165127,184526,93916,75581,62029,63176,644355,187654,255094,442748,161628,184105,119081,110728,92117,77406,745065,1389420,2289945,2289945
Kyrgyzstan,1962,KG,KGZ,EUR,201630,278288,479918,165858,190353,105882,74668,61867,62511,661139,195246,270923,466169,160700,189412,129693,109219,94653,77729,761406,1422545,2368626,2368626
Kyrgyzstan,1963,KG,KGZ,EUR,208152,293723,501875,167036,195642,119617,73694,61711,61901,679601,201506,287041,488547,160921,194764,141993,107580,96581,78432,780271,1459872,2450296,2450296
Kyrgyzstan,1964,KG,KGZ,EUR,212974,310473,523447,170059,199783,132997,72955,61720,61371,698885,206112,303410,509522,164071,198977,153755,106145,98178,79710,800836,1499721,2532695,2532695
Kyrgyzstan,1965,KG,KGZ,EUR,216161,326026,542187,177500,202787,145140,72884,61889,60917,721117,209128,318570,527698,171545,202178,163975,105354,99563,81544,824159,1545276,2615167,2615167
Kyrgyzstan,1966,KG,KGZ,EUR,217889,340334,558223,187534,206025,156112,73267,62264,60568,745770,210737,332373,543110,181666,205739,172707,104992,100787,84109,850000,1595770,2697106,2697106
Kyrgyzstan,1967,KG,KGZ,EUR,218572,354541,573113,200812,207667,165706,73889,62890,60377,771341,211334,346071,557405,194942,207858,179619,104932,101844,87398,876593,1647934,2778463,2778463
Kyrgyzstan,1968,KG,KGZ,EUR,218741,368290,587031,219848,204687,174010,75462,63541,60304,797852,211437,359307,570744,213717,205625,185091,105896,102563,91020,903912,1701764,2859536,2859536
Kyrgyzstan,1969,KG,KGZ,EUR,219265,381163,600428,241267,198375,181473,79020,63858,60209,824202,211886,371689,583575,234637,200191,190134,108851,102734,94468,931015,1755217,2939220,2939220
Kyrgyzstan,2031,KG,KGZ,EUR,374291,790652,1164943,724279,502072,539582,344725,227044,193898,2531600,356758,753334,1110092,700573,496778,547557,390651,280231,310065,2725855,5257455,7532492,7532492
Kyrgyzstan,2032,KG,KGZ,EUR,376280,783577,1159857,745709,505287,539746,362433,231252,200014,2584441,358637,746422,1105059,719661,500591,543477,410163,285363,321503,2780758,5365199,7630121,7630121
Kyrgyzstan,2033,KG,KGZ,EUR,379448,774748,1154196,765822,513445,536801,381232,235150,205894,2638344,361646,738005,1099651,737439,508742,536485,431095,290558,332086,2836405,5474749,7728599,7728599
Kyrgyzstan,2034,KG,KGZ,EUR,383636,765091,1148727,783199,526397,530694,401315,239289,211710,2692604,365624,728949,1094573,752601,521095,528417,451647,296564,341845,2892169,5584773,7828069,7828069
Kyrgyzstan,2035,KG,KGZ,EUR,388609,757743,1146352,794381,544833,521328,422616,243459,217688,2744305,370329,722188,1092517,761885,538399,519029,471634,303146,351190,2945283,5689588,7928449,7928449
Kyrgyzstan,2036,KG,KGZ,EUR,394077,753231,1147308,799581,567883,510741,442947,248361,223764,2793277,375500,718170,1093670,765520,559912,508838,490007,310148,361178,2995603,5788880,8029856,8029856
Kyrgyzstan,2037,KG,KGZ,EUR,399799,751076,1150875,800435,593610,500043,461366,254886,229865,2840205,380919,716329,1097248,765219,583727,499166,505709,317912,372144,3043877,5884082,8132208,8132208
Kyrgyzstan,2038,KG,KGZ,EUR,405543,751331,1156874,798186,620592,490760,476547,263321,235793,2885199,386353,716670,1103023,762248,608475,491319,517930,327137,383180,3090289,5975488,8235389,8235389
Kyrgyzstan,2039,KG,KGZ,EUR,411149,753814,1164963,793411,647853,484220,487650,274001,241450,2928585,391650,719043,1110693,757138,633320,486158,525599,339249,393631,3135095,6063680,8339337,8339337
Kyrgyzstan,2040,KG,KGZ,EUR,416330,758223,1174553,786863,674630,479255,496334,286543,247038,2970663,396553,723225,1119778,750518,657575,482438,530199,354021,403754,3178505,6149168,8443502,8443502
Kyrgyzstan,2041,KG,KGZ,EUR,420777,764427,1185204,779929,699120,477173,501705,300795,252914,3011636,400753,729100,1129853,743629,679652,481285,531463,370489,414187,3220705,6232341,8547397,8547397
Kyrgyzstan,2042,KG,KGZ,EUR,424466,772152,1196618,772916,720379,480592,502132,317019,258691,3051729,404233,736413,1140646,736747,698696,485159,527594,389445,424266,3261907,6313636,8650903,8650903
Kyrgyzstan,2043,KG,KGZ,EUR,427237,781078,1208315,764161,740342,488819,499617,334137,264144,3091220,406836,744863,1151699,728368,716440,493335,520882,409713,433652,3302390,6393610,8753624,8753624
Kyrgyzstan,2044,KG,KGZ,EUR,428858,790883,1219741,754584,757604,501719,494173,352399,269908,3130387,408344,754148,1162492,719347,731575,505675,513108,429584,443118,3342407,6472794,8855019,8855019
Kyrgyzstan,2045,KG,KGZ,EUR,429480,801049,1230529,747312,768739,519958,485695,371728,275994,3169426,408889,763760,1172649,712619,740855,522921,504044,448883,452868,3382190,6551616,8954792,8954792
Kyrgyzstan,2046,KG,KGZ,EUR,429332,810976,1240308,742861,773953,542688,476081,390170,282938,3208691,408702,773139,1181841,708626,744510,544341,494191,466623,463795,3422086,6630777,9052936,9052936
Kyrgyzstan,2047,KG,KGZ,EUR,428441,820398,1248839,740757,774876,568018,466400,406938,291413,3248402,407808,782047,1189855,706808,744242,568037,484857,481813,476535,3462292,6710694,9149386,9149386
Kyrgyzstan,2048,KG,KGZ,EUR,426933,828926,1255859,741055,772725,594551,458071,420828,301489,3288719,406320,790088,1196408,707167,741311,592653,477313,493654,490906,3503004,6791723,9243989,9243989
Kyrgyzstan,2049,KG,KGZ,EUR,424978,836170,1261148,743575,768081,621344,452332,431089,313310,3329731,404405,796901,1201306,709559,736248,617361,472404,501146,507594,3544312,6874043,9336496,9336496
Kyrgyzstan,2050,KG,KGZ,EUR,422709,841993,1264702,748013,761688,647648,448126,439247,326694,3371416,402191,802355,1204546,713751,729685,641474,468917,505744,526626,3586197,6957613,9426858,9426858
Cambodia,1970,KH,KHM,WPR,560559,914588,1475147,651930,430946,318602,224254,139769,87988,1853489,544468,905712,1450180,657111,440535,328367,234686,155883,113126,1929708,3783197,6708525,6708525
Cambodia,1971,KH,KHM,WPR,569175,922782,1491957,649730,406676,307900,220820,139104,88877,1813107,552456,913163,1465619,663378,427278,324767,235700,157892,116624,1925639,3738746,6696324,6696324
Cambodia,1972,KH,KHM,WPR,580609,932127,1512736,664136,394671,302943,219818,139626,89813,1811007,563244,921738,1484982,685346,426005,326391,238825,160841,120158,1957566,3768573,6766289,6766289
Cambodia,1973,KH,KHM,WPR,589467,941956,1531423,683052,386858,299299,219327,140428,90777,1819741,571640,930720,1502360,710288,429173,329236,242438,164021,123682,1998838,3818579,6852360,6852360
Cambodia,1974,KH,KHM,WPR,586286,952369,1538655,699622,381810,295042,218522,141100,91651,1827747,568613,940187,1508800,731327,435364,331519,245852,167098,127046,2038206,3865953,6913408,6913408
Cambodia,1975,KH,KHM,WPR,541395,952892,1494287,682445,354535,273865,204827,131268,82169,1729109,525413,939895,1465308,743814,439765,328786,243670,164131,119045,2039211,3768320,6727922,6727922
Cambodia,1976,KH,KHM,WPR,470707,921415,1392122,642971,313470,240269,183361,117065,69608,1566744,459275,916551,1375826,734088,430235,313374,232426,155538,106757,1972418,3539162,6307122,6307122
Cambodia,1977,KH,KHM,WPR,413162,893613,1306775,633738,296742,220972,173359,112766,67301,1504878,405531,898207,1303738,722460,422259,299076,224339,151656,105015,1924805,3429683,6040197,6040197
Cambodia,1978,KH,KHM,WPR,374398,893542,1267940,642327,292272,211116,169442,111920,67811,1494888,366804,898361,1265165,726013,427789,295179,224143,152841,107233,1933198,3428086,5961193,5961193
Cambodia,1979,KH,KHM,WPR,373741,891916,1265657,665417,305096,209303,169176,112807,68788,1530587,364136,895356,1259492,747296,452970,300332,228405,156384,110685,1996072,3526659,6051808,6051808
Cambodia,1980,KH,KHM,WPR,413753,878772,1292525,688562,321273,207789,169438,114425,70771,1572258,400874,880958,1281832,763142,477244,304444,232429,160099,114986,2052344,3624602,6198959,6198959
Cambodia,1981,KH,KHM,WPR,476923,858073,1334996,708479,339486,205413,169380,116088,73124,1611970,460807,858829,1319636,772494,499613,306952,235799,163573,119432,2097863,3709833,6364472,6364472
Cambodia,1982,KH,KHM,WPR,556454,831016,1387470,736893,374042,209229,171810,118852,75548,1686374,537441,830421,1367862,792268,536622,315521,241545,168015,124024,2177995,3864369,6619699,6619699
Cambodia,1983,KH,KHM,WPR,642768,804416,1447184,760605,409770,213377,173874,121434,78096,1757156,620700,802647,1423347,808406,572483,325133,247137,172381,128727,2254267,4011423,6881962,6881962
Cambodia,1984,KH,KHM,WPR,715900,796663,1512563,778133,441809,217920,174977,123612,80795,1817246,691207,793360,1484567,819365,601801,336336,251949,176507,133566,2319524,4136770,7133899,7133899
Cambodia,1985,KH,KHM,WPR,765378,814607,1579985,792482,470587,223086,175241,125454,83614,1870464,738944,809073,1548017,828202,625414,348986,256028,180452,138536,2377618,4248082,7376090,7376090
Cambodia,1986,KH,KHM,WPR,800405,849917,1650322,813675,507102,233406,177030,127970,86606,1945789,772870,841516,1614386,843228,652611,365676,260911,184819,143583,2450828,4396617,7661317,7661317
Cambodia,1987,KH,KHM,WPR,831456,892630,1724086,838355,549168,248465,180115,131071,89860,2037034,803106,880918,1684024,859906,680601,385570,266271,189414,148695,2530457,4567491,7975597,7975597
Cambodia,1988,KH,KHM,WPR,856371,946559,1802930,852635,584855,263400,182238,133713,93325,2110166,827423,931131,1758554,869311,703274,406520,271259,193848,153910,2598122,4708288,8269780,8269780
Cambodia,1989,KH,KHM,WPR,874375,1018013,1892388,856164,620502,282085,184815,136401,96842,2176809,844962,998506,1843468,868667,724844,430362,276660,198416,159310,2658259,4835068,8570928,8570928
Cambodia,1990,KH,KHM,WPR,888844,1105199,1994043,855036,662663,308605,189381,139758,100445,2255888,858961,1081592,1940553,860982,749036,458831,283205,203367,164901,2720322,4976210,8910808,8910808
Cambodia,1991,KH,KHM,WPR,903104,1201068,2104172,846467,703221,339966,194497,143198,104188,2331537,872710,1173982,2046692,846085,771386,490198,290268,208446,170582,2776965,5108502,9259362,9259362
Cambodia,1992,KH,KHM,WPR,917301,1309784,2227085,850415,765462,387981,205385,149010,108182,2466435,886691,1279189,2165880,834265,803699,529675,300182,214604,176390,2858815,5325250,9718215,9718215
Cambodia,1993,KH,KHM,WPR,930792,1421522,2352314,864142,840945,447285,220919,156333,112496,2642120,900244,1387291,2287535,828522,842584,573433,313236,221460,182351,2961586,5603706,10243550,10243550
Cambodia,1994,KH,KHM,WPR,940369,1512058,2452427,864335,886422,494638,233078,161034,116944,2756451,909865,1475221,2385086,823921,866794,609006,327071,227237,188356,3042385,5798836,10636353,10636353
Cambodia,1995,KH,KHM,WPR,941262,1575033,2516295,867292,909185,532505,243060,163721,121431,2837194,910899,1536375,2447274,831751,880844,637810,341840,232125,194396,3118766,5955960,10919528,10919528
Cambodia,1996,KH,KHM,WPR,930821,1623724,2554545,885915,929109,570961,254579,166383,125922,2932869,900810,1583572,2484382,854908,894615,665407,358381,236982,200525,3210818,6143687,11182612,11182612
Cambodia,1997,KH,KHM,WPR,911130,1666532,2577662,913111,946039,609843,268253,169190,130421,3036857,881542,1625180,2506722,885591,907226,691775,377046,241929,206756,3310323,6347180,11431569,11431569
Cambodia,1998,KH,KHM,WPR,853003,1684510,2537513,968643,967790,658723,289017,174041,135025,3193239,826190,1637216,2463406,940106,929774,732823,408317,250737,213160,3474917,6668156,11669077,11669077
Cambodia,1999,KH,KHM,WPR,797150,1687871,2485021,1042352,976653,707012,313383,179502,139700,3358602,772841,1635769,2408610,1010684,940445,772465,442795,260560,219817,3646766,7005368,11899006,11899006
Cambodia,2000,KH,KHM,WPR,781016,1691531,2472547,1115393,960164,742902,337357,183714,144442,3483972,756433,1640787,2397220,1082619,923712,793857,470364,267827,226739,3765118,7249090,12118841,12118841
Cambodia,2001,KH,KHM,WPR,773615,1683204,2456819,1197918,935060,776039,365635,188324,149304,3612280,748253,1634358,2382611,1163945,899229,812911,500683,275674,234048,3886490,7498770,12338192,12338192
Cambodia,2002,KH,KHM,WPR,779426,1660709,2440135,1291312,900383,805856,398170,193401,154301,3743423,752440,1614658,2367098,1256071,866065,829440,533440,284249,241852,4011117,7754540,12561779,12561779
Cambodia,2003,KH,KHM,WPR,785436,1637245,2422681,1386314,864728,832665,433740,199494,159427,3876368,757070,1593372,2350442,1349601,832986,844200,566810,294484,250129,4138210,8014578,12787710,12787710
Cambodia,2004,KH,KHM,WPR,785693,1621264,2406957,1463912,845712,856730,470485,207532,164934,4009305,756719,1578009,2334728,1425776,817107,857730,598303,307425,259043,4265384,8274689,13016371,13016371
Cambodia,2005,KH,KHM,WPR,789054,1604017,2393071,1515789,850141,879299,508116,217517,170723,4141585,759339,1560504,2319843,1476839,824459,871566,628038,322732,268449,4392083,8533668,13246583,13246583
Cambodia,2006,KH,KHM,WPR,794761,1584434,2379195,1552289,869711,899926,546754,229164,176573,4274417,764181,1539962,2304143,1513426,846386,885389,656853,339882,278095,4520031,8794448,13477779,13477779
Cambodia,2007,KH,KHM,WPR,802227,1565798,2368025,1582687,896322,917477,585525,242799,182593,4407403,770750,1519913,2290663,1544612,874751,897867,684303,359101,288071,4648705,9056108,13714791,13714791
Cambodia,2008,KH,KHM,WPR,810626,1547679,2358305,1600814,934186,928498,623880,259135,188861,4535374,777719,1499149,2276868,1565086,912680,905704,710365,380966,298541,4773342,9308716,13943888,13943888
Cambodia,2009,KH,KHM,WPR,818580,1531927,2350507,1600555,986924,927587,661331,278939,195522,4650858,783950,1480648,2264598,1571945,965042,902523,734772,405729,309766,4889777,9540635,14155740,14155740
Cambodia,2010,KH,KHM,WPR,825559,1524117,2349676,1586317,1052136,914955,696845,302460,202491,4755204,789609,1470532,2260141,1567802,1031033,888049,756868,433102,321656,4998510,9753714,14363532,14363532
Cambodia,2011,KH,KHM,WPR,831342,1527405,2358747,1563197,1124533,894029,729565,329788,209749,4850861,794446,1470598,2265044,1554116,1105373,865994,776536,462958,334254,5099231,9950092,14573885,14573885
Cambodia,2012,KH,KHM,WPR,836250,1544839,2381089,1527972,1204985,863878,759133,360998,217506,4934472,798681,1483609,2282290,1528208,1188967,835251,793593,495044,347724,5188787,10123259,14786640,14786640
Cambodia,2013,KH,KHM,WPR,840737,1563057,2403794,1493174,1285067,832664,785842,394870,226103,5017720,802593,1497532,2300125,1501474,1273100,804387,808756,527579,362753,5278049,10295769,14999683,14999683
Cambodia,2014,KH,KHM,WPR,845432,1574621,2420053,1466783,1346294,817126,809915,429729,236445,5106292,806622,1505747,2312369,1481183,1339422,789985,822636,558345,380530,5372101,10478393,15210817,15210817
Cambodia,2015,KH,KHM,WPR,849866,1587450,2437316,1440298,1381165,823834,832692,465276,248551,5191816,810335,1515271,2325606,1459514,1380635,797983,836762,587322,400565,5462781,10654597,15417523,15417523
Cambodia,2016,KH,KHM,WPR,852936,1601196,2454132,1415845,1400593,844352,853641,501414,261921,5277766,812959,1525854,2338813,1437537,1407996,819912,850900,615271,422262,5553878,10831644,15624584,15624584
Cambodia,2017,KH,KHM,WPR,853077,1615439,2468516,1395839,1413095,870537,871803,537541,277012,5365827,812866,1537078,2349944,1417831,1429713,847351,863794,641871,445832,5646392,11012219,15830689,15830689
Cambodia,2018,KH,KHM,WPR,849779,1629852,2479631,1376164,1416961,907021,884250,572745,294231,5451372,809282,1548612,2357894,1398200,1443384,884676,872317,666407,471352,5736336,11187708,16025238,16025238
Cambodia,2019,KH,KHM,WPR,843511,1643723,2487234,1357948,1412101,958493,884792,606796,313901,5534031,802738,1559894,2362632,1379991,1448530,936999,870070,689222,499039,5823851,11357882,16207746,16207746
Cambodia,2020,KH,KHM,WPR,835370,1656724,2492094,1354601,1399076,1022078,873065,638718,335897,5623435,794957,1570606,2365563,1372832,1445470,1002258,856514,710050,528645,5915769,11539204,16396860,16396860
Cambodia,2021,KH,KHM,WPR,826089,1667524,2493613,1373741,1377067,1090422,852073,666305,358848,5718456,786975,1579886,2366861,1381635,1433109,1074254,834769,727445,558888,6010100,11728556,16589023,16589023
Cambodia,2022,KH,KHM,WPR,816346,1673386,2489732,1408944,1342603,1164009,821006,689890,383348,5809800,778731,1585603,2364334,1404617,1409078,1154205,804076,741836,590169,6103981,11913781,16767842,16767842
Cambodia,2023,KH,KHM,WPR,806766,1674316,2481082,1443332,1310243,1236327,789291,712007,412282,5903482,770354,1587625,2357979,1428376,1386200,1234685,773595,755229,624205,6202290,12105772,16944826,16944826
Cambodia,2024,KH,KHM,WPR,797543,1672001,2469544,1470275,1289521,1290402,773060,732682,444952,6000892,761943,1587219,2349162,1445704,1371564,1297843,759329,767918,659886,6302244,12303136,17121847,17121847
Cambodia,2025,KH,KHM,WPR,788826,1667323,2456149,1496855,1272214,1319107,778081,752049,479073,6097379,753779,1584997,2338776,1463404,1357559,1336830,766967,780861,695608,6401229,12498608,17293532,17293532
Cambodia,2026,KH,KHM,WPR,780850,1660324,2441174,1522148,1257232,1332718,796447,769849,514341,6192735,746318,1580681,2326999,1480698,1343120,1362119,788159,793790,731284,6499170,12691905,17460074,17460074
Cambodia,2027,KH,KHM,WPR,773609,1650177,2423786,1545678,1247144,1339467,820120,785063,550411,6287883,739551,1573311,2312862,1497293,1330947,1381858,814648,805508,766864,6597118,12885001,17621659,17621659
Cambodia,2028,KH,KHM,WPR,767628,1636842,2404470,1567519,1241850,1338679,853160,794824,586727,6382759,733920,1562789,2296709,1513435,1321286,1394700,850602,813049,802071,6695143,13077902,17779074,17779074
Cambodia,2029,KH,KHM,WPR,763460,1621123,2384583,1586910,1241928,1330782,899875,793548,623523,6476566,730001,1549763,2279764,1528546,1315109,1400365,900823,810367,837362,6792572,13269138,17933485,17933485
Cambodia,2030,KH,KHM,WPR,760321,1604218,2364539,1602725,1250730,1314908,957869,781326,660995,6568553,727052,1535298,2262350,1541534,1316138,1397518,963358,797203,873055,6888806,13457359,18084248,18084248
Cambodia,1950,KH,KHM,WPR,381904,558953,940857,425997,313047,222008,148514,88375,51839,1249780,374907,549995,924902,418403,308122,220848,153892,98496,65079,1264840,2514620,4380380,4380380
Cambodia,1951,KH,KHM,WPR,396429,569197,965626,434889,319835,227071,151970,90607,52725,1277097,389678,560283,949961,427531,315129,225588,157371,100795,66299,1292713,2569810,4485391,4485391
Cambodia,1952,KH,KHM,WPR,411753,579421,991174,443991,326613,232212,155446,92799,53862,1304923,404977,570771,975748,436775,322195,230424,160896,103057,67687,1321034,2625957,4592875,4592875
Cambodia,1953,KH,KHM,WPR,427144,590652,1017796,453001,333144,237291,158904,94976,55155,1332471,419870,582707,1002577,445858,329105,235267,164441,105324,69226,1349221,2681692,4702061,4702061
Cambodia,1954,KH,KHM,WPR,440451,605486,1045937,461847,339571,242362,162407,97230,56532,1359949,432544,598345,1030889,454769,336009,240198,168023,107694,70916,1377609,2737558,4814378,4814378
Cambodia,1955,KH,KHM,WPR,452530,623436,1075966,470631,346103,247537,166025,99601,57983,1387880,444119,616814,1060933,463577,343060,245276,171656,110182,72697,1406448,2794328,4931224,4931224
Cambodia,1956,KH,KHM,WPR,465341,642363,1107704,479304,352682,252739,169717,102047,59481,1415970,456408,636222,1092630,472259,350182,250456,175317,112757,74569,1435540,2851510,5051841,5051841
Cambodia,1957,KH,KHM,WPR,478571,662326,1140897,487910,359298,257934,173479,104569,61013,1444203,469114,656670,1125784,480901,357371,255762,179025,115441,76576,1465076,2909279,5175949,5175949
Cambodia,1958,KH,KHM,WPR,490261,683431,1173692,496293,365641,262973,177242,107122,62601,1471872,480338,678253,1158591,489319,364278,261030,182728,118198,78706,1494259,2966131,5298409,5298409
Cambodia,1959,KH,KHM,WPR,499125,705785,1204910,504986,372137,268082,181087,109692,64255,1500239,488791,701023,1189814,498075,371291,266426,186516,121008,80875,1524191,3024430,5419152,5419152
Cambodia,1960,KH,KHM,WPR,505326,729686,1235012,514469,379259,273524,185142,112330,66027,1530751,494591,725155,1219746,507671,378850,272168,190496,123886,83093,1556164,3086915,5541676,5541676
Cambodia,1961,KH,KHM,WPR,509045,755090,1264135,524229,386749,279099,189335,115013,67900,1562325,497900,750700,1248600,517705,386758,278158,194655,126868,85450,1589594,3151919,5664654,5664654
Cambodia,1962,KH,KHM,WPR,510789,781871,1292660,534107,394721,284811,193656,117752,69855,1594902,499191,777454,1276645,528172,395144,284408,199011,129969,87944,1624648,3219550,5788854,5788854
Cambodia,1963,KH,KHM,WPR,511768,807859,1319627,545022,403006,290647,198112,120583,71936,1629306,499712,802965,1302677,540090,403819,290863,203541,133175,90582,1662070,3291376,5913680,5913680
Cambodia,1964,KH,KHM,WPR,514411,829685,1344096,559184,411263,296529,202652,123511,74126,1667265,501873,824229,1326102,555334,412462,297468,208231,136470,93417,1703382,3370647,6040847,6040847
Cambodia,1965,KH,KHM,WPR,519593,847890,1367483,575963,419201,302370,207223,126523,76397,1707677,506527,841986,1348513,572954,420767,304100,213021,139818,96394,1747054,3454731,6170727,6170727
Cambodia,1966,KH,KHM,WPR,526372,864455,1390827,593062,426372,307964,211731,129583,78781,1747493,512758,858024,1370782,590818,428268,310529,217817,143180,99515,1790127,3537620,6299230,6299230
Cambodia,1967,KH,KHM,WPR,534295,879528,1413823,610624,432807,313309,216135,132677,81246,1786798,520084,872549,1392633,609205,435173,316808,222642,146567,102793,1833188,3619986,6426445,6426445
Cambodia,1968,KH,KHM,WPR,543446,892674,1436120,629055,438802,318477,220444,135786,83737,1826301,528598,885129,1413727,628548,441784,322980,227516,149976,106153,1876957,3703258,6553109,6553109
Cambodia,1969,KH,KHM,WPR,552520,904873,1457393,648654,444633,323539,224722,138936,86255,1866739,537059,896694,1433753,649015,448251,329047,232453,153447,109608,1921821,3788560,6679708,6679708
Cambodia,2031,KH,KHM,WPR,758152,1587235,2345387,1614192,1270786,1290623,1021543,761976,698560,6657680,725009,1520472,2245481,1551528,1327131,1385421,1033122,777093,908555,6982850,13640530,18231391,18231391
Cambodia,2032,KH,KHM,WPR,757005,1570763,2327768,1620380,1304511,1256575,1091670,734530,735794,6743460,723931,1505867,2229798,1557527,1350561,1362495,1111133,748988,943521,7074225,13817685,18375249,18375249
Cambodia,2033,KH,KHM,WPR,756326,1555640,2311966,1621698,1338632,1225699,1160812,706318,772328,6825487,723283,1492188,2215471,1559803,1374413,1340408,1189397,720907,977687,7162615,13988102,18515538,18515538
Cambodia,2034,KH,KHM,WPR,755900,1542645,2298545,1619721,1365387,1206013,1212417,692300,807675,6903513,722865,1480146,2203011,1559652,1391899,1326422,1250895,708265,1010696,7247829,14151342,18652904,18652904
Cambodia,2035,KH,KHM,WPR,755961,1531157,2287118,1615389,1391757,1189615,1240013,698393,842699,6977866,722906,1469295,2192201,1557669,1409715,1313021,1289103,716742,1043770,7330020,14307886,18787213,18787213
Cambodia,2036,KH,KHM,WPR,755899,1521347,2277246,1608738,1416846,1175465,1253352,717104,876953,7048458,722813,1460028,2182841,1553585,1427106,1299175,1314113,738294,1076616,7408889,14457347,18917434,18917434
Cambodia,2037,KH,KHM,WPR,755639,1513274,2268913,1598970,1440200,1166064,1260152,740786,909308,7115480,722532,1452398,2174930,1546445,1443778,1287543,1333739,764929,1108140,7484574,14600054,19043897,19043897
Cambodia,2038,KH,KHM,WPR,755067,1506900,2261967,1586046,1461888,1161310,1259785,773026,936852,7178907,721971,1446312,2168283,1536152,1459979,1278364,1346676,800508,1135410,7557089,14735996,19166243,19166243
Cambodia,2039,KH,KHM,WPR,753371,1502564,2255935,1570762,1481161,1161773,1252656,817455,954965,7238772,720339,1442139,2162478,1523360,1475145,1272605,1352642,849356,1153316,7626424,14865196,19283610,19283610
Cambodia,2040,KH,KHM,WPR,750808,1499725,2250533,1554304,1496941,1170708,1237892,871770,963954,7295569,717872,1439392,2157264,1509130,1488204,1273924,1350315,909551,1161942,7693066,14988635,19396431,19396431
Cambodia,2041,KH,KHM,WPR,747911,1497721,2245632,1537770,1508468,1190560,1215026,930842,966798,7349464,715078,1437402,2152480,1494543,1498296,1285033,1338937,976300,1164086,7757195,15106659,19504774,19504774
Cambodia,2042,KH,KHM,WPR,744467,1496531,2240998,1521741,1514838,1223679,1182739,995256,962401,7400654,711744,1436178,2147922,1480164,1504436,1308359,1316965,1050469,1158538,7818931,15219585,19608512,19608512
Cambodia,2043,KH,KHM,WPR,740585,1495489,2236074,1507043,1516439,1257189,1153565,1058377,957053,7449666,707968,1435102,2143070,1466708,1506887,1332095,1295848,1124645,1152561,7878744,15328410,19707547,19707547
Cambodia,2044,KH,KHM,WPR,736370,1493580,2229950,1494445,1514821,1283569,1135207,1105521,963567,7497130,703863,1433183,2137046,1454870,1506933,1349583,1282672,1183063,1160125,7937246,15434376,19801361,19801361
Cambodia,2045,KH,KHM,WPR,731624,1491289,2222913,1483332,1510894,1309572,1120015,1131089,987865,7542767,699245,1430883,2130128,1444215,1505159,1367392,1270069,1219748,1187574,7994157,15536924,19889964,19889964
Cambodia,2046,KH,KHM,WPR,726414,1488540,2214954,1473879,1504693,1334327,1107027,1143895,1022895,7586716,694187,1428113,2122300,1435133,1501299,1384767,1257052,1244163,1227208,8049622,15636338,19973587,19973587
Cambodia,2047,KH,KHM,WPR,720855,1485046,2205901,1466133,1495438,1357402,1098641,1150743,1060943,7629300,688795,1424618,2113413,1427673,1494409,1401447,1246221,1263498,1270653,8103901,15733201,20052513,20052513
Cambodia,2048,KH,KHM,WPR,714747,1480803,2195550,1460065,1483091,1378863,1094760,1151109,1102613,7670501,682901,1420394,2103295,1421744,1484395,1417659,1237805,1276546,1318775,8156924,15827425,20126275,20126275
Cambodia,2049,KH,KHM,WPR,708200,1475114,2183314,1456011,1468426,1397975,1095921,1145353,1147095,7710781,676587,1414775,2091362,1417721,1471904,1432849,1232732,1283017,1370875,8209098,15919879,20194550,20194550
Cambodia,2050,KH,KHM,WPR,701708,1468031,2169739,1453434,1452614,1413691,1105201,1132567,1192685,7750192,670316,1407808,2078124,1415103,1457984,1445961,1234546,1281579,1425217,8260390,16010582,20258435,20258435
Kiribati,1970,KI,KIR,WPR,5029,8175,13204,5018,3248,2721,1944,1244,1072,15247,4711,7813,12524,5286,3508,2715,2079,1462,1418,16468,31715,57437,57437
Kiribati,1971,KI,KIR,WPR,5009,8417,13426,5135,3316,2750,2002,1264,1062,15529,4716,8019,12735,5469,3573,2771,2123,1485,1427,16848,32377,58535,58535
Kiribati,1972,KI,KIR,WPR,4958,8676,13634,5228,3405,2776,2073,1286,1048,15816,4693,8240,12933,5644,3637,2821,2175,1516,1432,17225,33041,59606,59606
Kiribati,1973,KI,KIR,WPR,4876,8920,13796,5321,3500,2800,2137,1320,1026,16104,4633,8438,13071,5814,3715,2873,2237,1548,1434,17621,33725,60598,60598
Kiribati,1974,KI,KIR,WPR,4751,8999,13750,5458,3575,2795,2155,1346,1005,16334,4519,8500,13019,5944,3776,2881,2259,1573,1421,17854,34188,60953,60953
Kiribati,1975,KI,KIR,WPR,4614,8904,13518,5617,3634,2751,2130,1351,992,16475,4383,8412,12795,6033,3810,2853,2237,1573,1382,17888,34363,60675,60675
Kiribati,1976,KI,KIR,WPR,4520,8757,13277,5749,3688,2705,2129,1340,972,16583,4290,8269,12559,6108,3845,2825,2220,1563,1335,17896,34479,60310,60310
Kiribati,1977,KI,KIR,WPR,4476,8576,13052,5852,3743,2659,2131,1319,945,16649,4240,8083,12323,6167,3877,2797,2210,1536,1288,17875,34524,59894,59894
Kiribati,1978,KI,KIR,WPR,4470,8351,12821,5949,3789,2635,2132,1296,904,16705,4235,7861,12096,6236,3907,2778,2194,1504,1232,17851,34556,59465,59465
Kiribati,1979,KI,KIR,WPR,4543,8159,12702,6150,3869,2662,2134,1286,893,16994,4301,7704,12005,6377,4003,2791,2182,1499,1226,18078,35072,59775,59775
Kiribati,1980,KI,KIR,WPR,4678,8022,12700,6437,3987,2738,2133,1293,911,17499,4429,7622,12051,6596,4170,2834,2179,1524,1253,18556,36055,60813,60813
Kiribati,1981,KI,KIR,WPR,4823,7900,12723,6698,4109,2822,2135,1304,929,17997,4570,7538,12108,6810,4332,2887,2182,1553,1278,19042,37039,61875,61875
Kiribati,1982,KI,KIR,WPR,4980,7797,12777,6935,4241,2908,2130,1319,939,18472,4723,7475,12198,7007,4495,2945,2189,1581,1308,19525,37997,62977,62977
Kiribati,1983,KI,KIR,WPR,5145,7735,12880,7114,4384,3002,2128,1338,959,18925,4882,7445,12327,7167,4662,3017,2203,1613,1331,19993,38918,64121,64121
Kiribati,1984,KI,KIR,WPR,5296,7761,13057,7237,4540,3095,2135,1362,977,19346,5028,7487,12515,7274,4825,3101,2230,1645,1349,20424,39770,65338,65338
Kiribati,1985,KI,KIR,WPR,5452,7875,13327,7310,4704,3196,2150,1398,996,19754,5177,7604,12781,7341,4991,3205,2263,1677,1373,20850,40604,66708,66708
Kiribati,1986,KI,KIR,WPR,5630,8069,13699,7348,4867,3291,2184,1443,1011,20144,5345,7783,13128,7382,5180,3315,2319,1710,1385,21291,41435,68266,68266
Kiribati,1987,KI,KIR,WPR,5796,8337,14133,7363,5033,3370,2239,1491,1022,20518,5513,8032,13545,7398,5392,3433,2386,1739,1399,21747,42265,69946,69946
Kiribati,1988,KI,KIR,WPR,5953,8646,14599,7346,5226,3453,2302,1532,1030,20889,5666,8325,13991,7379,5619,3556,2456,1764,1420,22194,43083,71680,71680
Kiribati,1989,KI,KIR,WPR,6093,8976,15069,7300,5442,3540,2368,1566,1043,21259,5802,8654,14456,7330,5868,3697,2525,1782,1445,22647,43906,73436,73436
Kiribati,1990,KI,KIR,WPR,6205,9313,15518,7231,5668,3619,2444,1588,1042,21592,5916,9000,14916,7265,6136,3838,2597,1798,1462,23096,44688,75124,75124
Kiribati,1991,KI,KIR,WPR,6308,9642,15950,7129,5887,3694,2509,1596,1052,21867,6006,9328,15334,7180,6375,3966,2650,1806,1483,23460,45327,76612,76612
Kiribati,1992,KI,KIR,WPR,6405,9961,16366,7023,6080,3791,2553,1581,1068,22096,6073,9627,15700,7087,6556,4088,2688,1807,1516,23742,45838,77901,77901
Kiribati,1993,KI,KIR,WPR,6469,10273,16742,6947,6224,3891,2592,1572,1087,22313,6119,9905,16024,7017,6704,4216,2716,1818,1545,24016,46329,79093,79093
Kiribati,1994,KI,KIR,WPR,6510,10559,17069,6949,6314,4000,2628,1566,1115,22572,6146,10149,16295,7018,6809,4348,2748,1843,1567,24333,46905,80264,80264
Kiribati,1995,KI,KIR,WPR,6534,10829,17363,7040,6348,4118,2672,1565,1148,22891,6163,10369,16532,7094,6874,4487,2789,1877,1590,24711,47602,81481,81481
Kiribati,1996,KI,KIR,WPR,6550,11090,17640,7194,6340,4252,2727,1574,1163,23250,6184,10593,16777,7239,6897,4654,2847,1913,1611,25161,48411,82832,82832
Kiribati,1997,KI,KIR,WPR,6569,11324,17893,7416,6295,4404,2795,1601,1169,23680,6212,10799,17011,7460,6895,4843,2932,1953,1643,25726,49406,84308,84308
Kiribati,1998,KI,KIR,WPR,6590,11532,18122,7681,6222,4575,2864,1632,1165,24139,6239,10975,17214,7727,6864,5044,3026,1991,1672,26324,50463,85805,85805
Kiribati,1999,KI,KIR,WPR,6607,11711,18318,7970,6127,4765,2940,1673,1157,24632,6258,11123,17381,8026,6805,5251,3140,2026,1704,26952,51584,87289,87289
Kiribati,2000,KI,KIR,WPR,6614,11865,18479,8297,6030,4973,3027,1724,1149,25200,6270,11252,17522,8357,6734,5468,3267,2063,1735,27624,52824,88826,88826
Kiribati,2001,KI,KIR,WPR,6640,12019,18659,8666,5961,5185,3095,1758,1151,25816,6310,11423,17733,8729,6682,5655,3393,2087,1780,28326,54142,90531,90531
Kiribati,2002,KI,KIR,WPR,6655,12189,18844,9072,5931,5387,3166,1788,1161,26505,6339,11630,17969,9126,6665,5823,3523,2109,1838,29084,55589,92400,92400
Kiribati,2003,KI,KIR,WPR,6630,12358,18988,9480,5943,5571,3271,1835,1184,27284,6311,11828,18139,9506,6670,5995,3674,2153,1888,29886,57170,94302,94302
Kiribati,2004,KI,KIR,WPR,6617,12518,19135,9852,6032,5707,3385,1881,1217,28074,6295,12026,18321,9849,6739,6125,3829,2209,1941,30692,58766,96224,96224
Kiribati,2005,KI,KIR,WPR,6657,12655,19312,10187,6194,5782,3487,1916,1245,28811,6338,12225,18563,10164,6874,6201,3972,2264,1999,31474,60285,98164,98164
Kiribati,2006,KI,KIR,WPR,6722,12730,19452,10506,6403,5822,3618,1958,1278,29585,6397,12343,18740,10460,7072,6265,4129,2327,2057,32310,61895,100083,100083
Kiribati,2007,KI,KIR,WPR,6818,12744,19562,10791,6670,5833,3781,2009,1318,30402,6487,12349,18836,10723,7328,6338,4295,2407,2102,33193,63595,101998,101998
Kiribati,2008,KI,KIR,WPR,7001,12716,19717,11035,6975,5819,3957,2063,1353,31202,6664,12307,18971,10947,7630,6387,4471,2492,2145,34072,65274,103966,103966
Kiribati,2009,KI,KIR,WPR,7227,12669,19896,11238,7317,5783,4155,2120,1387,32000,6879,12243,19122,11152,7967,6415,4668,2582,2189,34973,66973,105996,105996
Kiribati,2010,KI,KIR,WPR,7457,12605,20062,11408,7689,5732,4359,2174,1411,32773,7104,12151,19255,11344,8339,6426,4882,2672,2236,35899,68672,107995,107995
Kiribati,2011,KI,KIR,WPR,7713,12532,20245,11531,8036,5674,4572,2226,1428,33467,7341,12089,19430,11508,8685,6417,5093,2762,2265,36730,70197,109871,109871
Kiribati,2012,KI,KIR,WPR,7963,12494,20457,11610,8334,5620,4775,2285,1430,34054,7553,12104,19657,11638,8989,6395,5279,2859,2294,37454,71508,111618,111618
Kiribati,2013,KI,KIR,WPR,8151,12518,20669,11672,8613,5593,4938,2357,1443,34616,7702,12182,19884,11745,9280,6391,5441,2954,2335,38146,72762,113311,113311
Kiribati,2014,KI,KIR,WPR,8278,12620,20898,11703,8850,5633,5058,2438,1457,35139,7801,12333,20134,11815,9541,6439,5569,3049,2394,38807,73946,114985,114985
Kiribati,2015,KI,KIR,WPR,8354,12820,21174,11700,9064,5741,5131,2534,1487,35657,7861,12564,20425,11849,9781,6543,5653,3160,2465,39451,75108,116707,116707
Kiribati,2016,KI,KIR,WPR,8386,13126,21512,11653,9275,5893,5162,2651,1522,36156,7892,12881,20773,11836,10012,6689,5703,3276,2546,40062,76218,118513,118513
Kiribati,2017,KI,KIR,WPR,8407,13498,21905,11561,9460,6097,5160,2787,1572,36637,7908,13253,21161,11774,10228,6891,5715,3405,2643,40656,77293,120362,120362
Kiribati,2018,KI,KIR,WPR,8442,13917,22359,11442,9611,6341,5130,2942,1615,37081,7944,13657,21601,11684,10410,7130,5706,3548,2743,41221,78302,122261,122261
Kiribati,2019,KI,KIR,WPR,8491,14344,22835,11324,9747,6620,5081,3118,1665,37555,7987,14049,22036,11604,10576,7406,5683,3704,2843,41816,79371,124241,124241
Kiribati,2020,KI,KIR,WPR,8543,14777,23320,11273,9882,6941,5031,3326,1722,38175,8036,14416,22452,11557,10737,7717,5673,3892,2940,42516,80691,126463,126463
Kiribati,2021,KI,KIR,WPR,8589,15202,23791,11274,10045,7278,4994,3556,1789,38936,8079,14749,22828,11554,10902,8052,5679,4104,3035,43326,82262,128874,128874
Kiribati,2022,KI,KIR,WPR,8619,15590,24209,11313,10199,7601,4973,3785,1868,39739,8112,15028,23140,11577,11041,8373,5703,4324,3134,44152,83891,131232,131232
Kiribati,2023,KI,KIR,WPR,8628,15931,24559,11413,10339,7903,4974,3989,1964,40582,8121,15262,23383,11646,11134,8682,5744,4533,3241,44980,85562,133515,133515
Kiribati,2024,KI,KIR,WPR,8618,16211,24829,11596,10460,8163,5045,4149,2085,41498,8117,15449,23566,11795,11194,8962,5835,4715,3368,45869,87367,135763,135763
Kiribati,2025,KI,KIR,WPR,8604,16417,25021,11879,10543,8392,5174,4266,2222,42476,8109,15591,23700,12030,11205,9213,5977,4856,3511,46792,89268,137984,137984
Kiribati,2026,KI,KIR,WPR,8588,16565,25153,12259,10571,8617,5341,4336,2371,43495,8095,15694,23789,12349,11167,9453,6156,4954,3667,47746,91241,140179,140179
Kiribati,2027,KI,KIR,WPR,8567,16675,25242,12720,10551,8812,5559,4373,2543,44558,8080,15769,23849,12735,11075,9664,6380,5018,3840,48712,93270,142356,142356
Kiribati,2028,KI,KIR,WPR,8549,16757,25306,13234,10494,8971,5813,4381,2724,45617,8065,15829,23894,13157,10956,9845,6646,5059,4019,49682,95299,144502,144502
Kiribati,2029,KI,KIR,WPR,8536,16821,25357,13755,10434,9109,6097,4362,2921,46678,8054,15877,23931,13575,10841,9999,6936,5085,4219,50655,97333,146625,146625
Kiribati,2030,KI,KIR,WPR,8526,16866,25392,14250,10396,9232,6405,4331,3129,47743,8045,15915,23960,13955,10755,10133,7246,5100,4431,51620,99363,148720,148720
Kiribati,1950,KI,KIR,WPR,3042,3888,6930,3268,2526,1892,1484,1078,1174,11422,3009,4203,7212,3352,2522,2081,1613,1200,1518,12286,23708,37846,37846
Kiribati,1951,KI,KIR,WPR,3212,4032,7244,3279,2595,1916,1510,1062,1150,11512,3137,4328,7465,3399,2575,2104,1648,1181,1493,12400,23912,38621,38621
Kiribati,1952,KI,KIR,WPR,3372,4199,7571,3288,2665,1943,1532,1048,1133,11609,3255,4467,7722,3445,2634,2126,1680,1172,1466,12523,24132,39419,39419
Kiribati,1953,KI,KIR,WPR,3503,4402,7905,3300,2733,1971,1549,1047,1113,11713,3356,4633,7989,3489,2697,2142,1706,1173,1436,12643,24356,40250,40250
Kiribati,1954,KI,KIR,WPR,3599,4644,8243,3319,2799,2002,1558,1055,1089,11822,3437,4824,8261,3540,2764,2155,1726,1186,1413,12784,24606,41112,41112
Kiribati,1955,KI,KIR,WPR,3680,4907,8587,3347,2861,2037,1565,1066,1074,11950,3515,5020,8535,3597,2836,2170,1743,1205,1387,12938,24888,42008,42008
Kiribati,1956,KI,KIR,WPR,3760,5171,8931,3385,2918,2080,1573,1084,1058,12098,3589,5219,8808,3659,2903,2185,1766,1229,1363,13105,25203,42940,42940
Kiribati,1957,KI,KIR,WPR,3842,5435,9277,3438,2964,2126,1587,1102,1038,12255,3668,5421,9089,3729,2969,2206,1789,1250,1342,13285,25540,43906,43906
Kiribati,1958,KI,KIR,WPR,3934,5697,9631,3513,2997,2176,1599,1119,1016,12420,3753,5624,9377,3810,3028,2232,1812,1280,1315,13477,25897,44912,44912
Kiribati,1959,KI,KIR,WPR,4032,5955,9987,3607,3026,2233,1618,1142,998,12624,3848,5826,9674,3906,3083,2268,1833,1307,1290,13687,26311,45972,45972
Kiribati,1960,KI,KIR,WPR,4141,6208,10349,3723,3043,2295,1637,1163,987,12848,3951,6026,9977,4014,3129,2310,1858,1339,1275,13925,26773,47093,47093
Kiribati,1961,KI,KIR,WPR,4269,6448,10717,3862,3056,2361,1660,1182,976,13097,4070,6221,10291,4136,3175,2361,1878,1365,1256,14171,27268,48275,48275
Kiribati,1962,KI,KIR,WPR,4399,6680,11079,4026,3070,2427,1687,1201,963,13374,4192,6413,10605,4275,3221,2419,1900,1394,1243,14452,27826,49508,49508
Kiribati,1963,KI,KIR,WPR,4522,6897,11419,4222,3085,2494,1716,1214,962,13693,4309,6595,10904,4436,3268,2478,1919,1420,1245,14766,28459,50780,50780
Kiribati,1964,KI,KIR,WPR,4639,7087,11726,4459,3106,2559,1747,1228,969,14068,4421,6767,11188,4621,3320,2544,1933,1437,1252,15107,29175,52092,52092
Kiribati,1965,KI,KIR,WPR,4748,7276,12024,4716,3137,2620,1780,1237,978,14468,4524,6945,11469,4815,3376,2613,1950,1459,1270,15483,29951,53444,53444
Kiribati,1966,KI,KIR,WPR,4866,7425,12291,4851,3156,2649,1813,1236,1000,14705,4619,7104,11723,4929,3405,2646,1971,1458,1303,15712,30417,54428,54428
Kiribati,1967,KI,KIR,WPR,4969,7552,12521,4845,3158,2648,1839,1226,1038,14754,4681,7247,11928,4961,3405,2635,2001,1438,1353,15793,30547,54990,54990
Kiribati,1968,KI,KIR,WPR,5020,7740,12760,4820,3154,2651,1867,1218,1064,14774,4697,7418,12115,4990,3406,2620,2031,1418,1390,15855,30629,55511,55511
Kiribati,1969,KI,KIR,WPR,5032,7953,12985,4881,3181,2679,1898,1226,1073,14938,4696,7614,12310,5102,3441,2650,2054,1430,1407,16084,31022,56324,56324
Kiribati,2031,KI,KIR,WPR,8511,16893,25404,14712,10385,9357,6718,4301,3341,48814,8033,15943,23976,14294,10699,10257,7562,5116,4653,52581,101395,150776,150776
Kiribati,2032,KI,KIR,WPR,8493,16903,25396,15114,10416,9496,7021,4290,3545,49882,8019,15959,23978,14580,10702,10373,7874,5149,4874,53552,103434,152807,152807
Kiribati,2033,KI,KIR,WPR,8478,16893,25371,15453,10519,9634,7311,4299,3736,50952,8006,15958,23964,14812,10776,10470,8174,5194,5090,54516,105468,154809,154809
Kiribati,2034,KI,KIR,WPR,8465,16877,25342,15732,10702,9754,7558,4368,3900,52014,7995,15949,23944,14999,10927,10533,8442,5286,5295,55482,107496,156787,156787
Kiribati,2035,KI,KIR,WPR,8460,16859,25319,15941,10981,9836,7778,4490,4048,53074,7992,15935,23927,15145,11160,10547,8692,5423,5475,56442,109516,158756,158756
Kiribati,2036,KI,KIR,WPR,8466,16833,25299,16088,11360,9865,7991,4647,4163,54114,7996,15916,23912,15250,11477,10510,8928,5592,5627,57384,111498,160708,160708
Kiribati,2037,KI,KIR,WPR,8484,16801,25285,16199,11814,9848,8176,4846,4259,55142,8012,15891,23903,15327,11864,10426,9133,5806,5769,58325,113467,162654,162654
Kiribati,2038,KI,KIR,WPR,8524,16771,25295,16283,12321,9797,8335,5077,4344,56157,8053,15868,23921,15392,12283,10309,9308,6058,5895,59245,115402,164613,164613
Kiribati,2039,KI,KIR,WPR,8586,16745,25331,16351,12839,9740,8468,5333,4420,57151,8111,15846,23957,15442,12700,10202,9461,6329,6014,60148,117299,166589,166589
Kiribati,2040,KI,KIR,WPR,8663,16731,25394,16399,13327,9705,8586,5610,4496,58123,8185,15836,24021,15481,13081,10118,9592,6623,6142,61037,119160,168583,168583
Kiribati,2041,KI,KIR,WPR,8755,16727,25482,16427,13781,9696,8709,5893,4579,59085,8274,15837,24111,15512,13417,10070,9719,6917,6281,61916,121001,170595,170595
Kiribati,2042,KI,KIR,WPR,8864,16734,25598,16437,14179,9731,8847,6165,4668,60027,8377,15842,24219,15533,13702,10076,9836,7208,6433,62788,122815,172625,172625
Kiribati,2043,KI,KIR,WPR,8964,16760,25724,16433,14520,9836,8981,6420,4761,60951,8474,15870,24344,15533,13937,10152,9935,7493,6590,63640,124591,174658,174658
Kiribati,2044,KI,KIR,WPR,9060,16808,25868,16418,14795,10017,9100,6646,4888,61864,8564,15919,24483,15525,14128,10306,9998,7746,6771,64474,126338,176694,176694
Kiribati,2045,KI,KIR,WPR,9149,16884,26033,16401,15002,10294,9180,6840,5038,62755,8647,15991,24638,15516,14274,10538,10016,7977,6978,65299,128054,178730,178730
Kiribati,2046,KI,KIR,WPR,9216,16986,26202,16374,15150,10670,9212,7029,5195,63630,8712,16089,24801,15498,14380,10856,9985,8200,7195,66114,129744,180752,180752
Kiribati,2047,KI,KIR,WPR,9262,17112,26374,16344,15262,11117,9197,7196,5378,64494,8755,16210,24965,15475,14459,11238,9907,8394,7438,66911,131405,182748,182748
Kiribati,2048,KI,KIR,WPR,9296,17257,26553,16316,15352,11616,9148,7338,5568,65338,8788,16349,25137,15451,14526,11660,9798,8565,7696,67696,133034,184719,184719
Kiribati,2049,KI,KIR,WPR,9311,17414,26725,16295,15419,12123,9095,7458,5779,66169,8802,16500,25302,15435,14581,12072,9698,8711,7970,68467,134636,186665,186665
Kiribati,2050,KI,KIR,WPR,9302,17579,26881,16284,15470,12606,9066,7570,6007,67003,8795,16663,25458,15427,14624,12447,9622,8840,8266,69226,136229,188570,188570
Saint Kitts and Nevis,1970,KN,KNA,AMR,3286,7374,10660,3731,1251,1261,1546,1560,1145,10494,3290,7456,10746,3891,1623,1719,1869,1944,2025,13071,23565,44968,44968
Saint Kitts and Nevis,1971,KN,KNA,AMR,3068,7233,10301,4007,1269,1207,1497,1553,1182,10715,3061,7264,10325,4166,1626,1648,1824,1919,2057,13240,23955,44583,44583
Saint Kitts and Nevis,1972,KN,KNA,AMR,2902,7057,9959,4286,1349,1174,1455,1550,1227,11041,2878,7040,9918,4452,1682,1595,1793,1895,2091,13508,24549,44416,44416
Saint Kitts and Nevis,1973,KN,KNA,AMR,2796,6844,9640,4517,1445,1141,1405,1539,1269,11316,2762,6788,9550,4686,1749,1543,1755,1872,2129,13734,25050,44242,44242
Saint Kitts and Nevis,1974,KN,KNA,AMR,2752,6592,9344,4702,1561,1115,1362,1525,1313,11578,2714,6500,9214,4863,1843,1489,1718,1842,2165,13920,25498,44056,44056
Saint Kitts and Nevis,1975,KN,KNA,AMR,2747,6330,9077,4843,1696,1092,1316,1505,1359,11811,2714,6208,8922,4984,1950,1445,1678,1812,2205,14074,25885,43888,43888
Saint Kitts and Nevis,1976,KN,KNA,AMR,2750,6089,8839,4951,1832,1078,1271,1484,1408,12024,2717,5953,8670,5068,2058,1416,1637,1777,2253,14209,26233,43740,43740
Saint Kitts and Nevis,1977,KN,KNA,AMR,2750,5881,8631,5022,1966,1075,1232,1450,1466,12211,2718,5740,8458,5111,2161,1393,1597,1737,2299,14298,26509,43603,43603
Saint Kitts and Nevis,1978,KN,KNA,AMR,2747,5696,8443,5054,2103,1078,1198,1410,1533,12376,2709,5572,8281,5114,2267,1383,1557,1696,2347,14364,26740,43465,43465
Saint Kitts and Nevis,1979,KN,KNA,AMR,2737,5537,8274,5056,2236,1088,1162,1366,1592,12500,2691,5440,8131,5071,2374,1379,1513,1653,2388,14378,26878,43278,43278
Saint Kitts and Nevis,1980,KN,KNA,AMR,2721,5376,8097,5062,2381,1106,1129,1325,1630,12633,2666,5309,7975,5034,2497,1381,1463,1608,2407,14390,27023,43097,43097
Saint Kitts and Nevis,1981,KN,KNA,AMR,2700,5206,7906,5066,2565,1131,1098,1287,1647,12794,2642,5159,7801,5004,2662,1387,1420,1564,2402,14439,27233,42953,42953
Saint Kitts and Nevis,1982,KN,KNA,AMR,2672,5057,7729,5023,2764,1177,1068,1257,1653,12942,2611,5022,7633,4945,2851,1402,1380,1526,2383,14487,27429,42794,42794
Saint Kitts and Nevis,1983,KN,KNA,AMR,2640,4940,7580,4927,2957,1236,1044,1222,1658,13044,2578,4916,7494,4835,3035,1421,1334,1493,2366,14484,27528,42600,42600
Saint Kitts and Nevis,1984,KN,KNA,AMR,2613,4850,7463,4790,3127,1304,1021,1196,1662,13100,2545,4827,7372,4687,3205,1452,1290,1460,2348,14442,27542,42380,42380
Saint Kitts and Nevis,1985,KN,KNA,AMR,2574,4788,7362,4635,3272,1394,1002,1159,1668,13130,2505,4761,7266,4525,3351,1497,1256,1430,2332,14391,27521,42144,42144
Saint Kitts and Nevis,1986,KN,KNA,AMR,2524,4745,7269,4469,3382,1484,990,1121,1676,13122,2458,4718,7176,4357,3467,1549,1231,1397,2311,14312,27434,41889,41889
Saint Kitts and Nevis,1987,KN,KNA,AMR,2482,4718,7200,4298,3454,1590,987,1087,1678,13094,2412,4681,7093,4203,3546,1615,1212,1364,2291,14231,27325,41617,41617
Saint Kitts and Nevis,1988,KN,KNA,AMR,2441,4699,7140,4128,3482,1713,992,1054,1673,13042,2368,4650,7018,4057,3578,1697,1195,1321,2266,14114,27156,41321,41321
Saint Kitts and Nevis,1989,KN,KNA,AMR,2399,4688,7087,3976,3462,1836,1000,1017,1678,12969,2330,4627,6957,3921,3560,1795,1191,1269,2245,13981,26950,40992,40992
Saint Kitts and Nevis,1990,KN,KNA,AMR,2348,4676,7024,3853,3401,1961,1014,975,1689,12893,2288,4605,6893,3806,3502,1898,1181,1211,2225,13823,26716,40636,40636
Saint Kitts and Nevis,1991,KN,KNA,AMR,2305,4669,6974,3809,3367,2104,1035,941,1681,12937,2248,4590,6838,3761,3454,2037,1178,1168,2195,13793,26730,40542,40542
Saint Kitts and Nevis,1992,KN,KNA,AMR,2273,4654,6927,3847,3417,2275,1078,919,1655,13191,2214,4574,6788,3809,3467,2218,1183,1142,2169,13988,27179,40900,40900
Saint Kitts and Nevis,1993,KN,KNA,AMR,2246,4641,6887,3914,3494,2457,1142,910,1623,13540,2185,4565,6750,3880,3492,2415,1204,1130,2152,14273,27813,41447,41447
Saint Kitts and Nevis,1994,KN,KNA,AMR,2213,4630,6843,3970,3565,2631,1217,908,1590,13881,2161,4558,6719,3936,3513,2605,1241,1124,2137,14556,28437,42001,42001
Saint Kitts and Nevis,1995,KN,KNA,AMR,2182,4622,6804,4012,3624,2801,1304,911,1560,14212,2141,4549,6690,3983,3528,2785,1301,1120,2121,14838,29050,42550,42550
Saint Kitts and Nevis,1996,KN,KNA,AMR,2148,4613,6761,4043,3673,2967,1410,923,1537,14553,2127,4540,6667,4016,3548,2947,1382,1122,2106,15121,29674,43097,43097
Saint Kitts and Nevis,1997,KN,KNA,AMR,2120,4611,6731,4060,3709,3117,1537,941,1520,14884,2120,4526,6646,4039,3572,3094,1479,1122,2094,15400,30284,43656,43656
Saint Kitts and Nevis,1998,KN,KNA,AMR,2105,4607,6712,4070,3732,3252,1683,965,1505,15207,2119,4510,6629,4057,3593,3227,1598,1127,2082,15684,30891,44230,44230
Saint Kitts and Nevis,1999,KN,KNA,AMR,2111,4594,6705,4074,3745,3373,1841,995,1499,15527,2126,4496,6622,4068,3619,3345,1726,1139,2071,15968,31495,44825,44825
Saint Kitts and Nevis,2000,KN,KNA,AMR,2134,4574,6708,4080,3757,3482,2013,1026,1509,15867,2145,4475,6620,4088,3643,3442,1883,1149,2065,16270,32137,45461,45461
Saint Kitts and Nevis,2001,KN,KNA,AMR,2149,4525,6674,4103,3752,3569,2191,1057,1510,16182,2144,4434,6578,4124,3660,3506,2045,1160,2056,16551,32733,45986,45986
Saint Kitts and Nevis,2002,KN,KNA,AMR,2125,4439,6564,4138,3730,3614,2355,1096,1491,16424,2100,4366,6466,4192,3666,3526,2208,1175,2035,16802,33226,46264,46264
Saint Kitts and Nevis,2003,KN,KNA,AMR,2066,4344,6410,4178,3715,3624,2513,1142,1468,16640,2033,4295,6328,4270,3670,3509,2387,1195,2019,17050,33690,46431,46431
Saint Kitts and Nevis,2004,KN,KNA,AMR,1988,4261,6249,4220,3706,3614,2662,1197,1451,16850,1956,4233,6189,4333,3680,3468,2571,1227,2019,17298,34148,46580,46580
Saint Kitts and Nevis,2005,KN,KNA,AMR,1898,4190,6088,4249,3701,3588,2808,1260,1446,17052,1879,4184,6063,4353,3710,3432,2740,1279,2012,17526,34578,46725,46725
Saint Kitts and Nevis,2006,KN,KNA,AMR,1825,4117,5942,4259,3702,3552,2937,1330,1453,17233,1827,4134,5961,4332,3743,3420,2885,1343,2004,17727,34960,46874,46874
Saint Kitts and Nevis,2007,KN,KNA,AMR,1779,4046,5825,4240,3706,3512,3036,1425,1467,17386,1807,4073,5880,4287,3790,3423,2998,1416,2007,17921,35307,47015,47015
Saint Kitts and Nevis,2008,KN,KNA,AMR,1760,3977,5737,4193,3708,3470,3111,1541,1481,17504,1802,4004,5806,4230,3847,3416,3097,1490,2016,18096,35600,47156,47156
Saint Kitts and Nevis,2009,KN,KNA,AMR,1757,3904,5661,4136,3712,3440,3160,1668,1504,17620,1805,3929,5734,4162,3911,3402,3187,1574,2038,18274,35894,47286,47286
Saint Kitts and Nevis,2010,KN,KNA,AMR,1761,3823,5584,4065,3713,3426,3196,1793,1538,17731,1802,3855,5657,4085,3977,3383,3258,1682,2054,18439,36170,47403,47403
Saint Kitts and Nevis,2011,KN,KNA,AMR,1763,3756,5519,4021,3713,3435,3224,1924,1540,17857,1775,3802,5577,4028,4036,3381,3303,1823,2048,18619,36476,47581,47581
Saint Kitts and Nevis,2012,KN,KNA,AMR,1753,3684,5437,3995,3729,3434,3235,2074,1534,18001,1733,3754,5487,3988,4097,3406,3294,1993,2023,18801,36802,47727,47727
Saint Kitts and Nevis,2013,KN,KNA,AMR,1730,3594,5324,3944,3755,3423,3220,2214,1546,18102,1690,3685,5375,3936,4162,3433,3242,2187,2012,18972,37074,47767,47767
Saint Kitts and Nevis,2014,KN,KNA,AMR,1698,3504,5202,3888,3788,3416,3192,2341,1574,18199,1655,3600,5255,3895,4197,3467,3180,2383,2006,19128,37327,47789,47789
Saint Kitts and Nevis,2015,KN,KNA,AMR,1672,3419,5091,3815,3823,3403,3166,2463,1605,18275,1631,3512,5143,3864,4183,3507,3148,2549,2030,19281,37556,47790,47790
Saint Kitts and Nevis,2016,KN,KNA,AMR,1648,3349,4997,3731,3846,3394,3143,2565,1644,18323,1609,3445,5054,3822,4138,3552,3164,2667,2073,19416,37739,47788,47788
Saint Kitts and Nevis,2017,KN,KNA,AMR,1625,3298,4923,3655,3835,3387,3119,2638,1711,18345,1586,3391,4977,3765,4089,3597,3191,2754,2141,19537,37882,47785,47785
Saint Kitts and Nevis,2018,KN,KNA,AMR,1599,3263,4862,3583,3801,3380,3091,2692,1803,18350,1563,3347,4910,3698,4050,3650,3199,2839,2207,19643,37993,47761,47761
Saint Kitts and Nevis,2019,KN,KNA,AMR,1577,3236,4813,3501,3758,3375,3073,2726,1898,18331,1536,3312,4848,3617,4005,3705,3188,2919,2281,19715,38046,47712,47712
Saint Kitts and Nevis,2020,KN,KNA,AMR,1551,3213,4764,3408,3707,3371,3069,2761,2002,18318,1511,3270,4781,3535,3947,3761,3173,2991,2383,19790,38108,47642,47642
Saint Kitts and Nevis,2021,KN,KNA,AMR,1523,3189,4712,3334,3651,3372,3064,2784,2096,18301,1479,3220,4699,3473,3896,3815,3172,3032,2502,19890,38191,47606,47606
Saint Kitts and Nevis,2022,KN,KNA,AMR,1501,3175,4676,3283,3620,3401,3054,2785,2193,18336,1449,3175,4624,3432,3853,3888,3192,3028,2637,20030,38366,47657,47657
Saint Kitts and Nevis,2023,KN,KNA,AMR,1475,3157,4632,3243,3597,3455,3053,2767,2277,18392,1419,3135,4554,3396,3812,3974,3223,2985,2779,20169,38561,47755,47755
Saint Kitts and Nevis,2024,KN,KNA,AMR,1449,3133,4582,3203,3572,3519,3060,2746,2369,18469,1391,3100,4491,3347,3780,4033,3264,2937,2944,20305,38774,47847,47847
Saint Kitts and Nevis,2025,KN,KNA,AMR,1424,3111,4535,3164,3534,3578,3064,2724,2462,18526,1367,3071,4438,3298,3760,4043,3320,2918,3101,20440,38966,47935,47935
Saint Kitts and Nevis,2026,KN,KNA,AMR,1402,3087,4489,3141,3485,3631,3073,2709,2542,18581,1347,3038,4385,3268,3733,4018,3375,2936,3229,20559,39140,48016,48016
Saint Kitts and Nevis,2027,KN,KNA,AMR,1386,3054,4440,3135,3446,3646,3091,2694,2619,18631,1332,2997,4329,3254,3693,3992,3432,2972,3341,20684,39315,48086,48086
Saint Kitts and Nevis,2028,KN,KNA,AMR,1373,3020,4393,3140,3415,3640,3107,2676,2700,18678,1320,2954,4274,3246,3639,3971,3501,2987,3455,20799,39477,48148,48148
Saint Kitts and Nevis,2029,KN,KNA,AMR,1361,2987,4348,3155,3376,3623,3127,2665,2774,18720,1310,2909,4219,3247,3577,3945,3576,2983,3584,20912,39632,48200,48200
Saint Kitts and Nevis,2030,KN,KNA,AMR,1350,2953,4303,3170,3331,3595,3156,2664,2841,18757,1300,2867,4167,3243,3519,3905,3652,2978,3719,21016,39773,48247,48247
Saint Kitts and Nevis,1950,KN,KNA,AMR,4308,4672,8980,2883,2823,2969,1717,824,729,11945,4308,5489,9797,3802,3518,3531,2397,1481,1796,16525,28470,47254,47254
Saint Kitts and Nevis,1951,KN,KNA,AMR,4642,4971,9613,2817,2758,2962,1799,835,749,11920,4579,5739,10318,3753,3456,3547,2449,1501,1804,16510,28430,48362,48362
Saint Kitts and Nevis,1952,KN,KNA,AMR,4941,5298,10239,2764,2709,2923,1882,864,774,11916,4840,5997,10837,3703,3405,3534,2502,1541,1797,16482,28398,49474,49474
Saint Kitts and Nevis,1953,KN,KNA,AMR,5218,5628,10846,2730,2659,2859,1967,902,785,11902,5104,6243,11347,3667,3359,3496,2557,1595,1796,16470,28372,50569,50569
Saint Kitts and Nevis,1954,KN,KNA,AMR,5358,6041,11399,2708,2586,2785,2050,946,797,11872,5247,6558,11805,3641,3296,3437,2613,1650,1788,16425,28297,51505,51505
Saint Kitts and Nevis,1955,KN,KNA,AMR,5320,6498,11818,2802,2516,2697,2129,1005,805,11954,5220,6897,12117,3705,3239,3349,2670,1704,1787,16454,28408,52347,52347
Saint Kitts and Nevis,1956,KN,KNA,AMR,5306,6843,12149,3022,2474,2607,2197,1073,818,12191,5214,7125,12339,3869,3207,3238,2719,1757,1801,16591,28782,53275,53275
Saint Kitts and Nevis,1957,KN,KNA,AMR,5397,7070,12467,3276,2441,2527,2253,1141,834,12472,5308,7258,12566,4059,3180,3132,2757,1797,1819,16744,29216,54255,54255
Saint Kitts and Nevis,1958,KN,KNA,AMR,5552,7226,12778,3549,2424,2457,2275,1209,850,12764,5456,7341,12797,4258,3167,3037,2775,1829,1845,16911,29675,55256,55256
Saint Kitts and Nevis,1959,KN,KNA,AMR,5693,7360,13053,3827,2425,2400,2269,1272,886,13079,5592,7430,13022,4455,3163,2957,2765,1859,1872,17071,30150,56230,56230
Saint Kitts and Nevis,1960,KN,KNA,AMR,5708,7479,13187,4007,2410,2338,2250,1330,915,13250,5604,7532,13136,4546,3129,2882,2735,1889,1897,17078,30328,56660,56660
Saint Kitts and Nevis,1961,KN,KNA,AMR,5550,7584,13134,4026,2347,2258,2225,1389,928,13173,5445,7640,13085,4493,3043,2790,2700,1918,1899,16843,30016,56247,56247
Saint Kitts and Nevis,1962,KN,KNA,AMR,5282,7689,12971,3972,2274,2171,2190,1449,941,12997,5182,7750,12932,4378,2934,2695,2647,1952,1899,16505,29502,55404,55404
Saint Kitts and Nevis,1963,KN,KNA,AMR,4986,7784,12770,3888,2192,2074,2139,1498,957,12748,4888,7853,12741,4244,2815,2594,2581,1985,1911,16130,28878,54391,54391
Saint Kitts and Nevis,1964,KN,KNA,AMR,4710,7838,12548,3798,2102,1978,2078,1538,981,12475,4604,7910,12514,4113,2683,2491,2501,2010,1919,15717,28192,53255,53255
Saint Kitts and Nevis,1965,KN,KNA,AMR,4440,7856,12296,3712,1993,1870,2004,1574,1008,12161,4335,7930,12265,3997,2537,2385,2408,2028,1939,15294,27455,52016,52016
Saint Kitts and Nevis,1966,KN,KNA,AMR,4185,7847,12032,3631,1869,1760,1923,1595,1034,11812,4092,7921,12013,3883,2374,2269,2307,2037,1948,14818,26630,50683,50683
Saint Kitts and Nevis,1967,KN,KNA,AMR,3960,7785,11745,3571,1730,1638,1834,1607,1055,11435,3893,7864,11757,3796,2194,2143,2201,2034,1965,14333,25768,49269,49269
Saint Kitts and Nevis,1968,KN,KNA,AMR,3753,7672,11425,3550,1564,1504,1734,1602,1084,11038,3717,7759,11476,3746,1993,2007,2080,2017,1985,13828,24866,47772,47772
Saint Kitts and Nevis,1969,KN,KNA,AMR,3532,7523,11055,3580,1366,1366,1627,1578,1114,10631,3525,7617,11142,3751,1766,1850,1957,1982,2003,13309,23940,46135,46135
Saint Kitts and Nevis,2031,KN,KNA,AMR,1340,2917,4257,3174,3293,3560,3179,2672,2909,18787,1290,2823,4113,3219,3479,3867,3720,2987,3851,21123,39910,48282,48282
Saint Kitts and Nevis,2032,KN,KNA,AMR,1330,2878,4208,3166,3254,3542,3217,2671,2970,18820,1280,2779,4059,3179,3446,3831,3801,3008,3949,21214,40034,48300,48300
Saint Kitts and Nevis,2033,KN,KNA,AMR,1319,2842,4161,3146,3218,3519,3271,2675,3013,18842,1269,2739,4008,3140,3407,3791,3884,3039,4038,21299,40141,48309,48309
Saint Kitts and Nevis,2034,KN,KNA,AMR,1309,2806,4115,3123,3179,3496,3332,2683,3051,18864,1259,2701,3960,3105,3361,3760,3945,3079,4122,21372,40236,48310,48310
Saint Kitts and Nevis,2035,KN,KNA,AMR,1299,2772,4071,3103,3142,3458,3393,2689,3088,18873,1249,2667,3916,3076,3313,3742,3955,3134,4216,21436,40309,48297,48297
Saint Kitts and Nevis,2036,KN,KNA,AMR,1288,2741,4029,3079,3122,3413,3442,2703,3124,18883,1239,2637,3876,3044,3281,3714,3929,3189,4327,21484,40367,48270,48270
Saint Kitts and Nevis,2037,KN,KNA,AMR,1278,2715,3993,3049,3117,3379,3459,2719,3160,18883,1229,2612,3841,3002,3269,3675,3901,3249,4428,21524,40407,48236,48236
Saint Kitts and Nevis,2038,KN,KNA,AMR,1269,2691,3960,3017,3123,3349,3453,2738,3192,18872,1221,2589,3810,2959,3262,3624,3884,3315,4511,21555,40427,48191,48191
Saint Kitts and Nevis,2039,KN,KNA,AMR,1259,2669,3928,2984,3135,3310,3437,2763,3218,18847,1212,2569,3781,2915,3263,3564,3861,3390,4588,21581,40428,48133,48133
Saint Kitts and Nevis,2040,KN,KNA,AMR,1249,2649,3898,2950,3148,3265,3415,2791,3256,18825,1203,2549,3752,2876,3258,3506,3825,3464,4666,21595,40420,48067,48067
Saint Kitts and Nevis,2041,KN,KNA,AMR,1240,2628,3868,2913,3155,3229,3382,2819,3303,18801,1194,2529,3723,2831,3235,3463,3788,3532,4747,21596,40397,47989,47989
Saint Kitts and Nevis,2042,KN,KNA,AMR,1230,2608,3838,2876,3148,3198,3365,2857,3340,18784,1185,2509,3694,2785,3197,3431,3753,3607,4821,21594,40378,47898,47898
Saint Kitts and Nevis,2043,KN,KNA,AMR,1220,2588,3808,2839,3130,3160,3349,2909,3365,18752,1174,2490,3664,2747,3157,3396,3715,3690,4876,21581,40333,47797,47797
Saint Kitts and Nevis,2044,KN,KNA,AMR,1209,2568,3777,2804,3108,3122,3329,2967,3388,18718,1163,2471,3634,2709,3124,3349,3687,3748,4948,21565,40283,47691,47691
Saint Kitts and Nevis,2045,KN,KNA,AMR,1198,2548,3746,2770,3086,3088,3297,3029,3418,18688,1152,2452,3604,2674,3097,3304,3671,3761,5041,21548,40236,47578,47578
Saint Kitts and Nevis,2046,KN,KNA,AMR,1187,2528,3715,2740,3065,3070,3257,3076,3444,18652,1141,2433,3574,2644,3064,3274,3643,3741,5156,21522,40174,47453,47453
Saint Kitts and Nevis,2047,KN,KNA,AMR,1176,2508,3684,2713,3037,3064,3226,3095,3469,18604,1130,2414,3544,2618,3023,3260,3606,3716,5260,21483,40087,47316,47316
Saint Kitts and Nevis,2048,KN,KNA,AMR,1165,2489,3654,2690,3006,3074,3200,3088,3507,18565,1121,2395,3516,2595,2980,3255,3557,3702,5358,21447,40012,47179,47179
Saint Kitts and Nevis,2049,KN,KNA,AMR,1155,2468,3623,2669,2973,3086,3162,3080,3554,18524,1111,2376,3487,2574,2938,3255,3496,3680,5458,21401,39925,47036,47036
Saint Kitts and Nevis,2050,KN,KNA,AMR,1146,2447,3593,2649,2940,3099,3122,3061,3610,18481,1101,2357,3458,2556,2894,3252,3442,3648,5562,21354,39835,46882,46882
Republic of Korea,1970,KR,KOR,WPR,2355837,4765785,7121622,3052229,2371724,1563695,1128629,729528,431014,9276819,2234232,4449974,6684206,2862842,2245995,1703851,1177057,827077,701666,9518488,18795307,32601143,32601143
Republic of Korea,1971,KR,KOR,WPR,2362472,4800012,7162484,3202957,2393216,1648771,1145149,740907,447916,9578916,2235568,4488716,6724284,3017986,2254707,1767110,1210701,842939,729249,9822692,19401608,33288369,33288369
Republic of Korea,1972,KR,KOR,WPR,2388034,4822417,7210451,3327335,2424310,1750209,1166047,746630,464638,9879169,2247753,4516543,6764296,3143488,2282568,1838426,1249383,855574,753490,10122929,20002098,33976851,33976851
Republic of Korea,1973,KR,KOR,WPR,2412655,4821390,7234045,3461571,2459652,1854539,1195606,751434,479002,10201804,2260967,4518732,6779699,3271624,2322477,1910396,1296836,868063,774771,10444167,20645971,34659713,34659713
Republic of Korea,1974,KR,KOR,WPR,2416495,4811875,7228370,3622137,2487565,1954170,1232097,756503,491442,10543914,2252529,4507073,6759602,3421953,2359819,1978096,1354344,878766,794474,10787452,21331366,35319338,35319338
Republic of Korea,1975,KR,KOR,WPR,2384174,4805629,7189803,3801562,2509092,2045445,1262873,772638,499891,10891501,2215145,4493770,6708915,3591982,2390442,2040276,1406168,899892,811725,11140485,22031986,35930694,35930694
Republic of Korea,1976,KR,KOR,WPR,2310316,4791535,7101851,3989751,2525525,2126003,1286563,799787,507069,11234698,2155916,4475096,6631012,3773256,2411924,2096309,1446246,931462,829568,11488765,22723463,36456320,36456320
Republic of Korea,1977,KR,KOR,WPR,2221988,4768497,6990485,4137629,2570435,2191142,1316543,829384,515039,11560172,2083884,4458597,6542481,3924545,2451156,2142022,1487494,963478,849464,11818159,23378331,36911298,36911298
Republic of Korea,1978,KR,KOR,WPR,2145508,4732814,6878322,4254634,2646167,2233219,1352477,858287,522838,11867622,2013897,4437422,6451319,4050264,2517586,2171713,1527251,995901,870012,12132727,24000349,37329984,37329984
Republic of Korea,1979,KR,KOR,WPR,2088212,4695876,6784088,4339252,2746851,2250185,1400292,882498,531802,12150880,1959939,4413968,6373907,4140780,2614039,2183403,1570674,1027802,892344,12429042,24579922,37737918,37737918
Republic of Korea,1980,KR,KOR,WPR,2056616,4656687,6713303,4378737,2882869,2251594,1467643,898495,543244,12422582,1929792,4387538,6317330,4169708,2764574,2181582,1626934,1056763,917728,12717289,25139871,38170501,38170501
Republic of Korea,1981,KR,KOR,WPR,2062290,4610394,6672684,4424960,3023440,2267307,1543092,910938,562630,12732367,1935200,4350879,6286079,4195369,2923832,2192913,1688786,1086175,953705,13040780,25773147,38731905,38731905
Republic of Korea,1982,KR,KOR,WPR,2087928,4572112,6660040,4460236,3165789,2313174,1620116,926812,587465,13073592,1959860,4315785,6275645,4228203,3063103,2231946,1752478,1122009,996409,13394148,26467740,39403422,39403422
Republic of Korea,1983,KR,KOR,WPR,2107157,4523836,6630993,4469486,3331683,2364627,1698180,949041,608320,13421337,1976107,4270076,6246183,4245185,3217156,2277660,1815637,1167198,1032398,13755234,27176571,40053748,40053748
Republic of Korea,1984,KR,KOR,WPR,2101259,4460466,6561725,4489516,3513913,2408934,1774713,976916,626797,13790789,1965136,4210918,6176054,4262205,3396780,2315446,1876998,1221069,1063291,14135789,27926578,40664361,40664361
Republic of Korea,1985,KR,KOR,WPR,2047954,4407412,6455366,4528962,3694675,2453826,1848333,1002469,650311,14178576,1907012,4161849,6068861,4279430,3592314,2351066,1934918,1271189,1100990,14529907,28708483,41232709,41232709
Republic of Korea,1986,KR,KOR,WPR,1967798,4363997,6331795,4581391,3888742,2492387,1927440,1027437,679769,14597166,1822567,4125226,5947793,4308867,3791138,2378306,1993091,1311770,1148776,14931948,29529114,41808708,41808708
Republic of Korea,1987,KR,KOR,WPR,1891743,4317375,6209118,4622336,4076602,2552602,2005099,1065368,710588,15032595,1742945,4086630,5829575,4348294,3962174,2421138,2047591,1356603,1198165,15333965,30366560,42405253,42405253
Republic of Korea,1988,KR,KOR,WPR,1833471,4264563,6098034,4639485,4252301,2642514,2061259,1111921,743108,15450588,1678141,4037599,5715740,4374935,4120179,2491289,2087147,1401868,1248679,15724097,31174685,42988455,42988455
Republic of Korea,1989,KR,KOR,WPR,1801596,4198969,6000565,4659995,4390634,2765887,2094170,1167188,776837,15854711,1635908,3974511,5610419,4397965,4253929,2591847,2107497,1449780,1300796,16101814,31956525,43567512,43567512
Republic of Korea,1990,KR,KOR,WPR,1794106,4126985,5921091,4678369,4449755,2941146,2113670,1237909,808823,16229672,1614473,3901963,5516436,4406842,4324220,2746831,2112328,1510704,1351917,16452842,32682514,44120039,44120039
Republic of Korea,1991,KR,KOR,WPR,1786448,4051746,5838194,4650059,4466544,3103312,2138622,1309345,839240,16507122,1598070,3821579,5419649,4370385,4347372,2902810,2123550,1571792,1406540,16722449,33229571,44487412,44487412
Republic of Korea,1992,KR,KOR,WPR,1783799,3963838,5747637,4580585,4467082,3231570,2180883,1377761,869311,16707192,1590523,3730023,5320546,4305778,4342022,3030674,2153796,1631220,1464850,16928340,33635532,44703709,44703709
Republic of Korea,1993,KR,KOR,WPR,1804916,3868403,5673319,4489991,4461703,3369647,2227393,1450072,900661,16899467,1601699,3630404,5232103,4230001,4321484,3169312,2190689,1691520,1524969,17127975,34027442,44932861,44932861
Republic of Korea,1994,KR,KOR,WPR,1836308,3757593,5593901,4405143,4443866,3528393,2265513,1521374,935902,17100191,1624659,3513400,5138059,4148922,4292485,3333613,2219429,1748847,1590338,17333634,34433825,45165780,45165780
Republic of Korea,1995,KR,KOR,WPR,1860609,3631172,5491781,4355903,4406470,3697251,2299383,1588412,972524,17319943,1644793,3379686,5024479,4080263,4262872,3510823,2243257,1802404,1657607,17557226,34877169,45393418,45393418
Republic of Korea,1996,KR,KOR,WPR,1861135,3530177,5391312,4317605,4378707,3864555,2325953,1656298,1012903,17556021,1646170,3263307,4909477,4025091,4245610,3685936,2262990,1856138,1727587,17803352,35359373,45660168,45660168
Republic of Korea,1997,KR,KOR,WPR,1832930,3474864,5307794,4267794,4367262,3999919,2368395,1722196,1065372,17790938,1627702,3183912,4811614,3969054,4239761,3829478,2298760,1908872,1806118,18052043,35842981,45962393,45962393
Republic of Korea,1998,KR,KOR,WPR,1788475,3451910,5240385,4205862,4351713,4115659,2432631,1770216,1125808,18001889,1600258,3133738,4733996,3901551,4225551,3954417,2358242,1948347,1885871,18273979,36275868,46250259,46250259
Republic of Korea,1999,KR,KOR,WPR,1739712,3453475,5193187,4135245,4336774,4200472,2522638,1795589,1194117,18184835,1569926,3110261,4680187,3821011,4208178,4051285,2445353,1966463,1969941,18462231,36647066,46520444,46520444
Republic of Korea,2000,KR,KOR,WPR,1692842,3475841,5168683,4070028,4306916,4227628,2657317,1809099,1272825,18343813,1537676,3114527,4652203,3734033,4185111,4088978,2581708,1969001,2065061,18623892,36967705,46788591,46788591
Republic of Korea,2001,KR,KOR,WPR,1635685,3505886,5141571,4005202,4260972,4244677,2796426,1832284,1357951,18497512,1492851,3137820,4630671,3659377,4148115,4112182,2726720,1980759,2167889,18795042,37292554,47064790,47064790
Republic of Korea,2002,KR,KOR,WPR,1560621,3530938,5091559,3926165,4224003,4255821,2920322,1878310,1447957,18652578,1428663,3164913,4593576,3593319,4109286,4134579,2852730,2016607,2276437,18982958,37635536,47320668,47320668
Republic of Korea,2003,KR,KOR,WPR,1481022,3543528,5024550,3843341,4184847,4249018,3054968,1932477,1540994,18805645,1358256,3185181,4543437,3523032,4062360,4142829,2990838,2060796,2386248,19166103,37971748,47539738,47539738
Republic of Korea,2004,KR,KOR,WPR,1401008,3535545,4936553,3758113,4139832,4239846,3210158,1979068,1635460,18962477,1289406,3192089,4481495,3442164,4010813,4144176,3155255,2096180,2498172,19346760,38309237,47727285,47727285
Republic of Korea,2005,KR,KOR,WPR,1312322,3514962,4827284,3672356,4095890,4234397,3376286,2021615,1727522,19128066,1212349,3187281,4399630,3349035,3969252,4145907,3332523,2128214,2609660,19534591,38662657,47889573,47889573
Republic of Korea,2006,KR,KOR,WPR,1231032,3470659,4701691,3594678,4055833,4235860,3544434,2059273,1823327,19313405,1141637,3155188,4296825,3259428,3929054,4154453,3506901,2158576,2729013,19737425,39050830,48049347,48049347
Republic of Korea,2007,KR,KOR,WPR,1183452,3380286,4563738,3541661,4016223,4241091,3683944,2114115,1923450,19520484,1102302,3080788,4183090,3193002,3880020,4167613,3649617,2207319,2855711,19953282,39473766,48220601,48220601
Republic of Korea,2008,KR,KOR,WPR,1160153,3259679,4419832,3522130,3968786,4238996,3796984,2195269,2014281,19736446,1085112,2983996,4069108,3153921,3823538,4172546,3767151,2284466,2971616,20173238,39909684,48398626,48398626
Republic of Korea,2009,KR,KOR,WPR,1153892,3126565,4280457,3524288,3913180,4232331,3891474,2291748,2100099,19953120,1082972,2877093,3960065,3135061,3760478,4169988,3866519,2379684,3082651,20394381,40347501,48588019,48588019
Republic of Korea,2010,KR,KOR,WPR,1163560,2986005,4149565,3541316,3854184,4224794,3965034,2404953,2192601,20182882,1095678,2760100,3855778,3132878,3693634,4162574,3942960,2493440,3199331,20624817,40807699,48813042,48813042
Republic of Korea,2011,KR,KOR,WPR,1173437,2848761,4022198,3567247,3818865,4229565,4050328,2543020,2288939,20497964,1107156,2640069,3747225,3149626,3630477,4154670,4021471,2631462,3314793,20902499,41400463,49169878,49169878
Republic of Korea,2012,KR,KOR,WPR,1175974,2728103,3904077,3591561,3805299,4243701,4137144,2706715,2391738,20876158,1110348,2530371,3640719,3176382,3572412,4142264,4097058,2791960,3433150,21213226,42089384,49634185,49634185
Republic of Korea,2013,KR,KOR,WPR,1174110,2629018,3803128,3602128,3792770,4240361,4215003,2878794,2507358,21236414,1109445,2439636,3549081,3193850,3519176,4105526,4168391,2959119,3563553,21509615,42746029,50098229,50098229
Republic of Korea,2014,KR,KOR,WPR,1169841,2544816,3714657,3591211,3772771,4229712,4293606,3060488,2633705,21581493,1107025,2363562,3470587,3192000,3461910,4058941,4237011,3137220,3704222,21791304,43372797,50558043,50558043
Republic of Korea,2015,KR,KOR,WPR,1161461,2466160,3627621,3565623,3730960,4229794,4351361,3270947,2761742,21910427,1101176,2293796,3394972,3175477,3389380,4027199,4273845,3349577,3845899,22061377,43971804,50994401,50994401
Republic of Korea,2016,KR,KOR,WPR,1134586,2404985,3539571,3527559,3671829,4209350,4374397,3495613,2879442,22158190,1077587,2242948,3320535,3148577,3316290,3992076,4278189,3579118,3977432,22291682,44449872,51309984,51309984
Republic of Korea,2017,KR,KOR,WPR,1087993,2376044,3464037,3452005,3624471,4170384,4380748,3674338,3015929,22317875,1034212,2223952,3258164,3092177,3259330,3955541,4280180,3753881,4130455,22471564,44789439,51511639,51511639
Republic of Korea,2018,KR,KOR,WPR,1036330,2358041,3394371,3342421,3612455,4125918,4388815,3815745,3168254,22453608,984879,2214533,3199412,3011381,3226982,3911341,4295845,3883204,4300754,22629507,45083115,51676900,51676900
Republic of Korea,2019,KR,KOR,WPR,980347,2337792,3318139,3220865,3637094,4056895,4405794,3928600,3327071,22576319,931102,2202158,3133260,2923755,3227461,3839482,4319830,3988049,4477534,22776111,45352430,51803829,51803829
Republic of Korea,2020,KR,KOR,WPR,913595,2328527,3242122,3075586,3675007,3990779,4399794,4000254,3518012,22659432,866911,2198607,3065518,2812515,3245285,3765203,4312845,4053251,4688525,22877624,45537056,51844690,51844690
Republic of Korea,2021,KR,KOR,WPR,847884,2318794,3166678,2923555,3708974,3945367,4361201,4058324,3720858,22718279,803444,2193704,2997148,2690235,3267908,3705617,4273910,4101108,4909257,22948035,45666314,51830139,51830139
Republic of Korea,2022,KR,KOR,WPR,798011,2281425,3079436,2798205,3736695,3902543,4321148,4099389,3930043,22788023,755511,2160992,2916503,2585779,3292824,3649990,4226313,4143814,5133132,23031852,45819875,51815810,51815810
Republic of Korea,2023,KR,KOR,WPR,766089,2221524,2987613,2691489,3749687,3858516,4264956,4139008,4148481,22852137,725111,2105245,2830356,2495260,3309981,3591277,4152615,4196218,5368604,23113955,45966092,51784059,51784059
Republic of Korea,2024,KR,KOR,WPR,749617,2155535,2905152,2589858,3743445,3806253,4205495,4181958,4374291,22901300,709189,2044144,2753333,2409509,3314733,3519463,4078616,4242500,5617357,23182178,46083478,51741963,51741963
Republic of Korea,2025,KR,KOR,WPR,745250,2079736,2824986,2494166,3720202,3740107,4169555,4197523,4621532,22943085,704732,1974001,2678733,2327266,3308720,3430624,4033068,4247412,5896585,23243675,46186760,51690479,51690479
Republic of Korea,2026,KR,KOR,WPR,748260,1991176,2739436,2424181,3665925,3680165,4135955,4201590,4877966,22985782,707231,1891001,2598232,2267673,3275771,3351980,3989883,4235697,6186368,23307372,46293154,51630817,51630817
Republic of Korea,2027,KR,KOR,WPR,754999,1896916,2651915,2393247,3559035,3642456,4104526,4210826,5115260,23025350,713299,1801617,2514916,2245263,3195098,3294636,3950477,4236469,6447641,23369584,46394934,51561768,51561768
Republic of Korea,2028,KR,KOR,WPR,763041,1811161,2574202,2376078,3420276,3633412,4069458,4220887,5329325,23049436,720646,1719424,2440070,2236071,3089357,3259607,3904647,4249592,6679249,23418523,46467959,51482230,51482230
Republic of Korea,2029,KR,KOR,WPR,770899,1736475,2507374,2357574,3274355,3654665,4010183,4238669,5521684,23057130,727827,1647121,2374948,2224941,2980592,3253907,3831438,4269355,6892827,23453060,46510190,51392505,51392505
Republic of Korea,2030,KR,KOR,WPR,776806,1664865,2441671,2349690,3121035,3692178,3951420,4235985,5706652,23056960,733202,1577832,2311034,2222544,2862895,3270154,3758388,4261767,7104802,23480550,46537510,51290214,51290214
Republic of Korea,1950,KR,KOR,WPR,1706436,2856331,4562767,1610625,1405473,1178056,765424,496967,236926,5693471,1540656,2526488,4067144,1805386,1345373,1029959,728266,557035,314605,5780624,11474095,20104010,20104010
Republic of Korea,1951,KR,KOR,WPR,1661650,2898645,4560295,1643884,1324511,1128301,748206,483411,227099,5555412,1528841,2560903,4089744,1857938,1382452,1048202,734451,568212,320184,5911439,11466851,20116892,20116892
Republic of Korea,1952,KR,KOR,WPR,1640070,2932335,4572405,1754875,1289896,1103302,753956,482625,229315,5613969,1545180,2593519,4138699,1919214,1424039,1065792,746212,579107,333938,6068302,11682271,20393370,20393370
Republic of Korea,1953,KR,KOR,WPR,1665126,2935095,4600221,1916534,1287103,1098700,776073,490457,239257,5808124,1585561,2621624,4207185,1989137,1468425,1083839,763078,589254,353132,6246865,12054989,20862396,20862396
Republic of Korea,1954,KR,KOR,WPR,1725078,2934975,4660053,2082148,1295786,1105354,803903,500003,251991,6039185,1647912,2644757,4292669,2066040,1513222,1105023,783781,597972,374939,6440977,12480162,21432886,21432886
Republic of Korea,1955,KR,KOR,WPR,1822484,2931122,4753606,2235973,1314451,1121312,833414,509609,266010,6280769,1737694,2658637,4396331,2145157,1557980,1130607,807352,605188,398022,6644306,12925075,22075008,22075008
Republic of Korea,1956,KR,KOR,WPR,1939505,2926976,4866481,2383733,1334614,1142398,863156,517015,279884,6520800,1845883,2675713,4521596,2223356,1603621,1160567,834310,610751,421973,6854578,13375378,22763457,22763457
Republic of Korea,1957,KR,KOR,WPR,2057013,2937085,4994098,2529927,1354474,1169232,892761,522353,293384,6762131,1955458,2717144,4672602,2295257,1649129,1195060,864871,614726,446177,7065220,13827351,23494049,23494049
Republic of Korea,1958,KR,KOR,WPR,2170133,2991138,5161271,2642681,1384167,1198639,919694,527681,306550,6979412,2061689,2784365,4846054,2357408,1694589,1232708,896684,618289,470437,7270115,14249527,24256851,24256851
Republic of Korea,1959,KR,KOR,WPR,2272616,3096213,5368829,2706370,1436399,1223632,941692,535831,319787,7163711,2158387,2879014,5037401,2406992,1742741,1271626,926200,623564,495027,7466150,14629861,25036097,25036097
Republic of Korea,1960,KR,KOR,WPR,2362379,3220022,5582401,2748321,1514011,1240654,958860,548347,333566,7343759,2243206,2994450,5237656,2447223,1793091,1310340,951998,631586,519476,7653714,14997473,25817529,25817529
Republic of Korea,1961,KR,KOR,WPR,2442054,3336522,5778576,2766186,1627396,1255335,968239,562120,346394,7525670,2313292,3125959,5439251,2467886,1845076,1343481,972398,641008,538874,7808723,15334393,26552225,26552225
Republic of Korea,1962,KR,KOR,WPR,2507410,3464687,5972097,2745557,1769915,1270902,972998,575238,357896,7692506,2364701,3270818,5635519,2468732,1901598,1371063,988522,651619,552815,7934349,15626855,27234470,27234470
Republic of Korea,1963,KR,KOR,WPR,2546026,3632764,6178790,2709916,1906874,1290337,979589,588535,367422,7842673,2390417,3429969,5820386,2469139,1962118,1400545,1002534,665191,564497,8064024,15906697,27905873,27905873
Republic of Korea,1964,KR,KOR,WPR,2551931,3827286,6379217,2687068,2015025,1321572,988089,602984,373239,7987977,2386859,3603091,5989950,2469760,2022178,1437501,1012533,683498,573255,8198725,16186702,28555856,28555856
Republic of Korea,1965,KR,KOR,WPR,2525026,4040357,6565383,2681187,2091748,1359520,1003873,617248,377674,8131250,2357812,3786173,6143985,2474564,2078314,1474977,1024649,704164,582123,8338791,16470041,29179407,29179407
Republic of Korea,1966,KR,KOR,WPR,2483113,4252306,6735419,2701276,2159692,1388203,1026105,634573,387311,8297160,2321348,3974887,6296235,2491744,2133189,1512325,1045995,723907,602243,8509403,16806563,29838219,29838219
Republic of Korea,1967,KR,KOR,WPR,2442509,4427851,6870360,2756155,2228400,1414964,1052141,658268,400609,8510537,2291369,4137062,6428431,2536536,2184466,1557886,1074399,747279,630710,8731276,17241813,30540596,30540596
Republic of Korea,1968,KR,KOR,WPR,2396965,4580890,6977855,2824896,2292756,1448770,1082377,684343,410623,8743765,2259602,4276351,6535953,2609674,2222461,1601257,1107758,776074,654831,8972055,17715820,31229630,31229630
Republic of Korea,1969,KR,KOR,WPR,2364878,4703507,7068385,2913126,2342783,1496657,1109526,708867,419005,8989964,2238689,4388587,6627276,2713667,2241536,1647459,1143555,803715,676456,9226388,18216352,31912015,31912015
Republic of Korea,2031,KR,KOR,WPR,779009,1602473,2381482,2340206,2971077,3728603,3908954,4202309,5892238,23043387,735119,1517165,2252284,2217884,2742415,3294686,3700823,4225410,7314836,23496054,46539441,51173200,51173200
Republic of Korea,2032,KR,KOR,WPR,777623,1559222,2336845,2302710,2845168,3755858,3867115,4165504,6069451,23005806,733650,1475182,2208832,2185022,2637106,3318871,3645617,4179306,7522963,23488885,46494691,51040363,51040363
Republic of Korea,2033,KR,KOR,WPR,772664,1535384,2308048,2242881,2738719,3768899,3823969,4112904,6255917,22943289,728837,1452170,2181007,2129337,2546755,3336081,3587368,4107178,7751397,23458116,46401405,50890473,50890473
Republic of Korea,2034,KR,KOR,WPR,763151,1526796,2289947,2176968,2637341,3762759,3772872,4057885,6452152,22859977,719781,1443452,2163233,2068296,2461162,3340907,3516124,4034956,7987132,23408577,46268554,50721724,50721724
Republic of Korea,2035,KR,KOR,WPR,749721,1528352,2278073,2101250,2541893,3739683,3708377,4026039,6642212,22759454,707044,1444389,2151433,1998212,2379065,3334987,3428019,3990970,8212347,23343600,46103054,50532567,50532567
Republic of Korea,2036,KR,KOR,WPR,734111,1533582,2267693,2012785,2472106,3685691,3650225,3996778,6829547,22647132,692267,1448819,2141086,1915282,2319598,3302182,3350111,3949369,8431665,23268207,45915339,50324119,50324119
Republic of Korea,2037,KR,KOR,WPR,717544,1538945,2256489,1918629,2441300,3579288,3614171,3969543,7003171,22526102,676614,1453436,2130050,1825975,2297269,3221753,3293439,3911457,8635312,23185205,45711307,50097849,50097849
Republic of Korea,2038,KR,KOR,WPR,701047,1542047,2243094,1832975,2424220,3441145,3606400,3938309,7155072,22398121,661011,1455989,2117000,1743849,2288128,3116293,3258964,3867085,8821931,23096250,45494371,49854467,49854467
Republic of Korea,2039,KR,KOR,WPR,686055,1540407,2226462,1758375,2405798,3295883,3628336,3883214,7293153,22264759,646805,1454131,2100936,1671610,2277055,3007818,3253619,3795508,8997141,23002751,45267510,49594904,49594904
Republic of Korea,2040,KR,KOR,WPR,673769,1532905,2206674,1686855,2397972,3143260,3666135,3828000,7404150,22126372,635161,1446787,2081948,1602381,2274699,2890428,3270069,3723881,9143523,22904981,45031353,49319974,49319974
Republic of Korea,2041,KR,KOR,WPR,663910,1519522,2183432,1624552,2388543,2993996,3702708,3788008,7485909,21983716,625819,1433951,2059770,1541771,2270076,2770265,3294738,3667384,9259136,22803370,44787086,49030283,49030283
Republic of Korea,2042,KR,KOR,WPR,656631,1501592,2158223,1581367,2351143,2868723,3730071,3748480,7556566,21836350,618911,1416856,2035767,1499832,2237277,2665252,3319036,3613159,9362642,22697198,44533548,48727532,48727532
Republic of Korea,2043,KR,KOR,WPR,651823,1480161,2131984,1557575,2291446,2762847,3743239,3707670,7620866,21683643,614354,1396461,2010815,1476852,2181678,2575178,3336362,3555902,9459760,22585732,44269375,48412166,48412166
Republic of Korea,2044,KR,KOR,WPR,648232,1455683,2103915,1549017,2225658,2662019,3737376,3659530,7692228,21525828,610961,1373226,1984187,1468158,2120721,2489838,3341325,3485865,9562764,22468671,43994499,48082601,48082601
Republic of Korea,2045,KR,KOR,WPR,645261,1429989,2075250,1550595,2150086,2567121,3714783,3599114,7780108,21361807,608148,1348872,1957020,1469113,2050728,2408003,3335582,3399343,9681725,22344494,43706301,47738573,47738573
Republic of Korea,2046,KR,KOR,WPR,642322,1404555,2046877,1555837,2061786,2497804,3661610,3545312,7868310,21190659,605358,1324780,1930138,1473558,1967904,2348749,3303068,3323039,9795606,22211924,43402583,47379594,47379594
Republic of Korea,2047,KR,KOR,WPR,637701,1380736,2018437,1561214,1967805,2467292,3556552,3513230,7946012,21012105,600998,1302241,1903239,1478185,1878707,2326548,3223091,3267846,9895960,22070337,43082442,47004124,47004124
Republic of Korea,2048,KR,KOR,WPR,630265,1359450,1989715,1564327,1882307,2450403,3420113,3508482,8000122,20825754,594011,1282099,1876110,1480747,1796686,2317499,3118174,3234614,9971581,21919301,42745055,46610891,46610891
Republic of Korea,2049,KR,KOR,WPR,620131,1340894,1961025,1562700,1807855,2432147,3276680,3532052,8019913,20631347,584482,1264528,1849010,1478905,1724537,2306509,3010250,3230068,10007895,21758164,42389511,46199541,46199541
Republic of Korea,2050,KR,KOR,WPR,607320,1325655,1932975,1555215,1736477,2424436,3125986,3570575,8016244,20428933,572428,1250085,1822513,1471577,1655399,2304215,2893440,3246995,10014828,21586454,42015387,45770874,45770874
Kuwait,1970,KW,KWT,EMR,77077,107461,184538,82628,79123,54905,29996,11748,6928,265328,74466,99520,173986,62577,51307,32580,16621,8536,7314,178935,444263,802786,802786
Kuwait,1971,KW,KWT,EMR,82128,116645,198773,86607,83291,57651,32054,12794,7191,279588,79455,108586,188041,66931,55091,35278,18129,9182,7717,192328,471916,858734,858734
Kuwait,1972,KW,KWT,EMR,86744,124727,211471,91641,88036,60529,34099,13844,7363,295512,83945,116511,200456,71747,58932,37974,19744,9906,8050,206353,501865,913785,913785
Kuwait,1973,KW,KWT,EMR,91189,132903,224092,97213,92874,63548,36223,14972,7556,312386,88249,124584,212833,77015,62906,40713,21476,10714,8383,221207,533593,970527,970527
Kuwait,1974,KW,KWT,EMR,95560,141450,237010,103639,97859,66819,38348,16151,7831,330647,92458,133017,225475,82932,67064,43589,23367,11604,8740,237296,567943,1030426,1030426
Kuwait,1975,KW,KWT,EMR,100167,150439,250606,111594,103270,70434,40410,17359,8191,351258,96863,141783,238646,89995,71541,46759,25471,12589,9123,255478,606736,1095998,1095998
Kuwait,1976,KW,KWT,EMR,105266,158625,263891,121393,113018,76400,42626,18289,8431,380157,101733,149801,251534,96894,76492,49851,27276,13349,9350,273212,653369,1168791,1168791
Kuwait,1977,KW,KWT,EMR,110668,166078,276746,131894,127210,85064,45181,18936,8525,416810,106914,157217,264131,102940,81868,52795,28723,13838,9382,289546,706356,1247225,1247225
Kuwait,1978,KW,KWT,EMR,116090,174194,290284,141825,142034,94667,48117,19607,8665,454915,112126,165236,277362,108948,87502,56018,30277,14354,9412,306511,761426,1329074,1329074
Kuwait,1979,KW,KWT,EMR,121295,182973,304268,150676,156759,104941,51547,20414,8843,493180,117122,173901,291023,114723,93227,59523,31923,14921,9482,323799,816979,1412266,1412266
Kuwait,1980,KW,KWT,EMR,126025,192379,318404,157765,170283,115490,55526,21453,9078,529595,121670,183217,304887,120040,98746,63291,33692,15585,9633,340987,870582,1493870,1493870
Kuwait,1981,KW,KWT,EMR,130998,199883,330881,164639,184874,124520,58561,22235,9272,564101,126532,190603,317135,126866,105809,67140,35184,16111,9798,360908,925009,1573026,1573026
Kuwait,1982,KW,KWT,EMR,136500,205630,342130,171779,201884,132507,60475,22641,9382,598668,131924,196116,328040,135106,115073,71193,36338,16433,9953,384096,982764,1652921,1652921
Kuwait,1983,KW,KWT,EMR,141862,212220,354082,178152,219588,141496,62582,23055,9468,634341,137142,202350,339492,142805,125145,75729,37528,16776,10129,408112,1042453,1736028,1736028
Kuwait,1984,KW,KWT,EMR,145700,220933,366633,181092,233702,151361,65761,23914,9712,665542,140910,210771,351681,148243,134244,80731,39117,17383,10414,430132,1095674,1813986,1813986
Kuwait,1985,KW,KWT,EMR,148176,230858,379034,182502,245535,161969,69715,25015,10072,694808,143382,220419,363801,152393,142909,86037,41054,18167,10776,451336,1146144,1888975,1888975
Kuwait,1986,KW,KWT,EMR,149012,245561,394573,180426,251130,174826,76581,27539,10883,721385,144256,234964,379220,154895,150032,92609,44329,19633,11418,472916,1194301,1968093,1968093
Kuwait,1987,KW,KWT,EMR,147472,265667,413139,174564,247424,189660,87155,32008,12328,743139,142834,255087,397921,155744,154318,100508,49249,22012,12451,494282,1237421,2048477,2048477
Kuwait,1988,KW,KWT,EMR,144856,285007,429863,171903,240918,204301,98657,37048,14023,766850,140320,274426,414746,158497,157693,108554,54674,24664,13615,517697,1284547,2129153,2129153
Kuwait,1989,KW,KWT,EMR,141511,302565,444076,173148,231942,218362,111004,42703,15964,793123,137002,291996,428998,163937,160137,116656,60601,27550,14934,543815,1336938,2210013,2210013
Kuwait,1990,KW,KWT,EMR,100166,230600,330766,132568,161498,169314,90908,35791,13377,603456,96851,222952,319803,127266,118499,91369,49160,22528,12083,420905,1024361,1674938,1674938
Kuwait,1991,KW,KWT,EMR,72594,181013,253607,113056,113493,138446,80317,32503,12323,490138,70001,175386,245387,108918,91352,76344,43134,19965,10659,350372,840510,1339500,1339500
Kuwait,1992,KW,KWT,EMR,85136,213225,298361,143838,129419,167736,101434,41602,15971,600000,81982,206690,288672,138388,107964,94081,54408,25214,13544,433599,1033599,1620633,1620633
Kuwait,1993,KW,KWT,EMR,88645,201160,289805,152599,152993,170843,100387,41132,16144,634098,85338,194806,280144,144584,116908,96239,53581,24704,13584,449600,1083698,1653645,1653645
Kuwait,1994,KW,KWT,EMR,94573,180233,274806,144061,205605,172745,87332,34733,13696,658172,91080,174210,265290,134821,134077,95268,46042,20815,11815,442838,1101010,1641106,1641106
Kuwait,1995,KW,KWT,EMR,97865,175160,273025,135907,241089,180105,80046,30765,11801,679713,94077,168518,262595,124758,146895,97542,41784,18327,10588,439894,1119607,1655222,1655222
Kuwait,1996,KW,KWT,EMR,98009,180225,278234,146077,248392,187868,82119,31116,11893,707465,93827,172255,266082,126633,151060,101753,42946,18371,10776,451539,1159004,1703318,1703318
Kuwait,1997,KW,KWT,EMR,98366,183982,282348,164552,248052,194675,87370,32748,12835,740232,93777,175219,268996,134395,152708,106088,45919,19270,11516,469896,1210128,1761468,1761468
Kuwait,1998,KW,KWT,EMR,99621,184778,284399,182571,249867,201508,92951,34231,13897,775025,94701,175726,270427,142810,154966,110353,49030,20233,12304,489696,1264721,1819544,1819544
Kuwait,1999,KW,KWT,EMR,101033,184032,285065,198136,254773,208669,98845,35663,15054,811140,95852,174823,270675,151079,158135,114655,52266,21309,13110,510554,1321694,1877427,1877427
Kuwait,2000,KW,KWT,EMR,102099,182798,284897,209600,263408,216472,105073,37133,16221,847907,96694,173363,270057,158379,162483,119124,55619,22528,13896,532029,1379936,1934901,1934901
Kuwait,2001,KW,KWT,EMR,102708,181684,284392,215847,276018,225159,111644,38728,17318,884714,97091,171850,268941,163895,168255,123865,59064,23905,14640,553624,1438338,1991674,1991674
Kuwait,2002,KW,KWT,EMR,102798,181154,283952,216494,292320,234869,118499,40528,18246,920956,96943,170715,267658,166954,175553,128971,62567,25428,15325,574798,1495754,2047364,2047364
Kuwait,2003,KW,KWT,EMR,102284,181464,283748,211940,311385,245793,125572,42577,18930,956197,96141,170246,266387,167282,184219,134545,66096,27065,15963,595170,1551367,2101506,2101506
Kuwait,2004,KW,KWT,EMR,101007,182593,283600,203360,331640,258304,132782,44876,19337,990299,94533,170494,265027,165068,193758,140726,69662,28769,16575,614558,1604857,2153481,2153481
Kuwait,2005,KW,KWT,EMR,102209,185676,287885,202402,349006,272334,140572,47767,19984,1032065,95632,172850,268482,169762,205497,149388,74185,30719,17420,646971,1679036,2235403,2235403
Kuwait,2006,KW,KWT,EMR,108022,190816,298838,213362,363590,287211,149346,51373,21293,1086175,101566,177520,279086,184978,220793,161454,80368,33067,18652,699312,1785487,2363409,2363409
Kuwait,2007,KW,KWT,EMR,115530,196368,311898,224843,379920,302669,158908,55441,22881,1144662,109054,182890,291944,200412,238901,175354,87742,35746,20117,758272,1902934,2506769,2506769
Kuwait,2008,KW,KWT,EMR,122720,201914,324634,231856,399400,319056,169174,59962,24490,1203938,115978,188527,304505,211249,259617,190463,96060,38772,21699,817860,2021798,2650930,2650930
Kuwait,2009,KW,KWT,EMR,128957,207757,336714,234240,422045,336525,180375,64988,26076,1264249,121642,194576,316218,217200,283170,207025,105388,42193,23390,878366,2142615,2795550,2795550
Kuwait,2010,KW,KWT,EMR,135442,214477,349919,232192,447060,355303,193045,70450,27669,1325719,126239,201538,327777,218038,309419,225343,115903,45864,25375,939942,2265661,2943356,2943356
Kuwait,2011,KW,KWT,EMR,144461,224497,368958,227156,470711,395502,215103,80786,30357,1419615,133621,211024,344645,214678,334093,252573,130369,51075,27816,1010604,2430219,3143825,3143825
Kuwait,2012,KW,KWT,EMR,154454,237620,392074,222429,486233,458734,247263,96983,34511,1546153,143081,222826,365907,210033,353351,288924,149275,58283,30670,1090536,2636689,3394663,3394663
Kuwait,2013,KW,KWT,EMR,162479,252187,414666,220036,490447,525079,283577,115305,39635,1674079,150193,235858,386051,206553,366845,327003,170715,66649,33957,1171722,2845801,3646518,3646518
Kuwait,2014,KW,KWT,EMR,167429,261579,429008,217912,471873,567466,312861,131650,44813,1746575,152402,240841,393243,199665,357252,341989,184238,73004,36611,1192759,2939334,3761584,3761584
Kuwait,2015,KW,KWT,EMR,171027,283865,454892,224794,460257,631752,358566,155977,52831,1884177,149886,243771,393657,193352,333070,340779,191730,78178,38909,1176018,3060195,3908743,3908743
Kuwait,2016,KW,KWT,EMR,168621,306234,474855,233550,435966,674580,403396,178830,61632,1987954,146565,252657,399222,194869,313024,345454,204946,85782,41978,1186053,3174007,4048085,4048085
Kuwait,2017,KW,KWT,EMR,163667,317526,481193,239312,394076,680982,442906,198328,71158,2026762,144272,261659,405931,199911,294202,352441,223390,95180,45902,1211026,3237788,4124904,4124904
Kuwait,2018,KW,KWT,EMR,162064,336902,498966,250890,371052,715341,506297,228262,85027,2156869,142602,271215,413817,205642,277724,362662,244830,105945,50721,1247524,3404393,4317185,4317185
Kuwait,2019,KW,KWT,EMR,156163,349493,505656,259623,340217,721469,557171,254041,100045,2232566,139785,279842,419627,211610,260470,370485,266664,117441,56578,1283248,3515814,4441100,4441100
Kuwait,2020,KW,KWT,EMR,144976,352038,497014,239811,277857,687933,585458,271110,111874,2174043,133174,284385,417559,203446,228394,367476,283003,127667,61840,1271826,3445869,4360444,4360444
Kuwait,2021,KW,KWT,EMR,133857,352359,486216,219492,217946,646899,609415,287973,122748,2104473,125008,286406,411414,194147,195159,359323,295079,137590,66706,1248004,3352477,4250114,4250114
Kuwait,2022,KW,KWT,EMR,125221,352047,477268,229256,193745,612801,636153,309371,137357,2118683,118364,288673,407037,200966,179260,354846,308347,149337,73140,1265896,3384579,4268873,4268873
Kuwait,2023,KW,KWT,EMR,118066,348181,466247,245212,181884,575284,660087,333544,154040,2150051,112384,288853,401237,211104,169695,348294,320604,162245,80631,1292573,3442624,4310108,4310108
Kuwait,2024,KW,KWT,EMR,112057,340392,452449,262296,176403,532445,679373,360420,172101,2183038,106946,286477,393423,221923,164136,337807,331246,176294,89071,1320477,3503515,4349380,4349380
Kuwait,2025,KW,KWT,EMR,106473,329670,436143,280695,176428,485071,693407,390433,191516,2217550,101726,282072,383798,233642,162719,322863,340181,191638,98567,1349610,3567160,4387109,4387109
Kuwait,2026,KW,KWT,EMR,102195,315841,418036,299861,181064,434861,701697,423311,212333,2253127,97740,275107,372847,246005,165103,303933,347387,208137,109153,1379718,3632845,4423726,4423726
Kuwait,2027,KW,KWT,EMR,100002,299234,399236,318480,189487,384342,703899,458009,234571,2288788,95683,265554,361237,258266,170591,282410,352933,225312,120748,1410260,3699048,4459526,4459526
Kuwait,2028,KW,KWT,EMR,98964,281886,380850,335236,200750,336233,699703,493329,258296,2323547,94718,254893,349611,269703,178296,259887,356933,242630,133284,1440733,3764280,4494733,4494733
Kuwait,2029,KW,KWT,EMR,98918,265144,364062,348899,213816,293218,688788,528107,283546,2356374,94696,243999,338695,279639,187255,237937,359466,259592,146681,1470570,3826944,4529698,4529698
Kuwait,2030,KW,KWT,EMR,99725,250115,349840,358399,227749,257737,670878,561189,310425,2386377,95488,233578,329066,287459,196639,218099,360502,275682,160903,1499284,3885661,4564570,4564570
Kuwait,1950,KW,KWT,EMR,12297,17205,29502,19998,20399,10506,5984,2816,2302,62005,11865,15977,27842,12346,8416,4927,4356,2223,2120,34388,96393,153738,153738
Kuwait,1951,KW,KWT,EMR,12796,17712,30508,19027,21083,11357,6127,2940,2359,62893,12340,16657,28997,12552,8777,5116,4412,2296,2206,35359,98252,157764,157764
Kuwait,1952,KW,KWT,EMR,13308,18358,31666,18051,21703,12266,6201,3115,2402,63738,12834,17438,30272,12689,9131,5370,4412,2435,2276,36313,100051,161988,161988
Kuwait,1953,KW,KWT,EMR,13821,19118,32939,17150,22185,13217,6279,3320,2433,64584,13331,18317,31648,12791,9482,5669,4377,2614,2331,37264,101848,166439,166439
Kuwait,1954,KW,KWT,EMR,14352,19915,34267,16440,22425,14175,6433,3546,2465,65484,13841,19238,33079,12915,9838,5989,4341,2806,2374,38263,103747,171095,171095
Kuwait,1955,KW,KWT,EMR,15061,20883,35944,17458,24046,15950,7066,3940,2599,71059,14528,20256,34784,13963,11040,6702,4476,3063,2436,41680,112739,183458,183458
Kuwait,1956,KW,KWT,EMR,16174,22044,38218,20036,27119,18597,8194,4521,2830,81297,15607,21371,36978,15852,13139,7837,4800,3384,2528,47540,128837,204028,204028
Kuwait,1957,KW,KWT,EMR,17725,23176,40901,22004,29517,21048,9372,5096,3032,90069,17105,22456,39561,17366,15060,8919,5113,3699,2583,52740,142809,223274,223274
Kuwait,1958,KW,KWT,EMR,20275,25146,45421,24763,31913,23199,10421,5563,3197,99056,19532,24019,43551,18901,16827,9911,5430,4040,2691,57800,156856,245827,245827
Kuwait,1959,KW,KWT,EMR,23709,28111,51820,28910,35043,25384,11420,5928,3391,110076,22784,26256,49040,20818,18688,10952,5818,4399,2902,63577,173653,274514,274514
Kuwait,1960,KW,KWT,EMR,27331,31422,58753,33166,38497,27781,12543,6249,3617,121853,26208,28916,55124,22816,20603,12095,6283,4722,3167,69686,191539,305415,305415
Kuwait,1961,KW,KWT,EMR,31051,35440,66491,37764,42423,30474,13801,6522,3888,134872,29709,32296,62005,24962,22624,13372,6846,5021,3503,76328,211200,339697,339697
Kuwait,1962,KW,KWT,EMR,34795,40628,75423,43075,46402,33289,15237,6723,4161,148887,33167,36683,69850,27819,24792,14762,7538,5276,3844,84031,232918,378190,378190
Kuwait,1963,KW,KWT,EMR,38803,46660,85463,49019,50356,36114,16844,6923,4412,163668,36855,41734,78589,31403,27101,16251,8354,5507,4161,92777,256445,420494,420494
Kuwait,1964,KW,KWT,EMR,43162,53068,96230,55137,54732,39017,18563,7229,4672,179350,40937,47157,88094,35164,29547,17878,9238,5765,4482,102074,281424,465748,465748
Kuwait,1965,KW,KWT,EMR,47812,59926,107738,61293,59535,41965,20402,7684,4940,195819,45357,53032,98389,38993,32204,19644,10177,6067,4803,111888,307707,513840,513840
Kuwait,1966,KW,KWT,EMR,53026,67748,120774,66337,63782,44682,22242,8257,5278,210578,50478,60336,110814,43229,35400,21767,11244,6436,5218,123294,333872,565463,565463
Kuwait,1967,KW,KWT,EMR,58856,76744,135600,70358,67404,47135,24053,8955,5711,223616,56313,69244,125557,47982,39140,24288,12452,6875,5740,136477,360093,621242,621242
Kuwait,1968,KW,KWT,EMR,65034,86618,151652,74655,71309,49648,25930,9782,6149,237473,62471,78952,141423,52994,43168,27007,13765,7372,6262,150568,388041,681117,681117
Kuwait,1969,KW,KWT,EMR,71289,97062,168351,78950,75316,52251,27908,10718,6564,251707,68693,89215,157908,58027,47335,29819,15170,7930,6804,165085,416792,743044,743044
Kuwait,2031,KW,KWT,EMR,101300,237394,338694,363263,242177,230751,646077,591666,339239,2413173,97009,224132,321141,292792,206111,201339,359711,290559,176080,1526592,3939765,4599596,4599596
Kuwait,2032,KW,KWT,EMR,103623,227012,330635,363630,257241,211768,614841,618898,370475,2436853,99243,215872,315115,295559,215804,188048,356423,304096,192473,1552403,3989256,4635015,4635015
Kuwait,2033,KW,KWT,EMR,106627,218840,325467,359781,273167,199984,577748,642276,404714,2457670,102128,208939,311067,295742,225936,178518,349923,316177,210409,1576705,4034375,4670915,4670915
Kuwait,2034,KW,KWT,EMR,110185,212802,322987,352011,290220,194555,535380,661202,442483,2475851,105540,203488,309028,293367,236750,172987,339509,326682,230218,1599513,4075364,4707382,4707382
Kuwait,2035,KW,KWT,EMR,114182,208042,322224,341318,308596,194604,488526,675105,484182,2492331,109373,199067,308440,288965,248464,171580,324661,335532,252134,1621336,4113667,4744328,4744328
Kuwait,2036,KW,KWT,EMR,118450,205349,323799,327528,327730,199250,438870,683498,529542,2506418,113472,196607,310079,282001,260820,173972,305853,342703,276026,1641375,4147793,4781662,4781662
Kuwait,2037,KW,KWT,EMR,122812,205488,328300,310963,346322,207661,388917,686008,577574,2517445,117656,196786,314442,272455,273075,179458,284467,348261,301352,1659068,4176513,4819257,4819257
Kuwait,2038,KW,KWT,EMR,127016,207459,334475,293656,363059,218901,341354,682310,627179,2526459,121687,198710,320397,261804,284505,187152,262089,352303,327518,1675371,4201830,4856708,4856708
Kuwait,2039,KW,KWT,EMR,130846,210973,341819,276954,376714,231939,298844,672052,677284,2533787,125365,202099,327464,250913,294440,196102,240294,354900,353935,1690584,4224371,4893652,4893652
Kuwait,2040,KW,KWT,EMR,134180,215780,349960,261958,386215,245851,263796,654931,726851,2539602,128560,206725,335285,240500,302255,205475,220606,356016,380051,1704903,4244505,4929743,4929743
Kuwait,2041,KW,KWT,EMR,136839,221623,358462,249270,391088,260254,237163,631039,775275,2544089,131105,212345,343450,231058,307584,214934,203983,355317,405653,1718529,4262618,4964524,4964524
Kuwait,2042,KW,KWT,EMR,138702,228310,367012,238913,391477,275289,218456,600833,822418,2547386,132892,218763,351655,222802,310352,224620,190812,352145,430854,1731585,4278971,4997633,4997633
Kuwait,2043,KW,KWT,EMR,139698,235520,375218,230764,387654,291186,206870,564890,868235,2549599,133845,225680,359525,215869,310537,234743,181383,345799,455860,1744191,4293790,5028536,5028536
Kuwait,2044,KW,KWT,EMR,139714,242907,382621,224749,379920,308215,201573,523803,912673,2550933,133855,232767,366622,210423,308163,245545,175928,335587,480847,1756493,4307426,5056669,5056669
Kuwait,2045,KW,KWT,EMR,138807,250241,389048,219999,369268,326555,201694,478348,955543,2551407,132983,239797,372780,206005,303768,257246,174565,320999,505986,1768569,4319976,5081806,5081806
Kuwait,2046,KW,KWT,EMR,137092,257166,394258,217321,355522,345659,206358,430179,996131,2551170,131338,246439,377777,203547,296811,269591,176975,302509,531096,1780529,4331699,5103734,5103734
Kuwait,2047,KW,KWT,EMR,134610,263390,398000,217467,339003,364218,214751,381738,1033167,2550344,128958,252408,381366,203730,287273,281834,182452,281485,555717,1792491,4342835,5122198,5122198
Kuwait,2048,KW,KWT,EMR,131521,268597,400118,219445,321744,380926,225943,335642,1065285,2548985,126000,257396,383396,205652,276625,293250,190128,259494,579351,1804500,4353485,5137002,5137002
Kuwait,2049,KW,KWT,EMR,128063,272446,400509,222964,305087,394559,238916,294482,1091159,2547167,122689,261082,383771,209045,265744,303174,199047,238090,601511,1816611,4363778,5148056,5148056
Kuwait,2050,KW,KWT,EMR,124358,274876,399234,227770,290130,404047,252759,260599,1109539,2544844,119145,263411,382556,213668,255337,310979,208389,218776,621636,1828785,4373629,5155414,5155414
Lao People's Democratic Republic,1970,LA,LAO,WPR,228256,345355,573611,251607,172098,130568,95682,59897,36712,746564,223438,339904,563342,256336,180609,135270,103879,69602,46077,791773,1538337,2675283,2675283
Lao People's Democratic Republic,1971,LA,LAO,WPR,234521,353919,588440,259499,175841,132388,97345,61339,37817,764229,229456,348118,577574,262630,185848,137179,105668,71338,47835,810498,1574727,2740732,2740732
Lao People's Democratic Republic,1972,LA,LAO,WPR,240975,362904,603879,267432,179851,134362,99032,62841,38911,782429,235651,356724,592375,268827,191364,139265,107493,73099,49555,829603,1612032,2808290,2808290
Lao People's Democratic Republic,1973,LA,LAO,WPR,247648,372310,619958,275467,184003,136415,100703,64363,40000,800951,242037,365722,607759,275198,196781,141511,109302,74852,51251,848895,1649846,2877561,2877561
Lao People's Democratic Republic,1974,LA,LAO,WPR,254516,382063,636579,284355,187391,138380,102314,65871,41108,819419,248589,375025,623614,281955,201206,143722,110949,76517,52918,867267,1686686,2946882,2946882
Lao People's Democratic Republic,1975,LA,LAO,WPR,261287,392177,653464,291700,191391,139960,103739,67302,42232,836324,255051,384639,639690,287502,205163,145654,112309,78053,54557,883238,1719562,3012720,3012720
Lao People's Democratic Republic,1976,LA,LAO,WPR,267651,402504,670155,296372,196156,140927,104825,68557,43298,850135,261124,394428,655552,291352,208715,147220,113336,79419,56135,896177,1746312,3072017,3072017
Lao People's Democratic Republic,1977,LA,LAO,WPR,273484,412985,686469,300616,199908,141422,105601,69642,44306,861495,266683,404337,671020,294808,211043,148552,114053,80626,57662,906744,1768239,3125742,3125742
Lao People's Democratic Republic,1978,LA,LAO,WPR,278734,423776,702510,305088,203262,141800,106232,70646,45334,872362,271672,414559,686231,298551,212760,149932,114617,81758,59220,916838,1789200,3177945,3177945
Lao People's Democratic Republic,1979,LA,LAO,WPR,283642,435074,718716,310574,206869,142463,106901,71674,46442,884923,276315,425257,701572,303396,214506,151649,115214,82907,60816,928488,1813411,3233700,3233700
Lao People's Democratic Republic,1980,LA,LAO,WPR,288749,446889,735638,317614,211300,143784,107777,72830,47693,900998,281130,436448,717578,309823,216835,153986,116004,84138,62515,943301,1844299,3297519,3297519
Lao People's Democratic Republic,1981,LA,LAO,WPR,294496,459012,753508,326234,216837,145864,108938,74117,49088,921078,286570,447965,734535,317873,220094,157032,117064,85476,64337,961876,1882954,3370993,3370993
Lao People's Democratic Republic,1982,LA,LAO,WPR,301247,471253,772500,336189,223489,148564,110389,75510,50596,944737,292960,459583,752543,327353,224346,160642,118406,86915,66238,983900,1928637,3453691,3453691
Lao People's Democratic Republic,1983,LA,LAO,WPR,309215,483460,792675,347037,231110,151697,112046,76964,52191,971045,300518,471160,771678,337785,229679,164422,119988,88395,68191,1008460,1979505,3543861,3543861
Lao People's Democratic Republic,1984,LA,LAO,WPR,318341,495675,814016,358385,240315,154466,113752,78414,53813,999145,309219,482758,791977,348746,236461,167824,121763,89840,70183,1034817,2033962,3639956,3639956
Lao People's Democratic Republic,1985,LA,LAO,WPR,328373,508027,836400,370191,249300,158673,115487,79855,55470,1028976,318835,494498,813333,360177,243657,171878,123734,91226,72215,1062887,2091863,3741604,3741604
Lao People's Democratic Republic,1986,LA,LAO,WPR,338995,520764,859759,382292,257359,164981,117318,81293,57168,1060411,329048,506626,835674,371902,250917,176910,125971,92567,74279,1092546,2152957,3848390,3848390
Lao People's Democratic Republic,1987,LA,LAO,WPR,349897,534168,884065,394510,266190,171561,119300,82718,58874,1093153,339522,519432,858954,383743,259056,182009,128526,93857,76334,1123525,2216678,3959697,3959697
Lao People's Democratic Republic,1988,LA,LAO,WPR,360829,548351,909180,406831,275599,178392,121472,84137,60578,1127009,350015,533037,883052,395691,267905,187172,131414,95129,78397,1155708,2282717,4074961,4074961
Lao People's Democratic Republic,1989,LA,LAO,WPR,371669,563358,935027,419227,285439,185333,123850,85560,62285,1161694,360425,547494,907919,407714,277327,192300,134607,96435,80511,1188894,2350588,4193532,4193532
Lao People's Democratic Republic,1990,LA,LAO,WPR,382381,579236,961617,431537,295520,192292,126458,86977,63964,1196748,370702,562817,933519,419645,287087,197320,138090,97792,82624,1222558,2419306,4314443,4314443
Lao People's Democratic Republic,1991,LA,LAO,WPR,392935,596085,989020,443598,305691,199303,129303,88430,65646,1231971,380844,579071,959915,431282,296959,202284,141825,99220,84745,1256315,2488286,4437225,4437225
Lao People's Democratic Republic,1992,LA,LAO,WPR,403012,613972,1016984,455323,315865,206438,132290,89955,67324,1267195,390578,596315,986893,442519,306865,207279,145701,100759,86909,1290032,2557227,4561106,4561106
Lao People's Democratic Republic,1993,LA,LAO,WPR,412297,632879,1045176,466675,325958,213815,135358,91516,68971,1302293,399566,614574,1014140,453369,316731,212646,149464,102400,89068,1323678,2625971,4685296,4685296
Lao People's Democratic Republic,1994,LA,LAO,WPR,419998,652705,1072703,477777,335848,222205,137869,93019,70568,1337286,406959,633790,1040749,463945,326392,218925,152678,104125,91148,1357213,2694499,4807950,4807950
Lao People's Democratic Republic,1995,LA,LAO,WPR,425334,673244,1098578,488775,345518,229961,141496,94457,72122,1372329,412013,653747,1065760,474392,335825,225170,156310,105933,93136,1390766,2763095,4927432,4927432
Lao People's Democratic Republic,1996,LA,LAO,WPR,428357,694203,1122560,499975,354894,236454,146863,95892,73637,1407715,414814,674137,1088951,485035,344926,231076,160685,107903,95061,1424686,2832401,5043914,5043914
Lao People's Democratic Republic,1997,LA,LAO,WPR,428204,713403,1141607,509624,363398,243657,152353,97607,76109,1442748,414206,692971,1107177,495394,353783,237997,164492,109835,97509,1459010,2901758,5150538,5150538
Lao People's Democratic Republic,1998,LA,LAO,WPR,424868,730608,1155476,517982,370865,251525,157914,99623,79580,1477489,410401,709530,1119931,505770,362379,245924,167843,111673,100433,1494022,2971511,5246922,5246922
Lao People's Democratic Republic,1999,LA,LAO,WPR,420481,746592,1167073,527400,377590,259643,163466,101715,83111,1512925,405912,724067,1129979,517215,370479,254240,171366,113554,103230,1530084,3043009,5340056,5340056
Lao People's Democratic Republic,2000,LA,LAO,WPR,416788,759975,1176763,538086,383537,267717,169206,103892,86701,1549139,402195,735538,1137733,529886,378061,262624,175298,115411,105939,1567219,3116358,5430853,5430853
Lao People's Democratic Republic,2001,LA,LAO,WPR,414098,770285,1184383,550244,388825,275447,175289,106151,90363,1586319,399560,743657,1143217,543992,385257,270832,179890,117202,108613,1605786,3192105,5519707,5519707
Lao People's Democratic Republic,2002,LA,LAO,WPR,411317,778010,1189327,564028,393761,282627,181730,108511,94056,1624713,397183,748989,1146172,559443,392307,278753,185239,118947,111195,1645884,3270597,5606101,5606101
Lao People's Democratic Republic,2003,LA,LAO,WPR,407407,783567,1190974,579543,398712,289033,188494,111092,97654,1664528,393924,752349,1146273,575929,399456,286252,191420,120681,113553,1687291,3351819,5689065,5689065
Lao People's Democratic Republic,2004,LA,LAO,WPR,402183,786679,1188862,596886,403812,294652,195411,113952,101150,1705863,389541,754157,1143698,593090,406862,293341,198189,122544,115718,1729744,3435607,5768167,5768167
Lao People's Democratic Republic,2005,LA,LAO,WPR,397804,785691,1183495,617577,411970,301043,202739,117198,103531,1754058,385530,753904,1139434,610943,415899,301097,205105,125176,117762,1775982,3530040,5852970,5852970
Lao People's Democratic Republic,2006,LA,LAO,WPR,395670,780786,1176456,640039,424372,308708,210630,120905,104850,1809504,382855,751501,1134356,628543,427156,309678,212266,128653,119976,1826272,3635776,5946593,5946593
Lao People's Democratic Republic,2007,LA,LAO,WPR,394980,774408,1169388,660207,438748,316546,218722,125120,106404,1865747,381411,747704,1129115,644284,439667,318099,219956,132485,122616,1877107,3742854,6041348,6041348
Lao People's Democratic Republic,2008,LA,LAO,WPR,395486,767818,1163304,676782,454634,324449,226846,129878,108341,1920930,381450,742879,1124329,657587,453238,326181,228119,136612,125572,1927309,3848239,6135861,6135861
Lao People's Democratic Republic,2009,LA,LAO,WPR,396627,762239,1158866,689182,471808,332536,234930,135218,110666,1974340,382319,738145,1120464,668081,467673,334000,236594,141116,128794,1976258,3950598,6229930,6229930
Lao People's Democratic Republic,2010,LA,LAO,WPR,396930,758975,1155905,697649,489804,341062,242852,141212,113378,2025957,382442,734850,1117292,675954,482778,341842,245238,146140,132316,2024268,4050225,6323418,6323418
Lao People's Democratic Republic,2011,LA,LAO,WPR,395739,758033,1153772,702919,508416,350433,250536,147754,116487,2076545,381179,733152,1114331,681634,498418,349961,253957,151633,136084,2071687,4148232,6416327,6416327
Lao People's Democratic Republic,2012,LA,LAO,WPR,394020,757961,1151981,705753,527502,360776,257996,154738,119990,2126755,379299,732309,1111608,685405,514357,358396,262726,157540,140039,2118463,4245218,6508803,6508803
Lao People's Democratic Republic,2013,LA,LAO,WPR,392314,757176,1149490,707544,546695,372028,265209,162092,123874,2177442,377358,731320,1108678,688086,530435,367086,271462,163918,144147,2165134,4342576,6600742,6600742
Lao People's Democratic Republic,2014,LA,LAO,WPR,390510,754998,1145508,709464,565037,384240,272315,169620,128181,2228857,375461,729505,1104966,690478,546234,376315,279670,170958,148464,2212119,4440976,6691454,6691454
Lao People's Democratic Republic,2015,LA,LAO,WPR,391059,753501,1144560,713543,581400,396826,279442,176907,130730,2278848,375833,728233,1104066,694396,561916,386841,286657,179112,151022,2259944,4538792,6787419,6787419
Lao People's Democratic Republic,2016,LA,LAO,WPR,394357,753918,1148275,718747,596190,409698,286698,184019,131827,2327179,378725,728333,1107058,699181,577538,398695,293056,188055,152328,2308853,4636032,6891363,6891363
Lao People's Democratic Republic,2017,LA,LAO,WPR,397803,755744,1153547,722275,610033,423553,294220,191208,133970,2375259,381796,729717,1111513,702191,592342,411492,299745,197058,154772,2357600,4732859,6997917,6997917
Lao People's Democratic Republic,2018,LA,LAO,WPR,400777,758649,1159426,724659,622624,438461,302057,198311,137023,2423135,384474,732415,1116889,703623,605887,425273,306682,205956,158130,2405551,4828686,7105006,7105006
Lao People's Democratic Republic,2019,LA,LAO,WPR,402929,762035,1164964,726707,633854,454188,310255,205320,140917,2471241,386379,735746,1122125,704640,617975,439972,313875,214787,162465,2453714,4924955,7212053,7212053
Lao People's Democratic Republic,2020,LA,LAO,WPR,403783,766057,1169840,729005,643988,470470,318927,212197,145399,2519986,386978,739593,1126571,705978,628864,455448,321453,223492,167767,2503002,5022988,7319399,7319399
Lao People's Democratic Republic,2021,LA,LAO,WPR,403355,770081,1173436,732054,652971,487224,328160,218706,150029,2569144,386351,743226,1129577,708004,638603,471552,329478,231775,173492,2552904,5122048,7425057,7425057
Lao People's Democratic Republic,2022,LA,LAO,WPR,402229,773618,1175847,735210,660667,504441,337992,225051,155472,2618833,385196,746157,1131353,710626,646823,488258,337985,239803,179949,2603444,5222277,7529475,7529475
Lao People's Democratic Republic,2023,LA,LAO,WPR,400728,776955,1177683,737183,667960,522000,348478,231386,161952,2668959,383818,748743,1132561,712929,653930,505516,347016,247723,187454,2654568,5323527,7633779,7633779
Lao People's Democratic Republic,2024,LA,LAO,WPR,399051,780123,1179174,737615,675566,539236,359735,237699,168816,2718667,382324,751150,1133474,714235,660619,522857,356856,255016,195776,2705359,5424026,7736681,7736681
Lao People's Democratic Republic,2025,LA,LAO,WPR,397119,783399,1180518,737587,682810,555398,371773,244261,175976,2767805,380623,753723,1134346,714639,667031,539611,367811,261504,205037,2755633,5523438,7838305,7838305
Lao People's Democratic Republic,2026,LA,LAO,WPR,395015,786638,1181653,738298,688609,570438,384501,251114,183429,2816389,378760,756374,1135134,715011,672433,555539,379670,267766,214937,2805356,5621745,7938533,7938533
Lao People's Democratic Republic,2027,LA,LAO,WPR,392940,789295,1182235,740343,692528,584354,398067,258167,191133,2864592,376862,758651,1135513,716602,675839,570469,392368,274272,225162,2854712,5719304,8037043,8037043
Lao People's Democratic Republic,2028,LA,LAO,WPR,390881,791096,1181977,743429,695215,596958,412588,265478,198987,2912655,374923,760284,1135207,719489,677609,584127,406020,281033,235617,2903895,5816550,8133739,8133739
Lao People's Democratic Republic,2029,LA,LAO,WPR,388779,791898,1180677,746982,697548,608219,427882,273103,207020,2960754,372925,761014,1133939,722991,678940,596334,420554,288033,246344,2953196,5913950,8228567,8228567
Lao People's Democratic Republic,2030,LA,LAO,WPR,386432,791113,1177545,751162,700020,618300,443641,281149,215286,3009558,370686,760196,1130882,726992,680516,607292,435789,295371,257339,3003299,6012857,8321287,8321287
Lao People's Democratic Republic,1950,LA,LAO,WPR,134093,200131,334224,160379,126360,92217,61907,34617,21071,496551,140915,205973,346888,161933,130738,97190,65591,36682,14871,507005,1003556,1684674,1684674
Lao People's Democratic Republic,1951,LA,LAO,WPR,140021,204579,344600,162793,128534,94317,63531,35800,21315,506290,144826,211636,356462,163915,132716,99356,67604,38235,16254,518080,1024370,1725432,1725432
Lao People's Democratic Republic,1952,LA,LAO,WPR,145450,209240,354690,165379,130722,96491,65118,36969,21612,516291,148320,217598,365918,166098,134734,101564,69584,39738,17675,529393,1045684,1766294,1766294
Lao People's Democratic Republic,1953,LA,LAO,WPR,150832,214071,364903,168109,132921,98719,66693,38146,21993,526581,151954,223533,375487,168511,136749,103781,71540,41232,19127,540940,1067521,1807910,1807910
Lao People's Democratic Republic,1954,LA,LAO,WPR,157144,218258,375402,170885,135097,100938,68284,39367,22464,537035,156329,228902,385231,171145,138673,105939,73475,42767,20587,552586,1089621,1850256,1850256
Lao People's Democratic Republic,1955,LA,LAO,WPR,162283,223996,386279,173661,137233,103097,69906,40631,23014,547542,160237,234951,395188,174035,140485,108024,75413,44361,22057,564375,1111917,1893389,1893389
Lao People's Democratic Republic,1956,LA,LAO,WPR,165465,232056,397521,176531,139340,105204,71542,41930,23629,558176,163276,242075,405351,177283,142225,110045,77353,46022,23551,576479,1134655,1937517,1937517
Lao People's Democratic Republic,1957,LA,LAO,WPR,168780,240235,409015,179595,141445,107258,73197,43282,24338,569115,166438,249141,415579,180956,143888,111968,79263,47738,25054,588867,1157982,1982575,1982575
Lao People's Democratic Republic,1958,LA,LAO,WPR,172168,248530,420698,182921,143567,109279,74895,44658,25110,580430,169669,256146,425815,185078,145518,113833,81160,49484,26567,601640,1182070,2028591,2028591
Lao People's Democratic Republic,1959,LA,LAO,WPR,175737,256810,432547,186412,145576,111214,76604,45992,25907,591705,173088,262979,436067,189643,147197,115688,83081,51222,28070,614901,1206606,2075229,2075229
Lao People's Democratic Republic,1960,LA,LAO,WPR,179491,265018,444509,190158,147483,113077,78322,47270,26715,603025,176682,269589,446271,194670,148977,117551,85021,52930,29577,628726,1231751,2122532,2122532
Lao People's Democratic Republic,1961,LA,LAO,WPR,183422,273192,456614,194278,149494,114948,80101,48524,27553,614898,180436,276032,456468,200135,150908,119431,86993,54613,31079,643159,1258057,2171141,2171141
Lao People's Democratic Republic,1962,LA,LAO,WPR,187573,281382,468955,198777,151808,116916,81997,49770,28423,627691,184401,282376,466777,205902,153049,121366,89018,56283,32580,658198,1285889,2221615,2221615
Lao People's Democratic Republic,1963,LA,LAO,WPR,191942,289734,481676,203376,154148,118826,83896,50987,29306,640539,188593,288983,477576,211647,155402,123300,91049,57933,34094,673425,1313964,2273219,2273219
Lao People's Democratic Republic,1964,LA,LAO,WPR,196482,299221,495703,207170,156275,120556,85689,52171,30223,652084,192974,296503,489477,216863,157964,125150,93031,59579,35661,688248,1340332,2325513,2325513
Lao People's Democratic Republic,1965,LA,LAO,WPR,201234,307792,509026,212500,158409,122247,87444,53385,31204,665189,197555,303770,501325,222733,160773,126914,94960,61246,37294,703920,1369109,2379456,2379456
Lao People's Democratic Republic,1966,LA,LAO,WPR,206135,314645,520780,220094,160637,123899,89144,54617,32235,680626,202257,310358,512615,229614,163905,128609,96826,62909,38980,720843,1401469,2434861,2434861
Lao People's Democratic Republic,1967,LA,LAO,WPR,211231,321845,533076,227854,163057,125532,90793,55872,33323,696431,207138,317276,524414,236451,167434,130234,98612,64555,40725,738011,1434442,2491927,2491927
Lao People's Democratic Republic,1968,LA,LAO,WPR,216608,329336,545944,235772,165741,127171,92417,57168,34463,712732,212289,324486,536775,243255,171407,131847,100364,66218,42528,755619,1468351,2551070,2551070
Lao People's Democratic Republic,1969,LA,LAO,WPR,222260,337159,559419,243711,168729,128846,94043,58508,35596,729433,217693,332025,549718,249901,175792,133508,102117,67903,44314,773535,1502968,2612111,2612111
Lao People's Democratic Republic,2031,LA,LAO,WPR,383811,788873,1172684,755342,703166,627184,459827,289749,223622,3058890,368187,757999,1126186,730790,682770,617118,451657,303192,268471,3053998,6112888,8411762,8411762
Lao People's Democratic Republic,2032,LA,LAO,WPR,381281,785965,1167246,759046,706499,634912,476519,298893,231939,3107808,365768,755236,1121004,733887,685632,625500,468151,311492,279674,3104336,6212144,8500404,8500404
Lao People's Democratic Republic,2033,LA,LAO,WPR,378907,782685,1161592,762547,708710,642312,493571,308578,240270,3155988,363496,752180,1115676,736627,688166,632786,485184,320247,290987,3153997,6309985,8587263,8587263
Lao People's Democratic Republic,2034,LA,LAO,WPR,376682,779173,1155855,765867,709399,650029,510315,318959,248705,3203274,361372,748932,1110304,739184,689702,639669,502306,329766,302238,3202865,6406139,8672294,8672294
Lao People's Democratic Republic,2035,LA,LAO,WPR,374838,775148,1149986,769292,709628,657391,526028,330068,257420,3249827,359614,745226,1104840,741893,690344,646272,518869,340330,313375,3251083,6500910,8755745,8755745
Lao People's Democratic Republic,2036,LA,LAO,WPR,373416,770670,1144086,772672,710573,663328,540679,341830,266464,3295546,358247,741086,1099333,744674,690948,651884,534637,351765,324687,3298595,6594141,8837553,8837553
Lao People's Democratic Republic,2037,LA,LAO,WPR,372044,766296,1138340,775463,712827,667408,554260,354370,275779,3340107,356918,736976,1093894,747075,692740,655508,549445,364015,336348,3345131,6685238,8917466,8917466
Lao People's Democratic Republic,2038,LA,LAO,WPR,370576,762079,1132655,777388,716095,670277,566593,367803,285363,3383519,355493,732954,1088447,748827,695804,657512,563026,377199,348361,3390729,6774248,8995350,8995350
Lao People's Democratic Republic,2039,LA,LAO,WPR,369045,757952,1126997,778313,719808,672782,577655,381969,295320,3425847,353994,729005,1082999,749664,699462,659062,575201,391245,360771,3435405,6861252,9071242,9071242
Lao People's Democratic Republic,2040,LA,LAO,WPR,367352,753953,1121305,777656,724124,675414,587588,396589,305815,3467186,352322,725164,1077486,748948,703603,660839,586166,405983,373690,3479229,6946415,9145206,9145206
Lao People's Democratic Republic,2041,LA,LAO,WPR,365578,750085,1115663,775543,728435,678698,596388,411627,316825,3507516,350564,721442,1072006,746848,707530,663278,596037,421345,387119,3522157,7029673,9217336,9217336
Lao People's Democratic Republic,2042,LA,LAO,WPR,363781,746339,1110120,772760,732263,682160,604088,427142,328276,3546689,348780,717826,1066606,744177,710744,666299,604493,437309,401006,3564028,7110717,9287445,9287445
Lao People's Democratic Republic,2043,LA,LAO,WPR,362080,742652,1104732,769600,735875,684516,611505,442988,340191,3584675,347089,714246,1061335,741207,713591,668981,611884,453797,415376,3604836,7189511,9355580,9355580
Lao People's Democratic Republic,2044,LA,LAO,WPR,360513,739040,1099553,766201,739293,685372,619243,458569,352788,3621466,345525,710730,1056255,738037,716240,670665,618879,470371,430382,3644574,7266040,9421852,9421852
Lao People's Democratic Republic,2045,LA,LAO,WPR,358968,735639,1094607,762288,742802,685772,626630,473236,366262,3656990,343990,707395,1051385,734401,719028,671453,625606,486435,446245,3683168,7340158,9486148,9486148
Lao People's Democratic Republic,2046,LA,LAO,WPR,357484,732561,1090045,757920,746255,686862,632627,486946,380576,3691186,342510,704351,1046861,730328,721877,672185,631345,501756,463042,3720533,7411719,9548627,9548627
Lao People's Democratic Republic,2047,LA,LAO,WPR,355972,729504,1085476,753649,749122,689216,636818,499704,395763,3724272,340994,701317,1042311,726279,724339,674078,635134,516183,480879,3756892,7481164,9608954,9608954
Lao People's Democratic Republic,2048,LA,LAO,WPR,354224,726452,1080676,749534,751131,692560,639827,511357,411873,3756282,339262,698279,1037541,722317,726147,677222,637319,529467,499826,3792298,7548580,9666799,9666799
Lao People's Democratic Republic,2049,LA,LAO,WPR,352352,723463,1075815,745507,752149,696342,642494,521885,428845,3787222,337423,695284,1032707,718424,727048,680951,639056,541427,519815,3826721,7613943,9722462,9722462
Lao People's Democratic Republic,2050,LA,LAO,WPR,350246,720334,1070580,741602,751605,700727,645289,531416,446545,3817184,335361,692143,1027504,714638,726407,685152,641023,552257,540797,3860274,7677458,9775552,9775552
Lebanon,1970,LB,LBN,EMR,186545,332589,519134,228200,132885,124056,78204,65672,55303,684320,177090,312424,489514,219388,138319,122273,77087,66930,64829,688826,1373146,2381791,2381791
Lebanon,1971,LB,LBN,EMR,188847,338416,527263,242409,134818,125616,82027,65783,56309,706962,179349,318242,497591,231828,140104,124451,80874,67071,65991,710319,1417281,2442137,2442137
Lebanon,1972,LB,LBN,EMR,191698,344091,535789,256578,137901,126838,86993,65290,57401,731001,182030,324027,506057,244442,142595,126443,85793,66614,67223,733110,1464111,2505965,2505965
Lebanon,1973,LB,LBN,EMR,194772,349245,544017,269928,142379,127580,92575,64355,58571,755388,184899,329332,514231,256322,146234,128082,91334,65713,68528,756213,1511601,2569841,2569841
Lebanon,1974,LB,LBN,EMR,197902,353831,551733,282221,148466,127848,97903,63530,59880,779848,187838,334100,521938,267270,151251,129304,96644,64909,69982,779360,1559208,2632880,2632880
Lebanon,1975,LB,LBN,EMR,201098,358154,559252,290599,156442,127083,102094,62887,60961,800066,190863,338646,529509,276127,159005,130193,101308,64560,71564,802757,1602823,2691586,2691586
Lebanon,1976,LB,LBN,EMR,226925,407395,634320,330569,184258,140211,117046,69112,67578,908774,215485,385684,601169,318544,189949,147254,118012,72104,80290,926153,1834927,3070419,3070419
Lebanon,1977,LB,LBN,EMR,252558,456752,709310,372676,214420,153616,131932,75785,74576,1023005,240044,432774,672818,361601,222819,164372,134525,79977,89190,1052484,2075489,3457617,3457617
Lebanon,1978,LB,LBN,EMR,230428,415680,646108,344416,206473,137537,121601,68869,68538,947434,219264,394170,613434,333548,214120,148959,124658,72982,82155,976422,1923856,3183405,3183405
Lebanon,1979,LB,LBN,EMR,208503,373763,582266,314856,197374,121870,110289,62731,61948,869068,198634,354700,553334,304298,204417,133568,113914,66775,74518,897490,1766558,2902164,2902164
Lebanon,1980,LB,LBN,EMR,212585,376932,589517,321459,209137,122163,111522,64904,62235,891420,202620,357885,560505,310335,216496,134836,116132,69332,75133,922264,1813684,2963702,2963702
Lebanon,1981,LB,LBN,EMR,217416,380256,597672,327420,220968,123203,112316,67831,62099,913837,207221,361195,568416,315978,228685,136554,118081,72723,75281,947302,1861139,3027222,3027222
Lebanon,1982,LB,LBN,EMR,219788,382806,602594,330035,230168,123902,111548,70645,60330,926628,209544,363711,573255,320129,239945,138252,119123,76451,73747,967647,1894275,3070133,3070133
Lebanon,1983,LB,LBN,EMR,221549,385301,606850,331133,237529,125336,110081,73705,58302,936086,211366,366099,577465,323246,250072,140866,119703,80621,72082,986590,1922676,3106990,3106990
Lebanon,1984,LB,LBN,EMR,225412,389449,614861,334073,245653,129041,109220,77321,57762,953070,215144,370099,585243,326864,260142,145442,120591,85177,72163,1010379,1963449,3163558,3163558
Lebanon,1985,LB,LBN,EMR,229100,394815,623915,337621,252267,135630,108361,80519,57869,972267,218716,375336,594052,330889,268763,153022,121508,89349,72988,1036519,2008786,3226750,3226750
Lebanon,1986,LB,LBN,EMR,233217,402883,636100,343020,258550,145221,107996,83694,58772,997253,222617,383262,605879,336579,276963,163979,122979,93529,74756,1068785,2066038,3308010,3308010
Lebanon,1987,LB,LBN,EMR,236436,411281,647717,349119,265730,155496,107784,86447,60113,1024689,225647,391581,617228,342214,285046,175597,124411,97129,76846,1101243,2125932,3390870,3390870
Lebanon,1988,LB,LBN,EMR,237629,417863,655492,353824,272483,165517,107248,88308,61515,1048895,226800,398161,624961,345838,291561,186763,125197,99669,78763,1127791,2176686,3457148,3457148
Lebanon,1989,LB,LBN,EMR,239488,425161,664649,357625,278517,175481,106976,89808,63357,1071764,228628,405368,633996,349191,297877,198314,126210,102060,81446,1155098,2226862,3525502,3525502
Lebanon,1990,LB,LBN,EMR,242014,432653,674667,360451,283467,185200,107115,90939,65504,1092676,231100,412670,643770,352139,303748,210041,127553,104338,84766,1182585,2275261,3593700,3593700
Lebanon,1991,LB,LBN,EMR,244081,440086,684167,364800,289664,195767,108288,92023,68148,1118690,233138,419819,652957,355354,309382,222016,129404,106417,88345,1210918,2329608,3666734,3666734
Lebanon,1992,LB,LBN,EMR,245340,447020,692360,371335,297327,207175,110663,93114,71321,1150935,234406,426534,660940,359605,314887,234161,131929,108343,92254,1241179,2392114,3745407,3745407
Lebanon,1993,LB,LBN,EMR,244844,453250,698094,377842,304617,218048,114071,93787,74565,1182930,234012,432661,666673,364131,319730,245518,135483,109942,96300,1271104,2454034,3818796,3818796
Lebanon,1994,LB,LBN,EMR,242114,459768,701882,384079,311675,228338,118767,94111,77808,1214778,231525,439020,670545,368802,324054,256044,140400,111228,100408,1300936,2515714,3888144,3888144
Lebanon,1995,LB,LBN,EMR,238316,466418,704734,390785,319029,237241,126140,94340,81168,1248703,228060,445470,673530,374272,328415,264908,148081,112399,104603,1332678,2581381,3959640,3959640
Lebanon,1996,LB,LBN,EMR,234857,472113,706970,398085,326653,244943,135876,94571,84624,1284752,224951,450954,675905,380699,332909,272139,158364,113567,108930,1366608,2651360,4034243,4034243
Lebanon,1997,LB,LBN,EMR,231706,476181,707887,405437,334143,252841,146068,94780,88032,1321301,222180,454890,677070,387506,337256,279180,169246,114731,113367,1401286,2722587,4107551,4107551
Lebanon,1998,LB,LBN,EMR,228861,478298,707159,413035,341345,261011,156522,95090,91333,1358336,219744,457035,676779,394727,341354,286108,180509,115955,117854,1436507,2794843,4178784,4178784
Lebanon,1999,LB,LBN,EMR,226643,478720,705363,421226,348241,269355,167324,95710,94562,1396418,217962,457615,675577,402573,345260,292897,192183,117362,122388,1472663,2869081,4250020,4250020
Lebanon,2000,LB,LBN,EMR,224974,478111,703085,429534,354641,277566,178378,96816,97693,1434628,216685,457250,673935,410514,348884,299344,204116,119084,127049,1508991,2943619,4320642,4320642
Lebanon,2001,LB,LBN,EMR,223505,476843,700348,437359,360732,285438,189529,98499,100674,1472231,215496,456278,671774,417976,352460,305292,216116,121190,131811,1544845,3017076,4389200,4389200
Lebanon,2002,LB,LBN,EMR,221694,473747,695441,443232,366431,292414,200231,100683,103345,1506336,213901,453604,667505,423662,355894,310108,227590,123578,136549,1577381,3083717,4446666,4446666
Lebanon,2003,LB,LBN,EMR,220051,469623,689674,448924,372550,299382,210685,103999,106047,1541587,212408,450009,662417,429251,360022,314642,238574,127135,141500,1611124,3152711,4504807,4504807
Lebanon,2004,LB,LBN,EMR,218777,465405,684182,456446,379690,307169,221312,108904,108931,1582452,211204,446428,657632,436541,365525,319747,249551,132428,146738,1650530,3232982,4574797,4574797
Lebanon,2005,LB,LBN,EMR,217039,460412,677451,463612,386881,314913,230401,116190,111612,1623609,209592,442120,651712,443461,371450,324558,258713,140251,151835,1690268,3313877,4643044,4643044
Lebanon,2006,LB,LBN,EMR,215415,456767,672182,470213,394929,323192,238574,125807,114394,1667109,208204,439048,647252,449946,378754,329879,266639,150781,157325,1733324,3400433,4719864,4719864
Lebanon,2007,LB,LBN,EMR,214246,454944,669190,476632,404224,332325,247682,136237,117477,1714577,207339,437686,645025,456236,387576,336043,275197,162370,163395,1780817,3495394,4809608,4809608
Lebanon,2008,LB,LBN,EMR,212753,452350,665103,480185,413055,340569,256637,146742,120524,1757712,206249,435547,641796,459686,395950,341196,283044,174019,169099,1822994,3580706,4887613,4887613
Lebanon,2009,LB,LBN,EMR,211642,448573,660215,480457,421144,347426,264974,157185,123525,1794711,205419,432260,637679,460041,403663,345037,289846,185546,174403,1858536,3653247,4951135,4951135
Lebanon,2010,LB,LBN,EMR,211579,443046,654625,477719,427603,352332,272069,167178,126341,1823242,205306,427303,632609,457557,409800,347160,295084,196517,179195,1885313,3708555,4995800,4995800
Lebanon,2011,LB,LBN,EMR,213617,437692,651309,474745,433929,357200,279034,177375,129686,1851969,206937,422530,629467,454884,415787,349521,300053,207656,184406,1912307,3764276,5045056,5045056
Lebanon,2012,LB,LBN,EMR,220561,439584,660145,478901,446482,368399,290362,190483,135768,1910395,213074,424763,637837,459082,427814,358315,309515,222129,193103,1969958,3880353,5178337,5178337
Lebanon,2013,LB,LBN,EMR,244041,472503,716544,515332,490343,406062,322323,217185,152465,2103710,234926,457011,691937,494320,469918,393038,340563,252206,216619,2166664,4270374,5678851,5678851
Lebanon,2014,LB,LBN,EMR,272075,513024,785099,557665,542940,450606,359980,247974,173072,2332237,261017,496482,757499,535376,520369,434616,377014,286716,245412,2399503,4731740,6274342,6274342
Lebanon,2015,LB,LBN,EMR,284394,526354,810748,550897,542120,453356,369524,259396,187672,2362965,272082,507036,779118,533338,525759,442047,385559,297180,262227,2446110,4809075,6398940,6398940
Lebanon,2016,LB,LBN,EMR,286232,532466,818698,521408,503245,428149,361379,257734,200641,2272556,273350,508598,781948,510753,501669,429130,378762,291867,273234,2385415,4657971,6258619,6258619
Lebanon,2017,LB,LBN,EMR,281715,541618,823333,502144,459946,401079,350520,254531,212293,2180513,268590,514245,782835,492648,475221,414929,371433,286339,281997,2322567,4503080,6109252,6109252
Lebanon,2018,LB,LBN,EMR,272231,552259,824490,492417,413680,372600,336221,250356,221906,2087180,258740,522637,781377,478653,447677,399396,363064,281151,287860,2257801,4344981,5950839,5950839
Lebanon,2019,LB,LBN,EMR,258653,562683,821336,490835,367023,342745,317892,245240,229051,1992786,244288,532029,776317,468503,420509,382194,353106,276294,290861,2191467,4184253,5781907,5781907
Lebanon,2020,LB,LBN,EMR,243654,566846,810500,490418,337387,325399,305138,245220,234221,1937783,228863,536915,765778,458115,400456,370727,346472,277828,295266,2148864,4086647,5662923,5662923
Lebanon,2021,LB,LBN,EMR,229722,563894,793616,487017,325463,320589,299423,250363,237020,1919875,215414,535565,750979,446675,386674,365269,343411,285025,301110,2128164,4048039,5592631,5592631
Lebanon,2022,LB,LBN,EMR,216586,557125,773711,479700,312434,312318,292075,254484,237628,1888639,203017,529755,732772,433987,368761,356728,338701,290977,305457,2094611,3983250,5489739,5489739
Lebanon,2023,LB,LBN,EMR,204104,545590,749694,468354,296435,299652,283647,257887,239284,1845259,191633,518509,710142,419361,345005,344562,332699,296042,311170,2048839,3894098,5353930,5353930
Lebanon,2024,LB,LBN,EMR,193174,529244,722418,458152,281239,284441,275697,261236,245140,1805905,182247,501816,684063,407780,319494,330852,326707,300800,321028,2006661,3812566,5219044,5219044
Lebanon,2025,LB,LBN,EMR,182477,510190,692667,452093,269211,267597,269033,264002,253969,1775905,172712,482687,655399,401923,294929,316788,321461,304976,333560,1973637,3749542,5097604,5097604
Lebanon,2026,LB,LBN,EMR,171173,489845,661018,450730,260974,249481,263825,265443,263300,1753753,161952,462834,624786,401978,272461,302715,317132,308116,346193,1948595,3702348,4988145,4988145
Lebanon,2027,LB,LBN,EMR,160652,467920,628572,454218,257354,231379,260095,265632,273226,1741904,151982,441367,593349,407811,253800,289263,313731,310261,359040,1933906,3675810,4897736,4897736
Lebanon,2028,LB,LBN,EMR,151522,444692,596214,460999,257721,214279,257353,264628,283709,1738689,143364,418646,562010,417496,239392,276466,310847,311373,372323,1927897,3666586,4824807,4824807
Lebanon,2029,LB,LBN,EMR,144241,420391,564632,468784,260671,198898,254913,262436,294647,1740349,136512,394978,531490,428338,228917,264059,307875,311357,386182,1926728,3667077,4763208,4763208
Lebanon,2030,LB,LBN,EMR,138974,395917,534891,476504,265945,186554,252296,259178,306019,1746496,131573,371325,502898,438941,223174,252382,304405,310238,400818,1929958,3676454,4714240,4714240
Lebanon,1950,LB,LBN,EMR,95367,136903,232270,130339,84968,79369,58218,45823,47396,446113,92669,140830,233499,126477,81888,76235,56722,46005,50377,437704,883817,1349588,1349588
Lebanon,1951,LB,LBN,EMR,105711,138764,244475,131872,88972,79461,59333,46054,47594,453286,101702,142603,244305,128656,85822,76384,57854,46373,51050,446139,899425,1388215,1388215
Lebanon,1952,LB,LBN,EMR,115671,141674,257345,132922,94164,78797,60610,46309,47682,460484,110591,144955,255546,130523,90899,75807,59133,46745,51607,454714,915198,1428095,1428095
Lebanon,1953,LB,LBN,EMR,124946,146095,271041,133523,100082,77649,62048,46591,47711,467604,118837,148551,267388,132097,96689,74784,60567,47130,52134,463401,931005,1469430,1469430
Lebanon,1954,LB,LBN,EMR,133425,152289,285714,133732,105808,76648,63679,46923,47809,474599,126342,153665,280007,133339,102308,73892,62179,47542,52683,471943,946542,1512263,1512263
Lebanon,1955,LB,LBN,EMR,139507,161787,301294,133657,110863,76162,65420,47294,47961,481357,131742,161609,293351,134324,107311,73510,63905,47994,53281,480325,961682,1556327,1556327
Lebanon,1956,LB,LBN,EMR,143579,174105,317684,133446,115310,76033,67402,47698,48193,488082,135264,172126,307390,135162,111736,73490,65863,48493,53957,488701,976783,1601855,1601855
Lebanon,1957,LB,LBN,EMR,147703,187122,334825,133266,119102,76281,69659,48154,48567,495029,138843,183283,322126,135971,115512,73835,68080,49028,54739,497165,992194,1649151,1649151
Lebanon,1958,LB,LBN,EMR,151742,200725,352467,133117,122018,77100,71751,48643,48934,501563,142400,194967,337367,136839,118700,74818,70201,49627,55546,505731,1007294,1697139,1697139
Lebanon,1959,LB,LBN,EMR,155713,214759,370472,133393,124374,78897,73266,49295,49272,508497,145961,207061,353022,137876,121505,76736,71769,50382,56289,514557,1023054,1746544,1746544
Lebanon,1960,LB,LBN,EMR,159606,229033,388639,134506,126452,81805,74120,50209,49618,516710,149521,219424,368945,139236,124034,79630,72626,51330,56945,523801,1040511,1798092,1798092
Lebanon,1961,LB,LBN,EMR,163529,243636,407165,136644,128207,85867,74381,51360,49988,526447,153172,232204,385376,141237,126414,83639,72912,52504,57603,534309,1060756,1853295,1853295
Lebanon,1962,LB,LBN,EMR,167465,258308,425773,139983,129647,91185,74006,52705,50350,537876,156844,245257,402101,143987,128650,88866,72582,53866,58252,546203,1084079,1911959,1911959
Lebanon,1963,LB,LBN,EMR,171227,272267,443494,144786,130631,97204,73148,54175,50686,550630,160375,257685,418060,147942,130569,94793,71797,55359,58863,559323,1109953,1971511,1971511
Lebanon,1964,LB,LBN,EMR,174530,285193,459723,151232,131126,102973,72368,55770,51071,564540,163563,269203,432766,153297,132056,100496,71084,56977,59500,573410,1137950,2030440,2030440
Lebanon,1965,LB,LBN,EMR,177107,295390,472497,160779,131193,107997,72008,57419,51512,580908,166217,278373,444590,161293,133116,105488,70773,58632,60146,589448,1170356,2087445,2087445
Lebanon,1966,LB,LBN,EMR,179320,303522,482842,173205,131172,112470,72026,59299,52063,600235,168691,285682,454373,171919,134072,109945,70844,60517,60894,608191,1208426,2145646,2145646
Lebanon,1967,LB,LBN,EMR,181143,311268,492411,186219,131089,116229,72373,61388,52714,620012,170897,292626,463523,183089,134906,113698,71237,62604,61724,627258,1247270,2203202,2203202
Lebanon,1968,LB,LBN,EMR,182839,318887,501726,199894,131232,119382,73397,63414,53490,640809,172973,299521,472494,194871,135853,116922,72292,64634,62698,647270,1288079,2262291,2262291
Lebanon,1969,LB,LBN,EMR,184717,326351,511068,214132,131867,122079,75398,64949,54395,662820,175122,306440,481562,207189,137064,119851,74299,66190,63779,668372,1331192,2323823,2323823
Lebanon,2031,LB,LBN,EMR,135716,372462,508178,482787,273430,178118,249041,255104,317710,1756190,128542,348913,477455,447687,222705,241652,300154,308178,416246,1936622,3692812,4678450,4678450
Lebanon,2032,LB,LBN,EMR,134387,351066,485453,486172,283336,173638,244752,250668,329504,1768070,127339,328826,456165,452972,227714,231832,295050,305522,432175,1945265,3713335,4654951,4654951
Lebanon,2033,LB,LBN,EMR,134764,332563,467327,485359,295913,172665,239157,246327,341079,1780500,127751,311933,439684,453405,238038,222718,289214,302657,448143,1954175,3734675,4641685,4641685
Lebanon,2034,LB,LBN,EMR,136609,317805,454414,479311,311430,174819,232074,242525,352102,1792261,129550,299150,428700,447912,253421,214242,282857,299965,463658,1962055,3754316,4637432,4637432
Lebanon,2035,LB,LBN,EMR,139758,305208,444966,469724,330110,179941,223276,239726,362290,1805067,132580,288044,420624,439076,273569,206582,276080,297835,478298,1971440,3776507,4642097,4642097
Lebanon,2036,LB,LBN,EMR,143931,293773,437704,457905,351598,187847,212806,238131,371473,1819760,136581,277384,413965,428476,297676,200067,268923,296434,491787,1983363,3803123,4654791,4654791
Lebanon,2037,LB,LBN,EMR,148810,284584,433394,443262,374775,198104,201323,237504,379626,1834594,141240,268867,410107,414915,324221,195138,261443,295556,504122,1995395,3829989,4673485,4673485
Lebanon,2038,LB,LBN,EMR,154108,278022,432130,425915,398051,210116,189821,237370,386802,1848075,146288,262848,409136,398578,351281,192261,253685,294795,515466,2006066,3854141,4695407,4695407
Lebanon,2039,LB,LBN,EMR,159437,274468,433905,406218,419969,223310,179407,237228,393072,1859204,151353,259672,411025,379903,377036,191968,245758,293716,525988,2014369,3873573,4718509,4718509
Lebanon,2040,LB,LBN,EMR,164418,273874,438292,385216,439301,237214,171282,236578,398516,1868107,156076,259279,415355,360002,399922,194817,237896,291885,535885,2020407,3888514,4742163,4742163
Lebanon,2041,LB,LBN,EMR,168796,275945,444741,364285,454735,251647,166262,234955,403298,1875182,160219,261398,421617,340312,418366,201280,230276,289005,545311,2024550,3899732,4766088,4766088
Lebanon,2042,LB,LBN,EMR,172452,280332,452784,344663,465079,266950,164435,232008,407672,1880807,163674,265689,429363,322122,431028,211664,222905,285027,554354,2027100,3907907,4790049,4790049
Lebanon,2043,LB,LBN,EMR,175207,286631,461838,327370,469451,283653,165499,227541,411825,1885339,166282,271764,438046,306519,436968,226101,215703,280127,562991,2028409,3913748,4813633,4813633
Lebanon,2044,LB,LBN,EMR,177055,294273,471328,313406,467093,302195,169149,221418,415914,1889175,168029,279096,447125,294577,435395,244502,208678,274539,571155,2028846,3918021,4836471,4836471
Lebanon,2045,LB,LBN,EMR,177972,302717,480689,301284,459828,322808,175219,213431,420136,1892706,168894,287157,456051,283962,429020,266569,201988,268360,578807,2028706,3921412,4858147,4858147
Lebanon,2046,LB,LBN,EMR,177839,311433,489272,290091,449195,345258,183576,203645,424521,1896286,168764,295457,464221,273538,419664,291609,196027,261638,585905,2028381,3924667,4878160,4878160
Lebanon,2047,LB,LBN,EMR,176679,320022,496701,280990,434969,368694,193919,192762,428872,1900206,167652,303626,471278,265106,406526,318395,191331,254480,592290,2028128,3928334,4896315,4896315
Lebanon,2048,LB,LBN,EMR,174574,328080,502654,274463,417737,391939,205854,181810,432854,1904657,165640,311285,476925,259117,390285,345391,188537,246997,597803,2028130,3932787,4912361,4912361
Lebanon,2049,LB,LBN,EMR,171575,335258,506833,270928,398122,413792,218938,171934,436113,1909827,162783,318094,480877,255948,371676,371049,188290,239341,602238,2028542,3938369,4926083,4926083
Lebanon,2050,LB,LBN,EMR,167936,341154,509090,270347,377203,433075,232732,164287,438257,1915901,159322,323681,483003,255565,351839,393856,191161,231741,605424,2029586,3945487,4937579,4937579
Liberia,1970,LR,LBR,AFR,129148,181134,310282,129294,109203,78179,55353,35404,23051,430484,128027,182354,310381,132938,107168,73280,48834,29799,20400,412419,842903,1463563,1463563
Liberia,1971,LR,LBR,AFR,132658,186969,319627,131637,111499,80085,56419,36289,23799,439728,131522,187976,319498,135938,109924,75081,50294,30648,20928,422813,862541,1501658,1501658
Liberia,1972,LR,LBR,AFR,136280,192976,329256,134515,113430,82118,57490,37166,24574,449293,135097,193808,328905,139262,112436,77044,51807,31509,21481,433539,882832,1540995,1540995
Liberia,1973,LR,LBR,AFR,140206,199237,339443,138175,115104,84307,58576,38062,25367,459591,138868,199926,338794,143420,114595,79067,53304,32405,22081,444872,904463,1582697,1582697
Liberia,1974,LR,LBR,AFR,144374,205759,350133,142938,115929,86616,59702,38972,26200,470357,142850,206325,349175,148574,115968,81238,54765,33361,22720,456626,926983,1626283,1626283
Liberia,1975,LR,LBR,AFR,149346,212509,361855,147690,116231,89183,61135,39773,26505,480517,147891,213032,360923,152716,117603,84265,56455,34280,23012,468331,948848,1671632,1671632
Liberia,1976,LR,LBR,AFR,155103,219367,374470,151824,116782,91878,62848,40503,26312,490147,153868,220049,373917,155410,119955,88004,58381,35192,23009,479951,970098,1718482,1718482
Liberia,1977,LR,LBR,AFR,161223,226517,387740,156118,117415,94608,64767,41313,26234,500455,160177,227583,387760,157937,122362,92083,60450,36208,23095,492135,992590,1768092,1768092
Liberia,1978,LR,LBR,AFR,167596,234169,401765,160547,118118,97420,66952,42203,26267,511507,166746,235875,402621,160218,124801,96597,62751,37328,23273,504968,1016475,1820861,1820861
Liberia,1979,LR,LBR,AFR,173886,242270,416156,165289,118949,100129,69265,43178,26428,523238,173139,244805,417944,162815,127015,101095,65222,38548,23539,518234,1041472,1875566,1875566
Liberia,1980,LR,LBR,AFR,179753,251036,430789,170368,119956,102663,71706,44228,26759,535680,179019,254523,433542,165859,129070,105499,67920,39860,23944,532152,1067832,1932169,1932169
Liberia,1981,LR,LBR,AFR,184921,260317,445238,175871,121323,104840,74169,45379,27318,548900,184074,264753,448827,169738,130905,109503,70759,41295,24526,546726,1095626,1989690,1989690
Liberia,1982,LR,LBR,AFR,189391,269885,459276,181843,123273,106473,76567,46632,28171,562959,188329,275109,463438,174722,132600,112778,73662,42862,25307,561931,1124890,2047602,2047602
Liberia,1983,LR,LBR,AFR,194253,280148,474401,187693,125662,108134,79500,47846,28422,577257,193266,286129,479395,179034,135172,116670,77164,44372,25687,578099,1155356,2109151,2109151
Liberia,1984,LR,LBR,AFR,198540,290583,489123,194643,129717,108972,82452,49248,28865,593897,197456,297253,494709,185159,138676,119481,80878,46014,26247,596455,1190352,2174194,2174194
Liberia,1985,LR,LBR,AFR,201551,300744,502295,202880,135069,109070,84804,50942,30225,612990,199930,307775,507705,194486,141814,120703,84275,47934,27518,616730,1229720,2239724,2239724
Liberia,1986,LR,LBR,AFR,204825,310809,515634,210936,140279,109657,87040,52702,31590,632204,202799,317777,520576,204156,144538,122298,87705,49889,28850,637436,1269640,2305860,2305860
Liberia,1987,LR,LBR,AFR,208190,320526,528716,219002,145814,110443,89191,54535,32991,651976,205899,327108,533007,214178,147498,123783,91146,51886,30256,658747,1310723,2372449,2372449
Liberia,1988,LR,LBR,AFR,211029,330211,541240,227280,151737,111458,91255,56403,34399,672532,208568,336223,544791,224679,150943,125200,94597,53944,31712,681075,1353607,2439639,2439639
Liberia,1989,LR,LBR,AFR,214103,339136,553239,235784,158049,112731,93234,58305,35781,693884,211603,344407,556010,235539,155032,126580,98003,56110,33199,704463,1398347,2507600,2507600
Liberia,1990,LR,LBR,AFR,187157,298461,485618,208790,139442,97188,81339,51536,31616,609911,185100,302381,487481,212211,136670,110222,87556,50276,29788,626723,1236634,2209731,2209731
Liberia,1991,LR,LBR,AFR,163076,261441,424517,184356,122009,83162,70220,45356,27787,532890,161433,264157,425590,190884,120285,95312,77889,45147,26734,556251,1089141,1939236,1939236
Liberia,1992,LR,LBR,AFR,171948,274965,446913,197304,130236,87355,73120,48207,29687,565909,170308,277155,447463,205017,128418,99185,82225,48644,28852,592341,1158250,2052626,2052626
Liberia,1993,LR,LBR,AFR,178299,283341,461640,207320,136420,90476,74442,50226,31083,589967,176645,285077,461722,215845,135112,101678,84798,51473,30538,619444,1209411,2132771,2132771
Liberia,1994,LR,LBR,AFR,177556,279628,457184,208830,137050,90613,72007,50122,31140,589762,175883,280975,456858,217574,136758,100647,83226,52279,30908,621392,1211154,2125198,2125198
Liberia,1995,LR,LBR,AFR,179371,278940,458311,212640,139228,91960,70370,50508,31604,596310,177597,280007,457604,221313,140362,100588,82547,53688,31703,630201,1226511,2142422,2142422
Liberia,1996,LR,LBR,AFR,185309,284259,469568,220435,144144,94876,70747,51826,32785,614813,183330,285161,468491,228830,146942,102102,83879,56134,33199,651086,1265899,2203966,2203966
Liberia,1997,LR,LBR,AFR,201589,304860,506449,239559,156914,103151,74767,55764,35817,665972,199209,305696,504905,247665,161795,109242,89139,61493,36638,705972,1371944,2383300,2383300
Liberia,1998,LR,LBR,AFR,224841,334905,559746,266230,174979,114914,81184,61381,40094,738782,221879,335690,557569,273954,182126,120011,96870,68745,41420,783126,1521908,2639224,2639224
Liberia,1999,LR,LBR,AFR,239561,351749,591310,281434,186327,122214,84211,64443,42810,781439,236025,352453,588478,288365,195514,126109,100503,73320,44704,828515,1609954,2789743,2789743
Liberia,2000,LR,LBR,AFR,250368,364004,614372,290629,195137,127686,85929,66309,44844,810534,246281,364616,610897,296547,206038,130544,102334,76570,47386,859419,1669953,2895224,2895224
Liberia,2001,LR,LBR,AFR,259128,374535,633663,297260,203095,132450,87306,67536,46603,834250,254516,374942,629458,302149,215246,134593,103382,79062,49844,884276,1718526,2981648,2981648
Liberia,2002,LR,LBR,AFR,266689,385172,651861,302425,210756,136966,88849,68279,48236,855511,261600,385233,646833,306439,223656,138853,104219,80977,52250,906394,1761905,3060599,3060599
Liberia,2003,LR,LBR,AFR,268857,390217,659074,301381,214727,139057,89179,67462,48931,860737,263410,389787,653197,304846,227921,141213,103454,80990,53743,912167,1772904,3085173,3085173
Liberia,2004,LR,LBR,AFR,271759,397787,669546,301114,219463,141787,90590,66282,49802,869038,265945,396740,662685,304208,232585,144727,103646,80505,55505,921176,1790214,3122447,3122447
Liberia,2005,LR,LBR,AFR,284137,419337,703474,310997,231575,149348,95344,67263,52374,906901,277747,417531,695278,313730,244473,153563,107204,82519,59179,960668,1867569,3266318,3266318
Liberia,2006,LR,LBR,AFR,300826,446937,747763,325157,246613,158878,101167,69496,55592,956903,293724,444240,737964,327675,259115,164746,111717,85857,63655,1012765,1969668,3455397,3455397
Liberia,2007,LR,LBR,AFR,316661,473230,789891,338293,260401,167980,106809,71456,58561,1003500,308852,469530,778382,340664,272197,175651,115913,88624,67915,1060964,2064464,3632740,3632740
Liberia,2008,LR,LBR,AFR,329229,495409,824638,349399,273018,176443,111908,72895,61062,1044725,320821,490650,811471,351714,283911,185873,119443,90478,71641,1103060,2147785,3783887,3783887
Liberia,2009,LR,LBR,AFR,338012,513951,851963,358567,282905,183938,116329,73852,63024,1078615,329158,508097,837255,360838,292720,194997,122390,91497,74783,1137225,2215840,3905066,3905066
Liberia,2010,LR,LBR,AFR,345074,532939,878013,368199,290549,191514,120768,74890,64797,1110717,335905,525924,861829,370352,299195,204051,125681,92366,77757,1169402,2280119,4019956,4019956
Liberia,2011,LR,LBR,AFR,351917,553619,905536,385499,304988,203201,126969,76879,67067,1164603,342526,545446,887972,387963,312666,216675,130927,93764,81047,1223042,2387645,4181150,4181150
Liberia,2012,LR,LBR,AFR,358519,574023,932542,401360,316988,214441,132981,79071,68898,1213739,348892,564683,913575,403814,323922,228529,136526,95149,83945,1271885,2485624,4331740,4331740
Liberia,2013,LR,LBR,AFR,363531,592285,955816,409906,319551,221780,137321,80835,69706,1239099,353682,581808,935490,411507,325829,236338,141209,96101,85923,1296907,2536006,4427313,4427313
Liberia,2014,LR,LBR,AFR,366974,609316,976290,420075,321383,229085,141782,83204,70060,1265589,356977,597801,954778,420654,327119,243682,146487,97499,87285,1322726,2588315,4519398,4519398
Liberia,2015,LR,LBR,AFR,369224,625223,994447,432281,323309,236602,146382,85857,70388,1294819,359143,612754,971897,431757,328627,250905,152313,98943,88624,1351169,2645988,4612329,4612329
Liberia,2016,LR,LBR,AFR,371079,640239,1011318,445795,325364,244029,151046,88424,71073,1325731,360962,626896,987858,444091,330360,257767,158482,100128,90359,1381187,2706918,4706097,4706097
Liberia,2017,LR,LBR,AFR,371676,655444,1027120,459710,326996,250739,155756,91128,71841,1356170,361576,641268,1002844,456723,331710,263718,164845,101449,92055,1410500,2766670,4796631,4796631
Liberia,2018,LR,LBR,AFR,371755,670183,1041938,474816,328871,257406,160770,94029,72755,1388647,361683,655259,1016942,470562,333286,269580,171606,103079,93750,1441863,2830510,4889391,4889391
Liberia,2019,LR,LBR,AFR,372969,682551,1055520,491283,332001,263480,166179,97147,73825,1423915,362866,667030,1029896,485792,336113,274773,178712,105107,95451,1475948,2899863,4985289,4985289
Liberia,2020,LR,LBR,AFR,375139,692497,1067636,509825,337705,268804,172275,100428,74786,1463823,364971,676534,1041505,503155,341491,279096,186340,107619,96924,1514625,2978448,5087584,5087584
Liberia,2021,LR,LBR,AFR,377787,700429,1078216,529747,345199,273867,178870,103769,75503,1506955,367567,684170,1051737,521954,348542,283246,194181,110581,98006,1556510,3063465,5193416,5193416
Liberia,2022,LR,LBR,AFR,380802,706962,1087764,550207,354591,278531,185877,107314,76423,1552943,370536,690481,1061017,541384,357338,287107,202011,114121,99005,1600966,3153909,5302681,5302681
Liberia,2023,LR,LBR,AFR,384474,712875,1097349,570345,366248,282848,193421,111263,78007,1602132,374159,696203,1070362,560636,368295,290739,209965,118472,100422,1648529,3250661,5418377,5418377
Liberia,2024,LR,LBR,AFR,388765,718558,1107323,589055,379677,286789,201190,115553,80105,1652369,378430,701722,1080152,578570,380925,294130,217771,123566,102142,1697104,3349473,5536949,5536949
Liberia,2025,LR,LBR,AFR,393675,724006,1117681,606393,394702,290536,209065,119962,82371,1703029,383325,707031,1090356,595212,395081,297439,225379,129119,103925,1746155,3449184,5657229,5657229
Liberia,2026,LR,LBR,AFR,399147,729295,1128442,622535,410989,294481,216872,124433,84844,1754154,388790,712226,1101016,610703,410463,301055,232683,134971,105815,1795690,3549844,5779303,5779303
Liberia,2027,LR,LBR,AFR,404844,733592,1138436,638670,428272,298821,224370,129082,87529,1806744,394479,716499,1110978,626185,426827,305145,239519,141140,107881,1846697,3653441,5902858,5902858
Liberia,2028,LR,LBR,AFR,410543,737945,1148488,654105,446342,303317,231837,134017,90424,1860042,400149,720870,1121019,641022,443988,309376,246260,147654,110188,1898488,3758530,6028036,6028036
Liberia,2029,LR,LBR,AFR,416016,744021,1160037,666996,465227,308775,238663,139265,93526,1912452,405575,726941,1132516,653442,461979,314584,252287,154440,112781,1949513,3861965,6154516,6154516
Liberia,2030,LR,LBR,AFR,421211,751486,1172697,677240,484991,315772,244395,144992,96842,1964232,410737,734383,1145120,663344,480868,321341,257145,161586,115736,2000020,3964252,6282074,6282074
Liberia,1950,LR,LBR,AFR,73426,120798,194224,91751,71265,51443,34306,20837,13420,283022,70957,116110,187067,87310,62104,41116,28419,18873,13760,251582,534604,915894,915894
Liberia,1951,LR,LBR,AFR,73601,123035,196636,93470,72421,52643,35183,21352,13681,288750,71786,118455,190241,89204,64062,42298,28950,19287,13893,257694,546444,933334,933334
Liberia,1952,LR,LBR,AFR,74414,124947,199361,95369,73572,53862,36085,21892,13958,294738,73103,120546,193649,91207,66107,43534,29507,19733,14045,264133,558871,951883,951883
Liberia,1953,LR,LBR,AFR,75929,126441,202370,97402,74700,55089,37005,22451,14250,300897,75109,122206,197315,93288,68155,44824,30106,20194,14210,270777,571674,971361,971361
Liberia,1954,LR,LBR,AFR,78660,126978,205638,99584,75873,56337,37958,23040,14560,307352,78255,122988,201243,95493,70176,46223,30770,20650,14412,277724,585076,991949,991949
Liberia,1955,LR,LBR,AFR,81826,127325,209151,101901,77149,57620,38953,23654,14895,314172,81552,123891,205443,97822,72189,47759,31525,21088,14634,285017,599189,1013790,1013790
Liberia,1956,LR,LBR,AFR,84562,128368,212930,104277,78505,58929,39987,24293,15263,321254,84280,125632,209912,100237,74177,49416,32370,21519,14892,292611,613865,1036701,1036701
Liberia,1957,LR,LBR,AFR,87344,129650,216994,106676,79927,60257,41052,24955,15650,328517,87067,127614,214681,102710,76108,51178,33302,21941,15174,300413,628930,1060604,1060604
Liberia,1958,LR,LBR,AFR,90149,131142,221291,109037,81362,61550,42126,25628,16060,335763,89872,129789,219661,105174,77933,52992,34293,22357,15478,308227,643990,1084947,1084947
Liberia,1959,LR,LBR,AFR,93007,132860,225867,111433,82929,62817,43213,26316,16482,343190,92720,132182,224902,107672,79809,54871,35331,22773,15797,316253,659443,1110215,1110215
Liberia,1960,LR,LBR,AFR,95964,134874,230838,113876,84730,64102,44327,27023,16911,350969,95668,134866,230534,110206,81874,56829,36425,23215,16135,324684,675653,1137026,1137026
Liberia,1961,LR,LBR,AFR,99005,137304,236309,116179,86705,65379,45462,27746,17351,358822,98708,137903,236611,112640,84051,58853,37567,23680,16477,333268,692090,1165005,1165005
Liberia,1962,LR,LBR,AFR,102129,140335,242464,118160,88819,66644,46610,28486,17798,366517,101842,141451,243293,114823,86310,60939,38748,24162,16834,341816,708333,1194085,1194085
Liberia,1963,LR,LBR,AFR,105300,144059,249359,119826,91133,67872,47725,29270,18346,374172,104901,145692,250593,116871,88570,62796,39875,24682,17247,350041,724213,1224169,1224169
Liberia,1964,LR,LBR,AFR,108494,148969,257463,120659,93635,69100,48804,30101,18986,381285,107882,151028,258910,118378,90872,64359,40967,25265,17697,357538,738823,1255197,1255197
Liberia,1965,LR,LBR,AFR,111744,154357,266101,121301,96246,70400,49882,30959,19629,388417,110947,156513,267460,120016,93328,65832,42123,25901,18133,365333,753750,1287315,1287315
Liberia,1966,LR,LBR,AFR,115041,159435,274476,122516,98849,71761,50964,31826,20279,396195,114112,161484,275596,122341,95907,67286,43355,26596,18568,374053,770248,1320315,1320315
Liberia,1967,LR,LBR,AFR,118391,164645,283036,123898,101435,73195,52066,32712,20954,404260,117374,166543,283917,124771,98591,68717,44657,27347,18997,383080,787340,1354287,1354287
Liberia,1968,LR,LBR,AFR,121851,169983,291834,125475,104049,74730,53175,33611,21632,412672,120786,171673,292459,127340,101407,70141,46017,28145,19440,392490,805162,1389453,1389453
Liberia,1969,LR,LBR,AFR,125495,175458,300953,127229,106640,76381,54273,34507,22329,421359,124417,176907,301324,130002,104292,71661,47424,28962,19910,402251,823610,1425879,1425879
Liberia,2031,LR,LBR,AFR,426049,759827,1185876,685349,505428,323948,249692,151146,100363,2015926,415551,742713,1158264,671226,500454,329183,261643,168927,119129,2050562,4066488,6410627,6410627
Liberia,2032,LR,LBR,AFR,430531,768657,1199188,692003,525991,333623,254475,157595,104087,2067774,420014,751551,1171565,677706,520230,338409,265762,176252,122967,2101326,4169100,6539863,6539863
Liberia,2033,LR,LBR,AFR,434763,778082,1212845,697962,545752,344998,258690,164326,108029,2119757,424230,760975,1185205,683533,539295,349231,269438,183538,127282,2152317,4272074,6670120,6670120
Liberia,2034,LR,LBR,AFR,438664,787914,1226578,703707,564145,358082,262533,171181,112203,2171851,428126,770809,1198935,689162,557091,361684,272877,190642,132092,2203548,4375399,6800916,6800916
Liberia,2035,LR,LBR,AFR,442389,798089,1240478,709219,581210,372703,266210,178120,116556,2224018,431827,781007,1212834,694586,573636,375621,276254,197577,137303,2254977,4478995,6932309,6932309
Liberia,2036,LR,LBR,AFR,446015,808468,1254483,714576,597122,388543,270082,184985,121043,2276351,435414,791420,1226834,699900,589057,390751,279923,204238,142798,2306667,4583018,7064345,7064345
Liberia,2037,LR,LBR,AFR,449591,818718,1268309,718969,613037,405341,274329,191573,125781,2329030,438959,801713,1240672,704307,604485,406833,284046,210481,148648,2358800,4687830,7196805,7196805
Liberia,2038,LR,LBR,AFR,452895,828719,1281614,723421,628279,422904,278742,198140,130832,2382318,442245,811744,1253989,708814,619289,423700,288314,216659,154891,2411667,4793985,7329593,7329593
Liberia,2039,LR,LBR,AFR,455879,838177,1294056,729565,641049,441256,284064,204152,136209,2436295,445221,821214,1266435,715001,631729,441385,293512,222209,161522,2465358,4901653,7462143,7462143
Liberia,2040,LR,LBR,AFR,458480,847188,1305668,737078,651235,460464,290816,209219,142060,2490872,447815,830237,1278052,722543,641700,459957,300171,226726,168664,2519761,5010633,7594350,7594350
Liberia,2041,LR,LBR,AFR,460689,855757,1316446,745446,659354,480334,298691,213937,148310,2546072,450033,838801,1288834,730962,649696,479222,307872,230950,176216,2574918,5120990,7726261,7726261
Liberia,2042,LR,LBR,AFR,462505,863920,1326425,754306,666050,500337,307966,218229,154862,2601750,451862,846976,1298838,739883,656325,498688,316891,234859,184004,2630650,5232400,7857657,7857657
Liberia,2043,LR,LBR,AFR,464075,871558,1335633,763743,672074,519576,318835,222044,161700,2657972,453443,854647,1308090,749384,662308,517470,327431,238387,192033,2687013,5344985,7988703,7988703
Liberia,2044,LR,LBR,AFR,465810,878562,1344372,773578,677884,537504,331310,225563,168724,2714563,455190,861690,1316880,759287,668094,535031,339522,241722,200190,2743846,5458409,8119671,8119671
Liberia,2045,LR,LBR,AFR,467432,885011,1352443,783751,683468,554157,345225,228959,175853,2771413,456827,868164,1324991,769548,673681,551392,353029,245027,208399,2801076,5572489,8249922,8249922
Liberia,2046,LR,LBR,AFR,468730,890974,1359704,794127,688901,569703,360278,232545,182930,2828484,458142,874150,1332292,780025,679156,566672,367677,248605,216494,2858629,5687113,8379107,8379107
Liberia,2047,LR,LBR,AFR,470097,896499,1366596,804368,693392,585263,376232,236476,189887,2885618,459524,879705,1339229,790382,683743,581973,383238,252603,224399,2916338,5801956,8507779,8507779
Liberia,2048,LR,LBR,AFR,471489,901505,1372994,814365,697950,600182,392892,240591,196988,2942968,460913,884752,1345665,800477,688434,596672,399548,256770,232451,2974352,5917320,8635984,8635984
Liberia,2049,LR,LBR,AFR,472693,906361,1379054,823818,704151,612706,410290,245513,203812,3000290,462103,889661,1351764,810017,694773,609066,416642,261784,240183,3032465,6032755,8763579,8763579
Liberia,2050,LR,LBR,AFR,474078,910734,1384812,832834,711682,622746,428511,251686,210174,3057633,463483,894084,1357567,819108,702437,619071,434595,268108,247366,3090685,6148318,8890700,8890700
Libya,1970,LY,LBY,EMR,209364,294562,503926,157141,117042,84986,59239,38428,35094,491930,197782,260072,457854,136679,112851,81633,55762,35568,32969,455462,947392,1909177,1909177
Libya,1971,LY,LBY,EMR,210486,314797,525283,159580,119162,85043,60291,38282,35107,497465,199125,278093,477218,137465,113043,81740,56729,35878,33494,458349,955814,1958320,1958320
Libya,1972,LY,LBY,EMR,210714,334723,545437,163663,121931,85516,61699,38165,35260,506234,199840,296903,496743,139802,113782,82407,58104,36258,34029,464382,970616,2012796,2012796
Libya,1973,LY,LBY,EMR,207549,354539,562088,171726,126609,87709,64330,38576,35475,524425,198154,318898,517052,146030,116997,85200,60901,37001,34559,480688,1005113,2084256,2084256
Libya,1974,LY,LBY,EMR,207389,373558,580947,185090,134764,92138,67759,39687,35701,555139,198883,340660,539543,155456,121631,89020,64292,38295,35120,503814,1058953,2179446,2179446
Libya,1975,LY,LBY,EMR,214107,390804,604911,202838,145547,98184,71220,41304,35956,595049,205034,358757,563791,166860,125736,92413,67232,40067,35774,528082,1123131,2291841,2291841
Libya,1976,LY,LBY,EMR,222951,406014,628965,223575,157097,105408,74882,43409,36272,640643,213176,374882,588058,181185,129799,96170,70159,42226,36555,556094,1196737,2413760,2413760
Libya,1977,LY,LBY,EMR,233374,418909,652283,246528,169033,113562,78631,45955,36643,690352,222877,388746,611623,198372,133786,100254,72972,44714,37454,587552,1277904,2541805,2541805
Libya,1978,LY,LBY,EMR,244042,430658,674700,271738,181520,122735,82523,48849,37089,744454,233048,401166,634214,218526,137887,104657,75721,47492,38469,622752,1367206,2676117,2676117
Libya,1979,LY,LBY,EMR,254218,441909,696127,299179,194795,132976,86664,51956,37648,803218,243005,412651,655656,241583,142371,109332,78537,50497,39598,661918,1465136,2816917,2816917
Libya,1980,LY,LBY,EMR,263972,452647,716619,327998,208993,144214,91177,55195,38343,865920,252428,423369,675797,266734,147445,114205,81488,53661,40849,704382,1570302,2962720,2962720
Libya,1981,LY,LBY,EMR,272868,464100,736968,356490,224356,156297,96094,58572,39170,930979,260683,434592,695275,292379,153455,119146,84611,56969,42230,748790,1679769,3112015,3112015
Libya,1982,LY,LBY,EMR,281184,477381,758565,383323,241279,168984,101452,62084,40112,997234,268135,447406,715541,317195,160908,123923,87942,60394,43754,794116,1791350,3265457,3265457
Libya,1983,LY,LBY,EMR,289153,492922,782075,407916,260147,181900,107344,65708,41246,1064261,275104,462212,737316,340484,170240,128405,91490,63859,45460,839938,1904199,3423592,3423592
Libya,1984,LY,LBY,EMR,293826,507730,801556,426769,277040,193564,113269,69119,42667,1122428,279395,477020,756415,361215,180853,132961,94795,66901,47418,884143,2006571,3564547,3564547
Libya,1985,LY,LBY,EMR,296252,520493,816745,439338,291068,203328,119083,72199,44360,1169376,282052,490446,772498,378821,192574,137444,97807,69438,49613,925697,2095073,3684313,3684313
Libya,1986,LY,LBY,EMR,300089,532822,832911,448541,305313,212004,125206,75146,46333,1212543,285931,503093,789024,393506,206032,141352,100926,71754,52058,965628,2178171,3800110,3800110
Libya,1987,LY,LBY,EMR,304547,544772,849319,454800,319885,219849,131687,77984,48598,1252803,290145,515196,805341,405378,221460,144805,104226,73841,54772,1004482,2257285,3911939,3911939
Libya,1988,LY,LBY,EMR,308886,555287,864173,459911,335449,227247,138693,80811,51096,1293207,293983,526054,820037,415568,239240,148091,107763,75774,57711,1044147,2337354,4021565,4021565
Libya,1989,LY,LBY,EMR,312120,564098,876218,464923,352495,234583,146326,83746,53723,1335796,296587,535579,832166,424765,259538,151550,111529,77685,60791,1085858,2421654,4130042,4130042
Libya,1990,LY,LBY,EMR,313250,572602,885852,469796,370384,241990,154485,86885,56443,1379983,297233,544762,841995,433098,281601,155377,115460,79645,63978,1129159,2509142,4236983,4236983
Libya,1991,LY,LBY,EMR,312332,580910,893242,475583,387614,249705,163003,90266,59267,1425438,296050,553359,849409,441716,303900,159899,119421,81694,67264,1173894,2599332,4341971,4341971
Libya,1992,LY,LBY,EMR,309816,588548,898364,483196,403086,258122,171634,93923,62198,1472159,293348,560876,854224,451577,325176,165611,123198,83893,70618,1220073,2692232,4444820,4444820
Libya,1993,LY,LBY,EMR,306100,595067,901167,492796,416400,267634,179990,97911,65239,1519970,289376,566985,856361,462907,344778,172911,126630,86233,74011,1267470,2787440,4544970,4544970
Libya,1994,LY,LBY,EMR,301671,599955,901626,503976,427366,277752,188277,102293,68370,1568034,284540,571399,855939,475468,362374,181480,130221,88717,77433,1315693,2883727,4641296,4641296
Libya,1995,LY,LBY,EMR,297090,603577,900667,515493,435770,288422,196340,107143,71632,1614800,279487,574694,854181,488108,377657,191478,133939,91350,80881,1363413,2978213,4733063,4733063
Libya,1996,LY,LBY,EMR,292733,606542,899275,526256,441528,300090,203741,112455,75049,1659119,274749,577387,852136,499815,390410,203581,137265,94144,84325,1409540,3068659,4820066,4820066
Libya,1997,LY,LBY,EMR,288664,608524,897188,536361,444785,312689,210625,118185,78571,1701216,270517,578894,849411,510844,400604,217943,140273,97142,87720,1454526,3155742,4902346,4902346
Libya,1998,LY,LBY,EMR,284946,609168,894114,545019,446961,326439,217130,124376,82144,1742069,266905,578745,845650,520631,409169,234726,143160,100356,91087,1499129,3241198,4980962,4980962
Libya,1999,LY,LBY,EMR,281703,607997,889700,552337,449084,341610,223537,131089,85766,1783423,263997,576480,840477,529262,416764,253965,146196,103759,94449,1544395,3327818,5057998,5057998
Libya,2000,LY,LBY,EMR,280529,607456,887985,568774,456208,350589,223434,136406,89474,1824885,263784,576035,839819,546031,428997,273552,149334,106349,97843,1602106,3426991,5154790,5154790
Libya,2001,LY,LBY,EMR,283228,607784,891012,593185,472143,352359,216509,138890,93407,1866493,267750,578016,845766,569727,449249,291611,152901,107836,101314,1672638,3539131,5275916,5275916
Libya,2002,LY,LBY,EMR,289763,606759,896522,614593,495153,353970,209441,139145,97211,1909513,275068,579083,854151,590751,474646,308440,157706,109063,104539,1745145,3654658,5405326,5405326
Libya,2003,LY,LBY,EMR,299540,605355,904895,632322,523813,356436,202703,137530,100559,1953363,285238,579967,865205,608680,503753,324961,163851,110599,107337,1819181,3772544,5542641,5542641
Libya,2004,LY,LBY,EMR,311757,604567,916324,645613,555823,361539,196402,134204,104222,1997803,297557,581461,879018,622924,534637,342542,171360,112467,110491,1894421,3892224,5687563,5687563
Libya,2005,LY,LBY,EMR,324795,605556,930351,654541,589028,371030,190171,129412,108295,2042477,310183,584596,894779,633892,566077,361498,179865,114836,114220,1970388,4012865,5837986,5837986
Libya,2006,LY,LBY,EMR,336080,606035,942115,655780,613233,389214,192527,128416,111625,2090795,319958,585898,905856,636847,589438,382501,189584,119283,116944,2034597,4125392,5973369,5973369
Libya,2007,LY,LBY,EMR,345381,606254,951635,652074,628067,413439,205506,129988,115868,2144942,327311,585693,913004,633278,603591,404874,201568,124955,119331,2087597,4232539,6097177,6097177
Libya,2008,LY,LBY,EMR,353610,609458,963068,649922,641188,437967,221826,130054,120533,2201490,334114,588353,922467,630357,615154,427528,216364,129766,122175,2141344,4342834,6228370,6228370
Libya,2009,LY,LBY,EMR,360399,615556,975955,647184,652086,462757,239530,131037,123987,2256581,339949,593647,933596,626739,625040,450006,233167,133327,125780,2194059,4450640,6360191,6360191
Libya,2010,LY,LBY,EMR,366940,624369,991309,642160,661376,487196,257771,133393,126807,2308703,346247,600909,947156,621139,633643,472223,251022,136495,130299,2244821,4553524,6491988,6491988
Libya,2011,LY,LBY,EMR,361132,624223,985355,570964,596490,475675,260918,130368,128494,2162909,340953,597943,938896,545308,568044,461893,256410,135001,134310,2100966,4263875,6188132,6188132
Libya,2012,LY,LBY,EMR,349787,625668,975455,506191,524907,460939,262744,128445,129640,2012866,330462,596636,927098,476563,496587,448085,261072,134405,137733,1954445,3967311,5869870,5869870
Libya,2013,LY,LBY,EMR,346603,638662,985265,515196,521447,478506,279572,134305,131191,2060217,328008,607730,935738,486743,493422,463115,279188,140051,141486,2004005,4064222,5985221,5985221
Libya,2014,LY,LBY,EMR,344598,650399,994997,524544,516033,493296,296979,141136,133561,2105549,326392,617790,944182,497641,488683,475487,298329,146894,146003,2053037,4158586,6097764,6097764
Libya,2015,LY,LBY,EMR,341267,661679,1002946,532039,506825,503988,314618,148247,136715,2142432,323416,627511,950927,507071,481316,484860,316778,154586,151312,2095923,4238355,6192235,6192235
Libya,2016,LY,LBY,EMR,335001,673531,1008532,540621,497888,511791,333145,156004,139687,2179136,317693,637833,955526,517590,474290,492721,334835,162886,156673,2138995,4318131,6282196,6282196
Libya,2017,LY,LBY,EMR,330847,681019,1011866,552501,492469,517736,351991,166103,141894,2222694,313859,644137,957996,530305,469244,498614,352850,172851,161843,2185707,4408401,6378261,6378261
Libya,2018,LY,LBY,EMR,329029,683579,1012608,566731,491345,521197,370503,178838,143102,2271716,312102,645942,958044,544464,467448,501214,370619,185213,166464,2235422,4507138,6477793,6477793
Libya,2019,LY,LBY,EMR,324987,685329,1010316,580498,491396,521764,388610,192421,144007,2318696,308228,647122,955350,558309,467408,501645,387709,199187,170467,2284725,4603421,6569088,6569088
Libya,2020,LY,LBY,EMR,320007,685439,1005446,594088,491964,520981,406089,206242,145154,2364518,303470,647333,950803,571299,468384,500829,404186,213907,174571,2333176,4697694,6653942,6653942
Libya,2021,LY,LBY,EMR,315367,683132,998499,608132,494657,518543,423048,220268,146361,2411009,299033,646016,945049,583409,471592,497722,420537,229023,178436,2380719,4791728,6735277,6735277
Libya,2022,LY,LBY,EMR,310833,678946,989779,621619,499415,513901,439550,234156,148640,2457281,294697,642930,937627,594565,477019,493069,435918,244309,182773,2427653,4884934,6812341,6812341
Libya,2023,LY,LBY,EMR,306441,673463,979904,633770,505473,507974,454934,248583,153111,2503845,290504,638219,928723,604759,484063,487577,449461,260818,189236,2475914,4979759,6888388,6888388
Libya,2024,LY,LBY,EMR,302341,667059,969400,644711,512693,500881,468222,264045,159998,2550550,286600,632364,918964,614130,492491,480934,460739,278686,198303,2525283,5075833,6964197,6964197
Libya,2025,LY,LBY,EMR,298588,658895,957483,655691,521085,493197,479211,280483,168133,2597800,283029,624766,907795,623662,502082,474095,470170,296346,208948,2575303,5173103,7038380,7038380
Libya,2026,LY,LBY,EMR,295395,648153,943548,667319,530720,486179,487686,297822,176704,2646430,279998,614765,894763,633869,512872,467801,478230,313681,220192,2626645,5273075,7111388,7111388
Libya,2027,LY,LBY,EMR,293135,639459,932594,674455,541587,480636,493443,315079,186349,2691549,277847,606594,884441,639965,524833,462541,483978,330843,232679,2674839,5366388,7183416,7183416
Libya,2028,LY,LBY,EMR,291763,633136,924899,676641,553501,477823,496047,331738,197141,2732891,276533,600527,877060,641523,537631,459833,486225,347699,246724,2719635,5452526,7254484,7254484
Libya,2029,LY,LBY,EMR,291163,624992,916155,678253,566206,477263,496441,348256,208463,2774882,275956,592751,868707,642611,550788,459387,486603,364030,261665,2765084,5539966,7324828,7324828
Libya,2030,LY,LBY,EMR,291294,616314,907608,678351,579398,477834,495855,364373,220654,2816465,276081,584475,860556,642828,563488,460287,485942,379912,277723,2810180,5626645,7394813,7394813
Libya,1950,LY,LBY,EMR,93845,132525,226370,103552,80260,58380,43817,38539,34035,358583,87525,128720,216245,102425,78367,54041,39654,30077,24909,329473,688056,1130677,1130677
Libya,1951,LY,LBY,EMR,94420,136156,230576,103491,81106,58495,43570,38236,34145,359043,89010,130910,219920,103078,79734,54954,40031,30256,25260,333313,692356,1142852,1142852
Libya,1952,LY,LBY,EMR,95172,139773,234945,104121,82378,58669,43724,37916,34274,361082,90638,132961,223599,104189,81330,56009,40521,30413,25612,338074,699156,1157703,1157703
Libya,1953,LY,LBY,EMR,96598,143000,239598,105501,84094,59105,44215,37574,34424,364913,92730,134796,227526,105753,83145,57264,41131,30572,25954,343819,708732,1175861,1175861
Libya,1954,LY,LBY,EMR,98374,146255,244629,107682,86209,60102,44926,37197,34607,370723,94868,137090,231958,107711,85112,58785,41857,30761,26308,350534,721257,1197845,1197845
Libya,1955,LY,LBY,EMR,101253,150320,251573,110525,88485,61595,45785,36905,34773,378068,97602,140231,237833,110252,87292,60476,42550,30984,26660,358214,736282,1225687,1225687
Libya,1956,LY,LBY,EMR,105697,155033,260730,113744,90740,63451,46760,36667,34928,386290,101544,143836,245380,113246,89656,62292,43204,31203,27032,366633,752923,1259031,1259031
Libya,1957,LY,LBY,EMR,110765,160087,270852,117239,93005,65696,47853,36347,35119,395259,106152,147823,253975,116338,92087,64282,43937,31417,27442,375503,770762,1295601,1295601
Libya,1958,LY,LBY,EMR,116371,165650,282021,121088,95355,68230,49031,36036,35327,405067,111314,152370,263684,119536,94666,66426,44755,31639,27870,384892,789959,1335660,1335660
Libya,1959,LY,LBY,EMR,122398,171874,294272,125345,97902,70880,50189,35913,35521,415750,116911,157657,274568,122808,97517,68661,45657,31885,28291,394819,810569,1379408,1379408
Libya,1960,LY,LBY,EMR,128970,178780,307750,129960,100712,73535,51335,36043,35681,427266,123025,163703,286728,126103,100680,70954,46663,32159,28688,405247,832513,1426986,1426986
Libya,1961,LY,LBY,EMR,136214,186503,322717,134835,103755,76245,52449,36421,35813,439518,129768,170628,300396,129355,104124,73341,47768,32469,29071,416128,855646,1478760,1478760
Libya,1962,LY,LBY,EMR,144162,195359,339521,139822,106985,79041,53483,37062,35939,452332,137196,178709,315905,132452,107832,75869,48972,32830,29442,427397,879729,1535157,1535157
Libya,1963,LY,LBY,EMR,152679,205362,358041,144477,110241,81820,54520,37841,36039,464938,145248,187940,333188,135162,111591,78479,50309,33245,29807,438593,903531,1594758,1594758
Libya,1964,LY,LBY,EMR,161022,215012,376034,148685,113035,84286,55651,38490,36057,476204,153381,197294,350675,137537,114807,81048,51913,33716,30172,449193,925397,1652102,1652102
Libya,1965,LY,LBY,EMR,171032,223577,394609,151538,114332,85674,56368,38770,36005,482687,162823,204718,367541,138741,116074,82603,53107,34149,30563,455237,937924,1700072,1700072
Libya,1966,LY,LBY,EMR,183237,232644,415881,152710,114231,85851,56559,38763,35876,483990,173791,210766,384557,138390,115320,82741,53507,34463,30985,455406,939396,1739831,1739831
Libya,1967,LY,LBY,EMR,194266,243822,438088,153425,114040,85587,56869,38699,35650,484270,183673,218443,402116,137584,114168,82368,53800,34739,31447,454106,938376,1778578,1778578
Libya,1968,LY,LBY,EMR,202368,257891,460259,154254,114387,85282,57490,38640,35380,485433,191041,229197,420238,136909,113346,81974,54282,35010,31943,453464,938897,1819393,1819393
Libya,1969,LY,LBY,EMR,207182,275046,482228,155449,115398,85051,58308,38537,35179,487922,195551,243268,438819,136563,112906,81702,54944,35283,32452,453850,941772,1862823,1862823
Libya,2031,LY,LBY,EMR,291801,608494,900295,676051,592794,480181,493547,380057,233842,2856472,276564,577021,853585,641510,575297,463338,483072,395814,294814,2853845,5710317,7464206,7464206
Libya,2032,LY,LBY,EMR,292598,601710,894308,671915,605740,484589,489190,395428,247970,2894832,277323,570543,847866,638451,586314,468695,478766,410888,312864,2895978,5790810,7532997,7532997
Libya,2033,LY,LBY,EMR,293722,595992,889714,666538,617674,490527,483750,409764,263253,2931506,278398,565081,843479,633806,596504,475759,473651,424116,332725,2936561,5868067,7601269,7601269
Libya,2034,LY,LBY,EMR,294995,591349,886344,660260,628576,497751,477292,422236,280517,2966632,279601,560660,840261,628025,605872,484186,467384,435136,355061,2975664,5942296,7668904,7668904
Libya,2035,LY,LBY,EMR,296299,587782,884081,652243,639523,506114,470287,432701,299489,3000357,280823,557264,838087,620510,615402,493755,460926,444419,378480,3013492,6013849,7736015,7736015
Libya,2036,LY,LBY,EMR,297649,585145,882794,641688,651117,515697,463926,440909,319402,3032739,282089,554762,836851,610608,625602,504498,454993,452376,401956,3050033,6082772,7802411,7802411
Libya,2037,LY,LBY,EMR,298890,583726,882616,633153,658289,526484,458973,446632,339943,3063474,283252,553412,836664,602513,631721,516402,450069,458139,426211,3085055,6148529,7867801,7867801
Libya,2038,LY,LBY,EMR,299872,583519,883391,626941,660601,538302,456605,449453,360711,3092613,284168,553208,837376,596516,633329,529137,447622,460578,451393,3118575,6211188,7931947,7931947
Libya,2039,LY,LBY,EMR,300600,584228,884828,618931,662363,550893,456392,450245,381577,3120401,284844,553867,838711,588809,634476,542227,447378,461231,476678,3150799,6271200,7994743,7994743
Libya,2040,LY,LBY,EMR,300915,585698,886613,610404,662647,563969,457281,450184,402589,3147074,285132,555246,840378,580614,634758,554873,448454,460909,502322,3181930,6329004,8055989,8055989
Libya,2041,LY,LBY,EMR,300825,587586,888411,602724,660569,577256,459873,448583,423829,3172834,285031,557021,842052,573229,633514,566633,451636,458509,528653,3212174,6385008,8115476,8115476
Libya,2042,LY,LBY,EMR,300377,589658,890035,596070,656687,590110,464442,445144,445358,3197811,284588,558974,843562,566817,630537,577614,457073,454747,554821,3241609,6439420,8173019,8173019
Libya,2043,LY,LBY,EMR,299483,591793,891276,590478,651583,601976,470481,440767,466734,3222019,283731,560990,844721,561418,625983,587778,464168,450221,580662,3270230,6492249,8228242,8228242
Libya,2044,LY,LBY,EMR,298148,593823,891971,585949,645591,612832,477751,435502,487971,3245596,282457,562895,845352,557052,620300,597130,472594,444616,606435,3298127,6543723,8281052,8281052
Libya,2045,LY,LBY,EMR,296278,595475,891753,582493,637883,623737,486119,429781,508736,3268749,280677,564431,845108,553710,612893,606646,482125,438830,631281,3325485,6594234,8331094,8331094
Libya,2046,LY,LBY,EMR,293987,596766,890753,579958,627685,635284,495648,424649,528133,3291357,278500,565620,844120,551255,603115,616827,492804,433543,654643,3352187,6643544,8378414,8378414
Libya,2047,LY,LBY,EMR,291408,597592,889000,578633,619459,642497,506337,420794,545728,3313448,276046,566366,842412,549949,595132,622957,504612,429207,676367,3378224,6691672,8423078,8423078
Libya,2048,LY,LBY,EMR,288644,597714,886358,578510,613515,644943,518026,419271,560824,3335089,273417,566445,839862,549783,589224,624623,517231,427217,695550,3403628,6738717,8464938,8464938
Libya,2049,LY,LBY,EMR,285709,597138,882847,579292,605806,646856,530479,419714,574115,3356262,270618,565872,836490,550479,581623,625835,530210,427325,712879,3428351,6784613,8503951,8503951
Libya,2050,LY,LBY,EMR,282700,595616,878316,580832,597582,647328,543414,421201,586701,3377058,267752,564405,832157,551887,573531,626196,542753,428719,729366,3452452,6829510,8539976,8539976
Saint Lucia,1970,LC,LCA,AMR,9383,16453,25836,8471,4245,3295,3310,2453,1768,23542,9143,16045,25188,9207,5411,4356,3830,2889,2833,28526,52068,103090,103090
Saint Lucia,1971,LC,LCA,AMR,9305,16662,25967,8921,4452,3285,3311,2526,1826,24321,9073,16257,25330,9561,5564,4335,3871,2929,2892,29152,53473,104781,104781
Saint Lucia,1972,LC,LCA,AMR,9241,16845,26086,9370,4674,3296,3301,2593,1889,25123,9018,16434,25452,9927,5725,4322,3902,2972,2952,29800,54923,106457,106457
Saint Lucia,1973,LC,LCA,AMR,9212,16968,26180,9817,4899,3329,3276,2652,1946,25919,8989,16559,25548,10306,5893,4323,3919,3018,3011,30470,56389,108114,108114
Saint Lucia,1974,LC,LCA,AMR,9242,17037,26279,10252,5123,3378,3245,2705,2007,26710,8995,16630,25625,10682,6065,4331,3919,3061,3066,31124,57834,109740,109740
Saint Lucia,1975,LC,LCA,AMR,9362,17065,26427,10683,5361,3448,3213,2748,2064,27517,9095,16663,25758,11067,6233,4354,3911,3110,3120,31795,59312,111497,111497
Saint Lucia,1976,LC,LCA,AMR,9557,17073,26630,11104,5618,3532,3174,2783,2135,28346,9277,16679,25956,11462,6402,4399,3887,3160,3175,32485,60831,113421,113421
Saint Lucia,1977,LC,LCA,AMR,9777,17077,26854,11500,5887,3639,3137,2804,2202,29169,9478,16690,26168,11844,6590,4464,3855,3208,3241,33202,62371,115385,115385
Saint Lucia,1978,LC,LCA,AMR,10007,17075,27082,11876,6170,3770,3101,2818,2278,30013,9704,16680,26384,12210,6786,4544,3821,3250,3311,33922,63935,117397,117397
Saint Lucia,1979,LC,LCA,AMR,10232,17079,27311,12250,6466,3916,3080,2821,2349,30882,9940,16672,26612,12566,7003,4641,3784,3288,3373,34655,65537,119463,119463
Saint Lucia,1980,LC,LCA,AMR,10398,17145,27543,12629,6785,4081,3071,2819,2427,31812,10118,16726,26844,12921,7252,4756,3749,3317,3436,35431,67243,121633,121633
Saint Lucia,1981,LC,LCA,AMR,10475,17276,27751,13001,7104,4268,3091,2823,2519,32806,10196,16853,27049,13272,7529,4887,3745,3355,3517,36305,69111,123909,123909
Saint Lucia,1982,LC,LCA,AMR,10495,17432,27927,13329,7416,4473,3137,2843,2619,33817,10227,16998,27225,13580,7836,5025,3768,3404,3615,37228,71045,126194,126194
Saint Lucia,1983,LC,LCA,AMR,10486,17623,28109,13572,7751,4690,3203,2859,2727,34802,10230,17183,27413,13808,8173,5175,3798,3451,3715,38120,72922,128440,128440
Saint Lucia,1984,LC,LCA,AMR,10451,17857,28308,13714,8115,4911,3285,2873,2834,35732,10206,17405,27611,13946,8539,5332,3844,3485,3829,38975,74707,130625,130625
Saint Lucia,1985,LC,LCA,AMR,10400,18100,28500,13804,8487,5140,3383,2882,2936,36632,10169,17640,27809,14029,8923,5487,3910,3516,3951,39816,76448,132751,132751
Saint Lucia,1986,LC,LCA,AMR,10343,18319,28662,13878,8854,5379,3494,2894,3033,37532,10120,17849,27969,14097,9311,5650,3984,3537,4072,40651,78183,134810,134810
Saint Lucia,1987,LC,LCA,AMR,10275,18509,28784,13947,9202,5623,3625,2905,3123,38425,10053,18042,28095,14148,9691,5826,4079,3545,4191,41480,79905,136780,136780
Saint Lucia,1988,LC,LCA,AMR,10192,18676,28868,13996,9545,5877,3773,2911,3207,39309,9973,18222,28195,14175,10055,6013,4183,3552,4311,42289,81598,138660,138660
Saint Lucia,1989,LC,LCA,AMR,10095,18807,28902,14033,9881,6135,3933,2933,3290,40205,9877,18387,28264,14186,10402,6221,4299,3557,4427,43092,83297,140457,140457
Saint Lucia,1990,LC,LCA,AMR,9992,18888,28880,14125,10230,6403,4107,2956,3366,41187,9764,18492,28256,14255,10749,6458,4423,3562,4534,43981,85168,142301,142301
Saint Lucia,1991,LC,LCA,AMR,9888,18926,28814,14298,10583,6677,4290,2985,3431,42264,9651,18541,28192,14409,11099,6724,4551,3572,4643,44998,87262,144268,144268
Saint Lucia,1992,LC,LCA,AMR,9750,18871,28621,14525,10955,6961,4495,3092,3519,43547,9507,18512,28019,14607,11450,7034,4707,3645,4786,46229,89776,146420,146420
Saint Lucia,1993,LC,LCA,AMR,9556,18734,28290,14785,11300,7254,4711,3273,3656,44979,9308,18407,27715,14830,11754,7382,4889,3783,4977,47615,92594,148595,148595
Saint Lucia,1994,LC,LCA,AMR,9331,18595,27926,15019,11569,7583,4923,3443,3802,46339,9076,18305,27381,15027,11979,7754,5080,3904,5166,48910,95249,150561,150561
Saint Lucia,1995,LC,LCA,AMR,9090,18456,27546,15190,11786,7948,5140,3594,3970,47628,8828,18209,27037,15171,12165,8144,5267,4025,5366,50138,97766,152348,152348
Saint Lucia,1996,LC,LCA,AMR,8846,18315,27161,15294,11988,8321,5357,3721,4161,48842,8578,18092,26670,15263,12330,8542,5456,4139,5568,51298,100140,153969,153969
Saint Lucia,1997,LC,LCA,AMR,8617,18147,26764,15373,12170,8694,5581,3820,4359,49997,8356,17924,26280,15334,12477,8941,5651,4236,5770,52409,102406,155454,155454
Saint Lucia,1998,LC,LCA,AMR,8440,17919,26359,15453,12305,9083,5813,3889,4586,51129,8193,17681,25874,15418,12579,9361,5844,4315,5976,53493,104622,156855,156855
Saint Lucia,1999,LC,LCA,AMR,8345,17656,26001,15524,12388,9490,6055,3935,4818,52210,8128,17373,25501,15499,12632,9807,6031,4393,6185,54547,106757,158256,158256
Saint Lucia,2000,LC,LCA,AMR,8241,17370,25611,15555,12428,9903,6294,3997,5038,53215,8065,17042,25107,15560,12657,10238,6236,4481,6385,55557,108772,159500,159500
Saint Lucia,2001,LC,LCA,AMR,8013,17128,25141,15584,12492,10349,6487,4151,5187,54250,7864,16750,24614,15623,12740,10618,6476,4589,6543,56589,110839,160594,160594
Saint Lucia,2002,LC,LCA,AMR,7697,16975,24672,15641,12631,10794,6691,4380,5250,55387,7560,16528,24088,15681,12912,10943,6770,4725,6624,57655,113042,161799,161799
Saint Lucia,2003,LC,LCA,AMR,7369,16865,24234,15684,12801,11157,6992,4615,5275,56524,7219,16358,23577,15705,13072,11235,7117,4899,6678,58706,115230,163047,163047
Saint Lucia,2004,LC,LCA,AMR,7039,16765,23804,15697,12953,11449,7391,4832,5304,57626,6853,16230,23083,15700,13156,11524,7508,5094,6739,59721,117347,164239,164239
Saint Lucia,2005,LC,LCA,AMR,6766,16589,23355,15695,13077,11714,7841,5044,5361,58732,6538,16060,22598,15665,13195,11811,7926,5291,6815,60703,119435,165386,165386
Saint Lucia,2006,LC,LCA,AMR,6570,16302,22872,15675,13192,11956,8306,5249,5436,59814,6324,15783,22107,15593,13236,12079,8359,5487,6918,61672,121486,166470,166470
Saint Lucia,2007,LC,LCA,AMR,6430,15953,22383,15655,13308,12162,8785,5460,5525,60895,6176,15437,21613,15488,13285,12314,8811,5691,7026,62615,123510,167518,167518
Saint Lucia,2008,LC,LCA,AMR,6347,15564,21911,15666,13401,12331,9270,5679,5647,61994,6080,15054,21134,15376,13320,12512,9271,5908,7145,63532,125526,168576,168576
Saint Lucia,2009,LC,LCA,AMR,6332,15139,21471,15732,13443,12457,9751,5902,5793,63078,6045,14654,20699,15306,13325,12658,9738,6122,7283,64432,127510,169688,169688
Saint Lucia,2010,LC,LCA,AMR,6249,14699,20948,15943,13568,12536,10201,6105,5921,64274,5947,14245,20192,15404,13435,12745,10182,6324,7424,65514,129788,170935,170935
Saint Lucia,2011,LC,LCA,AMR,6071,14281,20352,16214,13784,12579,10584,6311,6022,65494,5776,13838,19614,15597,13645,12775,10587,6530,7554,66688,132182,172145,172145
Saint Lucia,2012,LC,LCA,AMR,5895,13912,19807,16361,13954,12600,10923,6541,6116,66495,5635,13462,19097,15695,13834,12784,10950,6777,7680,67720,134215,173124,173124
Saint Lucia,2013,LC,LCA,AMR,5703,13622,19325,16405,14114,12632,11206,6802,6209,67368,5495,13149,18644,15707,14025,12778,11266,7050,7812,68638,136006,173978,173978
Saint Lucia,2014,LC,LCA,AMR,5494,13397,18891,16365,14294,12674,11447,7088,6286,68154,5335,12879,18214,15681,14224,12766,11556,7357,7951,69535,137689,174804,174804
Saint Lucia,2015,LC,LCA,AMR,5391,13097,18488,16259,14508,12738,11646,7407,6360,68918,5247,12533,17780,15642,14430,12777,11811,7690,8094,70444,139362,175623,175623
Saint Lucia,2016,LC,LCA,AMR,5391,12708,18099,16072,14752,12830,11795,7745,6437,69631,5248,12140,17388,15516,14635,12825,12025,8054,8241,71296,140927,176413,176413
Saint Lucia,2017,LC,LCA,AMR,5391,12363,17754,15791,15014,12951,11893,8094,6537,70280,5246,11832,17078,15277,14833,12905,12189,8438,8407,72049,142329,177163,177163
Saint Lucia,2018,LC,LCA,AMR,5381,12066,17447,15432,15291,13092,11960,8446,6652,70873,5237,11591,16828,14961,15016,13026,12321,8831,8593,72748,143621,177888,177888
Saint Lucia,2019,LC,LCA,AMR,5363,11807,17170,15030,15563,13236,12003,8794,6785,71411,5221,11371,16592,14599,15191,13174,12415,9233,8796,73408,144819,178583,178583
Saint Lucia,2020,LC,LCA,AMR,5335,11595,16930,14597,15808,13382,12021,9134,6951,71893,5193,11164,16357,14207,15372,13341,12466,9637,9035,74058,145951,179237,179237
Saint Lucia,2021,LC,LCA,AMR,5297,11419,16716,14170,15999,13519,12019,9440,7073,72220,5155,10993,16148,13795,15523,13519,12479,10009,9239,74564,146784,179651,179651
Saint Lucia,2022,LC,LCA,AMR,5248,11240,16488,13799,16115,13654,12011,9698,7182,72459,5107,10850,15957,13417,15612,13696,12471,10334,9427,74957,147416,179857,179857
Saint Lucia,2023,LC,LCA,AMR,5191,11041,16232,13513,16154,13807,12032,9933,7392,72831,5052,10704,15756,13108,15623,13886,12467,10632,9724,75440,148271,180251,180251
Saint Lucia,2024,LC,LCA,AMR,5134,10818,15952,13295,16114,13981,12078,10154,7676,73298,4994,10528,15522,12841,15602,14088,12464,10918,10116,76029,149327,180805,180805
Saint Lucia,2025,LC,LCA,AMR,5077,10685,15762,12996,16006,14194,12145,10337,7978,73656,4938,10412,15350,12494,15563,14293,12478,11170,10545,76543,150199,181310,181310
Saint Lucia,2026,LC,LCA,AMR,5028,10649,15677,12611,15825,14435,12239,10480,8312,73902,4889,10377,15266,12103,15438,14502,12534,11376,10994,76947,150849,181787,181787
Saint Lucia,2027,LC,LCA,AMR,4984,10601,15585,12268,15553,14699,12363,10580,8666,74129,4846,10328,15174,11799,15204,14701,12618,11545,11483,77350,151479,182236,182236
Saint Lucia,2028,LC,LCA,AMR,4940,10534,15474,11977,15203,14972,12506,10655,9043,74356,4805,10264,15069,11561,14885,14881,12739,11679,11984,77729,152085,182631,182631
Saint Lucia,2029,LC,LCA,AMR,4895,10460,15355,11723,14810,15241,12653,10709,9427,74563,4762,10190,14952,11343,14530,15056,12891,11776,12511,78107,152670,182976,182976
Saint Lucia,2030,LC,LCA,AMR,4849,10379,15228,11518,14388,15488,12801,10745,9828,74768,4716,10108,14824,11134,14138,15238,13062,11835,13047,78454,153222,183274,183274
Saint Lucia,1950,LC,LCA,AMR,7286,11477,18763,8196,5786,4414,2870,1473,1098,23837,7016,10672,17688,7965,6040,4798,3383,2219,2006,26411,50248,86695,86695
Saint Lucia,1951,LC,LCA,AMR,7378,11571,18949,8077,5900,4467,2900,1523,1078,23945,7104,10846,17950,7864,6159,4805,3412,2246,1983,26469,50414,87310,87310
Saint Lucia,1952,LC,LCA,AMR,7492,11513,19005,7860,5984,4486,2892,1576,1082,23880,7218,10934,18152,7730,6273,4771,3416,2285,2004,26479,50359,87526,87526
Saint Lucia,1953,LC,LCA,AMR,7614,11477,19091,7690,6021,4481,2889,1632,1092,23805,7337,11010,18347,7654,6357,4729,3415,2327,2045,26527,50332,87775,87775
Saint Lucia,1954,LC,LCA,AMR,7771,11485,19256,7568,5956,4447,2901,1682,1112,23666,7489,11088,18577,7633,6367,4696,3426,2376,2079,26577,50243,88084,88084
Saint Lucia,1955,LC,LCA,AMR,7965,11522,19487,7516,5798,4386,2932,1733,1138,23503,7678,11150,18828,7692,6303,4670,3445,2428,2112,26650,50153,88463,88463
Saint Lucia,1956,LC,LCA,AMR,8153,11619,19772,7524,5570,4302,2972,1779,1167,23314,7862,11241,19103,7801,6187,4647,3468,2478,2145,26726,50040,88912,88912
Saint Lucia,1957,LC,LCA,AMR,8345,11793,20138,7565,5298,4195,3013,1817,1198,23086,8051,11384,19435,7926,6042,4628,3487,2513,2179,26775,49861,89435,89435
Saint Lucia,1958,LC,LCA,AMR,8568,12011,20579,7604,5022,4079,3040,1838,1229,22812,8268,11568,19836,8043,5904,4615,3491,2536,2219,26808,49620,90040,90040
Saint Lucia,1959,LC,LCA,AMR,8789,12277,21066,7629,4771,3959,3050,1841,1264,22514,8486,11804,20290,8128,5796,4598,3479,2541,2268,26810,49324,90678,90678
Saint Lucia,1960,LC,LCA,AMR,9037,12547,21584,7644,4615,3882,3081,1863,1293,22378,8731,12072,20803,8166,5719,4602,3484,2554,2323,26848,49226,91614,91614
Saint Lucia,1961,LC,LCA,AMR,9291,12805,22096,7634,4535,3853,3138,1910,1334,22404,8977,12364,21341,8175,5656,4619,3517,2581,2370,26918,49322,92761,92761
Saint Lucia,1962,LC,LCA,AMR,9469,13114,22583,7615,4458,3813,3186,1964,1375,22411,9151,12707,21858,8179,5590,4628,3548,2612,2426,26983,49394,93823,93823
Saint Lucia,1963,LC,LCA,AMR,9567,13493,23060,7609,4383,3764,3228,2019,1418,22421,9248,13107,22355,8202,5522,4628,3577,2642,2471,27042,49463,94887,94887
Saint Lucia,1964,LC,LCA,AMR,9594,13937,23531,7618,4315,3709,3263,2073,1467,22445,9288,13556,22844,8243,5462,4616,3611,2676,2528,27136,49581,95948,95948
Saint Lucia,1965,LC,LCA,AMR,9577,14414,23991,7648,4255,3645,3288,2134,1512,22482,9282,14034,23316,8303,5414,4590,3645,2707,2572,27231,49713,97024,97024
Saint Lucia,1966,LC,LCA,AMR,9546,14890,24436,7706,4208,3572,3308,2197,1555,22546,9262,14507,23769,8393,5374,4554,3678,2744,2623,27366,49912,98126,98126
Saint Lucia,1967,LC,LCA,AMR,9514,15336,24850,7804,4174,3493,3313,2262,1602,22648,9243,14953,24196,8527,5348,4505,3717,2781,2675,27553,50201,99257,99257
Saint Lucia,1968,LC,LCA,AMR,9478,15758,25236,7942,4154,3415,3313,2327,1660,22811,9219,15365,24584,8693,5331,4454,3753,2816,2725,27772,50583,100400,100400
Saint Lucia,1969,LC,LCA,AMR,9444,16147,25591,8131,4146,3336,3309,2387,1712,23021,9194,15747,24941,8911,5332,4398,3785,2851,2776,28053,51074,101605,101605
Saint Lucia,2031,LC,LCA,AMR,4794,10293,15087,11340,13972,15683,12948,10772,10234,74949,4662,10021,14683,10965,13730,15391,13245,11864,13606,78801,153750,183518,183518
Saint Lucia,2032,LC,LCA,AMR,4733,10199,14932,11167,13614,15809,13094,10805,10629,75118,4601,9929,14530,10821,13357,15483,13428,11880,14152,79121,154239,183700,183700
Saint Lucia,2033,LC,LCA,AMR,4669,10102,14771,10968,13333,15848,13250,10849,11008,75256,4540,9834,14374,10678,13051,15495,13621,11891,14694,79430,154686,183831,183831
Saint Lucia,2034,LC,LCA,AMR,4605,10001,14606,10747,13117,15813,13429,10909,11364,75379,4476,9734,14210,10503,12782,15475,13824,11897,15226,79707,155086,183910,183910
Saint Lucia,2035,LC,LCA,AMR,4538,9897,14435,10618,12829,15712,13640,10988,11701,75488,4412,9634,14046,10388,12441,15439,14029,11922,15753,79972,155460,183927,183927
Saint Lucia,2036,LC,LCA,AMR,4472,9792,14264,10585,12450,15537,13884,11089,12016,75561,4348,9533,13881,10352,12055,15317,14232,11982,16247,80185,155746,183889,183889
Saint Lucia,2037,LC,LCA,AMR,4406,9687,14093,10536,12114,15273,14143,11218,12325,75609,4282,9432,13714,10304,11752,15085,14433,12075,16733,80382,155991,183794,183794
Saint Lucia,2038,LC,LCA,AMR,4337,9585,13922,10473,11829,14932,14415,11365,12611,75625,4215,9329,13544,10241,11511,14769,14616,12199,17207,80543,156168,183636,183636
Saint Lucia,2039,LC,LCA,AMR,4270,9478,13748,10402,11581,14550,14685,11517,12894,75629,4151,9223,13374,10167,11295,14416,14794,12354,17654,80680,156309,183425,183425
Saint Lucia,2040,LC,LCA,AMR,4208,9362,13570,10320,11378,14138,14930,11670,13169,75605,4089,9111,13200,10087,11091,14029,14976,12526,18072,80781,156386,183155,183155
Saint Lucia,2041,LC,LCA,AMR,4145,9242,13387,10236,11207,13733,15125,11816,13443,75560,4027,8993,13020,10000,10921,13630,15129,12714,18473,80867,156427,182826,182826
Saint Lucia,2042,LC,LCA,AMR,4085,9115,13200,10143,11033,13386,15253,11970,13714,75499,3971,8869,12840,9911,10779,13260,15222,12898,18850,80920,156419,182459,182459
Saint Lucia,2043,LC,LCA,AMR,4031,8987,13018,10046,10843,13114,15297,12129,13990,75419,3920,8742,12662,9817,10637,12954,15238,13087,19212,80945,156364,182046,182046
Saint Lucia,2044,LC,LCA,AMR,3983,8856,12839,9951,10627,12906,15269,12311,14249,75313,3871,8614,12485,9716,10460,12694,15221,13290,19562,80943,156256,181576,181576
Saint Lucia,2045,LC,LCA,AMR,3936,8724,12660,9846,10501,12622,15174,12523,14512,75178,3825,8486,12311,9615,10348,12354,15186,13494,19911,80908,156086,181055,181055
Saint Lucia,2046,LC,LCA,AMR,3892,8595,12487,9745,10472,12253,15011,12761,14782,75024,3782,8363,12145,9514,10315,11968,15070,13698,20279,80844,155868,180493,180493
Saint Lucia,2047,LC,LCA,AMR,3852,8473,12325,9640,10424,11928,14764,13020,15065,74841,3741,8242,11983,9412,10267,11671,14843,13900,20649,80742,155583,179892,179892
Saint Lucia,2048,LC,LCA,AMR,3815,8354,12169,9538,10366,11652,14444,13292,15356,74648,3704,8122,11826,9310,10204,11434,14536,14084,21039,80607,155255,179245,179245
Saint Lucia,2049,LC,LCA,AMR,3783,8239,12022,9431,10293,11410,14080,13558,15644,74416,3673,8007,11680,9206,10131,11217,14192,14265,21438,80449,154865,178565,178565
Saint Lucia,2050,LC,LCA,AMR,3755,8128,11883,9318,10218,11211,13688,13804,15936,74175,3646,7898,11544,9096,10050,11021,13813,14447,21835,80262,154437,177856,177856
Sri Lanka,1970,LK,LKA,SEA,903604,1611480,2515084,1227049,852441,660596,523267,352348,275327,3891028,874565,1558721,2433286,1191013,816598,598070,432312,278540,232833,3549366,7440394,12388769,12388769
Sri Lanka,1971,LK,LKA,SEA,906644,1640764,2547408,1257403,879623,667496,534927,363200,284297,3986946,877604,1587625,2465229,1221221,846057,610444,447163,288197,241980,3655062,7642008,12654651,12654651
Sri Lanka,1972,LK,LKA,SEA,906572,1668197,2574769,1286775,909070,674691,546381,374106,293971,4084994,877620,1614755,2492375,1249993,877603,623114,462197,297915,251494,3762316,7847310,12914457,12914457
Sri Lanka,1973,LK,LKA,SEA,905083,1691606,2596689,1318741,939094,682516,557175,384843,303619,4185988,876338,1638095,2514433,1280446,909848,636287,477056,307783,261204,3872624,8058612,13169737,13169737
Sri Lanka,1974,LK,LKA,SEA,903286,1709049,2612335,1355924,966454,691323,566723,395520,313751,4289695,874837,1655745,2530582,1315569,939485,650071,491145,318095,271300,3985665,8275360,13418276,13418276
Sri Lanka,1975,LK,LKA,SEA,902708,1722890,2625598,1394323,992494,701459,574840,406139,324400,4393655,874501,1669917,2544418,1352029,967448,664707,504250,328973,281797,4099204,8492859,13662873,13662873
Sri Lanka,1976,LK,LKA,SEA,907063,1734754,2641817,1429291,1019474,713348,581710,416635,335552,4496010,878842,1682021,2560863,1385333,996034,680621,516433,340390,292677,4211488,8707498,13910170,13910170
Sri Lanka,1977,LK,LKA,SEA,915575,1745407,2660982,1461296,1046584,727212,587336,426837,346972,4596237,886989,1692771,2579760,1416053,1024369,698029,527631,352265,303729,4322076,8918313,14159052,14159052
Sri Lanka,1978,LK,LKA,SEA,929058,1754636,2683694,1492120,1073192,743061,592141,436951,359225,4696690,899589,1702080,2601669,1445800,1051745,716985,538143,364671,315418,4432762,9129452,14414816,14414816
Sri Lanka,1979,LK,LKA,SEA,950809,1760389,2711198,1522234,1098459,760676,596579,446948,372131,4797027,919829,1708031,2627860,1475052,1077407,737524,548491,377627,328203,4544304,9341331,14680387,14680387
Sri Lanka,1980,LK,LKA,SEA,975096,1764857,2739953,1550041,1121921,780022,600817,456475,385024,4894300,942248,1712708,2654956,1502259,1100981,759773,558849,390822,341742,4654426,9548726,14943645,14943645
Sri Lanka,1981,LK,LKA,SEA,995726,1772104,2767830,1574703,1143355,801338,605092,465661,398221,4988370,960941,1719921,2680862,1526436,1122184,783863,569301,404240,355833,4761857,9750227,15198918,15198918
Sri Lanka,1982,LK,LKA,SEA,1007847,1780486,2788333,1597434,1163634,824827,609696,474658,411709,5081958,971494,1728012,2699506,1548735,1141822,810001,580096,417959,370340,4868953,9950911,15438753,15438753
Sri Lanka,1983,LK,LKA,SEA,1005349,1792577,2797926,1616711,1186678,848916,615018,483194,425522,5176039,968208,1739368,2707576,1567835,1163473,836976,591478,431690,385440,4976892,10152931,15658442,15658442
Sri Lanka,1984,LK,LKA,SEA,990483,1813029,2803512,1631471,1216022,870945,621557,490834,439977,5270806,953209,1758471,2711680,1582978,1191151,861969,603735,445008,401735,5086576,10357382,15872577,15872577
Sri Lanka,1985,LK,LKA,SEA,970062,1837827,2807889,1644990,1248966,892828,629880,497474,454902,5369040,932995,1781482,2714477,1597290,1222780,886481,617303,457761,419311,5200926,10569966,16092338,16092338
Sri Lanka,1986,LK,LKA,SEA,945946,1864499,2810445,1659035,1281676,917099,640499,503278,469965,5471552,909329,1806051,2715380,1612228,1254548,913053,632701,470018,438071,5320619,10792171,16317995,16317995
Sri Lanka,1987,LK,LKA,SEA,923120,1887380,2810500,1673582,1314353,942899,653580,508184,484659,5577257,886907,1826865,2713772,1627770,1286906,940842,650179,481773,458136,5445606,11022863,16547139,16547139
Sri Lanka,1988,LK,LKA,SEA,906484,1900982,2807466,1687052,1347525,969076,668821,512316,498656,5683446,870421,1838660,2709081,1642457,1320447,968796,669622,493137,479288,5573747,11257193,16773736,16773736
Sri Lanka,1989,LK,LKA,SEA,894206,1910160,2804366,1695490,1379799,994077,685624,515834,511742,5782566,858285,1846045,2704330,1653036,1354631,995849,690806,504266,500731,5699319,11481885,16990575,16990575
Sri Lanka,1990,LK,LKA,SEA,885631,1915970,2801601,1701771,1410501,1018347,704609,519519,524576,5879323,850028,1850006,2700034,1661190,1387731,1021955,714093,515542,522629,5823140,11702463,17204094,17204094
Sri Lanka,1991,LK,LKA,SEA,881409,1914300,2795709,1710485,1439152,1042079,726272,523814,537622,5979424,846345,1846633,2692978,1670658,1418472,1046963,739783,527237,545363,5948476,11927900,17416596,17416596
Sri Lanka,1992,LK,LKA,SEA,881448,1905144,2786592,1719436,1465766,1065458,750442,528725,550844,6080671,847090,1836063,2683153,1679712,1447265,1071283,767871,539397,568504,6074032,12154703,17624457,17624457
Sri Lanka,1993,LK,LKA,SEA,882773,1887461,2770234,1731816,1488825,1092061,775546,534624,564204,6187076,849204,1817451,2666655,1690910,1471961,1097848,796910,552152,591872,6201653,12388729,17825611,17825611
Sri Lanka,1994,LK,LKA,SEA,881477,1861771,2743248,1751574,1505655,1123881,798228,541337,576002,6296677,848633,1791515,2640148,1708442,1490164,1129248,823529,565459,614828,6331670,12628347,18011744,18011744
Sri Lanka,1995,LK,LKA,SEA,876739,1833609,2710348,1773736,1517021,1156371,819315,548802,585326,6400571,844469,1763667,2608136,1728180,1503332,1161958,848554,579450,637048,6458522,12859093,18177572,18177572
Sri Lanka,1996,LK,LKA,SEA,868776,1805132,2673908,1796110,1524323,1185203,840963,557476,592511,6496586,836870,1735972,2572842,1747913,1512468,1191594,874170,594526,658499,6579170,13075756,18322506,18322506
Sri Lanka,1997,LK,LKA,SEA,856820,1781536,2638356,1813942,1528947,1211250,862695,567733,597742,6582309,824972,1713335,2538307,1762951,1518406,1218948,899656,610977,679215,6690153,13272462,18449123,18449123
Sri Lanka,1998,LK,LKA,SEA,843057,1764990,2608047,1822492,1531090,1236285,884021,579625,601466,6654979,811024,1697611,2508635,1768999,1521588,1245789,924497,628922,699344,6789139,13444118,18560798,18560798
Sri Lanka,1999,LK,LKA,SEA,832309,1750432,2582741,1827663,1529630,1261383,904863,593508,605459,6722506,799898,1683823,2483721,1771620,1520683,1272891,948329,648526,719392,6881441,13603947,18670411,18670411
Sri Lanka,2000,LK,LKA,SEA,828464,1736257,2564721,1830247,1526665,1284939,924662,608704,606394,6781611,795380,1670440,2465820,1771720,1517939,1298789,970909,669546,735318,6964221,13745832,18776371,18776371
Sri Lanka,2001,LK,LKA,SEA,835660,1720603,2556263,1824881,1528919,1308982,949450,626617,605586,6844435,802352,1660721,2463073,1770304,1521872,1326632,998479,691928,747297,7056512,13900947,18920275,18920275
Sri Lanka,2002,LK,LKA,SEA,850937,1705324,2556261,1810624,1535426,1333711,980522,648611,607724,6916618,818142,1655213,2473355,1767166,1531583,1356325,1032205,716915,760277,7164471,14081089,19110707,19110707
Sri Lanka,2003,LK,LKA,SEA,868049,1694599,2562648,1786309,1546356,1353630,1013251,672968,611067,6983581,835979,1651715,2487694,1755656,1545850,1381238,1067532,745519,773458,7269253,14252834,19303180,19303180
Sri Lanka,2004,LK,LKA,SEA,883749,1688060,2571809,1753497,1564845,1365742,1048867,697896,615081,7045928,852573,1649869,2502442,1736990,1568071,1397742,1105828,775818,785813,7370262,14416190,19490431,19490431
Sri Lanka,2005,LK,LKA,SEA,895298,1687768,2583066,1716505,1587326,1372139,1084005,724826,620278,7105079,865159,1651887,2517046,1714901,1595452,1407818,1144032,808533,797943,7468679,14573758,19673866,19673866
Sri Lanka,2006,LK,LKA,SEA,903861,1694535,2598396,1680301,1609264,1377209,1116340,755256,627571,7165941,874913,1658815,2533728,1693879,1624630,1416940,1180492,845393,811310,7572644,14738585,19870706,19870706
Sri Lanka,2007,LK,LKA,SEA,911717,1704227,2615944,1652140,1624162,1380891,1145991,786545,638536,7228265,883939,1667184,2551123,1680189,1649669,1425452,1214759,883190,830058,7683317,14911582,20078655,20078655
Sri Lanka,2008,LK,LKA,SEA,919524,1715644,2635168,1632531,1631827,1380714,1170630,819713,651553,7286968,892692,1677017,2569709,1673171,1670481,1430402,1244797,923330,851623,7793804,15080772,20285643,20285643
Sri Lanka,2009,LK,LKA,SEA,924746,1729226,2653972,1619028,1633629,1377301,1190087,853586,665781,7339412,898959,1689748,2588707,1669738,1688426,1432653,1271622,963929,874007,7900375,15239787,20482477,20482477
Sri Lanka,2010,LK,LKA,SEA,924326,1744588,2668914,1612073,1630390,1372557,1208604,885457,681784,7390865,900125,1705208,2605333,1668412,1703366,1433701,1298875,1001265,897833,8003452,15394317,20668557,20668557
Sri Lanka,2011,LK,LKA,SEA,918543,1763061,2681604,1614920,1619416,1373279,1221999,919496,700489,7449599,897126,1724514,2621640,1671462,1710649,1440145,1320229,1041278,923140,8106903,15556502,20859743,20859743
Sri Lanka,2012,LK,LKA,SEA,911583,1781086,2692669,1621147,1600783,1379845,1229996,946206,721876,7499853,890660,1742395,2633055,1669298,1703398,1450945,1333111,1074446,960366,8191564,15691417,21017147,21017147
Sri Lanka,2013,LK,LKA,SEA,905232,1795565,2700797,1625240,1575958,1391613,1238796,960621,744922,7537150,881651,1755686,2637337,1658808,1682794,1465284,1344911,1095004,1009664,8256465,15793615,21131756,21131756
Sri Lanka,2014,LK,LKA,SEA,897743,1806674,2704417,1629342,1546668,1410008,1242500,976394,771138,7576050,871413,1766201,2637614,1648736,1656391,1486851,1350112,1116550,1062730,8321370,15897420,21239457,21239457
Sri Lanka,2015,LK,LKA,SEA,889304,1811322,2700626,1635526,1513478,1432372,1242334,994500,800084,7618294,860046,1770852,2630898,1641439,1624588,1513581,1350172,1139768,1117335,8386883,16005177,21336697,21336697
Sri Lanka,2016,LK,LKA,SEA,879421,1810352,2689773,1642668,1481143,1452797,1245132,1012648,829516,7663904,846552,1770777,2617329,1635609,1591469,1539609,1353798,1163019,1170979,8454483,16118387,21425494,21425494
Sri Lanka,2017,LK,LKA,SEA,864314,1809625,2673939,1647963,1458766,1465465,1248919,1030666,859489,7711268,829630,1769116,2598746,1629115,1565598,1558311,1358922,1184891,1226030,8522867,16234135,21506813,21506813
Sri Lanka,2018,LK,LKA,SEA,845076,1809183,2654259,1654059,1443942,1475655,1250042,1044743,891237,7759678,810991,1765176,2576167,1625850,1544278,1574533,1360746,1202236,1282958,8590601,16350279,21580710,21580710
Sri Lanka,2019,LK,LKA,SEA,826932,1803778,2630710,1661908,1435151,1482689,1250776,1056208,923414,7810146,793424,1756347,2549771,1627295,1526009,1587248,1361547,1218136,1338805,8659040,16469186,21649664,21649664
Sri Lanka,2020,LK,LKA,SEA,811335,1791369,2602704,1671876,1431138,1484802,1251825,1070011,953832,7863484,778311,1740968,2519279,1633168,1509353,1595180,1362542,1237326,1392045,8729614,16593098,21715079,21715079
Sri Lanka,2021,LK,LKA,SEA,797434,1772626,2570060,1684995,1432741,1478235,1257731,1081102,985231,7920035,764837,1719735,2484572,1643549,1496072,1594081,1368854,1252267,1443956,8798779,16718814,21773441,21773441
Sri Lanka,2022,LK,LKA,SEA,784773,1749686,2534459,1701681,1439017,1462796,1267855,1089308,1019634,7980291,752570,1694586,2447156,1658486,1487239,1583005,1380153,1262251,1499096,8870230,16850521,21832143,21832143
Sri Lanka,2023,LK,LKA,SEA,773378,1724795,2498173,1718827,1446862,1440947,1281588,1099677,1053433,8041334,741559,1667622,2409181,1674630,1480338,1564409,1395500,1274458,1555558,8944893,16986227,21893579,21893579
Sri Lanka,2024,LK,LKA,SEA,763283,1699842,2463125,1732252,1454871,1414739,1301736,1105448,1089581,8098627,731812,1640467,2372279,1687631,1474088,1540230,1417988,1280388,1614914,9015239,17113866,21949268,21949268
Sri Lanka,2025,LK,LKA,SEA,754759,1676479,2431238,1738870,1465116,1384808,1325818,1107771,1128420,8150803,723573,1614630,2338203,1694403,1470856,1510929,1445679,1281529,1676600,9079996,17230799,22000246,22000246
Sri Lanka,2026,LK,LKA,SEA,747535,1653418,2400953,1739550,1476399,1355895,1348102,1112880,1166542,8199368,716592,1588355,2304947,1696103,1469228,1480550,1472800,1286178,1736260,9141119,17340487,22046386,22046386
Sri Lanka,2027,LK,LKA,SEA,741268,1626280,2367548,1740210,1485793,1336863,1362736,1119077,1204285,8248964,710548,1559772,2270320,1695931,1466929,1457527,1492741,1292408,1795143,9200679,17449643,22087510,22087510
Sri Lanka,2028,LK,LKA,SEA,736265,1596114,2332379,1740882,1495697,1325217,1374569,1122713,1239541,8298619,705706,1530564,2236270,1693194,1467627,1439053,1510148,1295509,1851484,9257015,17555634,22124288,22124288
Sri Lanka,2029,LK,LKA,SEA,732508,1568317,2300825,1736356,1506876,1319324,1382935,1125776,1272058,8343325,702042,1503667,2205709,1685292,1472582,1423459,1523926,1297587,1904742,9307588,17650913,22157456,22157456
Sri Lanka,2030,LK,LKA,SEA,729442,1544612,2274054,1724641,1519623,1317880,1386241,1129085,1304463,8381933,699043,1480712,2179755,1670628,1481404,1409250,1532816,1299832,1957300,9351230,17733163,22186970,22186970
Sri Lanka,1950,LK,LKA,SEA,621128,940258,1561386,755675,606998,444407,308129,228202,422305,2765716,597802,885795,1483597,668047,488435,331531,220894,152641,273733,2135281,4900997,7945977,7945977
Sri Lanka,1951,LK,LKA,SEA,635420,969368,1604788,765352,621762,457017,316372,226896,395914,2783313,612643,916640,1529283,682976,506025,342935,228577,154287,259272,2174072,4957385,8091461,8091461
Sri Lanka,1952,LK,LKA,SEA,648355,1001630,1649985,774963,635929,469602,325181,226599,371819,2804093,625812,950505,1576317,697843,523404,354331,236688,156555,246258,2215079,5019172,8245475,8245475
Sri Lanka,1953,LK,LKA,SEA,661147,1035124,1696271,784953,649130,482141,334497,227262,350317,2828300,638186,985822,1624008,712911,540192,365867,245136,159415,234823,2258344,5086644,8406910,8406910
Sri Lanka,1954,LK,LKA,SEA,676987,1066459,1743446,795796,660678,494621,344105,228978,331456,2855634,653178,1019086,1672264,728379,555762,377820,253775,162885,225109,2303730,5159364,8575075,8575075
Sri Lanka,1955,LK,LKA,SEA,694663,1097088,1791751,807976,670375,507019,353884,231690,314742,2885686,670039,1051336,1721375,744601,569884,390272,262505,166930,216618,2350810,5236496,8749627,8749627
Sri Lanka,1956,LK,LKA,SEA,711468,1129395,1840863,822110,678489,519282,363788,235319,300118,2919106,686058,1084965,1771023,762180,582719,403189,271314,171479,209215,2400096,5319202,8931095,8931095
Sri Lanka,1957,LK,LKA,SEA,728917,1162616,1891533,838714,685256,531390,373805,239890,287765,2956820,702754,1119186,1821940,781643,594419,416602,280234,176553,203228,2452679,5409499,9122978,9122978
Sri Lanka,1958,LK,LKA,SEA,749215,1196060,1945275,857969,691173,543430,384006,245394,277581,2999553,722218,1153281,1875499,803298,605429,430527,289322,182145,198625,2509346,5508899,9329666,9329666
Sri Lanka,1959,LK,LKA,SEA,771846,1229106,2000952,879995,697001,555537,394550,251751,269446,3048280,743982,1186667,1930649,827486,616480,444924,298703,188284,195535,2571412,5619692,9551293,9551293
Sri Lanka,1960,LK,LKA,SEA,793947,1261639,2055586,905215,703338,567649,405537,258931,263439,3104109,765297,1219238,1984535,854696,628040,459633,308475,194928,193868,2639640,5743749,9783871,9783871
Sri Lanka,1961,LK,LKA,SEA,813474,1293296,2106770,933894,710436,579796,416866,266837,259188,3167017,784148,1250640,2034788,885197,640345,474731,318586,202045,193396,2714300,5881317,10022888,10022888
Sri Lanka,1962,LK,LKA,SEA,829564,1324538,2154102,966073,718525,592042,428433,275341,256164,3236578,799763,1281301,2081064,919066,653641,490295,328933,209599,193790,2795324,6031902,10267067,10267067
Sri Lanka,1963,LK,LKA,SEA,841854,1358711,2200565,999720,727857,603961,440162,284299,254194,3310193,811930,1314098,2126028,954687,668044,505915,339625,217485,194981,2880737,6190930,10517531,10517531
Sri Lanka,1964,LK,LKA,SEA,851523,1398407,2249930,1031380,738718,614821,452008,293525,253392,3383844,821806,1351864,2173670,988467,683598,520926,350919,225590,197137,2966637,6350481,10774086,10774086
Sri Lanka,1965,LK,LKA,SEA,860196,1439514,2299710,1062397,751498,624421,463973,302962,253932,3459183,830807,1391188,2221995,1021325,700584,535131,362956,233890,200452,3054338,6513521,11035224,11035224
Sri Lanka,1966,LK,LKA,SEA,869061,1477279,2346340,1095090,766657,632970,475994,312585,255859,3539155,839915,1427487,2267402,1055634,719474,548624,375714,242409,204967,3146822,6685977,11299721,11299721
Sri Lanka,1967,LK,LKA,SEA,879903,1512235,2392138,1128672,784502,640535,487969,322308,259139,3623125,850844,1461363,2312207,1090571,740571,561403,389169,251141,210684,3243539,6866664,11571008,11571008
Sri Lanka,1968,LK,LKA,SEA,890819,1546126,2436945,1162348,804908,647383,499860,332115,263514,3710128,861767,1494443,2356210,1125309,763873,573694,403234,260064,217359,3343533,7053661,11846815,11846815
Sri Lanka,1969,LK,LKA,SEA,898457,1579625,2478082,1195220,827532,653930,511618,342030,268625,3798955,869415,1527322,2396737,1158909,789206,585845,417676,269148,224639,3445423,7244378,12119207,12119207
Sri Lanka,2031,LK,LKA,SEA,726839,1523912,2250751,1706478,1535064,1321769,1380895,1136549,1334805,8415560,696507,1460658,2157165,1649968,1494345,1398324,1532755,1307242,2006324,9388958,17804518,22212436,22212436
Sri Lanka,2032,LK,LKA,SEA,724934,1505247,2230181,1683909,1552910,1329289,1366835,1147771,1364459,8445173,694649,1442593,2137242,1625165,1510543,1390800,1522504,1319288,2053378,9421678,17866851,22234271,22234271
Sri Lanka,2033,LK,LKA,SEA,723615,1488926,2212541,1659216,1570200,1337408,1346622,1162546,1394830,8470822,693346,1426801,2120147,1598339,1526747,1384108,1504464,1335027,2100709,9449394,17920216,22252909,22252909
Sri Lanka,2034,LK,LKA,SEA,722306,1475149,2197455,1634448,1583798,1345692,1322360,1183261,1423197,8492756,692059,1413445,2105504,1571321,1539822,1378062,1480975,1357679,2144455,9472314,17965070,22268031,22268031
Sri Lanka,2035,LK,LKA,SEA,720489,1463620,2184109,1611260,1590642,1356196,1294629,1207647,1450954,8511328,690286,1402260,2092546,1545614,1546694,1375021,1452483,1385367,2185585,9490764,18002092,22278745,22278745
Sri Lanka,2036,LK,LKA,SEA,718430,1453855,2172285,1588366,1591611,1367746,1267985,1230461,1480692,8526861,688280,1392789,2081069,1519461,1548519,1373579,1422980,1412548,2227938,9505025,18031886,22285234,22285234
Sri Lanka,2037,LK,LKA,SEA,715940,1445740,2161680,1561414,1592565,1377471,1250879,1246091,1511256,8539676,685881,1384928,2070809,1491009,1548483,1371489,1400734,1432740,2270949,9515404,18055080,22287571,22287571
Sri Lanka,2038,LK,LKA,SEA,712484,1439471,2151955,1531453,1593537,1387713,1240828,1258810,1537576,8549917,682578,1378823,2061401,1461936,1545891,1372373,1382940,1450325,2308543,9522008,18071925,22285269,22285269
Sri Lanka,2039,LK,LKA,SEA,707728,1434455,2142183,1503847,1589347,1399217,1236263,1268055,1561291,8558020,678035,1373903,2051938,1435161,1538156,1377482,1367948,1464260,2342341,9525348,18083368,22277488,22277488
Sri Lanka,2040,LK,LKA,SEA,701987,1429615,2131602,1480315,1578013,1412272,1235943,1272504,1585508,8564555,672527,1369168,2041695,1412316,1523683,1386433,1354297,1473396,2375921,9526046,18090601,22263893,22263893
Sri Lanka,2041,LK,LKA,SEA,695446,1424995,2120441,1459773,1560272,1427994,1240703,1268839,1611979,8569560,666236,1364655,2030891,1392365,1503236,1399471,1343856,1473813,2411360,9524101,18093661,22244994,22244994
Sri Lanka,2042,LK,LKA,SEA,687914,1420643,2108557,1441260,1538155,1446071,1248881,1257060,1641626,8573053,658980,1360429,2019409,1374393,1478652,1415737,1336733,1464319,2449684,9519518,18092571,22220535,22220535
Sri Lanka,2043,LK,LKA,SEA,679624,1415909,2095533,1425078,1513916,1463591,1257605,1239687,1675575,8575452,650992,1355853,2006845,1358687,1452052,1432004,1330413,1447313,2492304,9512773,18088225,22190606,22190606
Sri Lanka,2044,LK,LKA,SEA,670721,1409890,2080611,1411429,1489594,1477442,1266493,1218717,1713468,8577143,642428,1350050,1992478,1345414,1425256,1445151,1324730,1425098,2538714,9504363,18081506,22154591,22154591
Sri Lanka,2045,LK,LKA,SEA,661326,1402369,2063695,1400021,1466821,1484606,1277544,1194663,1754448,8578103,633397,1342797,1976194,1334302,1399756,1452131,1322020,1398089,2588024,9494322,18072425,22112321,22112321
Sri Lanka,2046,LK,LKA,SEA,651344,1393810,2045154,1390365,1444331,1485958,1289652,1171769,1796095,8578170,623807,1334532,1958339,1324901,1373806,1454092,1320911,1370187,2638618,9482515,18060685,22064179,22064179
Sri Lanka,2047,LK,LKA,SEA,640768,1383831,2024599,1382351,1417798,1487300,1300042,1157796,1832282,8577569,613640,1324901,1938541,1317104,1345565,1454202,1319186,1349348,2683797,9469202,18046771,22009917,22009917
Sri Lanka,2048,LK,LKA,SEA,629899,1372122,2002021,1376174,1388267,1488664,1310925,1150328,1862283,8576641,603196,1313640,1916836,1311058,1316697,1451768,1320392,1332782,2721984,9454681,18031322,21950180,21950180
Sri Lanka,2049,LK,LKA,SEA,619243,1358508,1977751,1371250,1361066,1484908,1323031,1147896,1887099,8575250,592967,1300564,1893531,1306191,1290114,1444213,1325760,1318873,2753733,9438884,18014134,21885412,21885412
Sri Lanka,2050,LK,LKA,SEA,608552,1343411,1951963,1366494,1337895,1474069,1336649,1149385,1908349,8572841,582707,1286058,1868765,1301505,1267444,1429951,1334918,1306226,2781366,9421410,17994251,21814985,21814985
Lesotho,1970,LS,LSO,AFR,83917,141492,225409,84782,55119,45386,33397,21007,13853,253544,82762,140220,222982,99777,67822,55071,43219,29008,26657,321554,575098,1023481,1023481
Lesotho,1971,LS,LSO,AFR,86123,144893,231016,89867,58814,49414,35299,22353,14208,269955,84839,143978,228817,103537,68879,56475,43966,30064,27174,330095,600050,1059879,1059879
Lesotho,1972,LS,LSO,AFR,88626,148027,236653,95012,62676,53390,37290,23777,14594,286739,87229,147493,234722,107452,70216,57843,44729,31205,27684,339129,625868,1097242,1097242
Lesotho,1973,LS,LSO,AFR,91301,151111,242412,99883,66986,57286,39420,25255,15025,303855,89835,150899,240734,111227,72088,59166,45542,32399,28206,348628,652483,1135631,1135631
Lesotho,1974,LS,LSO,AFR,94356,154153,248509,104197,71983,61106,41727,26763,15506,321282,92811,154254,247065,114593,74723,60429,46435,33588,28744,358512,679794,1175369,1175369
Lesotho,1975,LS,LSO,AFR,97943,157196,255139,109341,76006,64649,44136,28229,16047,338408,96314,157514,253828,118705,77056,61555,47427,34729,29339,368811,707219,1216180,1216180
Lesotho,1976,LS,LSO,AFR,101979,160262,262241,115499,78345,67405,46385,29507,16647,353788,100283,160591,260874,123838,78981,62452,48513,35784,30004,379572,733360,1256478,1256478
Lesotho,1977,LS,LSO,AFR,106329,164253,270582,120737,79572,69057,48325,30577,17292,365560,104553,164506,269059,128636,80816,62912,49491,36655,30731,389241,754801,1294435,1294435
Lesotho,1978,LS,LSO,AFR,110700,169213,279913,125161,80321,69979,50151,31527,17991,375130,108832,169346,278178,133102,82584,63053,50377,37376,31496,397988,773118,1331213,1331213
Lesotho,1979,LS,LSO,AFR,114772,174632,289404,129356,81662,70636,52057,32412,18746,384869,112843,174514,287357,137508,84886,63193,51327,38040,32336,407290,792159,1368917,1368917
Lesotho,1980,LS,LSO,AFR,118398,180802,299200,133229,83587,71133,54035,33271,19547,394802,116422,180360,296782,141736,87573,63421,52279,38644,33229,416882,811684,1407672,1407672
Lesotho,1981,LS,LSO,AFR,121554,187720,309274,136833,86009,71586,56007,34124,20411,404970,119532,186911,306443,145797,90561,63815,53210,39212,34213,426808,831778,1447501,1447501
Lesotho,1982,LS,LSO,AFR,124364,195113,319477,140379,88778,72159,57907,35011,21318,415552,122295,194000,316295,149747,93743,64441,54113,39767,35264,437075,852627,1488399,1488399
Lesotho,1983,LS,LSO,AFR,127069,202687,329756,144012,91589,73111,59678,35959,22269,426618,124937,201364,326301,153675,96814,65542,54971,40317,36338,447657,874275,1530331,1530331
Lesotho,1984,LS,LSO,AFR,129751,210411,340162,147678,94181,74686,61306,37005,23230,438086,127556,208913,336469,157589,99526,67359,55759,40900,37421,458554,896640,1573267,1573267
Lesotho,1985,LS,LSO,AFR,132314,217674,349988,151859,97877,75367,62633,38096,24193,450025,130099,215862,345961,161797,103425,68925,56505,41563,38516,470731,920756,1616697,1616697
Lesotho,1986,LS,LSO,AFR,134819,222838,357657,157752,102951,74482,63299,39031,25111,462626,132732,220223,352955,166968,109846,70354,57360,42422,39600,486550,949176,1659793,1659793
Lesotho,1987,LS,LSO,AFR,137213,227256,364469,163113,107438,73750,63548,39970,25978,473797,135245,224265,359510,171370,115740,72020,57942,43422,40677,501171,974968,1698939,1698939
Lesotho,1988,LS,LSO,AFR,139280,232462,371742,166657,111004,73728,63683,41080,26804,482956,137302,229905,367207,174281,119742,73589,58046,44443,41718,511819,994775,1733733,1733733
Lesotho,1989,LS,LSO,AFR,140884,237501,378385,170304,114122,74215,63569,42236,27607,492053,138865,235454,374319,177340,123292,75495,58014,45449,42749,522339,1014392,1767091,1767091
Lesotho,1990,LS,LSO,AFR,141972,242133,384105,174294,116839,75201,63249,43393,28376,501352,139901,240601,380502,180836,126418,77693,57954,46392,43747,533040,1034392,1798997,1798997
Lesotho,1991,LS,LSO,AFR,142655,246264,388919,178654,119188,76586,62830,44481,29131,510870,140537,245229,385766,184860,129090,80081,57945,47249,44728,543953,1054823,1829509,1829509
Lesotho,1992,LS,LSO,AFR,142724,250208,392932,183191,121338,78187,62423,45404,29889,520432,140584,249587,390171,189328,131347,82542,58075,48003,45680,554975,1075407,1858507,1858507
Lesotho,1993,LS,LSO,AFR,141999,254062,396061,187661,123419,79709,62254,46112,30627,529782,139875,253782,393657,194024,133286,84805,58578,48651,46632,565976,1095758,1885478,1885478
Lesotho,1994,LS,LSO,AFR,140792,257479,398271,192102,125425,80978,62603,46640,31378,539126,138705,257476,396181,198920,134945,86654,59727,49213,47598,577057,1116183,1910642,1910642
Lesotho,1995,LS,LSO,AFR,139502,260244,399746,196528,127330,83074,62275,46970,32139,548316,137455,260479,397934,203996,136335,89071,60500,49613,48556,588071,1136387,1934079,1934079
Lesotho,1996,LS,LSO,AFR,138316,262387,400703,200755,129091,85965,61069,47040,32886,556806,136302,262863,399165,209035,137428,92120,60661,49715,49465,598424,1155230,1955098,1955098
Lesotho,1997,LS,LSO,AFR,137264,263281,400545,204954,130630,88447,60277,46977,33637,564922,135293,263646,398939,213615,138112,94989,61411,49706,50342,608175,1173097,1972579,1972579
Lesotho,1998,LS,LSO,AFR,136284,262623,398907,209203,131923,90413,59915,46761,34385,572600,134367,262593,396960,217710,138383,97558,62713,49600,51205,617169,1189769,1985639,1985639
Lesotho,1999,LS,LSO,AFR,135224,260916,396140,213160,133222,91764,59818,46247,35098,579309,133344,260621,393965,221420,138537,99461,64166,49268,51982,624834,1204143,1994243,1994243
Lesotho,2000,LS,LSO,AFR,133966,258554,392520,216561,134718,92486,59939,45497,35733,584934,132107,258126,390233,224433,138794,100618,65658,48825,52618,630946,1215880,1998630,1998630
Lesotho,2001,LS,LSO,AFR,132554,255984,388538,219278,136439,92600,60158,44599,36232,589306,130706,255523,386229,226638,139257,100986,67062,48372,53079,635394,1224700,1999473,1999473
Lesotho,2002,LS,LSO,AFR,131252,253051,384303,221577,138205,92282,60338,43662,36556,592620,129421,252645,382066,228312,139905,100666,68293,47996,53374,638546,1231166,1997534,1997534
Lesotho,2003,LS,LSO,AFR,130361,249466,379827,223562,139811,91698,60267,42870,36700,594908,128541,249204,377745,229600,140611,99824,69144,47896,53477,640552,1235460,1993030,1993030
Lesotho,2004,LS,LSO,AFR,129643,245441,375084,224890,141319,90824,59794,42367,36683,595877,127840,245382,373222,230267,141427,98528,69437,48187,53348,641194,1237071,1985384,1985384
Lesotho,2005,LS,LSO,AFR,128988,241577,370565,225790,143159,89860,59769,41329,36507,596414,127203,241698,368901,230623,142894,97008,70011,48030,52984,641550,1237964,1977424,1977424
Lesotho,2006,LS,LSO,AFR,128948,238801,367749,227294,146107,89157,60256,39695,36201,598710,127163,238972,366135,231738,146065,95714,71006,47237,52422,644182,1242892,1976780,1976780
Lesotho,2007,LS,LSO,AFR,128935,236806,365741,228630,150013,89502,61516,39095,35862,604618,127324,237080,364404,232421,149084,94721,72846,47785,51848,648705,1253323,1983465,1983465
Lesotho,2008,LS,LSO,AFR,129090,235731,364821,229582,154662,90421,62872,39027,35513,612077,127663,236170,363833,232733,152691,93980,74717,48874,51281,654276,1266353,1995014,1995014
Lesotho,2009,LS,LSO,AFR,129847,235520,365367,230313,159786,91433,63424,38864,35131,618951,128448,236070,364518,233073,157705,93554,75595,49597,50805,660329,1279280,2009169,2009169
Lesotho,2010,LS,LSO,AFR,130533,235023,365556,230053,164691,93246,64128,39281,34794,626193,129183,235785,364968,232260,161867,93669,76599,51074,50558,666027,1292220,2022747,2022747
Lesotho,2011,LS,LSO,AFR,131430,234262,365692,229336,169337,95924,65003,40138,34549,634287,130107,235338,365445,230965,165442,94584,77687,53052,50532,672262,1306549,2037677,2037677
Lesotho,2012,LS,LSO,AFR,132307,233862,366169,228231,174013,99265,66032,41224,34420,643185,131033,235272,366305,229366,168904,96155,78624,55211,50796,679056,1322241,2054718,2054718
Lesotho,2013,LS,LSO,AFR,133182,234102,367284,226595,178802,103038,67216,42342,34502,652495,131969,235834,367803,227404,172563,98280,79380,57280,51444,686351,1338846,2073939,2073939
Lesotho,2014,LS,LSO,AFR,134407,234773,369180,224723,183386,107203,68440,43335,34861,661948,133191,236819,370010,225379,176330,100972,79865,59016,52545,694107,1356055,2095242,2095242
Lesotho,2015,LS,LSO,AFR,135786,235872,371658,223060,187606,111757,69619,44560,34998,671600,134509,238142,372651,223745,180218,104305,80007,60805,53532,702612,1374212,2118521,2118521
Lesotho,2016,LS,LSO,AFR,136990,237533,374523,221811,191442,116676,70881,46078,34879,681767,135647,239921,375568,222633,184084,108236,79992,62790,54274,712009,1393776,2143872,2143872
Lesotho,2017,LS,LSO,AFR,137731,239577,377308,221126,194803,121956,72324,47494,34951,692654,136326,241999,378325,222148,187675,112735,79992,64580,55191,722321,1414975,2170617,2170617
Lesotho,2018,LS,LSO,AFR,138012,241808,379820,221098,197440,127593,73956,48796,35200,704083,136532,244185,380717,222370,190687,117807,80085,66161,56285,733395,1437478,2198017,2198017
Lesotho,2019,LS,LSO,AFR,138031,244388,382419,221313,199254,133435,75930,49974,35634,715540,136488,246639,383127,222873,192934,123263,80470,67516,57559,744615,1460155,2225702,2225702
Lesotho,2020,LS,LSO,AFR,138159,247407,385566,221599,200740,139211,78191,50822,36054,726617,136545,249411,385956,223515,195142,128909,81168,68360,58862,755956,1482573,2254100,2254100
Lesotho,2021,LS,LSO,AFR,138253,250748,389001,221884,202144,144636,80630,51218,36186,736698,136550,252391,388941,224213,197495,134515,82206,68568,59814,766811,1503509,2281454,2281454
Lesotho,2022,LS,LSO,AFR,138264,253775,392039,222316,202866,149648,83111,51340,36182,745463,136467,255017,391484,225060,199412,140057,83525,68232,60558,776844,1522307,2305825,2305825
Lesotho,2023,LS,LSO,AFR,138314,256468,394782,223187,202730,154510,85823,51590,36597,754437,136440,257265,393705,226307,200708,145706,85212,67721,61730,787384,1541821,2330318,2330318
Lesotho,2024,LS,LSO,AFR,138321,259246,397567,224371,202138,159118,88989,52070,37362,764048,136402,259557,395959,227804,201447,151249,87498,67242,63267,798507,1562555,2356083,2356083
Lesotho,2025,LS,LSO,AFR,138205,262004,400209,225791,201393,163180,92468,52586,38142,773560,136269,261838,398107,229433,201905,156414,90323,66646,64786,809507,1583067,2381381,2381381
Lesotho,2026,LS,LSO,AFR,137958,264247,402205,227637,200801,166717,96233,53194,38913,783495,136036,263642,399678,231382,202373,161201,93650,66017,66251,820874,1604369,2406247,2406247
Lesotho,2027,LS,LSO,AFR,137603,265807,403410,229827,200617,169707,100260,53920,39664,793995,135699,264807,400506,233576,203116,165566,97469,65434,67649,832810,1626805,2430720,2430720
Lesotho,2028,LS,LSO,AFR,137203,266849,404052,232220,200952,171979,104557,54768,40405,804881,135308,265497,400805,235874,204263,169274,101786,64940,68941,845078,1649959,2454823,2454823
Lesotho,2029,LS,LSO,AFR,136777,267573,404350,235011,201454,173476,109010,55844,41115,815910,134890,265922,400812,238476,205478,172245,106466,64707,70112,857484,1673394,2478552,2478552
Lesotho,2030,LS,LSO,AFR,136420,268110,404530,238159,201723,174496,113436,57259,41798,826871,134543,266235,400778,241330,206371,174741,111283,64897,71144,869766,1696637,2501946,2501946
Lesotho,1950,LS,LSO,AFR,56162,65830,121992,31185,22430,21630,18655,13889,13636,121425,52214,77654,129868,59229,42027,34135,28171,19503,23118,206183,327608,579470,579470
Lesotho,1951,LS,LSO,AFR,55850,70413,126263,33971,22344,21066,18325,13753,13326,122785,52810,79006,131816,60878,43134,34239,28397,19877,22605,209130,331915,590004,590004
Lesotho,1952,LS,LSO,AFR,55596,75045,130641,37055,22418,20480,17944,13630,13024,124551,53467,80519,133986,62522,44364,34400,28563,20335,22115,212299,336850,601476,601476
Lesotho,1953,LS,LSO,AFR,55150,79898,135048,40424,22692,19884,17503,13511,12727,126741,53891,82447,136338,64174,45711,34628,28671,20845,21654,215683,342424,613822,613822
Lesotho,1954,LS,LSO,AFR,54362,85101,139463,44078,23214,19285,17014,13400,12446,129437,53899,85041,138940,65816,47169,34945,28725,21387,21252,219294,348731,627130,627130
Lesotho,1955,LS,LSO,AFR,54832,88987,143819,48035,24021,18690,16470,13276,12173,132665,54727,87117,141844,67389,48727,35349,28727,21926,20921,223039,355704,641361,641361
Lesotho,1956,LS,LSO,AFR,56729,91284,148013,52278,25148,18111,15888,13124,11930,136479,56588,88494,145082,68819,50371,35854,28686,22403,20723,226856,363335,656426,656426
Lesotho,1957,LS,LSO,AFR,58947,93504,152451,55371,26671,18252,15858,13168,11749,141069,58642,90622,149264,70054,52032,36699,28943,22862,20689,231279,372348,674063,674063
Lesotho,1958,LS,LSO,AFR,61414,95892,157306,57093,28495,19156,16479,13424,11653,146300,60857,93516,154373,71188,53666,37835,29582,23308,20797,236376,382676,694355,694355
Lesotho,1959,LS,LSO,AFR,63742,98602,162344,58674,30416,20149,17240,13683,11624,151786,63000,96763,159763,72385,55255,39017,30368,23686,21023,241734,393520,715629,715629
Lesotho,1960,LS,LSO,AFR,65926,101614,167540,60159,32386,21243,18135,13946,11651,157520,65071,100283,165354,73748,56776,40250,31297,24008,21346,247425,404945,737838,737838
Lesotho,1961,LS,LSO,AFR,68004,104836,172840,61672,34316,22436,19149,14234,11732,163539,67087,103934,171021,75338,58218,41542,32358,24294,21747,253497,417036,760895,760895
Lesotho,1962,LS,LSO,AFR,69990,108127,178117,63354,36110,23745,20269,14565,11846,169889,69027,107602,176629,77220,59609,42906,33535,24567,22206,260043,429932,784681,784681
Lesotho,1963,LS,LSO,AFR,71909,111205,183114,65462,37732,25189,21479,14955,11993,176810,70900,110995,181895,79646,60966,44339,34806,24856,22710,267323,444133,809138,809138
Lesotho,1964,LS,LSO,AFR,73747,113841,187588,68207,39168,26781,22774,15414,12166,184510,72696,113866,186562,82850,62286,45834,36146,25180,23247,275543,460053,834215,834215
Lesotho,1965,LS,LSO,AFR,75595,117554,193149,69855,40448,28624,24214,15987,12376,191504,74484,117477,191961,85687,63524,47421,37590,25579,23806,283607,475111,860220,860220
Lesotho,1966,LS,LSO,AFR,77588,122597,200185,69677,41605,30954,26007,16764,12623,197630,76366,122215,198581,87948,64621,49155,39236,26089,24391,291440,489070,887841,887841
Lesotho,1967,LS,LSO,AFR,79245,127841,207086,71354,44006,33980,27906,17670,12906,207822,78025,127023,205048,90442,65505,50749,40628,26659,24991,298974,506796,918923,918923
Lesotho,1968,LS,LSO,AFR,80557,133004,213561,75446,47739,37552,29701,18649,13200,222287,79440,131713,211153,93163,66233,52157,41578,27290,25566,305987,528274,952992,952992
Lesotho,1969,LS,LSO,AFR,82102,137555,219657,79934,51458,41399,31537,19766,13515,237609,81005,136130,217135,96285,66968,53617,42433,28077,26125,313505,551114,987909,987909
Lesotho,2031,LS,LSO,AFR,136148,268275,404423,241557,201796,175382,117729,59046,42454,837964,134280,266235,400515,244334,207014,177056,116124,65609,72014,882151,1720115,2525055,2525055
Lesotho,2032,LS,LSO,AFR,135938,268142,404080,244621,202208,176007,122030,61151,43113,849130,134077,265980,400057,246992,207882,179039,121131,66821,72740,894605,1743735,2547869,2547869
Lesotho,2033,LS,LSO,AFR,135789,267899,403688,247304,203161,176103,126352,63481,43804,860205,133930,265664,399594,249243,209188,180403,126307,68445,73343,906929,1767134,2570416,2570416
Lesotho,2034,LS,LSO,AFR,135669,267557,403226,250058,204397,175781,130390,66030,44515,871171,133818,265286,399104,251527,210716,181237,131345,70478,73830,919133,1790304,2592633,2592633
Lesotho,2035,LS,LSO,AFR,135614,267167,402781,252789,205849,175319,133971,68814,45259,882001,133775,264884,398659,253806,212366,181812,136054,72953,74215,931206,1813207,2614644,2614644
Lesotho,2036,LS,LSO,AFR,135594,266731,402325,255018,207711,174996,137114,71823,46049,892711,133764,264463,398227,255607,214326,182401,140432,75836,74545,943147,1835858,2636414,2636414
Lesotho,2037,LS,LSO,AFR,135525,266248,401773,256581,209910,175050,139814,75033,46902,903290,133713,263995,397708,256788,216536,183255,144448,79117,74861,955005,1858295,2657782,2657782
Lesotho,2038,LS,LSO,AFR,135443,265777,401220,257644,212308,175565,141911,78449,47827,913704,133641,263532,397173,257509,218854,184490,147887,82812,75173,966725,1880429,2678823,2678823
Lesotho,2039,LS,LSO,AFR,135426,265303,400729,258395,215074,176219,143366,81992,48870,923916,133635,263076,396711,257974,221454,185774,150681,86813,75594,978290,1902206,2699646,2699646
Lesotho,2040,LS,LSO,AFR,135382,264964,400346,258965,218164,176649,144432,85531,50129,933870,133602,262751,396353,258319,224293,186755,153062,90933,76244,989606,1923476,2720180,2720180
Lesotho,2041,LS,LSO,AFR,135250,264737,399987,259175,221488,176921,145397,88974,51610,943565,133482,262541,396023,258362,227274,187515,155296,95081,77167,1000695,1944260,2740271,2740271
Lesotho,2042,LS,LSO,AFR,135094,264527,399621,259089,224507,177514,146166,92444,53300,953020,133331,262349,395680,258156,229926,188496,157251,99387,78365,1011581,1964601,2759909,2759909
Lesotho,2043,LS,LSO,AFR,134849,264356,399205,258907,227172,178605,146501,95938,55145,962268,133096,262192,395288,257891,232193,189891,158667,103840,79787,1022269,1984537,2779040,2779040
Lesotho,2044,LS,LSO,AFR,134453,264277,398730,258619,229901,179937,146484,99210,57141,971292,132713,262133,394846,257567,234495,191488,159615,108183,81428,1032776,2004068,2797647,2797647
Lesotho,2045,LS,LSO,AFR,133944,264237,398181,258290,232601,181455,146337,102120,59287,980090,132220,262108,394328,257220,236787,193202,160334,112248,83332,1043123,2023213,2815731,2815731
Lesotho,2046,LS,LSO,AFR,133425,264136,397561,257919,234834,183358,146315,104698,61600,988724,131720,262029,393749,256858,238633,195212,161070,116039,85495,1053307,2042031,2833338,2833338
Lesotho,2047,LS,LSO,AFR,132936,263970,396906,257501,236449,185591,146623,106932,64066,997162,131251,261881,393132,256449,239886,197470,162054,119530,87948,1063337,2060499,2850533,2850533
Lesotho,2048,LS,LSO,AFR,132406,263694,396100,257094,237597,188019,147330,108704,66691,1005435,130734,261634,392368,256043,240702,199843,163380,122540,90708,1073216,2078651,2867124,2867124
Lesotho,2049,LS,LSO,AFR,131816,263336,395152,256689,238454,190781,148141,109978,69473,1013516,130158,261297,391455,255644,241276,202478,164749,125016,93771,1082934,2096450,2883056,2883056
Lesotho,2050,LS,LSO,AFR,131182,262843,394025,256409,239138,193820,148756,110960,72349,1021432,129546,260828,390374,255379,241740,205329,165844,127160,97087,1092539,2113971,2898369,2898369
Lithuania,1970,LT,LTU,EUR,141229,296765,437994,241271,238497,219382,125313,123377,124622,1072462,137307,288586,425893,232548,245594,252150,172540,166232,204736,1273800,2346262,3210147,3210147
Lithuania,1971,LT,LTU,EUR,141906,296789,438695,246271,237336,225255,132282,117022,130462,1088628,138281,288882,427163,236616,242698,253461,183096,162509,210801,1289181,2377809,3243675,3243675
Lithuania,1972,LT,LTU,EUR,142317,295532,437849,253130,236030,228725,141611,108894,137137,1105527,138888,288349,427237,242498,239484,254553,194880,157550,216714,1305679,2411206,3276294,3276294
Lithuania,1973,LT,LTU,EUR,141581,292684,434265,261117,235718,229664,153241,100545,143766,1124051,138404,286620,425024,248944,238039,254238,207740,152412,222359,1323732,2447783,3307075,3307075
Lithuania,1974,LT,LTU,EUR,139868,289197,429065,268969,236963,230125,164015,95678,148205,1143955,137194,284295,421489,255121,238478,253580,219103,148859,228045,1343186,2487141,3337697,3337697
Lithuania,1975,LT,LTU,EUR,137717,285979,423696,276367,239079,230310,173180,95114,149721,1163771,135712,281971,417683,261404,240050,252869,227749,147608,233469,1363149,2526920,3368287,3368287
Lithuania,1976,LT,LTU,EUR,135413,283126,418539,284042,240077,231573,181001,96506,149966,1183165,133964,279637,413601,268687,241068,252881,234468,148254,238352,1383710,2566875,3399021,3399021
Lithuania,1977,LT,LTU,EUR,133673,280537,414210,291585,240288,233601,187621,98925,149797,1201817,132557,277560,410117,275918,241211,253742,239462,150802,242833,1403968,2605785,3430115,3430115
Lithuania,1978,LT,LTU,EUR,132964,277899,410863,298402,241610,234115,193615,102266,149208,1219216,132049,275728,407777,282344,242216,253412,242928,155621,246476,1422997,2642213,3460849,3460849
Lithuania,1979,LT,LTU,EUR,133096,275371,408467,303868,245667,233023,198581,106107,148108,1235354,132193,274182,406375,287743,246022,251605,244729,161999,249138,1441236,2676590,3491432,3491432
Lithuania,1980,LT,LTU,EUR,133516,273761,407277,307393,250826,231517,203193,110727,146214,1249870,132451,273390,405841,291352,251027,249656,245566,170425,250193,1458219,2708089,3521206,3521206
Lithuania,1981,LT,LTU,EUR,134094,272719,406813,309883,256042,229420,208021,116515,143614,1263495,132868,272920,405788,293779,256447,246975,246775,180837,249631,1474444,2737939,3550539,3550539
Lithuania,1982,LT,LTU,EUR,134960,272058,407018,310736,262826,227270,210727,124574,140771,1276904,133677,272465,406142,295147,263385,243647,247913,192299,248364,1490755,2767659,3580825,3580825
Lithuania,1983,LT,LTU,EUR,137088,271694,408782,309096,270532,226347,211064,134658,137983,1289680,135752,272048,407800,294696,270696,241969,247688,204476,246853,1506378,2796058,3612640,3612640
Lithuania,1984,LT,LTU,EUR,140203,271180,411383,306295,277667,227009,210968,143658,135910,1301507,138822,271744,410566,292914,277324,242267,247022,214716,246144,1520387,2821894,3643837,3643837
Lithuania,1985,LT,LTU,EUR,143392,270268,413660,303463,284151,228445,210591,151018,135034,1312702,142074,271351,413425,290575,283781,243548,246079,222116,246966,1533065,2845767,3672852,3672852
Lithuania,1986,LT,LTU,EUR,147120,269119,416239,300625,290935,228620,211322,157340,135739,1324581,145721,270563,416284,288038,290882,243866,245672,227729,249528,1545715,2870296,3702828,3702828
Lithuania,1987,LT,LTU,EUR,150756,268410,419166,297751,297288,227876,212882,162637,137633,1336067,149188,270007,419195,285633,297473,243065,246080,231594,253722,1557567,2893634,3732005,3732005
Lithuania,1988,LT,LTU,EUR,152141,269510,421651,294626,302513,227933,212938,167168,139911,1345089,150681,271056,421737,283254,302837,242742,245375,233719,259137,1567064,2912153,3755541,3755541
Lithuania,1989,LT,LTU,EUR,151360,272234,423594,290950,306194,230195,211408,170616,142118,1351481,150027,273434,423461,280773,306639,244956,243046,234063,265174,1574651,2926132,3773180,3773180
Lithuania,1990,LT,LTU,EUR,150125,275210,425335,287308,307627,233133,209469,173609,144153,1355299,148648,275964,424612,278747,308148,248157,240507,233470,271577,1580606,2935905,3785847,3785847
Lithuania,1991,LT,LTU,EUR,148027,278489,426516,283830,307493,235971,206780,176554,146135,1356763,146477,278722,425199,276897,308005,251438,237444,233184,277982,1584950,2941713,3793425,3793425
Lithuania,1992,LT,LTU,EUR,144790,281617,426407,280407,305363,240155,203669,177700,149094,1356388,143224,281417,424641,274761,306374,256284,233546,233028,284310,1588303,2944691,3795742,3795742
Lithuania,1993,LT,LTU,EUR,140208,283530,423738,277283,300632,244849,201274,176669,152741,1353448,138501,283110,421611,272514,302690,261631,230815,231795,290286,1589731,2943179,3788528,3788528
Lithuania,1994,LT,LTU,EUR,133787,284073,417860,274058,294695,248964,199815,174937,155583,1348052,131969,283426,415395,270236,297487,266475,229610,230049,295288,1589145,2937197,3770456,3770456
Lithuania,1995,LT,LTU,EUR,126261,284042,410303,270319,288516,252703,198893,173073,158490,1341994,124372,283050,407422,267648,291723,271048,229009,228042,300077,1587547,2929541,3747267,3747267
Lithuania,1996,LT,LTU,EUR,118420,283417,401837,266285,282122,256674,197163,172142,161830,1336216,116460,282032,398492,264534,285942,275728,227710,226346,305217,1585477,2921693,3722022,3722022
Lithuania,1997,LT,LTU,EUR,110790,281678,392468,262520,275610,260164,195049,171980,165458,1330781,108641,279825,388466,261441,280317,279704,225741,225232,310745,1583180,2913961,3694896,3694896
Lithuania,1998,LT,LTU,EUR,104513,277297,381810,260035,268872,262641,193768,171067,169492,1325875,102040,275116,377156,259385,274709,282633,224051,223457,316428,1580663,2906538,3665510,3665510
Lithuania,1999,LT,LTU,EUR,100103,269915,370018,258558,261851,263837,194204,169308,173171,1320929,97321,267484,364805,258196,269057,284259,224114,220676,321895,1578197,2899126,3633944,3633944
Lithuania,2000,LT,LTU,EUR,96201,261105,357306,257303,254781,263292,195551,167482,176957,1315366,93206,258279,351485,257108,263500,283954,225329,217721,327865,1575477,2890843,3599637,3599637
Lithuania,2001,LT,LTU,EUR,91755,251163,342918,256351,247724,261268,197311,165243,180912,1308809,88717,248095,336812,256070,257572,281936,227085,214542,334391,1571596,2880405,3560142,3560142
Lithuania,2002,LT,LTU,EUR,87052,240427,327479,255469,240695,257555,200355,162698,184252,1301024,84143,237143,321286,254936,250961,278261,230262,210875,340705,1566000,2867024,3515799,3515799
Lithuania,2003,LT,LTU,EUR,82730,229953,312683,253939,233862,252145,204105,160736,187258,1292045,80078,226207,306285,253113,243985,272816,234089,207968,346689,1558660,2850705,3469675,3469675
Lithuania,2004,LT,LTU,EUR,78968,219946,298914,251731,226986,245986,207694,159565,189881,1281843,76622,215739,292361,250387,236821,266240,237636,206173,352213,1549470,2831313,3422591,3422591
Lithuania,2005,LT,LTU,EUR,75999,209473,285472,249569,219936,239562,211039,158611,191731,1270448,73933,204963,278896,247576,229295,259340,241003,204680,356828,1538722,2809170,3373533,3373533
Lithuania,2006,LT,LTU,EUR,74410,198047,272457,247437,212920,233113,214415,156934,193146,1257965,72512,193427,265939,244773,221448,252505,244331,202617,360894,1526568,2784533,3322932,3322932
Lithuania,2007,LT,LTU,EUR,74039,186265,260304,245109,206638,226749,217281,154968,194010,1244755,72217,181527,253744,241711,214034,245886,246942,200285,364757,1513615,2758370,3272418,3272418
Lithuania,2008,LT,LTU,EUR,74376,175803,250179,241194,202276,220523,219406,153712,194239,1231350,72596,170853,243449,237110,208010,239450,248712,198405,367709,1499396,2730746,3224378,3224378
Lithuania,2009,LT,LTU,EUR,75336,167519,242855,235131,199416,214703,220742,154173,194107,1218272,73466,162457,235923,230230,203004,233076,249503,198446,369171,1483430,2701702,3180479,3180479
Lithuania,2010,LT,LTU,EUR,76551,160523,237074,228181,197416,209366,220931,155577,194063,1205534,74479,155427,229906,222219,198469,226964,248753,199741,370358,1466504,2672038,3139019,3139019
Lithuania,2011,LT,LTU,EUR,77739,154418,232157,220379,196619,204717,220389,157453,194042,1193599,75362,149309,224671,213638,194759,220826,247066,201580,371503,1449372,2642971,3099798,3099798
Lithuania,2012,LT,LTU,EUR,78928,149290,228218,211868,196819,200594,218753,160723,193705,1182462,76212,144205,220417,204489,192001,214327,244365,205024,372022,1432228,2614690,3063341,3063341
Lithuania,2013,LT,LTU,EUR,79436,145292,224728,203721,197123,196691,215816,164856,193669,1171876,76532,140305,216837,195450,189520,207741,240115,209098,372824,1414748,2586624,3028189,3028189
Lithuania,2014,LT,LTU,EUR,79141,142503,221644,196010,197493,192826,212409,169072,194251,1162061,76100,137537,213637,186939,187121,201140,234923,212851,374612,1397586,2559647,2994927,2994927
Lithuania,2015,LT,LTU,EUR,79015,140755,219770,187499,198734,188862,208978,173320,194978,1152371,75750,135688,211438,177884,185732,194177,229545,216700,376146,1380184,2532555,2963765,2963765
Lithuania,2016,LT,LTU,EUR,79002,140307,219309,177675,200545,184898,205703,177791,195316,1141928,75501,134896,210397,168005,185139,186907,224283,220848,376861,1362043,2503971,2933673,2933673
Lithuania,2017,LT,LTU,EUR,78383,140933,219316,167400,202281,181651,202566,181995,195739,1131632,74652,135122,209774,157737,184766,180264,219243,224342,377373,1343725,2475357,2904450,2904450
Lithuania,2018,LT,LTU,EUR,77422,141592,219014,158366,202354,180180,199535,185458,196339,1122232,73459,135611,209070,148626,183096,175377,214500,226943,377268,1325810,2448042,2876128,2876128
Lithuania,2019,LT,LTU,EUR,76152,142345,218497,151401,199972,180022,196585,188095,197313,1113388,72068,136077,208145,141786,179371,171816,209860,228661,377556,1309050,2422438,2849083,2849083
Lithuania,2020,LT,LTU,EUR,74186,143718,217904,145549,196475,180261,193597,189448,197964,1103294,70154,136962,207116,136149,174827,168895,205298,228852,377935,1291956,2395250,2820267,2820267
Lithuania,2021,LT,LTU,EUR,71850,145286,217136,140355,191805,181118,190736,189474,197111,1090599,68039,137910,205949,131249,169814,166829,200578,227830,376661,1272961,2363560,2786651,2786651
Lithuania,2022,LT,LTU,EUR,69787,146634,216421,135584,185288,182023,187679,188130,196537,1075241,66250,138735,204985,126970,164035,165703,195566,225761,375368,1253403,2328644,2750055,2750055
Lithuania,2023,LT,LTU,EUR,68027,147346,215373,131578,178242,182426,184295,185992,199244,1061777,64667,139257,203924,123632,158223,164869,190499,222482,377591,1237296,2299073,2718352,2718352
Lithuania,2024,LT,LTU,EUR,66402,146999,213401,129129,171540,182966,180729,183762,204314,1052440,63150,138907,202057,121652,152879,164134,185365,218368,382499,1224897,2277337,2692798,2692798
Lithuania,2025,LT,LTU,EUR,64897,146044,210941,128062,164066,184274,176855,181356,209613,1044226,61703,138038,199741,120846,146909,164450,179836,213923,387575,1213539,2257765,2668446,2668446
Lithuania,2026,LT,LTU,EUR,63452,144728,208180,128516,155419,186079,172787,179022,215074,1036897,60287,136892,197179,121266,140139,165493,173923,209494,392652,1202967,2239864,2645221,2645221
Lithuania,2027,LT,LTU,EUR,62008,142997,205005,130150,146538,187716,169246,176692,220111,1030453,58906,135323,194229,122814,132905,166701,168526,205284,397022,1193252,2223705,2622934,2622934
Lithuania,2028,LT,LTU,EUR,60499,141205,201704,131834,138897,187728,167348,174263,224348,1024418,57469,133589,191058,124644,126544,166661,164764,201322,400110,1184045,2208463,2601223,2601223
Lithuania,2029,LT,LTU,EUR,58967,139176,198143,133731,133122,185389,166704,171797,228097,1018840,56009,131664,187673,126532,122019,164594,162165,197473,402463,1175246,2194086,2579906,2579906
Lithuania,2030,LT,LTU,EUR,57482,136416,193898,136389,128389,181969,166568,169306,231486,1014107,54597,129099,183696,129006,118317,161655,160188,193696,404366,1167228,2181335,2558928,2558928
Lithuania,1950,LT,LTU,EUR,138021,241582,379603,224396,136985,143332,126539,75146,78891,785289,131766,244190,375956,256921,182895,172641,162344,106233,142915,1023949,1809238,2564798,2564798
Lithuania,1951,LT,LTU,EUR,141026,242840,383866,228027,144558,136012,131683,79515,75300,795095,134799,242775,377574,257248,192144,169529,164308,111808,137626,1032663,1827758,2589204,2589204
Lithuania,1952,LT,LTU,EUR,143713,244408,388121,230279,153581,128529,136890,83611,72550,805440,137423,241895,379318,256842,202530,166016,165816,117300,133649,1042153,1847593,2615037,2615037
Lithuania,1953,LT,LTU,EUR,145666,246485,392151,231255,163630,121896,141443,87510,70654,816388,139208,241833,381041,255814,213389,162586,166974,122550,131019,1052332,1868720,2641911,2641911
Lithuania,1954,LT,LTU,EUR,146767,249209,395976,231506,173808,117115,144731,90805,69912,827877,140162,242561,382723,254612,223651,159958,167917,126961,130191,1063290,1891167,2669860,2669860
Lithuania,1955,LT,LTU,EUR,147206,252283,399489,231546,183570,114783,146430,93539,70278,840146,140558,244161,384719,253146,232552,158685,168392,131020,130898,1074693,1914839,2699051,2699051
Lithuania,1956,LT,LTU,EUR,147628,254887,402515,232212,192397,114911,146461,96091,71383,853455,140992,246083,387075,251742,239806,159044,168539,135166,132404,1086701,1940156,2729749,2729749
Lithuania,1957,LT,LTU,EUR,148709,256831,405540,233445,200218,117182,144950,98776,73271,867842,142087,247713,389800,250653,245430,161269,168696,139212,134552,1099812,1967654,2762994,2762994
Lithuania,1958,LT,LTU,EUR,150613,258642,409255,234294,207461,120976,142312,101826,76012,882881,143987,249359,393346,249101,249707,165544,168542,143055,137578,1113527,1996408,2799003,2799003
Lithuania,1959,LT,LTU,EUR,152874,261058,413932,234427,214025,125871,138649,105487,79337,897796,146258,251674,397932,246716,252591,171674,167814,146628,141422,1126845,2024641,2836501,2836501
Lithuania,1960,LT,LTU,EUR,155188,263911,419099,234134,219933,132188,133609,110201,83096,913161,148583,254382,402965,243934,254338,179829,165960,150201,146197,1140459,2053620,2875684,2875684
Lithuania,1961,LT,LTU,EUR,157316,267198,424514,233379,225271,140033,127180,115959,86907,928729,150670,257612,408282,240615,255545,189777,162859,153664,151641,1154101,2082830,2915626,2915626
Lithuania,1962,LT,LTU,EUR,158120,271243,429363,232563,228939,149774,119802,122229,90273,943580,151490,261610,413100,237095,256039,200954,158858,156859,156617,1166422,2110002,2952461,2952461
Lithuania,1963,LT,LTU,EUR,156906,275679,432585,232276,230899,161165,112562,128189,93613,958704,150423,265807,416230,234425,255356,212979,154724,159819,161704,1179007,2137711,2986530,2986530
Lithuania,1964,LT,LTU,EUR,154400,279763,434163,232903,232243,172376,107928,132326,97482,975258,148121,269730,417851,232808,254258,224039,151738,162486,167857,1193186,2168444,3020457,3020457
Lithuania,1965,LT,LTU,EUR,151090,283425,434515,234019,233295,182675,106828,133873,101700,992390,145014,273525,418539,232023,252932,232990,150550,164035,175010,1207540,2199930,3052979,3052979
Lithuania,1966,LT,LTU,EUR,147379,287252,434631,234303,235254,191770,108036,133719,105992,1009074,141522,277792,419314,230929,252023,240023,151100,165092,181956,1221123,2230197,3084148,3084148
Lithuania,1967,LT,LTU,EUR,144192,290870,435062,233893,237845,199725,110778,132527,110437,1025205,138750,281869,420619,229176,251644,245309,153479,166554,188145,1234307,2259512,3115198,3115198
Lithuania,1968,LT,LTU,EUR,142133,293853,435986,234338,239209,207038,114769,130529,115002,1040885,137255,285139,422394,228198,250390,249024,157951,167665,193857,1247085,2287970,3146348,3146348
Lithuania,1969,LT,LTU,EUR,141172,295910,437082,237142,239105,213417,119545,127721,119641,1056571,136824,287468,424292,229667,247983,251076,164087,167915,199164,1259892,2316463,3177836,3177836
Lithuania,2031,LT,LTU,EUR,56067,133133,189200,139305,124416,177435,167272,167007,234506,1009941,53253,126139,179392,131573,115191,158081,159147,189834,405855,1159681,2169622,2538213,2538213
Lithuania,2032,LT,LTU,EUR,54722,129950,184672,141706,121374,171882,168608,164842,237258,1005670,51976,123328,175304,133595,112897,153725,158908,185652,407237,1152014,2157684,2517665,2517665
Lithuania,2033,LT,LTU,EUR,53501,126935,180436,143072,119368,166434,169826,162507,239961,1001168,50818,120560,171378,134828,111617,149339,158738,181190,408548,1144260,2145428,2497243,2497243
Lithuania,2034,LT,LTU,EUR,52414,123996,176410,143272,118605,161097,171009,159849,242692,996524,49788,117806,167594,135070,111379,145218,158555,176567,409670,1136459,2132983,2476990,2476990
Lithuania,2035,LT,LTU,EUR,51473,121197,172670,142774,118936,154828,172828,156873,245445,991684,48895,115130,164025,134690,112023,140292,159321,171529,410695,1128550,2120234,2456932,2456932
Lithuania,2036,LT,LTU,EUR,50723,118487,169210,141827,120515,147219,175035,153718,248376,986690,48186,112521,160707,133946,113621,134381,160722,166094,411763,1120527,2107217,2437128,2437128
Lithuania,2037,LT,LTU,EUR,50221,115823,166044,140390,123027,139214,176992,151000,250923,981546,47703,109984,157687,132692,116096,127838,162210,161131,412361,1112328,2093874,2417606,2417606
Lithuania,2038,LT,LTU,EUR,49955,113186,163141,138829,125412,132294,177334,149721,252680,976270,47449,107481,154930,131198,118657,122038,162413,157712,411967,1103985,2080255,2398329,2398329
Lithuania,2039,LT,LTU,EUR,49911,110643,160554,136975,127861,127095,175375,149555,253968,970829,47401,105071,152472,129461,121131,117961,160571,155400,410939,1095463,2066292,2379311,2379311
Lithuania,2040,LT,LTU,EUR,50071,108275,158346,134346,130939,122824,172330,149815,254906,965160,47552,102824,150376,127035,124054,114609,157835,153669,409504,1086706,2051866,2360590,2360590
Lithuania,2041,LT,LTU,EUR,50378,106155,156533,131159,134168,119226,168204,150827,255674,959258,47842,100813,148655,124169,126963,111762,154443,152825,407530,1077692,2036950,2342143,2342143
Lithuania,2042,LT,LTU,EUR,50776,104339,155115,128049,136806,116473,163075,152403,256324,953130,48220,99087,147307,121425,129234,109684,150256,152744,405070,1068413,2021543,2323956,2323956
Lithuania,2043,LT,LTU,EUR,51262,102877,154139,125085,138346,114704,158024,153831,256768,946758,48676,97695,146371,118704,130649,108557,146022,152702,402188,1058822,2005580,2306096,2306096
Lithuania,2044,LT,LTU,EUR,51809,101761,153570,122184,138679,114120,153065,155194,256939,940181,49197,96636,145833,115980,131025,108439,142030,152634,398888,1048996,1989177,2288573,2288573
Lithuania,2045,LT,LTU,EUR,52367,100989,153356,119406,138272,114567,147192,157110,256858,933405,49725,95901,145626,113324,130723,109162,137233,153466,395012,1038920,1972325,2271313,2271313
Lithuania,2046,LT,LTU,EUR,52910,100558,153468,116712,137381,116201,140033,159369,256771,926467,50243,95488,145731,110724,130020,110797,131450,154895,390736,1028622,1955089,2254285,2254285
Lithuania,2047,LT,LTU,EUR,53392,100453,153845,114057,135983,118726,132477,161381,256739,919363,50702,95386,146088,108196,128784,113279,125041,156398,386431,1018129,1937492,2237425,2237425
Lithuania,2048,LT,LTU,EUR,53766,100677,154443,111432,134450,121113,125951,161894,257287,912127,51057,95594,146651,105698,127304,115836,119356,156655,382637,1007486,1919613,2220704,2220704
Lithuania,2049,LT,LTU,EUR,53991,101180,155171,108897,132622,123554,121059,160273,258408,904813,51270,96066,147336,103290,125573,118305,115365,154927,379316,996776,1901589,2204104,2204104
Lithuania,2050,LT,LTU,EUR,54047,101905,155952,106538,130024,126623,117049,157633,259623,897490,51319,96747,148066,101045,123154,121222,112088,152322,376209,986040,1883530,2187550,2187550
Luxembourg,1970,LU,LUX,EUR,12235,26261,38496,23881,23671,25197,17984,19407,17760,127900,11701,25205,36906,23002,22098,24068,20614,21649,24613,136044,263944,339342,339342
Luxembourg,1971,LU,LUX,EUR,11945,26458,38403,24641,23993,25435,18406,18940,17990,129405,11346,25332,36678,23801,22253,23932,21110,21162,25240,137498,266903,341971,341971
Luxembourg,1972,LU,LUX,EUR,11691,26558,38249,25636,24812,25701,19334,18260,18254,131997,10964,25391,36355,24691,22773,23820,21876,20476,25834,139470,271467,346079,346079
Luxembourg,1973,LU,LUX,EUR,11305,26595,37900,26386,25395,25721,20403,17544,18518,133967,10578,25478,36056,25377,23209,23743,22723,19698,26517,141267,275234,349186,349186
Luxembourg,1974,LU,LUX,EUR,10976,26557,37533,26972,25689,25508,21366,16964,18730,135229,10278,25521,35799,26034,23534,23657,23423,19094,27088,142830,278059,351387,351387
Luxembourg,1975,LU,LUX,EUR,10758,26403,37161,27524,26097,25228,22153,16597,18992,136591,10079,25404,35483,26740,23977,23492,23763,18958,27512,144442,281033,353666,353666
Luxembourg,1976,LU,LUX,EUR,10533,26241,36774,27935,26736,24915,22815,16350,19152,137903,9893,25206,35099,27415,24590,23307,23930,19029,27840,146111,284014,355889,355889
Luxembourg,1977,LU,LUX,EUR,10335,26062,36397,28199,27459,24824,23433,16088,19236,139239,9784,24925,34709,27930,25343,23254,24061,19014,28312,147914,287153,358267,358267
Luxembourg,1978,LU,LUX,EUR,10373,25729,36102,28365,28180,24961,23983,15841,19383,140713,9879,24584,34463,28253,26191,23385,24072,19019,28871,149791,290504,361069,361069
Luxembourg,1979,LU,LUX,EUR,10461,25123,35584,28555,28722,25121,24378,15619,19533,141928,10004,24036,34040,28418,26946,23522,24002,19110,29390,151388,293316,362932,362932
Luxembourg,1980,LU,LUX,EUR,10499,24404,34903,28640,29183,25231,24556,15584,19562,142756,10090,23303,33393,28466,27644,23572,23906,19321,29785,152694,295450,363741,363741
Luxembourg,1981,LU,LUX,EUR,10669,23739,34408,28632,29517,25365,24564,15905,19401,143384,10234,22574,32808,28488,28291,23710,23743,19793,29843,153868,297252,364473,364473
Luxembourg,1982,LU,LUX,EUR,10844,23072,33916,28598,29627,25578,24380,16490,19194,143867,10343,21926,32269,28486,28759,23991,23541,20479,29719,154975,298842,365020,365020
Luxembourg,1983,LU,LUX,EUR,10876,22416,33292,28451,29749,25939,24091,17319,18919,144468,10413,21325,31738,28357,29174,24238,23398,21263,29514,155944,300412,365440,365440
Luxembourg,1984,LU,LUX,EUR,10861,21895,32756,28239,29859,26341,23842,18182,18689,145152,10398,20792,31190,28053,29561,24460,23301,21920,29388,156683,301835,365779,365779
Luxembourg,1985,LU,LUX,EUR,10865,21535,32400,27987,30073,26710,23571,18903,18642,145886,10289,20405,30694,27700,29968,24793,23098,22252,29680,157491,303377,366466,366466
Luxembourg,1986,LU,LUX,EUR,10849,21334,32183,27757,30563,27245,23239,19501,18680,146985,10258,20197,30455,27255,30595,25279,22824,22448,30144,158545,305530,368170,368170
Luxembourg,1987,LU,LUX,EUR,10867,21321,32188,27491,31071,27887,23150,20031,18664,148294,10340,20190,30530,26631,31195,25900,22734,22557,30499,159516,307810,370526,370526
Luxembourg,1988,LU,LUX,EUR,11091,21434,32525,27025,31671,28467,23360,20462,18636,149621,10546,20401,30947,25938,31585,26545,22847,22502,30918,160335,309956,373432,373432
Luxembourg,1989,LU,LUX,EUR,11430,21687,33117,26396,32458,29177,23634,20774,18676,151115,10913,20718,31631,25282,31885,27263,22921,22396,31344,161091,312206,376949,376949
Luxembourg,1990,LU,LUX,EUR,11909,22010,33919,25885,33217,30074,23836,21037,18832,152881,11409,20959,32368,24717,32229,28086,22958,22304,31803,162097,314978,381267,381267
Luxembourg,1991,LU,LUX,EUR,12429,22404,34833,25559,33958,30810,24141,21214,19228,154910,11882,21287,33169,24215,32664,28888,23171,22190,32358,163486,318396,386399,386399
Luxembourg,1992,LU,LUX,EUR,12882,22859,35741,25195,34528,31380,24625,21250,19763,156741,12285,21750,34035,23845,33124,29559,23576,22047,32831,164982,321723,391516,391516
Luxembourg,1993,LU,LUX,EUR,13360,23365,36725,24882,34826,31892,25245,21188,20380,158413,12637,22294,34931,23678,33521,30219,23973,21958,33271,166620,325033,396697,396697
Luxembourg,1994,LU,LUX,EUR,13793,23882,37675,24630,34972,32387,25906,21133,21064,160092,12966,22878,35844,23603,33795,30927,24351,21952,33812,168440,328532,402043,402043
Luxembourg,1995,LU,LUX,EUR,14054,24519,38573,24478,35134,32958,26516,21023,21765,161874,13272,23397,36669,23675,34023,31673,24816,21889,34445,170521,332395,407635,407635
Luxembourg,1996,LU,LUX,EUR,14297,25110,39407,24396,35292,33595,27245,20825,22448,163801,13511,23845,37356,23707,34165,32540,25386,21722,35109,172629,336430,413202,413202
Luxembourg,1997,LU,LUX,EUR,14607,25592,40199,24277,35290,34273,27964,20851,23044,165699,13686,24342,38028,23579,34210,33361,26058,21694,35590,174492,340191,418411,418411
Luxembourg,1998,LU,LUX,EUR,14715,26327,41042,24326,35009,35089,28553,21149,23545,167671,13722,24951,38673,23606,33978,34073,26755,21879,35900,176191,343862,423574,423574
Luxembourg,1999,LU,LUX,EUR,14727,27114,41841,24677,34613,35943,29271,21497,24004,170005,13719,25706,39425,23838,33658,34732,27505,22041,36306,178080,348085,429349,429349
Luxembourg,2000,LU,LUX,EUR,14705,27716,42421,25304,34489,37027,29848,21481,24314,172463,13736,26452,40188,24410,34074,35730,28163,21798,36383,180558,353021,435628,435628
Luxembourg,2001,LU,LUX,EUR,14572,28237,42809,25770,34342,38097,30289,21531,24685,174714,13746,26979,40725,24940,34386,36749,28822,21685,36409,182991,357705,441250,441250
Luxembourg,2002,LU,LUX,EUR,14423,28717,43140,25903,33844,38738,30955,22053,25264,176757,13661,27405,41066,25089,33894,37385,29657,22105,36829,184959,361716,445913,445913
Luxembourg,2003,LU,LUX,EUR,14434,29104,43538,26420,33458,39275,31723,22701,25737,179314,13558,27713,41271,25509,33496,38022,30454,22555,37198,187234,366548,451351,451351
Luxembourg,2004,LU,LUX,EUR,14477,29497,43974,27239,33266,39751,32522,23392,26275,182445,13511,28012,41523,26124,33200,38621,31269,22967,37659,189840,372285,457788,457788
Luxembourg,2005,LU,LUX,EUR,14436,29894,44330,27960,33288,40165,33405,24069,26931,185818,13403,28442,41845,26682,33143,39161,32213,23480,38188,192867,378685,464860,464860
Luxembourg,2006,LU,LUX,EUR,14456,30210,44666,28512,33502,40627,34366,24802,27545,189354,13382,28848,42230,27206,33443,39621,33270,24037,38576,196153,385507,472404,472404
Luxembourg,2007,LU,LUX,EUR,14490,30469,44959,28966,33921,40982,35355,25541,28099,192864,13514,29078,42592,27660,33969,39958,34259,24637,38973,199456,392320,479868,479868
Luxembourg,2008,LU,LUX,EUR,14568,30711,45279,29572,34742,41242,36479,26324,28737,197096,13734,29201,42935,28172,34819,40263,35205,25385,39474,203318,400414,488635,488635
Luxembourg,2009,LU,LUX,EUR,14682,30979,45661,30141,35731,41299,37770,27195,29523,201659,13912,29286,43198,28802,35581,40476,36213,26295,39972,207339,408998,497868,497868
Luxembourg,2010,LU,LUX,EUR,14856,31207,46063,30756,36539,41358,39115,28203,30197,206168,14141,29377,43518,29521,36090,40711,37237,27321,40434,211314,417482,507070,507070
Luxembourg,2011,LU,LUX,EUR,15036,31210,46246,31891,37516,41830,40695,29113,30964,212009,14416,29354,43770,30463,37249,40926,38281,28238,41023,216180,428189,518206,518206
Luxembourg,2012,LU,LUX,EUR,15320,31224,46544,33049,38876,42362,42203,29960,32009,218459,14609,29460,44069,31438,38646,41229,39378,29072,41750,221513,439972,530585,530585
Luxembourg,2013,LU,LUX,EUR,15763,31421,47184,33704,40181,42902,43449,31023,33233,224492,14923,29794,44717,32005,39707,41786,40527,29983,42662,226670,451162,543066,543066
Luxembourg,2014,LU,LUX,EUR,16116,31715,47831,34201,41446,43518,44696,32211,34576,230648,15280,30051,45331,32487,40876,42490,41669,30969,43764,232255,462903,556069,556069
Luxembourg,2015,LU,LUX,EUR,16372,32095,48467,34742,42931,44316,45779,33474,35843,237085,15496,30367,45863,33141,42010,43325,42617,32044,44859,237996,475081,569408,569408
Luxembourg,2016,LU,LUX,EUR,16453,32643,49096,35462,44281,45299,46850,34846,37072,243810,15603,30715,46318,33914,43190,44243,43471,33434,45879,244131,487941,583351,583351
Luxembourg,2017,LU,LUX,EUR,16464,33210,49674,36143,45435,46247,47657,36184,38253,249919,15707,31150,46857,34427,44370,45218,44176,34769,46878,249838,499757,596283,596283
Luxembourg,2018,LU,LUX,EUR,16584,33653,50237,36467,46908,47153,48036,37492,39341,255397,15850,31786,47636,34586,45571,46216,44551,35819,47906,254649,510046,607913,607913
Luxembourg,2019,LU,LUX,EUR,16724,34182,50906,36748,48563,48083,48155,38858,40522,260929,16073,32372,48445,34761,46913,47204,44854,36932,49033,259697,520626,619973,619973
Luxembourg,2020,LU,LUX,EUR,16842,34712,51554,37048,49839,48889,48082,40170,41624,265652,16284,32908,49192,34729,47962,48043,45100,38020,50148,264002,529654,630399,630399
Luxembourg,2021,LU,LUX,EUR,16982,35026,52008,37110,50505,49650,48079,41552,42860,269756,16398,33332,49730,34708,48398,48920,45319,39071,51407,267823,537579,639321,639321
Luxembourg,2022,LU,LUX,EUR,17089,35236,52325,36994,50691,50406,48139,42906,44469,273605,16480,33514,49994,34846,48426,49738,45613,40190,52856,271669,545274,647599,647599
Luxembourg,2023,LU,LUX,EUR,17159,35402,52561,37009,50387,51129,48166,44096,46213,277000,16566,33604,50170,35036,48036,50422,45964,41266,54319,275043,552043,654768,654768
Luxembourg,2024,LU,LUX,EUR,17314,35409,52723,37186,49784,51938,48192,45113,48053,280266,16633,33731,50364,35273,47443,51087,46363,42204,55869,278239,558505,661594,661594
Luxembourg,2025,LU,LUX,EUR,17506,35346,52852,37261,49118,52694,48505,45881,49956,283415,16713,33786,50499,35447,46868,51663,46802,43037,57509,281326,564741,668100,668100
Luxembourg,2026,LU,LUX,EUR,17624,35352,52976,37374,48364,53308,48906,46550,51914,286416,16798,33860,50658,35549,46277,52123,47322,43680,59294,284245,570661,674296,674296
Luxembourg,2027,LU,LUX,EUR,17668,35411,53079,37581,47497,53861,49279,47068,54004,289290,16827,33999,50826,35708,45538,52513,47932,44149,61199,287039,576329,680226,680226
Luxembourg,2028,LU,LUX,EUR,17669,35471,53140,37771,46589,54471,49783,47216,56265,292095,16817,34028,50845,36069,44660,52898,48654,44455,63154,289890,581985,685968,685968
Luxembourg,2029,LU,LUX,EUR,17642,35496,53138,38013,45790,54980,50308,47134,58681,294906,16782,34065,50847,36407,43902,53194,49320,44673,65204,292700,587606,691585,691585
Luxembourg,2030,LU,LUX,EUR,17593,35531,53124,38190,45219,55300,50782,47025,61129,297645,16727,34164,50891,36675,43235,53401,49920,44887,67318,295436,593081,697086,697086
Luxembourg,1950,LU,LUX,EUR,10302,19944,30246,24975,19916,23928,19862,14999,13893,117573,9551,20029,29580,23086,21064,24124,20973,15022,14909,119178,236751,296584,296584
Luxembourg,1951,LU,LUX,EUR,10466,19772,30238,25073,20028,23699,20343,15031,14089,118263,9704,19935,29639,22887,21387,23922,21345,15304,15225,120070,238333,298212,298212
Luxembourg,1952,LU,LUX,EUR,10761,19799,30560,24854,20328,23347,20838,15086,14298,118751,10023,19843,29866,22545,21897,23551,21661,15663,15562,120879,239630,300055,300055
Luxembourg,1953,LU,LUX,EUR,11145,19969,31114,24376,20798,22881,21312,15146,14447,118960,10444,19766,30210,22116,22508,23064,21926,16059,15804,121477,240437,301760,301760
Luxembourg,1954,LU,LUX,EUR,11602,20118,31720,23788,21388,22365,21734,15261,14608,119144,10964,19629,30593,21694,23060,22575,22189,16482,16048,122048,241192,303507,303507
Luxembourg,1955,LU,LUX,EUR,12036,20276,32312,23176,22030,21857,22093,15455,14820,119431,11435,19559,30994,21335,23481,22165,22463,16929,16399,122772,242203,305514,305514
Luxembourg,1956,LU,LUX,EUR,12289,20539,32828,22502,22745,21339,22381,15697,15007,119671,11683,19663,31346,21023,23777,21798,22734,17379,16705,123416,243087,307259,307259
Luxembourg,1957,LU,LUX,EUR,12399,20908,33307,21746,23553,20805,22594,15987,15145,119830,11802,19882,31684,20767,23947,21472,23023,17833,16979,124021,243851,308843,308843
Luxembourg,1958,LU,LUX,EUR,12435,21351,33786,21016,24350,20326,22729,16329,15325,120075,11846,20195,32041,20571,23989,21240,23286,18289,17311,124686,244761,310585,310585
Luxembourg,1959,LU,LUX,EUR,12443,21445,33888,21196,24787,19396,22962,17273,15088,120702,11826,20421,32247,20508,23683,20918,23339,19187,18035,125670,246372,312505,312505
Luxembourg,1960,LU,LUX,EUR,12471,21586,34057,21477,24885,18717,22943,18279,14824,121125,11879,20713,32592,20367,23274,20799,23118,20054,18783,126395,247520,314168,314168
Luxembourg,1961,LU,LUX,EUR,12607,22099,34706,21333,24934,19078,22395,18750,15059,121549,12026,21306,33332,20283,23093,21253,22645,20456,19267,126997,248546,316587,316587
Luxembourg,1962,LU,LUX,EUR,12728,22655,35383,21537,24871,19871,21626,19158,15300,122363,12174,21947,34121,20485,22926,22003,21960,20864,19739,127977,250340,319852,319852
Luxembourg,1963,LU,LUX,EUR,12780,23234,36014,21797,24667,20889,20808,19494,15532,123187,12340,22476,34816,20684,22820,22874,21143,21256,20211,128988,252175,323006,323006
Luxembourg,1964,LU,LUX,EUR,12894,23835,36729,21991,24479,21866,20138,19701,15872,124047,12458,23015,35473,20843,22785,23617,20517,21547,20802,130111,254158,326363,326363
Luxembourg,1965,LU,LUX,EUR,13074,24419,37493,22171,24290,22672,19680,19818,16220,124851,12565,23562,36127,21096,22646,24027,20419,21690,21450,131328,256179,329794,329794
Luxembourg,1966,LU,LUX,EUR,13182,24935,38117,22545,24024,23374,19366,19801,16595,125705,12651,24116,36767,21454,22466,24258,20508,21761,22084,132531,258236,333130,333130
Luxembourg,1967,LU,LUX,EUR,13171,25345,38516,22852,23857,24014,18934,19767,16944,126368,12558,24593,37151,21739,22377,24395,20417,21801,22788,133517,259885,335560,335560
Luxembourg,1968,LU,LUX,EUR,13018,25674,38692,23056,23807,24520,18484,19754,17210,126831,12314,24912,37226,22000,22335,24346,20371,21819,23423,134294,261125,337046,337046
Luxembourg,1969,LU,LUX,EUR,12674,26003,38677,23415,23763,24906,18137,19641,17491,127353,12029,25090,37119,22438,22245,24210,20447,21821,23968,135129,262482,338279,338279
Luxembourg,2031,LU,LUX,EUR,17523,35655,53178,38272,44721,55432,51323,46971,63529,300248,16651,34253,50904,36885,42750,53335,50660,45094,69407,298131,598379,702458,702458
Luxembourg,2032,LU,LUX,EUR,17435,35759,53194,38406,44262,55329,51945,47004,65866,302812,16560,34316,50876,36982,42516,53074,51349,45339,71536,300796,603608,707675,707675
Luxembourg,2033,LU,LUX,EUR,17336,35812,53148,38530,44098,54884,52601,47039,68195,305347,16462,34370,50832,37028,42517,52544,51972,45678,73690,303429,608776,712750,712750
Luxembourg,2034,LU,LUX,EUR,17240,35922,53162,38514,44153,54181,53363,47082,70444,307737,16367,34386,50753,37126,42619,51844,52596,46061,75792,306038,613775,717696,717696
Luxembourg,2035,LU,LUX,EUR,17147,36058,53205,38436,44148,53456,54093,47404,72508,310045,16276,34402,50678,37169,42703,51204,53140,46498,77874,308588,618633,722516,722516
Luxembourg,2036,LU,LUX,EUR,17074,36099,53173,38434,44219,52669,54691,47817,74522,312352,16204,34407,50611,37231,42761,50580,53583,47013,79912,311080,623432,727217,727217
Luxembourg,2037,LU,LUX,EUR,17026,36051,53077,38494,44415,51795,55242,48207,76500,314653,16155,34341,50496,37365,42906,49835,53973,47629,81864,313572,628225,731798,731798
Luxembourg,2038,LU,LUX,EUR,17007,35953,52960,38554,44608,50895,55852,48719,78273,316901,16134,34233,50367,37395,43269,48954,54359,48346,83701,316024,632925,736260,736260
Luxembourg,2039,LU,LUX,EUR,17011,35829,52840,38576,44848,50109,56366,49250,79954,319103,16138,34101,50239,37433,43607,48207,54660,49009,85522,318438,637541,740621,740621
Luxembourg,2040,LU,LUX,EUR,17036,35691,52727,38615,45026,49542,56692,49730,81631,321236,16163,33956,50119,37531,43875,47539,54865,49610,87376,320796,642032,744884,744884
Luxembourg,2041,LU,LUX,EUR,17077,35549,52626,38740,45113,49052,56827,50274,83301,323307,16199,33810,50009,37623,44086,47057,54804,50347,89173,323090,646397,749034,749034
Luxembourg,2042,LU,LUX,EUR,17136,35412,52548,38843,45245,48597,56731,50896,84975,325287,16252,33671,49923,37687,44182,46829,54551,51037,91037,325323,650610,753090,753090
Luxembourg,2043,LU,LUX,EUR,17222,35295,52517,38895,45371,48437,56297,51559,86637,327196,16332,33554,49886,37743,44232,46828,54029,51661,92979,327472,654668,757069,757069
Luxembourg,2044,LU,LUX,EUR,17308,35202,52510,39006,45360,48492,55610,52319,88218,329005,16413,33464,49877,37755,44331,46935,53339,52286,94890,329536,658541,760934,760934
Luxembourg,2045,LU,LUX,EUR,17395,35136,52531,39142,45277,48494,54898,53050,89870,330731,16494,33395,49889,37772,44372,47022,52707,52832,96818,331523,662254,764687,764687
Luxembourg,2046,LU,LUX,EUR,17491,35103,52594,39182,45277,48570,54130,53657,91563,332379,16582,33358,49940,37779,44437,47084,52093,53281,98759,333433,665812,768343,768343
Luxembourg,2047,LU,LUX,EUR,17589,35119,52708,39136,45342,48762,53274,54216,93185,333915,16674,33365,50039,37714,44572,47228,51360,53678,100688,335240,669155,771898,771898
Luxembourg,2048,LU,LUX,EUR,17675,35182,52857,39042,45401,48962,52394,54830,94734,335363,16756,33425,50181,37604,44602,47588,50489,54075,102591,336949,672312,775350,775350
Luxembourg,2049,LU,LUX,EUR,17760,35272,53032,38918,45424,49201,51623,55345,96212,336723,16834,33507,50341,37474,44643,47928,49752,54378,104411,338586,675309,778689,778689
Luxembourg,2050,LU,LUX,EUR,17845,35384,53229,38779,45465,49380,51072,55672,97640,338008,16914,33611,50525,37331,44742,48199,49094,54588,106191,340145,678153,781910,781910
Latvia,1970,LV,LVA,EUR,83400,177203,260603,177271,188975,172493,98815,102192,94264,834010,81035,172189,253224,165197,189498,194617,151720,153782,194759,1049573,1883583,2397414,2397414
Latvia,1971,LV,LVA,EUR,85149,176724,261873,181645,186562,176132,103677,98370,97491,843877,82886,171832,254718,169244,186668,193192,159702,150244,198780,1057830,1901707,2418298,2418298
Latvia,1972,LV,LVA,EUR,86776,175987,262763,185385,183809,178806,110789,94066,100366,853221,84589,171395,255984,172887,183761,192792,168693,145582,202807,1066522,1919743,2438485,2438485
Latvia,1973,LV,LVA,EUR,87884,174819,262703,188513,181326,180760,118936,90193,102674,862402,85737,170644,256381,176126,181370,193330,177188,141056,206476,1075546,1937948,2457032,2457032
Latvia,1974,LV,LVA,EUR,88606,173615,262221,191073,179526,182375,126842,87102,104528,871446,86482,169872,256354,179043,179754,194512,184236,137420,210083,1085048,1956494,2475079,2475079
Latvia,1975,LV,LVA,EUR,88997,172634,261631,193726,178231,183496,134007,84682,105884,880026,86878,169293,256171,182270,178655,195831,189712,134820,213424,1094712,1974738,2492528,2492528
Latvia,1976,LV,LVA,EUR,88867,171933,260800,196696,177338,184063,140321,82884,106834,888136,86758,168972,255730,185882,178001,196996,193365,133546,216406,1104196,1992332,2508850,2508850
Latvia,1977,LV,LVA,EUR,88479,171680,260159,199455,177437,183950,145695,81737,107707,895981,86435,168989,255424,189192,178336,197645,194821,134082,219193,1113269,2009250,2524834,2524834
Latvia,1978,LV,LVA,EUR,88262,171837,260099,201834,178780,183083,149980,81282,108320,903279,86347,169231,255578,192043,179956,197334,194344,136459,221497,1121633,2024912,2540588,2540588
Latvia,1979,LV,LVA,EUR,88264,172623,260887,203082,181913,181498,153289,81764,108157,909703,86516,170002,256518,193672,183434,196043,192707,140368,222895,1129119,2038822,2556222,2556222
Latvia,1980,LV,LVA,EUR,88550,174215,262765,202884,186552,178983,156240,83644,106990,915293,86969,171601,258570,193688,188403,193642,190882,146011,222778,1135404,2050697,2572037,2572037
Latvia,1981,LV,LVA,EUR,89307,175902,265209,202302,191058,175800,158955,87488,104891,920494,87860,173328,261188,193265,193194,190321,189689,153574,221118,1141161,2061655,2588051,2588051
Latvia,1982,LV,LVA,EUR,90808,177138,267946,201485,194823,172713,161098,93319,102523,925961,89438,174622,264060,192698,197147,186878,189442,162031,218774,1146970,2072931,2604945,2604945
Latvia,1983,LV,LVA,EUR,93554,177906,271460,200191,197895,170149,162778,100102,100433,931548,92211,175539,267750,191676,200241,183993,189908,169901,216673,1152392,2083940,2623151,2623151
Latvia,1984,LV,LVA,EUR,96868,178206,275074,198843,200380,168241,164135,106617,98623,936839,95562,176156,271718,190474,202645,181852,190700,176272,215037,1156980,2093819,2640608,2640608
Latvia,1985,LV,LVA,EUR,99588,178230,277818,197541,202814,166801,165033,112497,97295,941981,98332,176557,274889,189206,205093,180082,191355,181003,213685,1160424,2102405,2655104,2655104
Latvia,1986,LV,LVA,EUR,102093,178153,280246,196161,205195,165803,165511,117811,96943,947424,100883,176774,277657,187884,207573,178651,191689,183988,213753,1163538,2110962,2668867,2668867
Latvia,1987,LV,LVA,EUR,104386,178368,282754,194820,206850,165681,165362,122371,97361,952445,103206,177269,280475,186636,209308,178152,191410,184863,215796,1166165,2118610,2681836,2681836
Latvia,1988,LV,LVA,EUR,105159,179771,284930,193367,207572,166448,164394,125827,97996,955604,103966,178924,282890,185325,210141,178706,190195,183745,218931,1167043,2122647,2690470,2690470
Latvia,1989,LV,LVA,EUR,104155,181897,286052,191871,206650,168413,162620,128247,98777,956578,102926,181284,284210,184154,209322,180702,188143,181455,222769,1166545,2123123,2693388,2693388
Latvia,1990,LV,LVA,EUR,102264,183724,285988,190628,203768,171199,159713,130105,99542,954955,101062,183221,284283,183531,206442,183757,184984,178953,226498,1164165,2119120,2689391,2689391
Latvia,1991,LV,LVA,EUR,99115,185735,284850,189204,200083,173406,155896,131658,100758,951005,97989,185205,283194,182887,202810,186310,180860,177006,230041,1159914,2110919,2678964,2678964
Latvia,1992,LV,LVA,EUR,94278,188075,282353,187273,195864,174699,151894,132688,102861,945279,93241,187482,280723,181734,198828,187933,176494,175916,233631,1154536,2099815,2662883,2662883
Latvia,1993,LV,LVA,EUR,88267,189867,278134,184905,190992,175184,147967,132889,104869,936806,87402,189113,276515,180228,194293,188727,172455,175340,236394,1147437,2084243,2638889,2638889
Latvia,1994,LV,LVA,EUR,81672,190442,272114,182040,186172,174973,144250,132214,105853,925502,80973,189447,270420,178371,189629,188861,168958,174869,237732,1138420,2063922,2606454,2606454
Latvia,1995,LV,LVA,EUR,74784,189764,264548,178941,181677,174705,140924,131083,106648,913978,74130,188565,262695,176238,185044,189026,165799,174267,238556,1128930,2042908,2570151,2570151
Latvia,1996,LV,LVA,EUR,67865,187793,255658,175952,177468,174526,138292,130063,108345,904646,67159,186506,253665,173898,180589,189190,163086,173560,239997,1120320,2024966,2534287,2534287
Latvia,1997,LV,LVA,EUR,61560,184134,245694,173442,173652,173954,136660,128938,110595,897241,60753,182835,243588,171783,176385,188750,161223,172501,241710,1112352,2009593,2498879,2498879
Latvia,1998,LV,LVA,EUR,56428,178056,234484,172205,170048,172937,135825,127305,112560,890880,55484,176830,232314,170740,172388,187788,160130,170705,242910,1104661,1995541,2462337,2462337
Latvia,1999,LV,LVA,EUR,52915,169966,222881,171900,166799,170952,136146,125189,114251,885237,51806,168802,220608,170451,168833,185658,160311,168221,244159,1097633,1982870,2426351,2426351
Latvia,2000,LV,LVA,EUR,50997,161038,212035,171691,164239,167755,137474,122572,116191,879922,49750,159912,209662,170049,166025,182027,161674,164942,246186,1090903,1970825,2392530,2392530
Latvia,2001,LV,LVA,EUR,50158,151175,201333,171956,161878,164357,138663,119500,118447,874801,48868,150071,198939,170036,163349,178132,162886,160990,248786,1084179,1958980,2359249,2359249
Latvia,2002,LV,LVA,EUR,49955,140764,190719,172553,159399,160862,139584,116356,120905,869659,48676,139608,188284,170383,160462,174198,163724,156876,251833,1077476,1947135,2326144,2326144
Latvia,2003,LV,LVA,EUR,50422,131015,181437,172558,156818,157201,140395,113581,123564,864117,49125,129848,178973,169973,157558,169973,164219,153106,254983,1069812,1933929,2294342,2294342
Latvia,2004,LV,LVA,EUR,50764,122652,173416,171664,153945,154006,141016,111301,125996,857928,49452,121481,170933,168583,154489,165868,164329,149948,257949,1061166,1919094,2263443,2263443
Latvia,2005,LV,LVA,EUR,50841,115414,166255,170086,151019,151181,141737,109257,127653,850933,49538,114134,163672,166714,151276,161996,164706,147102,260502,1052296,1903229,2233157,2233157
Latvia,2006,LV,LVA,EUR,51495,108891,160386,167779,148230,148493,142507,107488,128625,843122,50166,107484,157650,164321,147977,158366,165170,144490,262430,1042754,1885876,2203913,2203913
Latvia,2007,LV,LVA,EUR,52699,103293,155992,164318,145895,146091,142961,106451,129005,834721,51344,101777,153121,160866,145133,154979,165115,142662,263461,1032216,1866937,2176053,2176053
Latvia,2008,LV,LVA,EUR,53919,99427,153346,158738,144906,143846,143173,106189,128892,825744,52617,97661,150278,155370,143588,151811,164832,141651,263788,1021040,1846784,2150412,2150412
Latvia,2009,LV,LVA,EUR,54678,97183,151861,151454,144695,141896,142668,107161,128596,816470,53492,95086,148578,148088,142713,149106,163534,142185,263731,1009357,1825827,2126265,2126265
Latvia,2010,LV,LVA,EUR,54494,96172,150666,143761,144240,140585,141047,109095,128094,806822,53346,93873,147219,140285,141484,147229,160711,144231,262881,996821,1803643,2101530,2101530
Latvia,2011,LV,LVA,EUR,53342,96599,149941,135334,144165,139313,139346,110856,127843,796857,52105,94242,146347,131563,140744,145314,157902,145979,262335,983837,1780694,2076974,2076974
Latvia,2012,LV,LVA,EUR,51923,98050,149973,126433,144594,137701,137520,112492,128232,786972,50489,95636,146125,122175,140676,142847,155203,147119,262548,970568,1757540,2053636,2053636
Latvia,2013,LV,LVA,EUR,50724,99962,150686,118264,144736,135762,135328,114094,129147,777331,49008,97396,146404,113716,140017,140192,152035,147852,263251,957063,1734394,2031486,2031486
Latvia,2014,LV,LVA,EUR,50439,100979,151418,111601,144320,133391,133468,115470,130260,768510,48342,98190,146532,106933,138602,137209,148849,148181,264803,944577,1713087,2011039,2011039
Latvia,2015,LV,LVA,EUR,51356,100701,152057,105864,143603,130996,131822,117003,131279,760567,48867,97547,146414,100983,137170,133958,145787,148933,266087,932918,1693485,1991955,1991955
Latvia,2016,LV,LVA,EUR,52855,100258,153113,100338,142540,128706,130207,118677,132222,752690,49976,96577,146553,95321,135575,130529,142909,149894,266896,921124,1673814,1973476,1973476
Latvia,2017,LV,LVA,EUR,53937,100225,154162,95434,140652,126764,128773,120047,133066,744736,50676,96003,146679,90383,133141,127566,140186,150336,267678,909290,1654026,1954862,1954862
Latvia,2018,LV,LVA,EUR,53905,100455,154360,92240,136744,126176,127348,121072,133733,737313,50325,95803,146128,86969,128855,125985,137598,150524,267896,897827,1635140,1935630,1935630
Latvia,2019,LV,LVA,EUR,52833,101209,154042,90609,131184,126301,126137,121364,134859,730454,49062,96138,145200,85015,122984,125032,135506,149698,268621,886856,1617310,1916555,1916555
Latvia,2020,LV,LVA,EUR,50872,102266,153138,90069,125399,126125,125487,120618,136271,723969,47146,96608,143754,84328,116875,123688,134233,147362,269702,876188,1600157,1897052,1897052
Latvia,2021,LV,LVA,EUR,48409,102946,151355,90852,118865,126353,124746,119441,136383,716640,44901,96570,141471,85137,110013,122913,132827,144898,268656,864444,1581084,1873919,1873919
Latvia,2022,LV,LVA,EUR,45917,103137,149054,92090,111588,127190,123565,118002,136931,709366,42754,96157,138911,86518,102657,123046,130931,142619,267547,853318,1562684,1850651,1850651
Latvia,2023,LV,LVA,EUR,43771,102555,146326,93447,104689,127938,122021,116377,138978,703450,40962,95203,136165,87996,96192,122933,128980,140088,268083,844272,1547722,1830211,1830211
Latvia,2024,LV,LVA,EUR,42030,101657,143687,94119,99123,128251,120128,115035,141002,697658,39484,94060,133544,88743,91162,122316,126717,137564,268846,835348,1533006,1810240,1810240
Latvia,2025,LV,LVA,EUR,40685,100802,141487,93794,94290,128419,118278,113845,143064,691690,38298,93176,131474,88387,86669,121984,124211,135140,269755,826146,1517836,1790796,1790796
Latvia,2026,LV,LVA,EUR,39702,99825,139527,93503,89468,128348,116588,112661,145172,685740,37363,92343,129706,87953,82236,121656,121622,132882,270591,816940,1502680,1771916,1771916
Latvia,2027,LV,LVA,EUR,38717,98522,137239,93742,85106,127533,115263,111676,147068,680388,36420,91239,127659,88018,78362,120598,119495,130769,271091,808333,1488721,1753619,1753619
Latvia,2028,LV,LVA,EUR,37660,96608,134268,94451,82213,124753,115223,110664,148635,675939,35457,89526,124983,88588,75761,117790,118640,128801,271039,800619,1476558,1735806,1735806
Latvia,2029,LV,LVA,EUR,36687,93949,130636,95818,80702,120322,115816,109807,149861,672326,34564,87129,121693,89805,74405,113365,118350,127301,270500,793726,1466052,1718386,1718386
Latvia,2030,LV,LVA,EUR,35807,90628,126435,97571,80267,115477,116103,109395,150623,669436,33755,84202,117957,91303,74190,108535,117680,126498,269303,787509,1456945,1701338,1701338
Latvia,1950,LV,LVA,EUR,79883,162629,242512,158531,92047,113411,89798,65811,69573,589171,76141,161484,237625,180245,141434,155528,139357,111667,124988,853219,1442390,1922525,1922525
Latvia,1951,LV,LVA,EUR,81061,160169,241230,161987,97634,110374,95065,65890,69911,600861,77573,159099,236672,179455,149813,153131,142649,113518,127662,866228,1467089,1944994,1944994
Latvia,1952,LV,LVA,EUR,81751,157621,239372,164485,105623,106701,100221,65922,70312,613264,78494,156458,234952,178676,159856,149637,145576,115372,130460,879577,1492841,1967171,1967171
Latvia,1953,LV,LVA,EUR,81567,155266,236833,166193,115116,103070,104878,66147,70686,626090,78528,153882,232410,178247,170269,145822,148174,117277,133332,893121,1519211,1988465,1988465
Latvia,1954,LV,LVA,EUR,81124,153342,234466,167460,124824,99959,108796,66942,70999,638980,78269,151720,229989,178249,179372,142684,150535,119520,136272,906632,1545612,2010069,2010069
Latvia,1955,LV,LVA,EUR,81073,151885,232958,168266,134018,97637,111834,68477,71312,651544,78338,150089,228427,178206,186593,140794,152598,122167,139220,919578,1571122,2032505,2032505
Latvia,1956,LV,LVA,EUR,81094,150917,232011,168639,142496,96055,114036,70695,71696,663617,78442,149004,227446,177960,191751,140263,154418,125135,142045,931572,1595189,2054640,2054640
Latvia,1957,LV,LVA,EUR,81469,150625,232094,168793,150014,95183,115427,73630,72231,675278,78845,148522,227367,177566,194521,141300,156060,128421,144744,942612,1617890,2077356,2077356
Latvia,1958,LV,LVA,EUR,82877,151022,233899,168764,156464,95243,115862,77240,72878,686451,80148,148659,228807,176681,195175,144086,157286,131831,147359,952418,1638869,2101583,2101583
Latvia,1959,LV,LVA,EUR,84515,152662,237177,168457,162130,96664,115124,81370,73591,697336,81614,150003,231617,174970,194576,148640,157509,135185,150080,960960,1658296,2127085,2127085
Latvia,1960,LV,LVA,EUR,85968,155392,241360,167811,167415,99911,113092,85854,74446,708529,82887,152370,235257,172541,193523,155009,156238,138515,153277,969103,1677632,2154251,2154251
Latvia,1961,LV,LVA,EUR,87765,158118,245883,166936,172190,105566,109828,90508,75297,720325,84482,154702,239184,169704,192372,163248,153355,141734,156901,977314,1697639,2182711,2182711
Latvia,1962,LV,LVA,EUR,89230,160650,249880,166053,176147,113642,105979,94893,75943,732657,85745,156801,242546,166777,191450,172640,149348,144588,160272,985075,1717732,2210147,2210147
Latvia,1963,LV,LVA,EUR,89616,163096,252712,165483,179471,123118,102389,98679,76648,745788,86071,158812,244883,164161,191165,181681,145210,147126,163698,993041,1738829,2236419,2236419
Latvia,1964,LV,LVA,EUR,89019,165287,254306,165473,182553,132741,99531,101776,78022,760096,85545,160691,246236,162059,191604,189124,141805,149465,168149,1002206,1762302,2262860,2262860
Latvia,1965,LV,LVA,EUR,87453,167610,255063,165806,185334,141837,97439,104064,79910,774390,84126,162891,247017,160345,192272,194719,139483,151456,173066,1011341,1785731,2287805,2287805
Latvia,1966,LV,LVA,EUR,85328,170347,255675,166347,187687,150154,96030,105565,82164,787947,82250,165587,247837,159007,192887,198268,138464,153109,177751,1019486,1807433,2310940,2310940
Latvia,1967,LV,LVA,EUR,83551,173089,256640,167484,189447,157431,95245,106318,84917,800842,80746,168230,248976,158465,193228,199464,139133,154500,182254,1027044,1827886,2333504,2333504
Latvia,1968,LV,LVA,EUR,82521,175674,258195,169403,190393,163422,95182,106154,87982,812536,79906,170684,250590,158998,192875,198636,141609,155433,186610,1034161,1846697,2355479,2355479
Latvia,1969,LV,LVA,EUR,82381,177197,259578,172723,190331,168265,96203,104826,91095,823443,79895,172158,252053,161303,191648,196676,145737,155425,190818,1041607,1865050,2376682,2376682
Latvia,2031,LV,LVA,EUR,35035,86991,122026,99025,81189,109675,116852,108937,151220,666898,33044,81030,114074,92393,75447,102696,117638,125520,267955,781649,1448547,1684648,1684648
Latvia,2032,LV,LVA,EUR,34373,83444,117817,99837,83044,103221,118146,108174,151898,664320,32433,78003,110436,92762,77632,96192,118321,123992,266871,775770,1440090,1668342,1668342
Latvia,2033,LV,LVA,EUR,33835,80385,114220,99648,85448,97231,119256,107093,152640,661316,31933,75390,107323,92237,80216,90499,118538,122305,265815,769610,1430926,1652459,1652459
Latvia,2034,LV,LVA,EUR,33450,77804,111254,99104,87069,92484,119909,105695,153607,657868,31582,73149,104731,91470,81960,86170,118228,120313,265044,763185,1421053,1637036,1637036
Latvia,2035,LV,LVA,EUR,33237,75694,108931,98559,87596,88398,120389,104350,154720,654012,31384,71269,102653,90925,82489,82313,118167,118087,264531,756512,1410524,1622114,1622114
Latvia,2036,LV,LVA,EUR,33197,74044,107241,97851,88044,84244,120610,103144,155873,649766,31350,69726,101076,90383,82831,78435,118076,115770,264143,749638,1399404,1607720,1607720
Latvia,2037,LV,LVA,EUR,33314,72478,105792,96783,88912,80461,120078,102260,156989,645483,31468,68258,99726,89529,83549,75034,117232,113885,263577,742806,1388289,1593821,1593821
Latvia,2038,LV,LVA,EUR,33536,70961,104497,95061,90146,78045,117647,102529,157799,641227,31687,66868,98555,88018,84670,72831,114640,113211,262636,736006,1377233,1580292,1580292
Latvia,2039,LV,LVA,EUR,33835,69666,103501,92554,91941,76917,113611,103356,158430,636809,31974,65684,97658,85788,86348,71804,110434,113077,261648,729099,1365908,1567064,1567064
Latvia,2040,LV,LVA,EUR,34167,68616,102783,89353,94047,76780,109145,103878,159031,632234,32292,64726,97018,82986,88222,71860,105807,112559,260657,722091,1354325,1554125,1554125
Latvia,2041,LV,LVA,EUR,34487,67847,102334,85811,95785,77922,103747,104799,159450,627514,32597,64022,96619,79906,89614,73324,100168,112632,259318,714962,1342476,1541431,1541431
Latvia,2042,LV,LVA,EUR,34765,67328,102093,82335,96833,79939,97716,106194,159670,622687,32864,63555,96419,76947,90228,75676,93861,113394,257652,707758,1330445,1528957,1528957
Latvia,2043,LV,LVA,EUR,34991,67038,102029,79330,96830,82455,92118,107376,159671,617780,33078,63295,96373,74379,89887,78384,88342,113685,255797,700474,1318254,1516659,1516659
Latvia,2044,LV,LVA,EUR,35154,66969,102123,76786,96422,84171,87701,108108,159603,612791,33233,63243,96476,72173,89258,80228,84155,113448,253884,693146,1305937,1504527,1504527
Latvia,2045,LV,LVA,EUR,35254,67100,102354,74705,95966,84783,83912,108678,159698,607742,33330,63379,96709,70315,88797,80829,80423,113444,251948,685756,1293498,1492555,1492555
Latvia,2046,LV,LVA,EUR,35285,67380,102665,73068,95307,85275,80050,109006,159946,602652,33361,63657,97018,68778,88299,81202,76663,113405,249989,678336,1280988,1480684,1480684
Latvia,2047,LV,LVA,EUR,35223,67784,103007,71517,94267,86154,76531,108639,160455,597563,33303,64044,97347,67318,87463,81936,73356,112628,248249,670950,1268513,1468878,1468878
Latvia,2048,LV,LVA,EUR,35088,68231,103319,70006,92570,87389,74311,106542,161713,592531,33177,64478,97655,65934,85965,83055,71221,110166,247287,663628,1256159,1457134,1457134
Latvia,2049,LV,LVA,EUR,34871,68694,103565,68718,90094,89178,73300,102976,163308,587574,32975,64918,97893,64750,83743,84729,70238,106148,246805,656413,1243987,1445434,1445434
Latvia,2050,LV,LVA,EUR,34547,69128,103675,67677,86932,91274,73239,98993,164614,582729,32667,65337,98004,63796,80951,86593,70315,101713,245958,649326,1232055,1433728,1433728
"China, Macao SAR",1970,MO,MAC,WPR,11265,38847,50112,31667,10483,12909,10299,7022,4694,77074,10083,34886,44969,27731,10624,13210,9820,6846,6889,75120,152194,247284,247284
"China, Macao SAR",1971,MO,MAC,WPR,10177,37550,47727,34437,10967,12780,10596,7240,4903,80923,8937,33900,42837,30268,10626,13146,10278,6931,7096,78345,159268,249832,249832
"China, Macao SAR",1972,MO,MAC,WPR,9231,34970,44201,36117,11906,12329,10820,7434,5120,83726,8134,31932,40066,31750,10839,12768,10759,7135,7431,80682,164408,248669,248669
"China, Macao SAR",1973,MO,MAC,WPR,8744,32350,41094,37240,13232,11837,10993,7610,5365,86277,7775,29903,37678,32773,11388,12287,11161,7377,7801,82787,169064,247838,247838
"China, Macao SAR",1974,MO,MAC,WPR,8629,29777,38406,37814,14886,11338,11102,7776,5639,88555,7778,27822,35600,33366,12281,11729,11475,7662,8203,84716,173271,247280,247280
"China, Macao SAR",1975,MO,MAC,WPR,8784,27349,36133,37855,16792,10874,11136,7934,5926,90517,8041,25750,33791,33560,13487,11125,11694,7990,8625,86481,176998,246919,246919
"China, Macao SAR",1976,MO,MAC,WPR,9053,25211,34264,37391,18854,10488,11094,8075,6217,92119,8331,23887,32218,33390,14936,10523,11799,8352,9051,88051,180170,246661,246661
"China, Macao SAR",1977,MO,MAC,WPR,9252,23514,32766,36488,20947,10247,10984,8201,6506,93373,8475,22377,30852,32924,16497,9978,11797,8727,9499,89422,182795,246405,246405
"China, Macao SAR",1978,MO,MAC,WPR,9267,22290,31557,35244,22918,10223,10813,8304,6768,94270,8460,21207,29667,32243,18026,9544,11698,9082,9960,90553,184823,246048,246048
"China, Macao SAR",1979,MO,MAC,WPR,9146,21473,30619,33748,24646,10464,10590,8383,7021,94852,8345,20352,28697,31389,19415,9279,11489,9410,10458,91440,186292,245605,245605
"China, Macao SAR",1980,MO,MAC,WPR,9064,20983,30047,32067,26061,10985,10321,8427,7273,95134,8296,19767,28063,30389,20602,9223,11172,9692,11003,92081,187215,245332,245332
"China, Macao SAR",1981,MO,MAC,WPR,9290,20741,30031,30887,27628,11802,10122,8478,7530,96447,8568,19763,28331,30022,22166,9476,10862,9921,11441,93888,190335,248695,248695
"China, Macao SAR",1982,MO,MAC,WPR,9946,20642,30588,30307,29612,12886,10037,8567,7788,99197,9271,20248,29519,30465,24429,10058,10620,10130,11686,97388,196585,256692,256692
"China, Macao SAR",1983,MO,MAC,WPR,10997,20581,31578,29648,31646,14226,9992,8692,8029,102233,10328,20635,30963,31005,26932,10909,10384,10347,11896,101473,203706,266253,266253
"China, Macao SAR",1984,MO,MAC,WPR,12358,20613,32971,28821,33542,15829,9983,8831,8262,105268,11639,20832,32471,31594,29414,12052,10143,10564,12104,105871,211139,276591,276591
"China, Macao SAR",1985,MO,MAC,WPR,13896,20804,34700,27995,35250,17640,10042,8962,8478,108367,13083,20903,33986,32361,31820,13478,9905,10770,12323,110657,219024,287700,287700
"China, Macao SAR",1986,MO,MAC,WPR,15460,21242,36702,27220,36770,19611,10156,9097,8671,111525,14541,20975,35516,33205,34199,15139,9686,10949,12574,115752,227277,299491,299491
"China, Macao SAR",1987,MO,MAC,WPR,16822,22106,38928,26414,38164,21765,10303,9261,8820,114727,15825,21374,37199,33760,36719,17022,9537,11097,12822,120957,235684,311808,311808
"China, Macao SAR",1988,MO,MAC,WPR,17841,23416,41257,25549,39463,24094,10539,9420,8946,118011,16783,22270,39053,33850,39383,19160,9486,11216,13062,126157,244168,324478,324478
"China, Macao SAR",1989,MO,MAC,WPR,18492,25134,43626,24836,40300,26626,10959,9540,9096,121357,17386,23729,41115,33677,41773,21585,9596,11279,13333,131243,252600,337336,337336
"China, Macao SAR",1990,MO,MAC,WPR,18748,27288,46036,24409,40341,29330,11660,9649,9287,124676,17611,25764,43375,33368,43655,24259,9919,11278,13667,136146,260822,350227,350227
"China, Macao SAR",1991,MO,MAC,WPR,18674,29669,48343,24202,39638,31978,12678,9754,9542,127792,17522,28137,45659,32861,44843,27137,10459,11184,14108,140592,268384,362390,362390
"China, Macao SAR",1992,MO,MAC,WPR,18377,31749,50126,24237,38292,34383,13879,9841,9899,130531,17226,30527,47753,32049,44991,30093,11202,11013,14610,143958,274489,372370,372370
"China, Macao SAR",1993,MO,MAC,WPR,17911,33535,51446,24381,36554,36576,15296,9909,10327,133043,16762,32617,49379,31116,44629,32953,12231,10834,15086,146849,279892,380712,380712
"China, Macao SAR",1994,MO,MAC,WPR,17285,35264,52549,24568,34853,38468,17024,9976,10742,135631,16127,34339,50466,30398,44455,35476,13629,10629,15546,150133,285764,388779,388779
"China, Macao SAR",1995,MO,MAC,WPR,16586,36858,53444,24736,33476,40029,18890,10050,11145,138326,15415,35706,51121,29958,44396,37725,15271,10379,16018,153747,292073,396641,396641
"China, Macao SAR",1996,MO,MAC,WPR,15845,38212,54057,24975,32346,41416,20771,10137,11553,141198,14671,36711,51382,29886,44163,39899,17053,10146,16509,157656,298854,404297,404297
"China, Macao SAR",1997,MO,MAC,WPR,15056,39102,54158,25547,31167,42774,22780,10218,11964,144450,13848,37317,51165,30352,43331,42264,19007,9990,16988,161932,306382,411700,411700
"China, Macao SAR",1998,MO,MAC,WPR,14234,39497,53731,26394,29950,43979,25009,10367,12359,148058,12987,37538,50525,31202,41938,44778,21169,9941,17431,166459,314517,418776,418776
"China, Macao SAR",1999,MO,MAC,WPR,13333,39525,52858,27431,29130,44428,27460,10737,12712,151898,12146,37446,49592,32290,40666,46667,23614,10061,17868,171166,323064,425518,425518
"China, Macao SAR",2000,MO,MAC,WPR,12297,39235,51532,28769,28775,43961,30028,11411,13068,156012,11252,37001,48253,33681,39762,47735,26239,10428,18260,176105,332117,431896,431896
"China, Macao SAR",2001,MO,MAC,WPR,11236,38634,49870,30763,28861,42920,32564,12354,13444,160906,10337,36293,46630,35520,39336,48246,28935,11052,18629,181718,342624,439122,439122
"China, Macao SAR",2002,MO,MAC,WPR,10445,37728,48173,33938,29512,41588,35123,13585,13806,167552,9673,35525,45198,38140,39517,48374,31853,11902,18960,188746,356298,449665,449665
"China, Macao SAR",2003,MO,MAC,WPR,10012,36437,46449,37831,30433,40276,37613,15124,14158,175435,9323,34477,43800,41248,39920,48541,34865,13009,19267,196850,372285,462533,462533
"China, Macao SAR",2004,MO,MAC,WPR,9830,34762,44592,41583,31473,39304,39691,16975,14487,183513,9141,32966,42107,44323,40423,49077,37517,14432,19547,205319,388832,475529,475529
"China, Macao SAR",2005,MO,MAC,WPR,9869,32915,42784,44893,32704,38728,41499,18954,14813,191591,9138,31275,40413,47227,40994,49821,39859,16181,19749,213831,405422,488619,488619
"China, Macao SAR",2006,MO,MAC,WPR,10069,31094,41163,47552,34231,38425,43271,20890,15167,199536,9358,29594,38952,49769,41597,50524,42212,18182,19927,222211,421747,501863,501863
"China, Macao SAR",2007,MO,MAC,WPR,10381,29335,39716,49409,36257,38122,45113,22927,15579,207407,9699,27856,37555,51834,42530,50825,44930,20339,20191,230649,438056,515330,515330
"China, Macao SAR",2008,MO,MAC,WPR,10885,27699,38584,50392,38766,37808,46892,25227,16058,215143,10135,26118,36253,53224,43936,50753,47852,22709,20587,239061,454204,529038,529038
"China, Macao SAR",2009,MO,MAC,WPR,11585,26234,37819,50475,41678,38041,47936,27808,16720,222658,10734,24628,35362,53649,46061,50668,50331,25368,21101,247178,469836,543021,543021
"China, Macao SAR",2010,MO,MAC,WPR,12431,24888,37319,49734,45127,38852,48012,30669,17640,230034,11503,23324,34827,52944,49182,50686,52319,28174,21811,255116,485150,557297,557297
"China, Macao SAR",2011,MO,MAC,WPR,13391,23855,37246,48382,48791,39748,47301,33462,18874,236558,12301,22461,34762,51184,52964,50979,53518,31031,22752,262428,498986,571003,571003
"China, Macao SAR",2012,MO,MAC,WPR,14319,23490,37809,46854,51737,40243,46068,35726,20476,241104,13058,22426,35484,49090,56641,51020,53875,33767,23984,268377,509481,582766,582766
"China, Macao SAR",2013,MO,MAC,WPR,15057,23600,38657,45472,53921,40448,44868,37529,22296,244534,13806,22744,36550,47223,59790,50808,54225,36125,25455,273626,518160,593374,593374
"China, Macao SAR",2014,MO,MAC,WPR,15690,23878,39568,44176,55771,40864,44022,38919,24250,248002,14479,23033,37512,45587,62358,51048,54941,38082,27063,279079,527081,604167,604167
"China, Macao SAR",2015,MO,MAC,WPR,16339,24359,40698,42939,57268,41546,43330,40094,26219,251396,15095,23377,38472,44320,64322,51624,55694,39873,28843,284676,536072,615239,615239
"China, Macao SAR",2016,MO,MAC,WPR,17055,25017,42072,41731,58440,42505,42637,41193,28235,254741,15772,23812,39584,43327,65740,52459,56130,41829,30802,290287,545028,626688,626688
"China, Macao SAR",2017,MO,MAC,WPR,17930,25841,43771,40425,59336,43812,41817,42155,30474,258019,16578,24384,40962,42321,66680,53742,56135,44066,32915,295859,553878,638609,638609
"China, Macao SAR",2018,MO,MAC,WPR,18933,26881,45814,38982,60002,45410,40870,42947,32977,261188,17489,25183,42672,41228,67200,55382,55907,46347,35248,301312,562500,650991,650991
"China, Macao SAR",2019,MO,MAC,WPR,19912,28153,48065,37455,60475,47238,40038,43375,35712,264293,18390,26246,44636,40090,67327,57330,55692,48427,37798,306664,570957,663653,663653
"China, Macao SAR",2020,MO,MAC,WPR,20639,29648,50287,35857,60791,49283,39395,43532,38505,267363,19100,27558,46658,38821,67171,59559,55618,50319,40479,311967,579330,676283,676283
"China, Macao SAR",2021,MO,MAC,WPR,20716,31327,52043,34056,60595,51514,39092,43737,41252,270246,19224,29068,48292,36932,66372,61688,55607,52077,43351,316027,586273,686607,686607
"China, Macao SAR",2022,MO,MAC,WPR,20282,33141,53423,32191,59665,53821,39257,43895,43927,272756,18861,30728,49589,34802,65067,63824,55659,53630,46414,319396,592152,695168,695168
"China, Macao SAR",2023,MO,MAC,WPR,19760,34984,54744,30648,58247,56115,39822,43771,46558,275161,18418,32436,50854,33051,63680,66221,55924,54854,49658,323388,598549,704149,704149
"China, Macao SAR",2024,MO,MAC,WPR,19240,36700,55940,29522,56460,58313,40733,43412,49213,277653,17956,34066,52022,31582,62066,68589,56366,55772,53089,327464,605117,713082,713082
"China, Macao SAR",2025,MO,MAC,WPR,18841,38157,56998,28858,54361,60315,41918,42840,51936,280228,17554,35493,53047,30517,60302,70717,56954,56391,56767,331648,611876,721922,721922
"China, Macao SAR",2026,MO,MAC,WPR,18700,39186,57886,28676,52025,62003,43318,42083,54783,282888,17398,36511,53909,29967,58428,72415,57673,56701,60737,335921,618809,730610,730610
"China, Macao SAR",2027,MO,MAC,WPR,18695,39896,58591,28991,49510,63300,44890,41195,57754,285640,17399,37181,54580,29996,56461,73582,58535,56726,65013,340313,625953,739126,739126
"China, Macao SAR",2028,MO,MAC,WPR,18610,40464,59074,29760,46904,64175,46604,40266,60778,288487,17328,37717,55045,30562,54442,74200,59563,56564,69511,344842,633329,747446,747446
"China, Macao SAR",2029,MO,MAC,WPR,18447,40852,59299,30906,44322,64598,48470,39448,63728,291472,17183,38078,55261,31570,52404,74301,60820,56324,74085,349504,640976,755534,755534
"China, Macao SAR",2030,MO,MAC,WPR,18222,41001,59223,32362,41862,64554,50487,38864,66481,294610,16978,38233,55211,32914,50369,73942,62378,56106,78625,354334,648944,763371,763371
"China, Macao SAR",1950,MO,MAC,WPR,12158,16612,28770,22326,19630,15869,9101,3569,1972,72467,11475,15249,26724,18998,16934,14032,9345,5422,4143,68874,141341,196838,196838
"China, Macao SAR",1951,MO,MAC,WPR,14717,16244,30961,21466,19297,15980,9446,3837,2008,72034,13840,14999,28839,18427,16729,14125,9492,5701,4203,68677,140711,200511,200511
"China, Macao SAR",1952,MO,MAC,WPR,16643,16110,32753,20020,18598,15704,9595,4091,2076,70084,15529,14927,30456,17504,16339,13936,9525,5948,4293,67545,137629,200829,200829
"China, Macao SAR",1953,MO,MAC,WPR,17719,16504,34223,18534,17852,15335,9685,4322,2156,67884,16425,15268,31693,16501,15948,13686,9516,6143,4410,66204,134088,199998,199998
"China, Macao SAR",1954,MO,MAC,WPR,18031,17342,35373,17080,17055,14885,9718,4521,2264,65523,16675,16004,32679,15422,15537,13385,9482,6286,4555,64667,130190,198232,198232
"China, Macao SAR",1955,MO,MAC,WPR,17416,18876,36292,15675,16190,14366,9678,4720,2390,63019,16024,17419,33443,14294,15066,13043,9429,6402,4765,62999,126018,195757,195757
"China, Macao SAR",1956,MO,MAC,WPR,16206,20888,37094,14347,15229,13771,9612,4870,2544,60373,14861,19170,34031,13215,14504,12689,9362,6449,5009,61228,121601,192720,192720
"China, Macao SAR",1957,MO,MAC,WPR,15062,22706,37768,13134,14212,13112,9503,4925,2695,57581,13900,20607,34507,12233,13839,12325,9263,6415,5268,59343,116924,189199,189199
"China, Macao SAR",1958,MO,MAC,WPR,14129,24152,38281,12093,13201,12404,9277,4942,2830,54747,13179,21610,34789,11447,13093,11933,9109,6381,5504,57467,112214,185291,185291
"China, Macao SAR",1959,MO,MAC,WPR,13527,25040,38567,11457,12075,11663,8947,4901,2966,52009,12611,22232,34843,10966,12287,11512,8910,6338,5692,55705,107714,181120,181120
"China, Macao SAR",1960,MO,MAC,WPR,13093,25492,38585,11282,10929,10887,8554,4819,3100,49571,12200,22548,34748,10759,11466,11077,8683,6266,5858,54109,103680,177014,177014
"China, Macao SAR",1961,MO,MAC,WPR,13219,26424,39643,11743,10571,10525,8420,4935,3174,49368,12316,23347,35663,11091,11158,10895,8591,6294,5969,53998,103366,178672,178672
"China, Macao SAR",1962,MO,MAC,WPR,13798,27989,41787,12827,10806,10679,8579,5195,3236,51322,12741,24868,37609,11914,11300,11046,8624,6407,6031,55322,106644,186039,186039
"China, Macao SAR",1963,MO,MAC,WPR,14134,29636,43770,14155,10957,10886,8779,5414,3341,53532,13015,26488,39503,12873,11359,11295,8683,6475,6124,56809,110341,193618,193618
"China, Macao SAR",1964,MO,MAC,WPR,14222,31423,45645,15686,11049,11120,8997,5619,3476,55947,13134,28245,41379,14002,11324,11594,8738,6530,6224,58412,114359,201380,201380
"China, Macao SAR",1965,MO,MAC,WPR,14085,33331,47416,17423,11005,11398,9187,5806,3695,58514,13092,30036,43128,15335,11211,11900,8780,6604,6383,60213,118727,209278,209278
"China, Macao SAR",1966,MO,MAC,WPR,13780,35160,48940,19514,10847,11700,9357,6044,3920,61382,12892,31711,44603,16958,11096,12176,8867,6687,6523,62307,123689,217232,217232
"China, Macao SAR",1967,MO,MAC,WPR,13355,36681,50036,22063,10633,12031,9532,6308,4097,64664,12533,33103,45636,19023,10973,12439,9011,6762,6610,64818,129482,225151,225151
"China, Macao SAR",1968,MO,MAC,WPR,12818,37839,50657,24981,10432,12389,9733,6550,4285,68370,11982,34115,46097,21541,10826,12711,9205,6816,6710,67809,136179,232929,232929
"China, Macao SAR",1969,MO,MAC,WPR,12138,38601,50739,28199,10356,12699,9981,6787,4486,72508,11180,34719,45899,24480,10701,12987,9465,6843,6791,71267,143775,240416,240416
"China, Macao SAR",2031,MO,MAC,WPR,17960,40867,58827,34048,39628,64035,52653,38625,68934,297923,16737,38141,54878,34482,48365,73166,64280,56024,83007,359324,657247,770958,770958
"China, Macao SAR",2032,MO,MAC,WPR,17666,40461,58127,35876,37714,63051,54916,38810,71049,301416,16466,37811,54277,36173,46447,72050,66500,56123,87164,364457,665873,778280,778280
"China, Macao SAR",2033,MO,MAC,WPR,17358,39856,57214,37716,36173,61638,57190,39383,72857,304957,16183,37294,53477,37888,44702,70668,68890,56399,91133,369680,674637,785332,785332
"China, Macao SAR",2034,MO,MAC,WPR,17058,39174,56232,39433,35052,59860,59376,40291,74418,308430,15910,36684,52594,39513,43232,69063,71252,56852,94954,374866,683296,792125,792125
"China, Macao SAR",2035,MO,MAC,WPR,16789,38554,55343,40886,34388,57775,61365,41461,75807,311682,15661,36083,51744,40941,42169,67296,73376,57447,98676,379905,691587,798680,798680
"China, Macao SAR",2036,MO,MAC,WPR,16561,38150,54711,41913,34211,55451,63040,42847,77102,314564,15451,35687,51138,41960,41625,65433,75073,58170,102354,384615,699179,805019,805019
"China, Macao SAR",2037,MO,MAC,WPR,16389,37851,54240,42625,34525,52945,64332,44394,78350,317171,15291,35417,50708,42634,41650,63478,76233,59039,105997,389031,706202,811150,811150
"China, Macao SAR",2038,MO,MAC,WPR,16295,37459,53754,43195,35288,50354,65201,46089,79586,319713,15205,35064,50269,43160,42216,61461,76853,60070,109619,393379,713092,817113,817113
"China, Macao SAR",2039,MO,MAC,WPR,16290,36998,53288,43579,36438,47779,65621,47924,80816,322157,15203,34643,49846,43528,43228,59427,76956,61325,113189,397653,719810,822949,822949
"China, Macao SAR",2040,MO,MAC,WPR,16374,36506,52880,43729,37892,45331,65585,49910,82055,324502,15282,34192,49474,43679,44568,57398,76601,62882,116678,401806,726308,828668,828668
"China, Macao SAR",2041,MO,MAC,WPR,16544,36013,52557,43598,39576,43110,65074,52040,83324,326722,15439,33741,49180,43589,46138,55399,75833,64787,120086,405832,732554,834288,834288
"China, Macao SAR",2042,MO,MAC,WPR,16803,35548,52351,43192,41397,41200,64100,54268,84647,328804,15680,33315,48995,43259,47830,53486,74730,66995,123387,409687,738491,839836,839836
"China, Macao SAR",2043,MO,MAC,WPR,17133,35147,52280,42586,43238,39670,62707,56510,86040,330751,15986,32945,48931,42746,49541,51749,73356,69374,126599,413365,744116,845330,845330
"China, Macao SAR",2044,MO,MAC,WPR,17521,34848,52369,41906,44953,38556,60952,58662,87515,332544,16347,32667,49014,42136,51166,50284,71763,71723,129771,416843,749387,850776,850776
"China, Macao SAR",2045,MO,MAC,WPR,17943,34662,52605,41285,46404,37897,58892,60619,89087,334184,16742,32495,49237,41533,52592,49225,70016,73840,132934,420140,754324,856168,856168
"China, Macao SAR",2046,MO,MAC,WPR,18385,34603,52988,40884,47433,37724,56590,62272,90780,335683,17150,32444,49594,41141,53610,48682,68161,75533,136103,423230,758913,861486,861486
"China, Macao SAR",2047,MO,MAC,WPR,18817,34690,53507,40582,48142,38039,54111,63543,92609,337026,17556,32528,50084,40868,54282,48715,66217,76693,139322,426097,763123,866719,866719
"China, Macao SAR",2048,MO,MAC,WPR,19223,34926,54149,40193,48707,38803,51548,64405,94601,338257,17931,32749,50680,40516,54815,49282,64210,77312,142631,428766,767023,871846,871846
"China, Macao SAR",2049,MO,MAC,WPR,19561,35310,54871,39734,49092,39949,49003,64830,96758,339366,18247,33105,51352,40098,55179,50285,62190,77424,146061,431237,770603,876823,876823
"China, Macao SAR",2050,MO,MAC,WPR,19847,35816,55663,39241,49243,41399,46579,64806,99113,340381,18515,33578,52093,39643,55330,51630,60174,77077,149672,433526,773907,881666,881666
Morocco,1970,MA,MAR,EMR,1403582,2236982,3640564,1373573,899582,805662,457167,255605,216165,4007754,1362566,2139691,3502257,1374317,972862,798600,450786,266234,260980,4123779,8131533,15274351,15274351
Morocco,1971,MA,MAR,EMR,1429840,2291343,3721183,1448751,901702,816696,486086,256354,221607,4131196,1387140,2191767,3578907,1440842,984003,810940,478028,264459,267731,4246003,8377199,15677300,15677300
Morocco,1972,MA,MAR,EMR,1457020,2341178,3798198,1521439,905315,825180,517602,258965,226458,4254959,1412826,2243458,3656284,1510528,993950,821491,508749,263869,273409,4371996,8626955,16081438,16081438
Morocco,1973,MA,MAR,EMR,1485099,2387904,3873003,1589385,912909,831442,550446,264090,230612,4378884,1439580,2295817,3735397,1581435,1004287,831103,542132,265505,277705,4502167,8881051,16489452,16489452
Morocco,1974,MA,MAR,EMR,1513842,2432926,3946768,1649432,933270,835145,581792,272334,233941,4505914,1466925,2345001,3811926,1647040,1026065,839301,573696,271137,280528,4637767,9143681,16902383,16902383
Morocco,1975,MA,MAR,EMR,1542830,2478707,4021537,1702444,967056,836586,610592,283863,236519,4637060,1494428,2392953,3887381,1706740,1060340,846611,602467,281133,282052,4779343,9416403,17325325,17325325
Morocco,1976,MA,MAR,EMR,1570970,2526405,4097375,1753202,1007184,836521,636922,298604,238428,4770861,1521024,2440993,3962017,1767007,1099757,853229,628450,295380,282448,4926271,9697132,17756516,17756516
Morocco,1977,MA,MAR,EMR,1597381,2578471,4175852,1808443,1052876,835703,660563,316056,239905,4913546,1545959,2490828,4036787,1829145,1143629,860535,651444,313563,281984,5080300,9993846,18206472,18206472
Morocco,1978,MA,MAR,EMR,1623082,2635760,4258842,1868361,1104520,834738,681368,335860,241380,5066227,1570125,2544118,4114243,1891158,1192244,869215,671657,335092,281186,5240552,10306779,18679859,18679859
Morocco,1979,MA,MAR,EMR,1649815,2694607,4344422,1927830,1161164,834188,699468,357917,243329,5223896,1595176,2599353,4194529,1951566,1245033,878614,689687,359203,280712,5404815,10628711,19167661,19167661
Morocco,1980,MA,MAR,EMR,1678669,2755499,4434168,1989866,1222698,834856,714863,381565,246163,5390011,1622528,2656683,4279211,2011528,1302296,889115,705926,384971,281214,5575050,10965061,19678444,19678444
Morocco,1981,MA,MAR,EMR,1710521,2816310,4526831,2052005,1288604,837234,727769,406959,249933,5562504,1653105,2714846,4367951,2070898,1364205,900116,720553,412409,282803,5750984,11313488,20208260,20208260
Morocco,1982,MA,MAR,EMR,1745001,2874056,4619057,2110623,1358242,841729,738276,434396,254773,5738039,1686466,2771680,4458146,2129074,1431047,910779,733619,441473,285533,5931525,11669564,20746765,20746765
Morocco,1983,MA,MAR,EMR,1777652,2932870,4710522,2167979,1427835,851137,746654,462764,261002,5917371,1717432,2829360,4546792,2183645,1499217,924059,745423,470496,289856,6112696,12030067,21287381,21287381
Morocco,1984,MA,MAR,EMR,1803513,2993440,4796953,2223355,1489570,873071,753177,490389,269030,6098592,1740768,2888428,4629196,2233976,1559594,948386,756553,497616,296405,6292530,12391122,21817271,21817271
Morocco,1985,MA,MAR,EMR,1819568,3054572,4874140,2276782,1544249,907886,757844,516408,279129,6282298,1754862,2948114,4702976,2283311,1613098,983953,767273,522542,305482,6475659,12757957,22335077,22335077
Morocco,1986,MA,MAR,EMR,1824570,3114391,4938961,2324454,1594932,949233,761573,541405,291275,6462872,1758119,3006512,4764631,2331227,1663629,1023177,777879,545087,316972,6657971,13120843,22824446,22824446
Morocco,1987,MA,MAR,EMR,1817611,3172255,4989866,2365183,1642466,995670,765037,565281,305468,6639105,1749789,3062398,4812187,2377475,1711893,1064760,788680,565219,330746,6838773,13477878,23279935,23279935
Morocco,1988,MA,MAR,EMR,1800640,3228693,5029333,2407129,1687935,1046694,768263,587145,321790,6818956,1732710,3114860,4847570,2426060,1759178,1109467,799784,583567,346675,7024731,13843687,23720590,23720590
Morocco,1989,MA,MAR,EMR,1777952,3280601,5058553,2450938,1730936,1101536,771706,606886,340322,7002324,1710495,3161368,4871863,2477139,1804855,1157044,811205,600507,364611,7215361,14217685,24148104,24148104
Morocco,1990,MA,MAR,EMR,1754326,3326022,5080348,2496494,1773043,1159636,776159,624416,360912,7190660,1687791,3200569,4888360,2530006,1850300,1207574,822984,616280,384307,7411451,14602111,24570814,24570814
Morocco,1991,MA,MAR,EMR,1735601,3363027,5098628,2539764,1812870,1220660,782327,640032,383573,7379226,1669207,3231745,4900952,2582529,1894095,1260911,834981,630923,405836,7609275,14988501,24988083,24988083
Morocco,1992,MA,MAR,EMR,1722626,3391175,5113801,2580879,1850590,1284106,790442,653687,408350,7568054,1655508,3254648,4910156,2634016,1936603,1317544,846780,644473,429245,7808661,15376715,25400676,25400676
Morocco,1993,MA,MAR,EMR,1711147,3409533,5120680,2624532,1887359,1347394,802711,665105,434545,7761646,1643943,3267493,4911436,2686606,1978834,1376222,860276,657173,453900,8013011,15774657,25806777,25806777
Morocco,1994,MA,MAR,EMR,1700395,3416601,5116996,2671158,1922956,1403950,826335,674351,461068,7959818,1633751,3268923,4902674,2740641,2020406,1429295,883599,669256,478875,8222072,16181890,26201551,26201551
Morocco,1995,MA,MAR,EMR,1688935,3411900,5100835,2727007,1966199,1456016,860436,678002,487225,8174885,1624162,3263302,4887464,2791238,2067588,1476994,916177,679771,504100,8435868,16610753,26599048,26599048
Morocco,1996,MA,MAR,EMR,1672144,3402385,5074529,2789264,2017475,1509634,898966,676833,512661,8404833,1609149,3257855,4867004,2837423,2119451,1526688,950642,688824,529697,8652725,17057558,26999093,26999093
Morocco,1997,MA,MAR,EMR,1653217,3393064,5046281,2849691,2068035,1563908,942456,675507,536962,8636559,1589525,3252642,4842167,2883227,2168996,1579774,986772,698251,555091,8872111,17508670,27397118,27397118
Morocco,1998,MA,MAR,EMR,1638682,3380914,5019596,2905210,2117950,1616706,991538,674599,559841,8865844,1571574,3244120,4815694,2926382,2216720,1633979,1025452,708318,579832,9090683,17956527,27791825,27791825
Morocco,1999,MA,MAR,EMR,1628598,3366230,4994828,2953520,2166865,1666986,1046130,674581,581088,9089170,1555970,3231383,4787353,2965671,2262451,1687735,1067183,719067,603539,9305646,18394816,28176997,28176997
Morocco,2000,MA,MAR,EMR,1620951,3350799,4971750,2995131,2213935,1715140,1105932,676857,600407,9307402,1542722,3213955,4756677,3001801,2305501,1741299,1112067,731909,625997,9518574,18825976,28554415,28554415
Morocco,2001,MA,MAR,EMR,1614860,3335153,4950013,3032803,2259152,1760546,1170265,682378,618376,9523520,1532520,3191667,4724187,3036281,2346449,1793859,1160316,747060,648411,9732376,19255896,28930097,28930097
Morocco,2002,MA,MAR,EMR,1606715,3321268,4927983,3067085,2302738,1802693,1237630,691311,636104,9737561,1522804,3167792,4690596,3068637,2386354,1843380,1212549,762253,672495,9945668,19683229,29301817,29301817
Morocco,2003,MA,MAR,EMR,1594513,3310526,4905039,3095452,2344866,1841322,1305992,704850,653299,9945781,1512835,3145099,4657934,3096106,2426022,1887686,1268338,776909,697467,10152528,20098309,29661270,29661270
Morocco,2004,MA,MAR,EMR,1585603,3294546,4880149,3129262,2392765,1873847,1368915,724870,668835,10158494,1510583,3120738,4631321,3120471,2473381,1926737,1326317,794925,721335,10363166,20521660,30033125,30033125
Morocco,2005,MA,MAR,EMR,1583313,3269740,4853053,3165661,2446978,1905334,1427123,758332,683760,10387188,1515651,3094239,4609890,3140085,2526211,1962779,1385441,822124,745133,10581773,20968961,30431902,30431902
Morocco,2006,MA,MAR,EMR,1585318,3241707,4827025,3190124,2499432,1940302,1484712,805435,700422,10620427,1522482,3067574,4590056,3150088,2574389,1996580,1445089,857119,772251,10795516,21415943,30833022,30833022
Morocco,2007,MA,MAR,EMR,1593800,3212994,4806794,3204665,2550141,1976266,1538996,858854,719230,10848152,1533689,3040811,4574500,3152053,2619235,2029217,1504453,895537,802688,11003183,21851335,31232633,31232633
Morocco,2008,MA,MAR,EMR,1608549,3187353,4795902,3209588,2599464,2014613,1589085,917030,738787,11068567,1548798,3017098,4565896,3147305,2661045,2063692,1561671,938291,832618,11204622,22273189,31634992,31634992
Morocco,2009,MA,MAR,EMR,1628825,3168633,4797458,3204219,2646891,2055628,1635194,979178,758924,11280034,1567230,3000678,4567908,3134494,2699590,2100626,1615709,985737,861323,11397479,22677513,32042877,32042877
Morocco,2010,MA,MAR,EMR,1653197,3158449,4811646,3191278,2693247,2098698,1677708,1043841,781253,11486025,1588975,2992689,4581664,3114673,2736228,2139749,1667018,1036308,891558,11585534,23071559,32464865,32464865
Morocco,2011,MA,MAR,EMR,1679843,3156445,4836288,3173418,2738791,2143291,1717175,1109793,806923,11689391,1613339,2992347,4605686,3090315,2770925,2180820,1715721,1089429,925123,11772333,23461724,32903699,32903699
Morocco,2012,MA,MAR,EMR,1706861,3159128,4865989,3154568,2781142,2189720,1754281,1175721,836316,11891748,1638362,2996928,4635290,3065996,2801510,2224040,1760706,1145800,961106,11959158,23850906,33352169,33352169
Morocco,2013,MA,MAR,EMR,1732058,3166332,4898390,3137209,2817398,2238493,1789576,1240155,869568,12092399,1661710,3006557,4668267,3044640,2825807,2269671,1801252,1205197,997898,12144465,24236864,33803527,33803527
Morocco,2014,MA,MAR,EMR,1750581,3182854,4933435,3116427,2847797,2288949,1824638,1301758,907805,12287374,1678522,3025749,4704271,3021697,2843914,2316451,1838854,1264908,1037695,12323519,24610893,34248603,34248603
Morocco,2015,MA,MAR,EMR,1760629,3206953,4967582,3089533,2874204,2340330,1860814,1360108,952033,12477022,1687010,3052463,4739473,2994922,2856801,2363258,1874916,1323471,1083006,12496374,24973396,34680458,34680458
Morocco,2016,MA,MAR,EMR,1759658,3237080,4996738,3063282,2898104,2392166,1897285,1415255,1002209,12668301,1685206,3084297,4769503,2969578,2866905,2410482,1909464,1381933,1134370,12672732,25341033,35107264,35107264
Morocco,2017,MA,MAR,EMR,1749961,3274140,5024101,3038033,2915943,2443867,1934479,1467276,1057747,12857345,1675231,3121476,4796707,2945102,2872425,2456842,1943630,1440506,1191454,12849959,25707304,35528115,35528115
Morocco,2018,MA,MAR,EMR,1736278,3314805,5051083,3011242,2922335,2494969,1974556,1516191,1116938,13036231,1661049,3160613,4821662,2920151,2868262,2500015,1979837,1497856,1252407,13018528,26054759,35927511,35927511
Morocco,2019,MA,MAR,EMR,1718410,3353957,5072367,2988634,2917479,2545114,2017548,1561751,1178891,13209417,1642718,3196515,4839233,2900720,2854166,2540355,2018729,1552699,1316718,13183387,26392804,36304408,36304408
Morocco,2020,MA,MAR,EMR,1697962,3390208,5088170,2983841,2909935,2593492,2060781,1598710,1240024,13386783,1623258,3228163,4851421,2897040,2839604,2580406,2059600,1602050,1383691,13362391,26749174,36688772,36688772
Morocco,2021,MA,MAR,EMR,1679099,3418468,5097567,2994566,2901358,2639894,2103897,1628631,1299758,13568104,1606203,3252235,4858438,2906206,2825986,2619095,2101907,1646134,1453157,13552485,27120589,37076584,37076584
Morocco,2022,MA,MAR,EMR,1661015,3437996,5099011,3012029,2892909,2681184,2147310,1655328,1364596,13753356,1590077,3268850,4858927,2920136,2814625,2653326,2145705,1685536,1527344,13746672,27500028,37457971,37457971
Morocco,2023,MA,MAR,EMR,1641150,3451423,5092573,3037704,2889287,2714943,2191121,1679216,1433133,13945404,1572374,3280978,4853352,2939931,2810671,2681992,2191410,1719868,1604844,13948716,27894120,37840044,37840044
Morocco,2024,MA,MAR,EMR,1623111,3452967,5076078,3071310,2884993,2744039,2236247,1704615,1500772,14141976,1555743,3283530,4839273,2967066,2807050,2705774,2238447,1752456,1683336,14154129,28296105,38211459,38211459
Morocco,2025,MA,MAR,EMR,1606583,3442568,5049151,3110976,2878215,2771364,2282163,1732351,1567932,14343001,1540070,3276036,4816106,2999775,2801916,2726772,2286198,1784676,1763703,14363040,28706041,38571289,38571289
Morocco,2026,MA,MAR,EMR,1590936,3422021,5012957,3154302,2871253,2795987,2328655,1762149,1635249,14547595,1524997,3259682,4784679,3035560,2796867,2744189,2334204,1816553,1847562,14574935,29122530,38920171,38920171
Morocco,2027,MA,MAR,EMR,1576425,3393595,4970020,3202364,2864967,2814981,2375211,1793967,1702504,14753994,1511058,3236066,4747124,3075091,2791597,2756907,2381409,1849008,1934374,14788386,29542380,39259527,39259527
Morocco,2028,MA,MAR,EMR,1563584,3359673,4923257,3252750,2862219,2827138,2421370,1828407,1767936,14959820,1498656,3207362,4706018,3115955,2788566,2764979,2427029,1884098,2020634,15001261,29961081,39590353,39590353
Morocco,2029,MA,MAR,EMR,1552163,3323442,4875605,3299955,2866400,2832184,2466967,1865361,1831158,15162025,1487548,3176345,4663893,3153366,2791519,2767298,2471174,1922231,2105276,15210864,30372889,39912385,39912385
Morocco,2030,MA,MAR,EMR,1542964,3286082,4829046,3340955,2878360,2830503,2511370,1904192,1893645,15359025,1478557,3143958,4622515,3185648,2800984,2763142,2513293,1962514,2190230,15415811,30774836,40226395,40226395
Morocco,1950,MA,MAR,EMR,741588,1065637,1807225,979712,611174,391801,341911,196401,115947,2636946,725910,1073078,1798988,980489,625671,394855,356270,205981,139785,2703051,5339997,8946209,8946209
Morocco,1951,MA,MAR,EMR,795680,1074110,1869790,991176,647343,391657,345157,202770,118628,2696731,776494,1081042,1857536,989920,662679,395126,360407,214055,142356,2764543,5461274,9188594,9188594
Morocco,1952,MA,MAR,EMR,850279,1086821,1937100,998826,685438,393652,347737,209966,120232,2755851,829394,1091559,1920953,995777,701054,397596,363318,222967,144231,2824943,5580794,9438849,9438849
Morocco,1953,MA,MAR,EMR,903969,1106873,2010842,1002736,723256,398330,349197,217431,121542,2812492,883148,1107445,1990593,998300,738593,402930,364714,232277,145957,2882771,5695263,9696704,9696704
Morocco,1954,MA,MAR,EMR,949094,1143095,2092189,1003875,758409,406912,348888,224632,123511,2866227,928150,1138896,2067046,998821,772858,412520,364229,241452,148286,2938166,5804393,9963626,9963626
Morocco,1955,MA,MAR,EMR,985759,1195828,2181587,1003212,789988,420023,346896,231282,126483,2917884,963796,1186725,2150521,998432,803037,426964,362087,250157,151492,2992169,5910053,10242168,10242168
Morocco,1956,MA,MAR,EMR,1021151,1256914,2278065,1001608,817958,437471,343309,237480,130317,2968143,998127,1242269,2240396,997668,829020,446053,358365,258455,155516,3045077,6013220,10531688,10531688
Morocco,1957,MA,MAR,EMR,1056388,1324337,2380725,1000129,842154,458843,338406,243246,135033,3017811,1032237,1303758,2335995,997360,850556,469502,353288,266345,160404,3097455,6115266,10831987,10831987
Morocco,1958,MA,MAR,EMR,1090618,1397457,2488075,999059,861699,483326,333098,248422,140315,3065919,1065294,1370653,2435947,997643,867077,496278,347782,273527,165991,3148298,6214217,11138237,11138237
Morocco,1959,MA,MAR,EMR,1123744,1475086,2598830,999663,877087,510532,328888,252854,145656,3114680,1097251,1442074,2539325,999522,879605,525447,343437,279598,171988,3199597,6314277,11452433,11452433
Morocco,1960,MA,MAR,EMR,1155111,1555589,2710700,1003008,888383,539412,326618,256177,150732,3164330,1127487,1516686,2644173,1003313,888393,555632,341148,284067,178020,3250573,6414903,11769774,11769774
Morocco,1961,MA,MAR,EMR,1185017,1633519,2818536,1005515,897207,570325,326036,259762,155926,3214771,1156114,1587556,2743670,1011547,896949,585150,338781,287838,184468,3304733,6519504,12081713,12081713
Morocco,1962,MA,MAR,EMR,1214598,1711510,2926108,1009241,904511,604082,327470,263669,161467,3270440,1184642,1658012,2842654,1023782,906339,615706,337079,291051,191595,3365552,6635992,12404757,12404757
Morocco,1963,MA,MAR,EMR,1241605,1788383,3029988,1016610,908709,638401,331194,266787,167321,3329022,1210821,1727599,2938420,1039408,914902,645869,337013,292816,199247,3429255,6758277,12726686,12726686
Morocco,1964,MA,MAR,EMR,1265386,1856505,3121891,1035581,910129,670907,338119,268606,173796,3397138,1233777,1787137,3020914,1067514,923645,673261,339584,292736,207581,3504321,6901459,13044254,13044254
Morocco,1965,MA,MAR,EMR,1287962,1921108,3209070,1072016,909263,700899,349192,268366,180768,3480504,1255497,1843576,3099073,1107695,931487,699504,347554,290558,216425,3593223,7073727,13381880,13381880
Morocco,1966,MA,MAR,EMR,1310612,1986973,3297585,1118580,906945,728270,364319,266277,188084,3572475,1276760,1903206,3179966,1152558,938703,724296,360794,286478,225660,3688489,7260964,13738502,13738502
Morocco,1967,MA,MAR,EMR,1332956,2053805,3386761,1172950,904107,752653,383143,262875,195641,3671369,1297344,1965325,3262669,1201428,945997,746741,378712,280906,235178,3788962,7460331,14109755,14109755
Morocco,1968,MA,MAR,EMR,1355610,2118219,3473829,1234201,901489,773701,405247,259272,203116,3777026,1318069,2026105,3344174,1254797,954041,766377,400363,274887,244583,3895048,7672074,14490077,14490077
Morocco,1969,MA,MAR,EMR,1379115,2178772,3557887,1301235,899666,791344,430167,256576,210039,3889027,1339736,2083763,3423499,1312436,962983,783506,424685,269676,253280,4006566,7895593,14876982,14876982
Morocco,2031,MA,MAR,EMR,1535290,3251072,4786362,3371544,2897371,2823879,2554140,1944314,1956468,15547716,1471002,3113401,4584403,3209797,2815769,2754394,2552415,2004335,2276524,15613234,31160950,40531718,40531718
Morocco,2032,MA,MAR,EMR,1528369,3218453,4746822,3392292,2919979,2817512,2593697,1985880,2019493,15728853,1464158,3084349,4548507,3226654,2833086,2746640,2587294,2047941,2362587,15804202,31533055,40828386,40828386
Morocco,2033,MA,MAR,EMR,1523273,3186168,4709441,3405942,2945874,2814412,2627639,2029238,2082020,15905125,1459071,3054583,4513654,3238947,2853080,2743144,2616286,2093593,2446318,15991368,31896493,41119588,41119588
Morocco,2034,MA,MAR,EMR,1520316,3157099,4677415,3407758,2979651,2810650,2657044,2073883,2144676,16073662,1456069,3027160,4483229,3241674,2880377,2739971,2640459,2140469,2528619,16171569,32245231,41405880,41405880
Morocco,2035,MA,MAR,EMR,1518061,3131741,4649802,3397689,3019461,2804452,2684796,2119397,2208673,16234468,1453741,3002787,4456528,3234381,2913225,2735304,2661906,2188048,2611592,16344456,32578924,41685255,41685255
Morocco,2036,MA,MAR,EMR,1516918,3108762,4625680,3377519,3062925,2798103,2709974,2165598,2274497,16388616,1452481,2980427,4432908,3218253,2949143,2730725,2679870,2235943,2696845,16510779,32899395,41957986,41957986
Morocco,2037,MA,MAR,EMR,1517738,3087649,4605387,3349510,3111102,2792428,2729675,2211987,2342076,16536778,1453114,2959893,4413007,3194872,2988787,2725929,2693227,2283144,2784821,16670780,33207558,42225957,42225957
Morocco,2038,MA,MAR,EMR,1518421,3070008,4588429,3316030,3161596,2790255,2742686,2258045,2410492,16679104,1453626,2942624,4396250,3166412,3029764,2723353,2702005,2328840,2874226,16824600,33503704,42488389,42488389
Morocco,2039,MA,MAR,EMR,1517658,3055911,4573569,3280249,3208947,2794935,2748722,2303571,2479395,16815819,1452787,2928717,4381504,3135639,3067297,2726715,2705110,2373116,2964528,16972405,33788224,42743296,42743296
Morocco,2040,MA,MAR,EMR,1516676,3044713,4561389,3243331,3250145,2807328,2748159,2348003,2549604,16946570,1451781,2917585,4369366,3103491,3099724,2736533,2701832,2415466,3056703,17113749,34060319,42991078,42991078
Morocco,2041,MA,MAR,EMR,1516028,3036131,4552159,3208744,3281008,2826709,2742781,2390962,2621717,17071921,1451068,2908940,4360008,3073162,3124048,2751630,2694031,2454970,3151202,17249043,34320964,43233124,43233124
Morocco,2042,MA,MAR,EMR,1514510,3030254,4544764,3176526,3302096,2849672,2737688,2430923,2695834,17192739,1449458,2902884,4352342,3044323,3141107,2769242,2687202,2490349,3246798,17379021,34571760,43468863,43468863
Morocco,2043,MA,MAR,EMR,1511595,3026050,4537645,3144640,3316134,2875901,2735786,2465559,2771716,17309736,1446506,2898454,4344960,3014772,3153617,2789508,2684539,2519950,3341835,17504221,34813957,43696563,43696563
Morocco,2044,MA,MAR,EMR,1507869,3022528,4530397,3115947,3318413,2909962,2733218,2495922,2849518,17422980,1442765,2894742,4337507,2987548,3156593,2817025,2682144,2544826,3436447,17624583,35047563,43915467,43915467
Morocco,2045,MA,MAR,EMR,1503294,3019485,4522779,3090940,3308873,2950007,2728313,2524844,2929932,17532909,1438160,2891536,4329696,2963360,3149586,2850056,2678277,2567079,3532277,17740635,35273544,44126016,44126016
Morocco,2046,MA,MAR,EMR,1496871,3017875,4514746,3068298,3289284,2993688,2723319,2551468,3013285,17639342,1431789,2889682,4321471,2941175,3133774,2886137,2674517,2586012,3630580,17852195,35491537,44327743,44327743
Morocco,2047,MA,MAR,EMR,1488893,3017348,4506241,3047504,3261884,3042049,2718985,2572959,3099044,17742425,1423980,2888809,4312789,2920805,3110734,2925916,2670541,2600519,3730791,17959306,35701731,44520762,44520762
Morocco,2048,MA,MAR,EMR,1479915,3015287,4495202,3030169,3229033,3092698,2718046,2588066,3185862,17843874,1415235,2886484,4301719,2903697,3082626,2967012,2668736,2610576,3830958,18063605,35907479,44704401,44704401
Morocco,2049,MA,MAR,EMR,1470351,3010968,4481319,3016356,3193878,3140221,2723796,2596496,3273249,17943996,1405955,2882007,4287962,2889932,3052203,3004678,2672771,2615097,3930733,18165414,36109410,44878690,44878690
Morocco,2050,MA,MAR,EMR,1460675,3005577,4466252,3005428,3157575,3181630,2737090,2598654,3361483,18041860,1396591,2876502,4273093,2878936,3020401,3037256,2683160,2613408,4030622,18263783,36305643,45044990,45044990
Monaco,1970,MC,MCO,EUR,656,1160,1816,1344,1389,1394,1421,1588,2106,9242,628,1099,1727,1431,1527,1566,1700,2046,3214,11484,20726,24270,24270
Monaco,1971,MC,MCO,EUR,683,1161,1844,1359,1445,1396,1497,1530,2156,9383,654,1096,1750,1436,1603,1560,1750,2001,3278,11628,21011,24610,24610
Monaco,1972,MC,MCO,EUR,660,1190,1850,1356,1502,1407,1569,1479,2214,9527,638,1124,1762,1425,1673,1553,1811,1940,3354,11756,21283,24889,24889
Monaco,1973,MC,MCO,EUR,584,1233,1817,1355,1558,1416,1628,1439,2268,9664,572,1165,1737,1417,1727,1555,1862,1888,3432,11881,21545,25102,25102
Monaco,1974,MC,MCO,EUR,495,1268,1763,1354,1605,1437,1673,1414,2323,9806,488,1192,1680,1411,1779,1565,1898,1840,3520,12013,21819,25262,25262
Monaco,1975,MC,MCO,EUR,480,1285,1765,1356,1646,1464,1704,1414,2365,9949,472,1215,1687,1406,1818,1596,1912,1812,3578,12122,22071,25524,25524
Monaco,1976,MC,MCO,EUR,541,1291,1832,1382,1671,1496,1713,1453,2373,10088,522,1226,1748,1426,1840,1635,1913,1810,3603,12227,22315,25898,25898
Monaco,1977,MC,MCO,EUR,589,1282,1871,1419,1685,1539,1708,1508,2381,10240,562,1226,1788,1457,1854,1685,1900,1829,3617,12342,22582,26242,26242
Monaco,1978,MC,MCO,EUR,621,1272,1893,1451,1693,1588,1701,1574,2388,10395,582,1229,1811,1477,1861,1737,1887,1867,3622,12451,22846,26553,26553
Monaco,1979,MC,MCO,EUR,612,1274,1886,1482,1693,1648,1694,1643,2402,10562,575,1223,1798,1501,1861,1804,1881,1913,3621,12581,23143,26834,26834
Monaco,1980,MC,MCO,EUR,566,1290,1856,1496,1698,1721,1689,1709,2419,10732,545,1215,1760,1511,1872,1888,1872,1961,3622,12726,23458,27076,27076
Monaco,1981,MC,MCO,EUR,512,1282,1794,1507,1703,1797,1688,1767,2458,10920,497,1200,1697,1521,1883,1971,1867,2002,3631,12875,23795,27284,27284
Monaco,1982,MC,MCO,EUR,520,1242,1762,1557,1710,1875,1689,1809,2481,11121,509,1159,1668,1562,1882,2043,1862,2029,3641,13019,24140,27573,27573
Monaco,1983,MC,MCO,EUR,594,1213,1807,1603,1746,1931,1701,1835,2487,11303,581,1133,1714,1598,1898,2091,1870,2040,3664,13161,24464,27985,27985
Monaco,1984,MC,MCO,EUR,660,1212,1872,1623,1789,1977,1740,1853,2500,11482,645,1140,1785,1608,1918,2120,1896,2046,3691,13279,24761,28407,28407
Monaco,1985,MC,MCO,EUR,703,1226,1929,1638,1832,2007,1794,1859,2513,11643,687,1153,1840,1612,1940,2142,1938,2043,3725,13400,25043,28807,28807
Monaco,1986,MC,MCO,EUR,727,1243,1970,1632,1881,2032,1861,1851,2544,11801,704,1182,1886,1599,1971,2159,1996,2036,3748,13509,25310,29171,29171
Monaco,1987,MC,MCO,EUR,718,1278,1996,1620,1928,2058,1936,1842,2586,11970,693,1216,1909,1584,1998,2180,2064,2019,3789,13634,25604,29500,29500
Monaco,1988,MC,MCO,EUR,687,1318,2005,1612,1962,2087,2002,1836,2632,12131,661,1260,1921,1578,2013,2204,2130,2003,3819,13747,25878,29802,29802
Monaco,1989,MC,MCO,EUR,649,1329,1978,1621,1988,2119,2067,1837,2687,12319,625,1279,1904,1579,2025,2230,2191,2004,3854,13883,26202,30078,30078
Monaco,1990,MC,MCO,EUR,633,1317,1950,1638,1990,2157,2118,1845,2727,12475,609,1279,1888,1576,2018,2268,2245,2011,3887,14005,26480,30329,30329
Monaco,1991,MC,MCO,EUR,668,1315,1983,1639,1995,2182,2169,1861,2751,12597,640,1274,1914,1568,2006,2284,2286,2020,3903,14067,26664,30564,30564
Monaco,1992,MC,MCO,EUR,726,1317,2043,1605,2044,2185,2214,1872,2763,12683,692,1264,1956,1540,2033,2274,2325,2040,3910,14122,26805,30794,30794
Monaco,1993,MC,MCO,EUR,770,1324,2094,1564,2090,2189,2252,1892,2780,12767,735,1258,1993,1497,2060,2266,2361,2059,3926,14169,26936,31024,31024
Monaco,1994,MC,MCO,EUR,803,1335,2138,1538,2120,2192,2288,1926,2800,12864,770,1259,2029,1465,2074,2261,2395,2077,3950,14222,27086,31253,31253
Monaco,1995,MC,MCO,EUR,817,1364,2181,1503,2152,2200,2320,1961,2820,12956,788,1276,2064,1422,2093,2259,2422,2096,3983,14275,27231,31482,31482
Monaco,1996,MC,MCO,EUR,807,1414,2221,1467,2165,2232,2347,2002,2846,13059,782,1307,2089,1383,2107,2271,2436,2123,4021,14341,27400,31719,31719
Monaco,1997,MC,MCO,EUR,800,1458,2258,1448,2146,2285,2365,2045,2885,13174,772,1337,2109,1352,2114,2297,2440,2158,4064,14425,27599,31968,31968
Monaco,1998,MC,MCO,EUR,799,1484,2283,1439,2119,2346,2373,2090,2940,13307,758,1359,2117,1329,2102,2320,2441,2201,4101,14494,27801,32209,32209
Monaco,1999,MC,MCO,EUR,772,1502,2274,1414,2117,2396,2374,2147,3000,13448,722,1381,2103,1306,2071,2364,2429,2257,4141,14568,28016,32394,32394
Monaco,2000,MC,MCO,EUR,734,1520,2254,1394,2087,2420,2368,2219,3051,13539,682,1402,2084,1298,2000,2391,2414,2322,4167,14592,28131,32465,32465
Monaco,2001,MC,MCO,EUR,734,1530,2264,1399,1985,2438,2341,2290,3073,13526,688,1414,2102,1308,1916,2394,2383,2382,4174,14557,28083,32444,32444
Monaco,2002,MC,MCO,EUR,752,1534,2286,1399,1866,2481,2309,2326,3094,13475,718,1428,2146,1314,1832,2411,2337,2422,4159,14475,27950,32386,32386
Monaco,2003,MC,MCO,EUR,760,1535,2295,1396,1771,2506,2307,2330,3138,13448,743,1433,2176,1315,1751,2431,2304,2441,4157,14399,27847,32316,32316
Monaco,2004,MC,MCO,EUR,768,1518,2286,1396,1704,2489,2314,2329,3187,13419,764,1423,2187,1322,1689,2431,2298,2438,4170,14348,27767,32236,32236
Monaco,2005,MC,MCO,EUR,765,1502,2267,1398,1636,2462,2328,2332,3244,13400,762,1416,2178,1333,1632,2427,2306,2424,4179,14301,27701,32141,32141
Monaco,2006,MC,MCO,EUR,725,1496,2221,1406,1577,2406,2363,2330,3298,13380,722,1429,2151,1336,1585,2416,2327,2398,4192,14254,27634,32011,32011
Monaco,2007,MC,MCO,EUR,666,1496,2162,1409,1530,2335,2406,2321,3353,13354,657,1443,2100,1337,1540,2395,2361,2370,4204,14207,27561,31823,31823
Monaco,2008,MC,MCO,EUR,633,1491,2124,1420,1489,2264,2445,2322,3474,13414,611,1449,2060,1345,1512,2359,2390,2348,4308,14262,27676,31862,31862
Monaco,2009,MC,MCO,EUR,658,1486,2144,1448,1445,2196,2489,2338,3753,13669,626,1456,2082,1367,1484,2298,2431,2336,4596,14512,28181,32401,32401
Monaco,2010,MC,MCO,EUR,702,1482,2184,1475,1422,2121,2518,2369,4115,14020,666,1455,2121,1385,1477,2208,2468,2347,4961,14846,28866,33178,33178
Monaco,2011,MC,MCO,EUR,741,1473,2214,1495,1434,2018,2535,2404,4501,14387,706,1444,2150,1405,1490,2112,2497,2357,5329,15190,29577,33945,33945
Monaco,2012,MC,MCO,EUR,776,1463,2239,1515,1458,1894,2562,2441,4885,14755,746,1424,2170,1425,1503,2007,2534,2371,5693,15533,30288,34700,34700
Monaco,2013,MC,MCO,EUR,794,1456,2250,1539,1477,1787,2561,2493,5264,15121,771,1410,2181,1450,1509,1915,2547,2410,6041,15872,30993,35425,35425
Monaco,2014,MC,MCO,EUR,796,1453,2249,1569,1497,1722,2512,2545,5621,15466,783,1404,2187,1474,1508,1868,2519,2471,6368,16208,31674,36110,36110
Monaco,2015,MC,MCO,EUR,798,1446,2244,1600,1515,1672,2435,2599,5966,15787,793,1404,2197,1496,1505,1839,2462,2546,6674,16522,32309,36760,36760
Monaco,2016,MC,MCO,EUR,813,1446,2259,1617,1528,1631,2347,2657,6146,15926,808,1405,2213,1514,1496,1815,2387,2616,6843,16671,32597,37071,37071
Monaco,2017,MC,MCO,EUR,829,1451,2280,1624,1538,1598,2256,2696,6163,15875,819,1410,2229,1525,1487,1789,2314,2672,6872,16659,32534,37044,37044
Monaco,2018,MC,MCO,EUR,840,1466,2306,1627,1543,1577,2168,2729,6192,15836,822,1424,2246,1531,1485,1766,2247,2705,6904,16638,32474,37029,37029
Monaco,2019,MC,MCO,EUR,850,1491,2341,1614,1557,1552,2098,2739,6240,15800,823,1446,2269,1531,1488,1734,2190,2725,6954,16622,32422,37034,37034
Monaco,2020,MC,MCO,EUR,848,1516,2364,1599,1567,1533,2034,2727,6266,15726,816,1477,2293,1521,1495,1706,2123,2724,6970,16539,32265,36922,36922
Monaco,2021,MC,MCO,EUR,839,1543,2382,1582,1575,1541,1946,2699,6251,15594,806,1509,2315,1501,1497,1690,2055,2702,6947,16392,31986,36686,36686
Monaco,2022,MC,MCO,EUR,836,1575,2411,1573,1600,1562,1839,2683,6205,15462,800,1542,2342,1494,1520,1677,1977,2691,6892,16251,31713,36469,36469
Monaco,2023,MC,MCO,EUR,836,1602,2438,1576,1648,1580,1747,2639,6150,15340,800,1576,2376,1502,1561,1668,1903,2663,6841,16138,31478,36297,36297
Monaco,2024,MC,MCO,EUR,835,1632,2467,1574,1699,1599,1701,2563,6109,15245,800,1602,2402,1506,1604,1653,1868,2604,6806,16041,31286,36157,36157
Monaco,2025,MC,MCO,EUR,842,1653,2495,1576,1751,1619,1663,2479,6077,15165,804,1619,2423,1519,1647,1648,1839,2535,6779,15967,31132,36051,36051
Monaco,2026,MC,MCO,EUR,851,1671,2522,1581,1792,1640,1636,2379,6071,15099,811,1635,2446,1532,1693,1643,1816,2450,6768,15902,31001,35968,35968
Monaco,2027,MC,MCO,EUR,861,1691,2552,1589,1830,1668,1618,2276,6064,15045,821,1645,2466,1549,1733,1638,1804,2361,6762,15847,30892,35908,35908
Monaco,2028,MC,MCO,EUR,871,1705,2576,1605,1861,1688,1615,2181,6045,14995,834,1653,2487,1569,1773,1648,1798,2281,6744,15813,30808,35877,35877
Monaco,2029,MC,MCO,EUR,885,1717,2602,1632,1880,1724,1609,2106,6018,14969,845,1657,2502,1598,1805,1661,1782,2211,6727,15784,30753,35862,35862
Monaco,2030,MC,MCO,EUR,897,1727,2624,1661,1897,1759,1604,2040,5993,14954,856,1658,2514,1638,1828,1683,1770,2139,6718,15776,30730,35862,35862
Monaco,1950,MC,MCO,EUR,486,859,1345,921,1060,1427,1545,1190,1286,7429,517,900,1417,1158,1278,1777,1833,1699,1790,9535,16964,19729,19729
Monaco,1951,MC,MCO,EUR,623,863,1486,888,1076,1365,1559,1193,1305,7386,620,913,1533,1116,1299,1716,1827,1715,1833,9506,16892,19901,19901
Monaco,1952,MC,MCO,EUR,852,841,1693,806,1022,1268,1553,1152,1282,7083,818,898,1716,976,1309,1595,1781,1672,1834,9167,16250,19663,19663
Monaco,1953,MC,MCO,EUR,807,863,1670,819,1079,1233,1585,1206,1325,7247,785,935,1720,988,1355,1547,1845,1722,1920,9377,16624,20016,20016
Monaco,1954,MC,MCO,EUR,669,910,1579,832,1141,1203,1613,1263,1384,7436,661,986,1647,1013,1391,1507,1901,1783,2016,9611,17047,20270,20270
Monaco,1955,MC,MCO,EUR,478,940,1418,844,1202,1175,1638,1329,1439,7627,483,1026,1509,1051,1415,1477,1955,1845,2132,9875,17502,20430,20430
Monaco,1956,MC,MCO,EUR,440,953,1393,867,1232,1148,1645,1388,1481,7761,439,1040,1479,1078,1424,1457,1982,1887,2229,10057,17818,20688,20688
Monaco,1957,MC,MCO,EUR,535,971,1506,909,1226,1140,1633,1443,1508,7859,519,1046,1565,1093,1416,1450,1978,1903,2294,10134,17993,21063,21063
Monaco,1958,MC,MCO,EUR,599,987,1586,954,1208,1161,1601,1490,1542,7956,574,1038,1612,1115,1405,1467,1960,1922,2362,10231,18187,21383,21383
Monaco,1959,MC,MCO,EUR,619,992,1611,1012,1191,1207,1554,1534,1574,8072,590,1019,1609,1152,1393,1501,1928,1934,2431,10339,18411,21628,21628
Monaco,1960,MC,MCO,EUR,580,1005,1585,1076,1171,1267,1493,1572,1617,8196,544,1017,1561,1194,1384,1542,1882,1948,2506,10456,18652,21797,21797
Monaco,1961,MC,MCO,EUR,491,1022,1513,1139,1166,1329,1429,1601,1664,8328,460,1020,1480,1236,1380,1585,1830,1965,2590,10586,18914,21907,21907
Monaco,1962,MC,MCO,EUR,473,1033,1506,1195,1153,1378,1374,1622,1713,8435,447,1015,1462,1274,1372,1616,1783,1981,2671,10697,19132,22106,22106
Monaco,1963,MC,MCO,EUR,543,1043,1586,1238,1148,1408,1336,1632,1766,8528,516,1018,1534,1309,1360,1636,1741,1998,2751,10795,19323,22442,22442
Monaco,1964,MC,MCO,EUR,608,1057,1665,1268,1158,1414,1315,1636,1815,8606,579,1023,1602,1336,1344,1657,1703,2016,2839,10895,19501,22766,22766
Monaco,1965,MC,MCO,EUR,644,1070,1714,1284,1181,1406,1305,1641,1869,8686,611,1035,1646,1357,1334,1654,1686,2027,2917,10975,19661,23022,23022
Monaco,1966,MC,MCO,EUR,628,1095,1723,1294,1220,1391,1308,1647,1928,8788,595,1051,1646,1372,1340,1633,1686,2032,2991,11054,19842,23198,23198
Monaco,1967,MC,MCO,EUR,551,1126,1677,1297,1268,1373,1315,1648,1975,8876,527,1076,1603,1383,1361,1612,1676,2039,3058,11129,20005,23281,23281
Monaco,1968,MC,MCO,EUR,532,1147,1679,1305,1310,1378,1325,1646,2019,8983,510,1089,1599,1397,1402,1590,1663,2055,3115,11222,20205,23481,23481
Monaco,1969,MC,MCO,EUR,598,1158,1756,1320,1344,1390,1360,1629,2055,9098,574,1101,1675,1413,1457,1577,1667,2063,3164,11341,20439,23875,23875
Monaco,2031,MC,MCO,EUR,908,1734,2642,1695,1912,1786,1629,1953,5970,14945,868,1661,2529,1678,1844,1706,1770,2071,6695,15764,30709,35879,35879
Monaco,2032,MC,MCO,EUR,919,1746,2665,1729,1921,1823,1654,1848,5959,14934,878,1668,2546,1713,1853,1738,1765,1994,6702,15765,30699,35904,35904
Monaco,2033,MC,MCO,EUR,929,1755,2684,1762,1923,1869,1675,1760,5943,14932,887,1678,2565,1742,1861,1779,1755,1924,6700,15761,30693,35941,35941
Monaco,2034,MC,MCO,EUR,937,1764,2701,1788,1916,1922,1694,1713,5898,14931,897,1690,2587,1771,1866,1823,1741,1887,6673,15761,30692,35987,35987
Monaco,2035,MC,MCO,EUR,947,1785,2732,1806,1919,1974,1710,1676,5844,14929,900,1708,2608,1790,1881,1865,1735,1857,6644,15772,30701,36038,36038
Monaco,2036,MC,MCO,EUR,950,1809,2759,1826,1924,2016,1734,1651,5788,14939,910,1727,2637,1804,1894,1912,1730,1836,6606,15782,30721,36111,36111
Monaco,2037,MC,MCO,EUR,959,1828,2787,1845,1934,2053,1762,1635,5726,14955,914,1748,2662,1815,1911,1954,1726,1826,6557,15789,30744,36184,36184
Monaco,2038,MC,MCO,EUR,962,1848,2810,1859,1952,2083,1786,1634,5647,14961,920,1767,2687,1823,1931,1990,1734,1818,6500,15796,30757,36257,36257
Monaco,2039,MC,MCO,EUR,970,1869,2839,1873,1978,2104,1817,1629,5586,14987,927,1787,2714,1827,1960,2024,1750,1803,6454,15818,30805,36350,36350
Monaco,2040,MC,MCO,EUR,977,1890,2867,1884,2006,2117,1846,1625,5523,15001,930,1807,2737,1827,2000,2046,1770,1792,6403,15838,30839,36443,36443
Monaco,2041,MC,MCO,EUR,981,1909,2890,1888,2039,2133,1881,1648,5432,15021,940,1824,2764,1828,2041,2060,1795,1791,6349,15864,30885,36535,36535
Monaco,2042,MC,MCO,EUR,990,1924,2914,1896,2070,2143,1917,1675,5341,15042,944,1840,2784,1835,2074,2070,1826,1787,6294,15886,30928,36637,36637
Monaco,2043,MC,MCO,EUR,997,1942,2939,1908,2104,2142,1961,1695,5266,15076,952,1854,2806,1848,2104,2079,1867,1777,6253,15928,31004,36748,36748
Monaco,2044,MC,MCO,EUR,1005,1956,2961,1923,2131,2141,2015,1713,5196,15119,959,1869,2828,1859,2133,2086,1908,1763,6213,15962,31081,36864,36864
Monaco,2045,MC,MCO,EUR,1014,1967,2981,1940,2149,2142,2067,1730,5124,15152,967,1882,2849,1875,2150,2097,1954,1755,6170,16001,31153,36986,36986
Monaco,2046,MC,MCO,EUR,1022,1981,3003,1961,2170,2145,2110,1754,5059,15199,976,1892,2868,1894,2163,2113,1997,1752,6121,16040,31239,37113,37113
Monaco,2047,MC,MCO,EUR,1029,1994,3023,1981,2188,2158,2147,1781,5000,15255,984,1906,2890,1915,2175,2126,2038,1751,6077,16082,31337,37249,37249
Monaco,2048,MC,MCO,EUR,1037,2008,3045,2005,2202,2173,2177,1807,4936,15300,989,1920,2909,1936,2184,2149,2076,1759,6025,16129,31429,37386,37386
Monaco,2049,MC,MCO,EUR,1044,2022,3066,2025,2216,2198,2198,1837,4885,15359,999,1932,2931,1954,2187,2178,2110,1773,5968,16170,31529,37523,37523
Monaco,2050,MC,MCO,EUR,1050,2036,3086,2044,2226,2229,2213,1869,4829,15410,1000,1947,2947,1974,2188,2218,2134,1794,5923,16231,31641,37664,37664
Republic of Moldova,1970,MD,MDA,EUR,173336,406460,579796,292817,234472,232003,157175,123740,92528,1132735,166875,402037,568912,335356,277161,273552,209254,171071,163303,1429697,2562432,3711140,3711140
Republic of Moldova,1971,MD,MDA,EUR,172998,398859,571857,310454,227709,236994,164513,124372,96296,1160338,167090,395293,562383,352232,268050,276065,219612,172553,168245,1456757,2617095,3751337,3751337
Republic of Moldova,1972,MD,MDA,EUR,174141,389768,563909,326281,223305,240996,173440,124086,99794,1187902,168784,387265,556049,366630,260825,278856,230958,173077,172788,1483134,2671036,3790996,3790996
Republic of Moldova,1973,MD,MDA,EUR,176833,379087,555920,339198,223331,243564,182809,123867,103316,1216085,172017,377645,549662,377206,258083,281432,241842,173594,177453,1509610,2725695,3831275,3831275
Republic of Moldova,1974,MD,MDA,EUR,180790,367044,547834,349566,227825,244825,191242,124485,107052,1244995,176552,366784,543336,384225,260349,283230,250698,175005,182612,1536119,2781114,3872281,3872281
Republic of Moldova,1975,MD,MDA,EUR,185187,354852,540039,356571,236825,245784,197671,125908,110970,1273729,181461,355986,537447,387310,267696,284672,256716,177540,188435,1562369,2836098,3913586,3913586
Republic of Moldova,1976,MD,MDA,EUR,189111,344047,533158,361169,248460,246635,202279,127666,115123,1301332,185823,346661,532484,388152,277916,285716,260070,180930,194801,1587585,2888917,3954568,3954568
Republic of Moldova,1977,MD,MDA,EUR,192087,336153,528240,364530,260869,246323,205871,129476,119337,1326406,189149,340135,529284,388489,288722,285463,261385,185030,201194,1610283,2936689,3994206,3994206
Republic of Moldova,1978,MD,MDA,EUR,194129,331680,525809,365450,275424,243508,209177,131363,123046,1347968,191334,336898,528232,387193,301521,282564,261594,189844,207049,1629765,2977733,4031773,4031773
Republic of Moldova,1979,MD,MDA,EUR,195655,330887,526542,362978,292722,237372,212963,133734,125715,1365484,192762,337017,529779,383334,317269,275895,261873,195756,211695,1645822,3011306,4067626,4067626
Republic of Moldova,1980,MD,MDA,EUR,197004,333432,530436,357383,311611,228951,217209,137393,127084,1379631,193981,339935,533916,377083,335034,266240,263071,203160,214667,1659255,3038886,4103240,4103240
Republic of Moldova,1981,MD,MDA,EUR,198674,337619,536293,350203,329628,220508,221260,143020,127408,1392027,195702,344125,539827,369605,352526,256008,265053,212115,216236,1671543,3063570,4139686,4139686
Republic of Moldova,1982,MD,MDA,EUR,201267,342809,544076,341746,344532,214810,224391,150476,127448,1403403,198491,348960,547451,360986,367355,248101,267289,222063,217326,1683120,3086523,4178053,4178053
Republic of Moldova,1983,MD,MDA,EUR,205497,348886,554383,331902,354902,214420,225769,158466,127680,1413139,202827,354752,557579,350713,377922,245474,268844,231527,218848,1693328,3106467,4218421,4218421
Republic of Moldova,1984,MD,MDA,EUR,210996,355718,566714,321131,361035,219668,225504,165420,128644,1421402,208390,361685,570075,338832,384428,248976,269088,238924,221510,1701758,3123160,4259952,4259952
Republic of Moldova,1985,MD,MDA,EUR,216091,362763,578854,310806,363374,229422,225064,170404,130699,1429769,213581,368812,582393,326895,387322,257675,268757,243460,225569,1709678,3139447,4300695,4300695
Republic of Moldova,1986,MD,MDA,EUR,220449,369398,589847,302809,363825,240446,225324,173814,134141,1440359,218131,375233,593364,317131,388587,268029,268674,245453,231836,1719710,3160069,4343283,4343283
Republic of Moldova,1987,MD,MDA,EUR,223756,375575,599331,298848,363923,251144,224930,176486,138603,1453934,221874,380974,602848,311097,389674,278208,267791,245607,239991,1732368,3186302,4388483,4388483
Republic of Moldova,1988,MD,MDA,EUR,223324,382377,605701,298755,362401,263616,221838,178833,142764,1468207,221989,387102,609091,308907,389143,290821,263938,244644,248246,1745699,3213906,4428709,4428709
Republic of Moldova,1989,MD,MDA,EUR,217572,390070,607642,302284,358045,278848,215250,181580,146284,1482291,216777,393726,610503,310305,385617,306885,256214,243676,256251,1758948,3241239,4459383,4459383
Republic of Moldova,1990,MD,MDA,EUR,208804,396999,605803,308960,351153,295514,206094,184839,149224,1495784,208387,399642,608029,314363,379372,324548,245451,243530,263309,1770573,3266357,4480199,4480199
Republic of Moldova,1991,MD,MDA,EUR,198464,403203,601667,316880,342860,311023,196962,187767,151872,1507364,198085,405232,603317,319325,371400,341099,234351,243976,268429,1778580,3285944,4490927,4490927
Republic of Moldova,1992,MD,MDA,EUR,187004,409085,596089,325076,332987,323351,190969,189458,155044,1516885,186274,410867,597141,324682,361173,354698,226434,244393,273400,1784780,3301665,4494902,4494902
Republic of Moldova,1993,MD,MDA,EUR,176329,412679,589008,333562,321508,331304,190851,189248,158826,1525299,175000,414133,589133,331035,348146,363795,224899,243684,278689,1790248,3315547,4493689,4493689
Republic of Moldova,1994,MD,MDA,EUR,167543,411944,579487,342235,309224,335058,196553,187144,161840,1532054,165542,412927,578469,338370,333048,368408,229959,240960,281746,1792491,3324545,4482507,4482507
Republic of Moldova,1995,MD,MDA,EUR,159476,407406,566882,350440,297439,335165,205725,184635,163460,1536864,156788,408218,565006,345461,318022,369274,239236,237482,283002,1792477,3329341,4461231,4461231
Republic of Moldova,1996,MD,MDA,EUR,151171,400233,551404,357633,287729,333333,214915,182409,163820,1539839,148021,400787,548808,351681,305165,367896,248839,234186,282370,1790137,3329976,4430195,4430195
Republic of Moldova,1997,MD,MDA,EUR,143836,390442,534278,363798,281249,330647,223459,179150,163802,1542105,140372,390720,531092,357296,295603,365270,257809,229827,280513,1786318,3328423,4393789,4393789
Republic of Moldova,1998,MD,MDA,EUR,137395,377487,514882,369421,277757,325885,233677,173577,164097,1544414,133624,377720,511344,362795,289410,359983,268929,222775,278995,1782887,3327301,4353534,4353534
Republic of Moldova,1999,MD,MDA,EUR,131210,361084,492294,374507,276975,317839,245896,165345,164411,1544973,127239,361330,488569,368293,286299,350876,282582,212524,277524,1778098,3323071,4303938,4303938
Republic of Moldova,2000,MD,MDA,EUR,126048,345415,471463,377263,278959,308270,256978,155515,164865,1541850,121957,345846,467803,372020,286285,340400,294793,200542,276416,1770456,3312306,4251573,4251573
Republic of Moldova,2001,MD,MDA,EUR,121954,331707,453661,378358,281600,299336,264955,146404,165187,1535840,117709,332320,450029,374446,287521,330756,303398,189611,275237,1760969,3296809,4200501,4200501
Republic of Moldova,2002,MD,MDA,EUR,118104,317371,435475,380095,283287,290248,270692,140252,164642,1529216,113610,317999,431609,377525,288369,320712,309600,182094,273040,1751340,3280556,4147642,4147642
Republic of Moldova,2003,MD,MDA,EUR,115250,302815,418065,381642,284218,280679,273758,138449,162652,1521398,110462,303298,413760,380312,289149,309732,312879,179437,269244,1740753,3262151,4093982,4093982
Republic of Moldova,2004,MD,MDA,EUR,115464,287509,402973,381000,284830,269940,275204,142444,160535,1513953,109925,287742,397667,380324,289416,297408,315092,183287,266872,1732399,3246352,4046995,4046995
Republic of Moldova,2005,MD,MDA,EUR,117491,271571,389062,377997,285871,258362,275160,149822,159188,1506400,111212,271320,382532,377468,289424,283936,315684,190927,265956,1723395,3229795,4001382,4001382
Republic of Moldova,2006,MD,MDA,EUR,119320,256131,375451,372296,286350,247368,273058,156238,157922,1493232,112949,254988,367937,371926,288630,270672,313130,197501,264279,1706138,3199370,3942748,3942748
Republic of Moldova,2007,MD,MDA,EUR,121324,241529,362853,363807,286120,237935,269809,161701,156249,1475621,115008,239677,354685,363235,286985,259093,309114,203190,262063,1683680,3159301,3876843,3876843
Republic of Moldova,2008,MD,MDA,EUR,123464,228769,352233,352737,286691,230673,265399,167995,153333,1456828,117145,226363,343508,351746,286270,249744,303774,210114,258204,1659852,3116680,3812422,3812422
Republic of Moldova,2009,MD,MDA,EUR,125438,218787,344225,338513,288166,225492,259267,175899,148663,1436000,119081,215636,334717,337258,286739,242482,296481,219358,252230,1634548,3070548,3749492,3749492
Republic of Moldova,2010,MD,MDA,EUR,124733,211201,335934,321084,289077,222367,251319,184412,142988,1411247,118683,207328,326011,319504,287199,237158,286725,229691,244714,1604991,3016238,3678186,3678186
Republic of Moldova,2011,MD,MDA,EUR,121018,204809,325827,301568,288981,220148,242161,191907,137728,1382493,115650,200491,316141,299705,286820,232832,275119,238957,237232,1570665,2953158,3595126,3595126
Republic of Moldova,2012,MD,MDA,EUR,116859,198713,315572,282092,288177,217533,232057,197994,133457,1351310,112042,194422,306464,280201,285305,228626,262387,246513,230813,1533845,2885155,3507191,3507191
Republic of Moldova,2013,MD,MDA,EUR,113412,192601,306013,263822,285868,214365,220976,201133,131844,1318008,108784,188945,297729,262005,281753,224614,248469,250246,227697,1494784,2812792,3416530,3416530
Republic of Moldova,2014,MD,MDA,EUR,112953,188660,301613,246048,283288,212021,209623,200693,133914,1285587,108023,185575,293598,244314,277717,221676,234178,249739,229913,1457537,2743124,3338336,3338336
Republic of Moldova,2015,MD,MDA,EUR,114892,187502,302394,228974,280777,211141,198991,198978,137318,1256179,109423,184591,294014,227150,274121,219983,220880,247728,234939,1424801,2680980,3277388,3277388
Republic of Moldova,2016,MD,MDA,EUR,116747,187352,304099,214046,277257,210794,189957,197138,140570,1229762,110859,184564,295423,211809,269942,218821,209671,245318,240276,1395837,2625599,3225123,3225123
Republic of Moldova,2017,MD,MDA,EUR,117345,188393,305738,200732,273133,211156,183186,195187,143532,1206926,111258,185523,296781,197950,265389,218194,201189,242898,245432,1371052,2577978,3180506,3180506
Republic of Moldova,2018,MD,MDA,EUR,116118,190807,306925,188864,268002,213105,178475,192748,145878,1187072,110004,187572,297576,185624,260148,218911,195101,240065,250416,1350265,2537337,3141837,3141837
Republic of Moldova,2019,MD,MDA,EUR,113005,194758,307763,179384,261119,216712,175725,189058,148295,1170293,106980,190858,297838,175791,253598,221268,191276,235618,256043,1333594,2503887,3109491,3109491
Republic of Moldova,2020,MD,MDA,EUR,108590,199821,308411,173134,252694,221763,175062,184059,150354,1157066,102723,195019,297742,169392,245849,225124,189829,229796,261637,1321627,2478693,3084847,3084847
Republic of Moldova,2021,MD,MDA,EUR,104079,204814,308893,169543,242425,228073,175267,178088,150952,1144348,98392,199077,297469,165730,236505,230195,189637,223132,265599,1310798,2455146,3061506,3061506
Republic of Moldova,2022,MD,MDA,EUR,107277,214781,322058,201949,268295,253293,183773,175000,153925,1236235,101713,208295,310008,200982,263817,253212,197071,218585,271028,1404695,2640930,3272996,3272996
Republic of Moldova,2023,MD,MDA,EUR,111926,221986,333912,223882,286423,274750,191434,171035,157339,1304863,106265,214530,320795,225193,283349,273079,204276,212953,277506,1476356,2781219,3435931,3435931
Republic of Moldova,2024,MD,MDA,EUR,110304,221318,331622,203629,261511,274070,190940,163452,159587,1253189,104460,212637,317097,203796,259457,272112,204764,203474,284349,1427952,2681141,3329865,3329865
Republic of Moldova,2025,MD,MDA,EUR,108594,221056,329650,189923,241092,273597,192151,157016,163228,1217007,102645,211412,314057,189159,239925,271277,206720,194601,292565,1394247,2611254,3254966,3254966
Republic of Moldova,2026,MD,MDA,EUR,106824,221385,328209,183103,226207,273875,194507,152063,166565,1196320,100834,211068,311902,181686,225510,271394,209504,187624,299724,1375442,2571762,3211875,3211875
Republic of Moldova,2027,MD,MDA,EUR,105091,221639,326730,182070,215295,274814,197968,148981,169121,1188249,99099,210948,310047,180084,214835,272264,212968,183053,305533,1368737,2556986,3193756,3193756
Republic of Moldova,2028,MD,MDA,EUR,102100,222069,324169,184546,205893,274940,202916,147440,170714,1186449,96286,211042,307328,181853,205603,272550,217530,180415,309959,1367910,2554359,3185847,3185847
Republic of Moldova,2029,MD,MDA,EUR,98278,221547,319825,189477,197785,272919,209180,147248,171278,1187887,92775,210205,302980,185855,197586,271086,223270,179477,312758,1370032,2557919,3180733,3180733
Republic of Moldova,2030,MD,MDA,EUR,95374,218743,314117,195629,190963,268227,216217,148354,170938,1190328,90095,207291,297386,190923,190823,267258,229710,180098,314075,1372887,2563215,3174727,3174727
Republic of Moldova,1950,MD,MDA,EUR,110889,229988,340877,217806,157483,151590,105924,67867,64414,765084,107520,223342,330862,235545,183559,174550,132638,92538,114660,933490,1698574,2370311,2370311
Republic of Moldova,1951,MD,MDA,EUR,126695,227929,354624,222513,165536,150437,108236,66759,63507,776988,123005,222942,345947,241638,195111,175056,135698,92915,112596,953014,1730002,2430564,2430564
Republic of Moldova,1952,MD,MDA,EUR,142172,226925,369097,227079,175240,148624,110205,66009,62634,789791,138125,223511,361636,248278,208376,174999,137767,93838,111006,974264,1764055,2494779,2494779
Republic of Moldova,1953,MD,MDA,EUR,156731,228301,385032,231146,185355,146926,112131,65892,61756,803206,152253,226203,378456,255164,221795,175082,139543,95623,109701,996908,1800114,2563597,2563597
Republic of Moldova,1954,MD,MDA,EUR,170141,232646,402787,234497,194592,146087,114335,66579,60890,816980,165105,231559,396664,262029,233657,176126,141663,98485,108645,1020605,1837585,2637035,2637035
Republic of Moldova,1955,MD,MDA,EUR,179794,242727,422521,237117,202337,146241,116905,68050,60148,830798,174219,242331,416550,268371,243393,178437,144254,102460,107937,1044852,1875650,2714714,2714714
Republic of Moldova,1956,MD,MDA,EUR,186092,258034,444126,239069,208570,147170,119858,70213,59570,844450,180065,258083,438148,273862,251046,181894,147350,107429,107569,1069150,1913600,2795865,2795865
Republic of Moldova,1957,MD,MDA,EUR,192226,275333,467559,239883,213792,148949,123057,72940,59243,857864,185688,275640,461328,277854,257053,186583,150963,112934,107504,1092891,1950755,2879651,2879651
Republic of Moldova,1958,MD,MDA,EUR,198149,294549,492698,238739,218849,151848,126069,75993,59263,870761,191032,294964,485996,279267,262205,192899,154751,118339,107930,1115391,1986152,2964841,2964841
Republic of Moldova,1959,MD,MDA,EUR,203533,315431,518964,235013,224327,156139,128481,79200,59735,882895,195936,315853,511789,277361,267171,201065,158193,123270,109048,1136108,2019003,3049756,3049756
Republic of Moldova,1960,MD,MDA,EUR,208056,337026,545082,229320,229972,162215,130184,82609,60677,894977,200042,337462,537504,272736,272192,210917,161134,127781,110935,1155695,2050672,3133267,3133267
Republic of Moldova,1961,MD,MDA,EUR,211197,357829,569026,223430,235107,170330,131248,86189,62014,908318,202853,358346,561199,267068,277002,222231,163686,131829,113618,1175434,2083752,3213979,3213979
Republic of Moldova,1962,MD,MDA,EUR,211899,376267,588166,219144,239454,179912,131998,89902,63729,924139,203419,376873,580292,262331,281519,234399,165980,135441,117060,1196730,2120869,3289323,3289323
Republic of Moldova,1963,MD,MDA,EUR,209729,391202,600931,218041,242811,189792,133036,93886,65927,943493,201150,391643,592793,260472,285614,245959,168504,139063,121330,1220942,2164435,3358162,3358162
Republic of Moldova,1964,MD,MDA,EUR,204645,402795,607440,220296,245204,198789,134896,98233,68714,966132,196085,402404,598489,262242,289069,255376,171946,143000,126508,1248141,2214273,3420198,3420198
Republic of Moldova,1965,MD,MDA,EUR,197652,409968,607620,226819,247074,206098,137615,102937,72079,992622,189229,408262,597491,268825,291909,262080,176373,147366,132503,1279056,2271678,3476796,3476796
Republic of Moldova,1966,MD,MDA,EUR,190302,413868,604170,236433,248363,211803,140763,107939,75918,1021219,182046,410611,592657,278918,293827,266262,181426,152229,139093,1311755,2332974,3529794,3529794
Republic of Moldova,1967,MD,MDA,EUR,183644,416160,599804,247054,248380,216557,144102,113043,80074,1049210,175631,411630,587261,290032,294046,268611,186973,157596,145707,1342965,2392175,3579245,3579245
Republic of Moldova,1968,MD,MDA,EUR,178372,415881,594253,259764,246223,221208,147678,117818,84323,1077014,170779,410746,581525,302908,291604,270018,193186,163169,151983,1372868,2449882,3625655,3625655
Republic of Moldova,1969,MD,MDA,EUR,174959,412491,587450,275290,241293,226481,151776,121572,88485,1104897,167948,407453,575401,318268,285690,271458,200499,167958,157862,1401735,2506632,3669484,3669484
Republic of Moldova,2031,MD,MDA,EUR,93162,214867,308029,201978,185405,260955,224143,150075,170244,1192800,88035,203449,291484,196218,185209,261048,236896,181557,314618,1375546,2568346,3167853,3167853
Republic of Moldova,2032,MD,MDA,EUR,91350,211076,302426,207488,181132,252080,232359,151920,169456,1194435,86336,199743,286079,200774,180855,253162,244408,183292,314713,1377204,2571639,3160142,3160142
Republic of Moldova,2033,MD,MDA,EUR,89767,207727,297494,211785,178181,242691,239914,154026,168499,1195096,84844,196495,281339,204134,177949,244486,251363,185502,314305,1377739,2572835,3151669,3151669
Republic of Moldova,2034,MD,MDA,EUR,88381,204565,292946,215069,176441,233323,246202,156743,167378,1195156,83538,193446,276984,206514,176243,235801,256937,188678,313331,1377504,2572660,3142584,3142584
Republic of Moldova,2035,MD,MDA,EUR,87170,201705,288875,217334,175657,224401,250846,160057,166286,1194581,82397,190693,273090,208002,175384,227506,260962,192516,312097,1376467,2571048,3133020,3133020
Republic of Moldova,2036,MD,MDA,EUR,86155,198742,284897,218955,175817,216079,253978,163483,165478,1193790,81438,187837,269275,209042,175368,219449,263825,196323,311088,1375095,2568885,3123061,3123061
Republic of Moldova,2037,MD,MDA,EUR,85355,195592,280947,219656,177296,207774,255955,167171,165055,1192907,80688,184786,265474,209403,176452,211171,265704,200136,310616,1373482,2566389,3112811,3112811
Republic of Moldova,2038,MD,MDA,EUR,84782,191134,275916,220205,180392,199268,256425,171877,164948,1193115,80152,180591,260743,209614,178884,202612,266280,204728,310539,1372657,2565772,3102423,3102423
Republic of Moldova,2039,MD,MDA,EUR,84388,185944,270332,219696,185314,191448,254651,177644,165144,1193897,79779,175783,255562,208779,182888,194682,264891,210342,310584,1372166,2566063,3091956,3091956
Republic of Moldova,2040,MD,MDA,EUR,84159,181849,266008,216914,191444,184880,250384,184113,165764,1193499,79559,171973,251532,205877,187951,187997,261187,216628,310856,1370496,2563995,3081524,3081524
Republic of Moldova,2041,MD,MDA,EUR,84153,178635,262788,213066,197766,179540,243732,191368,166713,1192185,79547,168964,248511,202043,193240,182443,255152,223625,311344,1367847,2560032,3071336,3071336
Republic of Moldova,2042,MD,MDA,EUR,84398,176031,260429,209301,203257,175451,235594,198834,167829,1190266,79769,166520,246289,198344,197788,178140,247477,230914,311886,1364549,2554815,3061537,3061537
Republic of Moldova,2043,MD,MDA,EUR,84841,173887,258728,205976,207539,172649,226970,205658,169145,1187937,80181,164496,244677,195102,201148,175277,239028,237641,312614,1360810,2548747,3052151,3052151
Republic of Moldova,2044,MD,MDA,EUR,85494,172120,257614,202832,210818,171031,218355,211335,170944,1185315,80793,162824,243617,192064,203526,173599,230558,243035,313944,1356726,2542041,3043273,3043273
Republic of Moldova,2045,MD,MDA,EUR,86310,170694,257004,199987,213079,170341,210153,215559,173343,1182462,81559,161470,243029,189314,205015,172773,222478,246938,315890,1352408,2534870,3034910,3034910
Republic of Moldova,2046,MD,MDA,EUR,87118,169680,256798,197042,214703,170578,202500,218431,176147,1179401,82317,160504,242821,186462,206055,172773,214621,249719,318247,1347877,2527278,3026902,3026902
Republic of Moldova,2047,MD,MDA,EUR,87844,169133,256977,193906,215414,172106,194864,220300,179553,1176143,82998,159977,242975,183421,206420,173868,206550,251567,321311,1343137,2519280,3019227,3019227
Republic of Moldova,2048,MD,MDA,EUR,88495,169008,257503,189467,215976,175213,187057,220935,184044,1172692,83606,159857,243463,179230,206629,176305,198211,252202,325657,1338234,2510926,3011890,3011890
Republic of Moldova,2049,MD,MDA,EUR,88940,169271,258211,184307,215498,180122,179901,219682,189622,1169132,84021,160098,244119,174429,205804,180305,190492,250994,331220,1333244,2502376,3004709,3004709
Republic of Moldova,2050,MD,MDA,EUR,89116,169866,258982,180232,212767,186209,173907,216295,196078,1165488,84188,160646,244834,170621,202913,185355,183991,247596,337745,1328221,2493709,2997532,2997532
Madagascar,1970,MG,MDG,AFR,632977,922876,1555853,616093,369869,313100,235457,170633,107751,1812903,623379,909912,1533291,614899,382736,289200,179947,147762,123168,1737712,3550615,6639751,6639751
Madagascar,1971,MG,MDG,AFR,658284,947976,1606260,648454,374311,316012,240139,171248,112966,1863130,647974,934137,1582111,644588,389089,296834,186618,144483,127356,1788968,3652098,6840457,6840457
Madagascar,1972,MG,MDG,AFR,685259,974778,1660037,681126,380156,318984,244791,171312,118647,1915016,674127,960046,1634173,674822,396298,304281,193987,140688,131794,1841870,3756886,7051090,7051090
Madagascar,1973,MG,MDG,AFR,711901,1003608,1715509,713286,388514,321807,249355,171291,124499,1968752,699851,987947,1687798,704654,405441,311367,201846,137083,136110,1896501,3865253,7268560,7268560
Madagascar,1974,MG,MDG,AFR,737251,1034928,1772179,739510,404926,324096,253734,171917,129992,2024175,724314,1018298,1742612,729443,421318,317745,209948,134687,139827,1952968,3977143,7491935,7491935
Madagascar,1975,MG,MDG,AFR,760790,1069158,1829948,760664,428485,325761,257885,173483,134870,2081148,747025,1051534,1798559,750012,443080,323339,218125,133941,142707,2011204,4092352,7720859,7720859
Madagascar,1976,MG,MDG,AFR,781573,1107172,1888745,782219,453499,327000,261803,175978,139182,2139681,767045,1088564,1855609,770928,466035,328265,226318,134826,144804,2071176,4210857,7955197,7955197
Madagascar,1977,MG,MDG,AFR,800237,1148336,1948573,804137,479824,328030,265459,179454,142900,2199804,785034,1128774,1913808,792171,490138,332660,234451,137427,146107,2132954,4332758,8195142,8195142
Madagascar,1978,MG,MDG,AFR,818515,1190869,2009384,826436,507383,329242,268857,183617,146153,2261688,802716,1170385,1973101,813789,515363,336914,242441,141466,146773,2196746,4458434,8440919,8440919
Madagascar,1979,MG,MDG,AFR,836753,1233976,2070729,849268,536108,331177,272032,187942,149206,2325733,820288,1212626,2032914,835932,541727,341559,250219,146349,147126,2262912,4588645,8692289,8692289
Madagascar,1980,MG,MDG,AFR,854428,1277363,2131791,872782,565853,334240,274988,192167,152224,2392254,837212,1255145,2092357,858783,569174,346963,257700,151769,147371,2331760,4724014,8948162,8948162
Madagascar,1981,MG,MDG,AFR,870884,1320526,2191410,897510,596358,338551,277893,196347,155142,2461801,852894,1297406,2150300,882868,597546,353198,264948,157800,147443,2403803,4865604,9207310,9207310
Madagascar,1982,MG,MDG,AFR,886729,1363010,2249739,923972,627383,344267,280862,200464,157923,2534871,867892,1338995,2206887,908710,626670,360333,272062,164391,147334,2479500,5014371,9470990,9470990
Madagascar,1983,MG,MDG,AFR,902635,1404554,2307189,952346,658032,352340,283677,204451,160667,2611513,882900,1379582,2262482,936484,655574,369330,278857,171371,147280,2558896,5170409,9740088,9740088
Madagascar,1984,MG,MDG,AFR,919307,1444507,2363814,982973,683235,367917,285996,208251,163543,2691915,898640,1418493,2317133,966505,679838,384627,285003,178538,147634,2642145,5334060,10015017,10015017
Madagascar,1985,MG,MDG,AFR,938347,1481900,2420247,1016274,703782,390159,287752,211854,166605,2776426,916700,1454783,2371483,999177,700212,405442,290434,185756,148569,2729590,5506016,10297746,10297746
Madagascar,1986,MG,MDG,AFR,960225,1515485,2475710,1053077,724737,413797,289139,215259,169891,2865900,937529,1487226,2424755,1035353,720943,427396,295257,192982,150127,2822058,5687958,10588428,10588428
Madagascar,1987,MG,MDG,AFR,985590,1546660,2532250,1092822,746060,438692,290364,218472,173455,2959865,961880,1517246,2479126,1074492,742030,450470,299628,200189,152462,2919271,5879136,10890514,10890514
Madagascar,1988,MG,MDG,AFR,1014862,1577820,2592682,1133842,767743,464754,291787,221491,177213,3056830,990305,1547250,2537555,1114932,763475,474633,303893,207303,155488,3019724,6076554,11206789,11206789
Madagascar,1989,MG,MDG,AFR,1047277,1610105,2657382,1175405,789886,491873,293866,224331,180998,3156359,1021950,1578286,2600236,1155933,785358,499813,308497,214218,158931,3122750,6279109,11536734,11536734
Madagascar,1990,MG,MDG,AFR,1082955,1644664,2727619,1217256,812595,519863,296957,226998,184781,3258450,1056815,1611545,2668360,1197207,807799,525929,313762,220863,162772,3228332,6486782,11882762,11882762
Madagascar,1991,MG,MDG,AFR,1121822,1681583,2803405,1258967,836386,548494,301179,229654,188592,3363272,1094806,1647106,2741912,1238320,831340,552851,319777,227325,167065,3336678,6699950,12245260,12245260
Madagascar,1992,MG,MDG,AFR,1161961,1721972,2883933,1300162,861822,577591,306696,232426,192467,3471164,1134126,1686057,2820183,1278913,856527,580467,326628,233712,171814,3448061,6919225,12623342,12623342
Madagascar,1993,MG,MDG,AFR,1202881,1766933,2969814,1340841,889403,606557,314484,235189,196512,3582986,1174258,1729713,2903971,1318963,883877,608099,335303,239937,177144,3563323,7146309,13020100,13020100
Madagascar,1994,MG,MDG,AFR,1245286,1816368,3061654,1380374,919497,630806,329234,237644,200778,3698333,1215857,1778118,2993975,1357851,913768,631746,349922,245715,183155,3682157,7380490,13436121,13436121
Madagascar,1995,MG,MDG,AFR,1288276,1871512,3159788,1417546,952212,650897,350093,239648,205136,3815532,1258178,1832406,3090584,1394428,946377,651993,369710,250951,189766,3803225,7618757,13869138,13869138
Madagascar,1996,MG,MDG,AFR,1331008,1932850,3263858,1451168,988334,671441,372238,241374,209600,3934155,1300373,1892873,3193246,1427533,982514,672748,390662,255748,196985,3926190,7860345,14317454,14317454
Madagascar,1997,MG,MDG,AFR,1372725,1999271,3371996,1482698,1027433,692508,395639,243067,214347,4055692,1341436,1958214,3299650,1458397,1021571,693926,412709,260195,204762,4051560,8107252,14778903,14778903
Madagascar,1998,MG,MDG,AFR,1411396,2070707,3482103,1514484,1067999,714146,420257,245074,219356,4181316,1379376,2028185,3407561,1489247,1061925,715499,435812,264570,212897,4179950,8361266,15250934,15250934
Madagascar,1999,MG,MDG,AFR,1445509,2147081,3592590,1547509,1109252,736373,445959,247728,224426,4311247,1412784,2102698,3515482,1521070,1102797,737494,459884,269242,221074,4311561,8622808,15730885,15730885
Madagascar,2000,MG,MDG,AFR,1473953,2227432,3701385,1582834,1150906,759255,472559,251303,229482,4446339,1440557,2180913,3621470,1554964,1143866,759990,484807,274471,229141,4447239,8893578,16216431,16216431
Madagascar,2001,MG,MDG,AFR,1498278,2310901,3809179,1620512,1192547,783271,499844,255907,234622,4586703,1464369,2262061,3726430,1591038,1184746,783520,510487,280351,237205,4587347,9174050,16709665,16709665
Madagascar,2002,MG,MDG,AFR,1520798,2394839,3915637,1661474,1233682,808847,527567,261626,239731,4732927,1486692,2343545,3830237,1630346,1225097,808612,536800,286975,245304,4733134,9466061,17211934,17211934
Madagascar,2003,MG,MDG,AFR,1543599,2476592,4020191,1706633,1274055,836197,555045,269225,244680,4885835,1509420,2422856,3932276,1674082,1264697,835567,563041,295197,253424,4886008,9771843,17724310,17724310
Madagascar,2004,MG,MDG,AFR,1569074,2555425,4124499,1756054,1313149,865735,578231,282907,249344,5045420,1534662,2499624,4034286,1722451,1303120,864877,585660,308830,261625,5046563,10091983,18250774,18250774
Madagascar,2005,MG,MDG,AFR,1598870,2629534,4228404,1811164,1350087,897837,597782,301978,253703,5212551,1563966,2572181,4136147,1776571,1339426,896852,605250,327175,269790,5215064,10427615,18792171,18792171
Madagascar,2006,MG,MDG,AFR,1633137,2699553,4332690,1872542,1383804,933324,617885,322204,258027,5387786,1597438,2641139,4238577,1836681,1372464,932257,625357,346551,277931,5391241,10779027,19350299,19350299
Madagascar,2007,MG,MDG,AFR,1670737,2766764,4437501,1938847,1415485,971620,638445,343461,262425,5570283,1633952,2707992,4341944,1901724,1403569,970659,646000,366994,286286,5575232,11145515,19924958,19924958
Madagascar,2008,MG,MDG,AFR,1710604,2831134,4541738,2009808,1447229,1011177,659413,365642,266994,5760263,1672338,2772348,4444686,1971394,1434759,1010411,667107,388403,294835,5766909,11527172,20513599,20513599
Madagascar,2009,MG,MDG,AFR,1751549,2893651,4645200,2085508,1480126,1051386,680935,388728,272016,5958699,1711382,2834925,4546307,2045755,1467067,1050855,688755,410752,303705,5966889,11925588,21117092,21117092
Madagascar,2010,MG,MDG,AFR,1791063,2954931,4745994,2164945,1515112,1091892,702996,412482,277534,6164961,1748698,2896205,4644903,2124036,1501549,1091677,711024,433930,312986,6175202,12340163,21731053,21731053
Madagascar,2011,MG,MDG,AFR,1824647,3016406,4841053,2247239,1552235,1132275,726026,436708,283731,6378214,1779928,2957648,4737576,2205437,1538271,1132481,734398,457858,322871,6391316,12769530,22348158,22348158
Madagascar,2012,MG,MDG,AFR,1851538,3079075,4930613,2329969,1592467,1172169,750518,461257,290792,6597172,1804335,3020334,4824669,2287443,1578230,1172911,759353,482404,333447,6613788,13210960,22966240,22966240
Madagascar,2013,MG,MDG,AFR,1874022,3143790,5017812,2410560,1636644,1211275,776622,485509,299152,6819762,1824320,3085025,4909345,2367491,1622524,1212700,786143,506936,345360,6841154,13660916,23588073,23588073
Madagascar,2014,MG,MDG,AFR,1892495,3211992,5104487,2488352,1684895,1249177,804793,506215,312274,7045706,1840528,3152624,4993152,2444934,1671233,1251293,815114,528337,361719,7072630,14118336,24215976,24215976
Madagascar,2015,MG,MDG,AFR,1909830,3283000,5192830,2561585,1738629,1285063,835395,523955,329516,7274143,1855904,3221912,5077816,2518038,1725325,1287668,846487,547004,381604,7306126,14580269,24850912,24850912
Madagascar,2016,MG,MDG,AFR,1933454,3352561,5286015,2630784,1798404,1317890,869171,542178,347445,7505872,1877685,3289054,5166739,2587618,1785258,1320922,881145,566166,402210,7543319,15049191,25501941,25501941
Madagascar,2017,MG,MDG,AFR,1964587,3418768,5383355,2697256,1862941,1348815,905603,560832,366092,7741539,1906964,3352415,5259379,2654956,1849936,1352263,918618,585824,423674,7785271,15526810,26169542,26169542
Madagascar,2018,MG,MDG,AFR,1999083,3482574,5481657,2760908,1931914,1379756,943159,579804,385327,7980868,1939697,3412979,5352676,2719756,1919040,1383603,957317,605836,445781,8031333,16012201,26846541,26846541
Madagascar,2019,MG,MDG,AFR,2035639,3543424,5579063,2822551,2005296,1411712,981274,599260,405384,8225477,1974599,3470524,5445123,2782728,1992655,1416021,996717,626429,468924,8283474,16508951,27533134,27533134
Madagascar,2020,MG,MDG,AFR,2073064,3601786,5674850,2883257,2082486,1445665,1019332,618455,424382,8473577,2010487,3525606,5536093,2844532,2070223,1450558,1036336,647144,491866,8540659,17014236,28225177,28225177
Madagascar,2021,MG,MDG,AFR,2107340,3660470,5767810,2944272,2162512,1481423,1056555,637263,441101,8723126,2043618,3580751,5624369,2906375,2150710,1486976,1075334,667830,513130,8800355,17523481,28915653,28915653
Madagascar,2022,MG,MDG,AFR,2138523,3720240,5858763,3006513,2243021,1520133,1093141,657100,457545,8977453,2074028,3636610,5710638,2969370,2231682,1526411,1113733,689638,534023,9064857,18042310,29611714,29611714
Madagascar,2023,MG,MDG,AFR,2169697,3779488,5949185,3071438,2322092,1563211,1129688,679227,475863,9241519,2104693,3691875,5796568,3034660,2311075,1570371,1151956,713748,556659,9338469,18579988,30325732,30325732
Madagascar,2024,MG,MDG,AFR,2200215,3837047,6037262,3140014,2398808,1610622,1165839,704287,496907,9516477,2135039,3745786,5880825,3102964,2388166,1618882,1189554,740722,581743,9622031,19138508,31056610,31056610
Madagascar,2025,MG,MDG,AFR,2228627,3894081,6122708,3211123,2471041,1663394,1200544,732378,520416,9798896,2163655,3799711,5963366,3173140,2461171,1672817,1225504,770686,609013,9912331,19711227,31797306,31797306
Madagascar,2026,MG,MDG,AFR,2255632,3953878,6209510,3280580,2539217,1721874,1232514,763636,545284,10083105,2191001,3857011,6048012,3241040,2530639,1732345,1258558,803920,637608,10204110,20287215,32544738,32544738
Madagascar,2027,MG,MDG,AFR,2282241,4017701,6299942,3346760,2604853,1784950,1262705,797210,570551,10367029,2217881,3918741,6136622,3305115,2597914,1796434,1289751,839668,666844,10495726,20862755,33299316,33299316
Madagascar,2028,MG,MDG,AFR,2308473,4084343,6392816,3410797,2667991,1852440,1293009,831818,596249,10652304,2244354,3983625,6227979,3366631,2662896,1864959,1321049,876566,696747,10788848,21441152,34061942,34061942
Madagascar,2029,MG,MDG,AFR,2334569,4152178,6486747,3471964,2729427,1924375,1324331,866866,622475,10939438,2270534,4050076,6320610,3425047,2726224,1937971,1353373,914007,727433,11084055,22023493,34830840,34830840
Madagascar,2030,MG,MDG,AFR,2360660,4219124,6579784,3530765,2789915,1999929,1357603,902121,649241,11229574,2296479,4116080,6412559,3480932,2788389,2014779,1387726,951745,758954,11382525,22612099,35604443,35604443
Madagascar,1950,MG,MDG,AFR,322477,435428,757905,384395,307259,255909,168652,99831,58865,1274911,327833,447810,775643,350980,230697,209762,172020,112227,69744,1145430,2420341,3953896,3953896
Madagascar,1951,MG,MDG,AFR,348504,440058,788562,387063,312180,255420,175342,101799,60289,1292093,350897,454678,805575,359481,238436,204275,176024,114644,71599,1164459,2456552,4050682,4050682
Madagascar,1952,MG,MDG,AFR,373970,446387,820357,389861,317100,253991,182881,103740,61802,1309375,373787,462585,836372,367777,247070,198002,180423,117073,73505,1183850,2493225,4149956,4149956
Madagascar,1953,MG,MDG,AFR,398087,455663,853750,392530,321908,252337,190599,105818,63409,1326601,395589,472796,868385,375667,256326,191951,184570,119576,75497,1203587,2530188,4252319,4252319
Madagascar,1954,MG,MDG,AFR,414893,474306,889199,394614,326465,251610,197679,107958,65073,1343399,411200,490828,902028,382730,265842,187552,187863,121891,77579,1223457,2566856,4358096,4358096
Madagascar,1955,MG,MDG,AFR,425708,501197,926905,396018,330732,252276,203594,110339,66782,1359741,421865,515630,937495,388883,275402,185444,189846,124105,79777,1243457,2603198,4467590,4467590
Madagascar,1956,MG,MDG,AFR,436955,529677,966632,397002,334714,254335,208171,113180,68583,1375985,432905,541674,974579,394272,284929,185588,190333,126487,82080,1263689,2639674,4580881,4580881
Madagascar,1957,MG,MDG,AFR,448507,559599,1008106,397816,338386,257884,211476,116356,70526,1392444,444205,568924,1013129,399062,294334,188111,189432,128907,84520,1284366,2676810,4698038,4698038
Madagascar,1958,MG,MDG,AFR,460287,590838,1051125,398926,341770,262499,213644,120012,72566,1409417,455676,597321,1052997,403694,303525,192623,187290,131492,87067,1305691,2715108,4819229,4819229
Madagascar,1959,MG,MDG,AFR,472107,623245,1095352,400922,344918,267418,214927,124395,74623,1427203,467150,626794,1093944,408786,312425,198296,184192,134457,89682,1327838,2755041,4944333,4944333
Madagascar,1960,MG,MDG,AFR,483889,656551,1140440,404242,347833,272251,215663,129408,76726,1446123,478573,657200,1135773,414729,320932,204711,180531,137742,92366,1351011,2797134,5073342,5073342
Madagascar,1961,MG,MDG,AFR,495630,690445,1186075,408988,350733,277093,215748,135068,78891,1466521,489916,688334,1178250,421581,329137,211983,176167,141407,95119,1375394,2841915,5206239,5206239
Madagascar,1962,MG,MDG,AFR,507332,724694,1232026,415339,353776,281944,215093,141421,81095,1488668,501205,720046,1221251,429437,337187,220066,171138,145420,97923,1401171,2889839,5343117,5343117
Madagascar,1963,MG,MDG,AFR,519102,758363,1277465,424448,356707,286715,214283,147930,83448,1513531,512586,751309,1263895,439425,344871,228720,166295,149225,100817,1429353,2942884,5484252,5484252
Madagascar,1964,MG,MDG,AFR,531234,785678,1316912,442266,359116,291296,214290,153939,85914,1546821,524302,777161,1301463,456622,351794,237632,162875,152287,103625,1464835,3011656,5630024,5630024
Madagascar,1965,MG,MDG,AFR,543901,807560,1351461,467805,360877,295621,215486,159012,88589,1587390,536564,798474,1335038,480104,357842,246585,161422,154208,106400,1506561,3093951,5780453,5780453
Madagascar,1966,MG,MDG,AFR,557650,829840,1387490,494938,362192,299666,217849,163011,91635,1629291,549945,820095,1370040,504848,363141,255508,161910,154869,109363,1549639,3178930,5936461,5936461
Madagascar,1967,MG,MDG,AFR,573171,852484,1425655,523494,363294,303427,221474,166010,95005,1672704,565049,841994,1407043,530772,367823,264312,164456,154350,112422,1594135,3266839,6099529,6099529
Madagascar,1968,MG,MDG,AFR,590720,875473,1466193,553327,364601,306903,226000,168115,98764,1717710,582161,864197,1446358,557822,372309,272919,168731,152801,115686,1640268,3357978,6270528,6270528
Madagascar,1969,MG,MDG,AFR,610560,898892,1509452,584273,366652,310119,230765,169554,103013,1764376,601545,886798,1488343,585915,377163,281255,174022,150501,119295,1688151,3452527,6450324,6450324
Madagascar,2031,MG,MDG,AFR,2386481,4281869,6668350,3590185,2850807,2078302,1392882,937263,676840,11526279,2322089,4178404,6500493,3537122,2850738,2094598,1424142,989422,791643,11687665,23213944,36382789,36382789
Madagascar,2032,MG,MDG,AFR,2411142,4340819,6751961,3650678,2913025,2157294,1431099,972028,705634,11829758,2346577,4237312,6583889,3594006,2914338,2175071,1463588,1026783,825870,11999656,23829414,37165274,37165274
Madagascar,2033,MG,MDG,AFR,2434445,4398821,6833266,3710321,2977505,2234602,1473108,1006268,735812,12137616,2369715,4295540,6665255,3650005,2979924,2253770,1507115,1063612,861850,12316276,24453892,37952413,37952413
Madagascar,2034,MG,MDG,AFR,2456440,4455836,6912276,3768114,3045388,2309480,1518922,1039559,767586,12449049,2391634,4352909,6744543,3704469,3048303,2330033,1554774,1099427,899809,12636815,25085864,38742689,38742689
Madagascar,2035,MG,MDG,AFR,2476916,4511190,6988106,3825570,3116017,2380251,1569776,1071205,801148,12763967,2412103,4408652,6820755,3759063,3118658,2402440,1607656,1133495,939972,12961284,25725251,39534122,39534122
Madagascar,2036,MG,MDG,AFR,2495952,4565266,7061218,3885901,3185283,2447344,1626100,1100345,836977,13081950,2431040,4463104,6894144,3817129,3186926,2471563,1666006,1164890,982927,13289441,26371391,40326745,40326745
Madagascar,2037,MG,MDG,AFR,2514027,4617775,7131802,3950167,3251366,2512029,1686793,1127995,874667,13403017,2448906,4515948,6964854,3879572,3251436,2538586,1728791,1194668,1028267,13621320,27024337,41120987,41120987
Madagascar,2038,MG,MDG,AFR,2531881,4668547,7200428,4017193,3315390,2574352,1751702,1155816,913161,13727614,2466446,4567013,7033459,3945124,3313435,2603414,1795902,1224620,1074812,13957307,27684921,41918817,41918817
Madagascar,2039,MG,MDG,AFR,2550553,4717883,7268436,4085382,3376652,2635100,1820862,1184618,952073,14054687,2484677,4616540,7101217,4012224,3372397,2666678,1867391,1255598,1122144,14296432,28351119,42720774,42720774
Madagascar,2040,MG,MDG,AFR,2569640,4765690,7335330,4152679,3435637,2694988,1893509,1215263,991290,14383366,2503350,4664355,7167705,4078878,3428887,2728862,1942607,1288550,1170115,14637899,29021265,43524300,43524300
Madagascar,2041,MG,MDG,AFR,2588489,4811767,7400256,4215848,3495263,2755331,1968861,1247776,1030793,14713872,2521830,4710282,7232112,4141885,3485701,2791286,2020782,1323502,1218721,14981877,29695749,44328120,44328120
Madagascar,2042,MG,MDG,AFR,2606421,4855729,7462150,4275301,3555979,2817016,2044834,1283035,1070666,15046831,2539400,4754001,7293401,4201509,3543237,2854989,2099644,1361386,1268107,15328872,30375703,45131260,45131260
Madagascar,2043,MG,MDG,AFR,2623241,4898112,7521353,4333827,3615892,2880945,2119244,1321815,1110942,15382665,2555884,4796029,7351913,4260458,3599915,2920683,2176848,1403193,1318254,15679351,31062016,45935275,45935275
Madagascar,2044,MG,MDG,AFR,2638916,4939983,7578899,4391383,3674015,2948205,2191361,1364097,1151428,15720489,2571241,4837490,7408731,4318543,3655082,2989140,2251742,1448940,1368935,16032382,31752871,46740497,46740497
Madagascar,2045,MG,MDG,AFR,2654609,4980756,7635365,4447291,3731824,3018137,2259605,1410980,1191744,16059581,2586540,4877903,7464443,4374992,3710372,3059545,2322939,1499638,1419731,16387217,32446798,47546606,47546606
Madagascar,2046,MG,MDG,AFR,2671846,5019852,7691698,4501937,3792436,3086762,2324395,1462803,1231591,16399924,2603345,4916566,7519911,4430156,3769093,3127904,2391008,1555488,1470328,16743977,33143901,48355513,48355513
Madagascar,2047,MG,MDG,AFR,2690162,5057065,7747227,4555034,3856903,3152309,2386945,1518576,1271499,16741266,2621340,4953230,7574570,4483718,3832130,3192584,2457104,1615524,1521302,17102362,33843628,49165426,49165426
Madagascar,2048,MG,MDG,AFR,2708063,5092920,7800983,4606429,3924089,3215888,2447330,1578180,1311980,17083896,2638943,4988437,7627380,4535507,3898254,3254816,2521145,1679661,1573222,17462605,34546501,49974855,49974855
Madagascar,2049,MG,MDG,AFR,2725523,5128411,7853934,4656385,3992408,3276802,2506316,1641661,1353426,17426998,2656059,5023166,7679225,4585744,3965894,3314069,2583751,1747975,1626556,17823989,35250987,50784139,50784139
Madagascar,2050,MG,MDG,AFR,2742547,5164310,7906857,4704801,4059836,3335525,2564612,1708337,1396475,17769586,2672725,5058228,7730953,4634240,4033050,3370884,2645399,1819877,1682119,18185569,35955155,51592965,51592965
Maldives,1970,MV,MDV,SEA,11655,17208,28863,10683,8913,7895,5069,2863,1821,37244,11193,16043,27236,9744,7817,6135,3505,1776,916,29893,67137,123243,123243
Maldives,1971,MV,MDV,SEA,12094,17745,29839,11207,8956,8033,5251,2955,1915,38317,11606,16550,28156,10179,7845,6262,3650,1851,973,30760,69077,127066,127066
Maldives,1972,MV,MDV,SEA,12483,18277,30760,11813,9017,8154,5442,3044,2019,39489,11985,17055,29040,10690,7895,6377,3794,1926,1028,31710,71199,130990,130990
Maldives,1973,MV,MDV,SEA,12749,18832,31581,12494,9109,8257,5634,3134,2123,40751,12266,17593,29859,11265,7974,6477,3940,2006,1085,32747,73498,134940,134940
Maldives,1974,MV,MDV,SEA,12996,19445,32441,13142,9224,8319,5831,3237,2237,41990,12505,18188,30693,11840,8086,6567,4093,2097,1149,33832,75822,138944,138944
Maldives,1975,MV,MDV,SEA,13363,20127,33490,13669,9340,8315,6020,3356,2344,43044,12831,18838,31669,12372,8243,6641,4257,2200,1220,34933,77977,143126,143126
Maldives,1976,MV,MDV,SEA,13787,20861,34648,14144,9478,8273,6188,3488,2450,44021,13213,19493,32706,12899,8447,6702,4426,2311,1306,36091,80112,147468,147468
Maldives,1977,MV,MDV,SEA,14120,21600,35720,14648,9666,8234,6333,3624,2565,45070,13542,20115,33657,13465,8698,6759,4589,2428,1402,37341,82411,151792,151792
Maldives,1978,MV,MDV,SEA,14491,22283,36774,15205,9810,8220,6481,3744,2634,46094,13875,20768,34643,14057,8865,6830,4749,2537,1470,38508,84602,156025,156025
Maldives,1979,MV,MDV,SEA,14979,22901,37880,15838,9894,8223,6645,3863,2671,47134,14268,21426,35694,14717,8934,6904,4915,2643,1510,39623,86757,160326,160326
Maldives,1980,MV,MDV,SEA,15481,23518,38999,16552,10022,8201,6804,4004,2713,48296,14692,22014,36706,15498,9039,6942,5084,2758,1555,40876,89172,164887,164887
Maldives,1981,MV,MDV,SEA,15998,24124,40122,17337,10215,8144,6963,4160,2765,49584,15159,22518,37677,16383,9198,6940,5262,2887,1607,42277,91861,169663,169663
Maldives,1982,MV,MDV,SEA,16520,24669,41189,18152,10490,8055,7112,4331,2813,50953,15664,22904,38568,17345,9445,6905,5434,3024,1655,43808,94761,174523,174523
Maldives,1983,MV,MDV,SEA,16935,25211,42146,18969,10879,7940,7243,4517,2858,52406,16112,23239,39351,18305,9807,6840,5610,3171,1702,45435,97841,179339,179339
Maldives,1984,MV,MDV,SEA,17357,25821,43178,19750,11384,7807,7360,4706,2916,53923,16563,23640,40203,19195,10311,6744,5779,3314,1752,47095,101018,184388,184388
Maldives,1985,MV,MDV,SEA,18139,26556,44695,20347,11974,7726,7444,4881,3003,55375,17294,24340,41634,19820,10956,6703,5927,3436,1837,48679,104054,190383,190383
Maldives,1986,MV,MDV,SEA,19212,27457,46669,20720,12600,7738,7480,5063,3139,56740,18233,25366,43599,20205,11699,6768,6043,3555,1957,50227,106967,197225,197225
Maldives,1987,MV,MDV,SEA,20235,28517,48752,21033,13233,7809,7467,5269,3269,58080,19078,26506,45584,20577,12466,6890,6146,3692,2069,51840,109920,204256,204256
Maldives,1988,MV,MDV,SEA,20970,29784,50754,21363,13849,7937,7423,5492,3406,59470,19634,27745,47379,21013,13217,7059,6247,3843,2181,53560,113030,211160,211160
Maldives,1989,MV,MDV,SEA,21271,31382,52653,21742,14418,8126,7362,5712,3546,60906,19832,29176,49008,21525,13924,7289,6345,4001,2284,55368,116274,217937,217937
Maldives,1990,MV,MDV,SEA,21402,33147,54549,22156,15002,8390,7296,5867,3735,62446,19953,30792,50745,22025,14630,7594,6400,4160,2409,57218,119664,224957,224957
Maldives,1991,MV,MDV,SEA,21547,34868,56415,22594,15634,8736,7218,5963,3935,64080,20101,32465,52566,22466,15366,7964,6407,4329,2556,59088,123168,232150,232150
Maldives,1992,MV,MDV,SEA,21567,36547,58114,23059,16248,9159,7120,6067,4144,65797,20116,34079,54195,22938,16091,8401,6386,4517,2699,61032,126829,239136,239136
Maldives,1993,MV,MDV,SEA,21406,38184,59590,23577,16815,9661,7022,6177,4347,67599,19978,35583,55561,23487,16780,8911,6366,4712,2839,63095,130694,245845,245845
Maldives,1994,MV,MDV,SEA,20954,39808,60762,24194,17317,10236,6940,6276,4556,69519,19611,36974,56585,24179,17425,9489,6351,4904,2988,65336,134855,252201,252201
Maldives,1995,MV,MDV,SEA,20340,41104,61444,25029,17807,10925,6905,6383,4763,71812,19097,38078,57175,24964,18010,10177,6353,5103,3160,67767,139579,258208,258208
Maldives,1996,MV,MDV,SEA,19696,41889,61585,26053,18336,11730,6927,6513,5013,74572,18517,38836,57353,25763,18541,10976,6368,5324,3367,70339,144911,263841,263841
Maldives,1997,MV,MDV,SEA,18977,42367,61344,27163,18858,12586,6999,6632,5292,77530,17822,39342,57164,26617,19021,11822,6401,5541,3601,73003,150533,269040,269040
Maldives,1998,MV,MDV,SEA,18180,42570,60750,28355,19363,13456,7127,6716,5607,80624,17053,39568,56621,27613,19444,12682,6479,5732,3851,75801,156425,273796,273796
Maldives,1999,MV,MDV,SEA,17282,42498,59780,29676,19848,14310,7342,6765,5929,83870,16217,39486,55703,28791,19825,13515,6628,5877,4124,78760,162630,278111,278111
Maldives,2000,MV,MDV,SEA,16415,42207,58622,31218,20321,15080,7679,6737,6260,87295,15400,39141,54541,30236,20247,14301,6903,5947,4422,82056,169351,282507,282507
Maldives,2001,MV,MDV,SEA,15726,41754,57480,32939,20807,15749,8164,6633,6595,90887,14704,38574,53278,31904,20748,15029,7320,5940,4742,85683,176570,287324,287324
Maldives,2002,MV,MDV,SEA,15209,41115,56324,34674,21331,16324,8776,6512,6963,94580,14152,37798,51950,33575,21300,15696,7871,5903,5089,89434,184014,292284,292284
Maldives,2003,MV,MDV,SEA,14865,40269,55134,36351,21901,16823,9498,6414,7335,98322,13745,36807,50552,35155,21905,16294,8548,5861,5451,93214,191536,297226,297226
Maldives,2004,MV,MDV,SEA,14678,39219,53897,37972,22549,17249,10304,6344,7696,102114,13473,35597,49070,36647,22578,16850,9326,5818,5821,97040,199154,302135,302135
Maldives,2005,MV,MDV,SEA,14561,38051,52612,39485,23323,17633,11160,6317,8037,105955,13295,34255,47550,37974,23377,17386,10172,5790,6204,100903,206858,307018,307018
Maldives,2006,MV,MDV,SEA,14582,36920,51502,42090,24976,18257,12051,6327,8297,111998,13322,32881,46203,39033,24400,17924,11021,5790,6534,104702,216700,314401,314401
Maldives,2007,MV,MDV,SEA,14874,35713,50587,46011,27864,19285,12984,6383,8469,120996,13653,31524,45177,39763,25680,18463,11843,5834,6782,108365,229361,325126,325126
Maldives,2008,MV,MDV,SEA,15403,34337,49740,49686,31477,20580,13951,6513,8596,130803,14193,30281,44474,40089,27197,19002,12668,5922,6992,111870,242673,336883,336883
Maldives,2009,MV,MDV,SEA,16092,33024,49116,52437,35674,22099,14946,6755,8711,140622,14838,29249,44087,39993,28918,19559,13471,6082,7191,115214,255836,349037,349037
Maldives,2010,MV,MDV,SEA,16909,31930,48839,54076,40496,23854,15947,7146,8811,150330,15538,28466,44004,39513,30792,20151,14209,6359,7378,118402,268732,361575,361575
Maldives,2011,MV,MDV,SEA,17780,31160,48940,54552,45922,25841,16970,7683,8897,159865,16209,27981,44190,38711,32760,20772,14888,6773,7548,121452,281317,374440,374440
Maldives,2012,MV,MDV,SEA,18602,30839,49441,53871,51802,28097,18046,8371,8983,169170,16759,27847,44606,37638,34731,21420,15508,7317,7704,124318,293488,387539,387539
Maldives,2013,MV,MDV,SEA,19254,31018,50272,52147,57872,30714,19225,9194,9091,178243,17129,28067,45196,36373,36596,22148,16079,7964,7861,127021,305264,400728,400728
Maldives,2014,MV,MDV,SEA,19619,31692,51311,50323,63599,33706,20605,10246,9349,187828,17479,28655,46134,35698,38858,23281,16758,8765,8107,131467,319295,416738,416738
Maldives,2015,MV,MDV,SEA,19775,32724,52499,48808,68666,37070,22181,11505,9763,197993,17892,29543,47435,35612,41430,24879,17573,9710,8447,137651,335644,435582,435582
Maldives,2016,MV,MDV,SEA,19846,33940,53786,47217,73098,40770,23838,12811,10197,207931,18256,30576,48832,35386,43686,26721,18415,10704,8788,143700,351631,454252,454252
Maldives,2017,MV,MDV,SEA,19837,35254,55091,45675,76736,44783,25557,14136,10649,217536,18577,31681,50258,35068,45580,28780,19273,11716,9138,149555,367091,472442,472442
Maldives,2018,MV,MDV,SEA,19788,36571,56359,44199,79325,49123,27359,15473,11128,226607,18847,32797,51644,34668,47053,31053,20148,12731,9497,155150,381757,489758,489758
Maldives,2019,MV,MDV,SEA,19739,37727,57466,42556,80376,53645,29174,16758,11648,234157,18948,33932,52880,34043,47906,33442,21009,13696,9908,160004,394161,504508,504508
Maldives,2020,MV,MDV,SEA,19623,38642,58265,40422,79399,58061,30895,17907,12174,238858,18831,34999,53830,33034,47915,35766,21841,14552,10382,163490,402348,514438,514438
Maldives,2021,MV,MDV,SEA,19412,39359,58771,38305,76899,62453,32597,18961,12750,241965,18601,35878,54479,31991,47287,38035,22671,15314,10945,166243,408208,521457,521457
Maldives,2022,MV,MDV,SEA,19065,39779,58844,35912,72621,66386,34204,19912,13437,242472,18236,36474,54710,30808,45844,40066,23439,15981,11619,167757,410229,523787,523787
Maldives,2023,MV,MDV,SEA,18552,39869,58421,33245,66653,69531,35750,20777,14211,240167,17711,36777,54488,29518,43588,41713,24172,16556,12393,167940,408107,521021,521021
Maldives,2024,MV,MDV,SEA,17950,39746,57696,31337,60238,72157,37470,21677,15099,237978,17110,36889,53999,28691,41055,43112,24997,17112,13247,168214,406192,517887,517887
Maldives,2025,MV,MDV,SEA,17282,39453,56735,30294,53757,74170,39446,22637,16084,236388,16452,36844,53296,28388,38372,44210,25982,17678,14173,168803,405191,515223,515223
Maldives,2026,MV,MDV,SEA,16583,39005,55588,30072,47485,75485,41716,23656,17141,235555,15768,36667,52435,28572,35682,44948,27181,18256,15153,169792,405347,513362,513362
Maldives,2027,MV,MDV,SEA,15874,38410,54284,30509,41661,76002,44274,24728,18260,235434,15089,36371,51460,29127,33090,45307,28577,18847,16154,171102,406536,512284,512284
Maldives,2028,MV,MDV,SEA,15180,37693,52873,31381,36400,75538,47162,25889,19445,235815,14423,35952,50375,29922,30659,45261,30184,19450,17181,172657,408472,511718,511718
Maldives,2029,MV,MDV,SEA,14527,36918,51445,32476,31879,73985,50421,27146,20713,236620,13801,35318,49119,30956,28477,44811,31989,20079,18233,174545,411165,511725,511725
Maldives,2030,MV,MDV,SEA,13940,36081,50021,33749,28305,71427,54038,28511,22052,238082,13239,34478,47717,32168,26666,44013,33933,20760,19326,176866,414948,512683,512683
Maldives,1950,MV,MDV,SEA,5451,10853,16304,8576,6175,4485,3004,2098,1536,25874,5066,9760,14826,6973,4380,2659,1550,1108,804,17474,43348,74484,74484
Maldives,1951,MV,MDV,SEA,5372,10858,16230,8832,6316,4611,3077,2140,1572,26548,5097,9774,14871,7274,4544,2793,1594,1133,830,18168,44716,75816,75816
Maldives,1952,MV,MDV,SEA,5391,10808,16199,9089,6452,4735,3158,2180,1597,27211,5207,9724,14931,7589,4703,2923,1646,1156,855,18872,46083,77211,77211
Maldives,1953,MV,MDV,SEA,5526,10670,16196,9338,6590,4846,3249,2216,1626,27865,5404,9609,15013,7902,4866,3048,1708,1180,876,19580,47445,78659,78659
Maldives,1954,MV,MDV,SEA,5822,10417,16239,9569,6743,4959,3346,2252,1652,28521,5724,9411,15135,8191,5043,3182,1781,1200,898,20295,48816,80193,80193
Maldives,1955,MV,MDV,SEA,6159,10176,16335,9764,6915,5081,3447,2285,1680,29172,6060,9262,15322,8438,5239,3316,1865,1216,921,20995,50167,81823,81823
Maldives,1956,MV,MDV,SEA,6449,10046,16495,9929,7106,5203,3558,2315,1701,29812,6344,9231,15575,8650,5448,3449,1958,1232,940,21677,51489,83559,83559
Maldives,1957,MV,MDV,SEA,6762,9961,16723,10057,7313,5331,3673,2335,1730,30439,6649,9250,15899,8821,5670,3591,2061,1245,963,22351,52790,85417,85417
Maldives,1958,MV,MDV,SEA,7096,9927,17023,10157,7539,5465,3790,2364,1755,31070,6975,9315,16290,8960,5906,3733,2174,1257,982,23012,54082,87387,87387
Maldives,1959,MV,MDV,SEA,7443,9947,17390,10233,7765,5595,3903,2398,1779,31673,7310,9439,16749,9059,6153,3872,2290,1278,998,23650,55323,89459,89459
Maldives,1960,MV,MDV,SEA,7808,10037,17845,10282,7989,5723,4014,2439,1802,32249,7663,9635,17298,9119,6403,4014,2401,1303,1013,24253,56502,91650,91650
Maldives,1961,MV,MDV,SEA,8179,10216,18395,10290,8214,5843,4118,2493,1832,32790,8019,9915,17934,9133,6664,4154,2515,1338,1033,24837,57627,93952,93952
Maldives,1962,MV,MDV,SEA,8542,10508,19050,10233,8438,5958,4218,2554,1858,33259,8370,10292,18662,9083,6939,4286,2628,1380,1047,25363,58622,96332,96332
Maldives,1963,MV,MDV,SEA,8892,10934,19826,10100,8656,6073,4311,2623,1883,33646,8704,10770,19474,8973,7206,4417,2738,1432,1063,25829,59475,98775,98775
Maldives,1964,MV,MDV,SEA,9227,11529,20756,9850,8844,6193,4404,2697,1905,33893,9022,11378,20400,8783,7438,4560,2842,1490,1075,26188,60081,101241,101241
Maldives,1965,MV,MDV,SEA,9712,12541,22253,9592,8973,6471,4453,2712,1856,34057,9445,12204,21649,8668,7640,4821,2925,1530,1024,26608,60665,104566,104566
Maldives,1966,MV,MDV,SEA,10231,13951,24182,9476,8992,6925,4489,2658,1719,34259,9890,13244,23134,8706,7765,5224,2995,1544,904,27138,61397,108713,108713
Maldives,1967,MV,MDV,SEA,10540,15229,25769,9550,8929,7334,4583,2638,1626,34660,10175,14244,24419,8828,7795,5593,3097,1574,819,27706,62366,112547,112547
Maldives,1968,MV,MDV,SEA,10838,16058,26896,9836,8890,7584,4728,2693,1639,35370,10449,14964,25413,9063,7796,5826,3226,1634,821,28366,63736,116049,116049
Maldives,1969,MV,MDV,SEA,11229,16643,27872,10229,8896,7749,4898,2780,1726,36278,10802,15511,26313,9375,7803,5989,3365,1704,869,29105,65383,119569,119569
Maldives,2031,MV,MDV,SEA,13424,35151,48575,35120,25780,68002,57921,29985,23474,240282,12751,33541,46292,33372,25370,42900,35966,21488,20462,179558,419840,514714,514714
Maldives,2032,MV,MDV,SEA,12996,34158,47154,36408,24298,63893,61857,31582,25021,243059,12343,32544,44887,34432,24635,41520,37990,22256,21656,182489,425548,517587,517587
Maldives,2033,MV,MDV,SEA,12653,33103,45756,37427,23725,59255,65565,33362,26683,246017,12019,31500,43519,35268,24438,39908,39888,23089,22888,185479,431496,520779,520779
Maldives,2034,MV,MDV,SEA,12390,32000,44390,38079,23926,54291,68823,35341,28475,248935,11771,30427,42198,35826,24715,38073,41575,24025,24184,188398,437333,523920,523920
Maldives,2035,MV,MDV,SEA,12212,30874,43086,38390,24795,49175,71438,37557,30393,251748,11599,29338,40937,36140,25423,36060,42947,25113,25529,191212,442960,526981,526981
Maldives,2036,MV,MDV,SEA,12111,29762,41873,38400,26215,44110,73290,40033,32382,254430,11501,28272,39773,36241,26475,33959,43926,26399,26911,193911,448341,529986,529986
Maldives,2037,MV,MDV,SEA,12087,28707,40794,38143,28026,39329,74281,42755,34426,256960,11478,27263,38741,36148,27754,31885,44499,27870,28314,196470,453430,532965,532965
Maldives,2038,MV,MDV,SEA,12146,27733,39879,37661,30052,34998,74244,45783,36578,259316,11531,26341,37872,35882,29168,29909,44651,29535,29722,198867,458183,535943,535943
Maldives,2039,MV,MDV,SEA,12272,26879,39151,37045,32081,31273,73076,49153,38856,261484,11648,25529,37177,35357,30704,28122,44373,31387,31169,201112,462596,538923,538923
Maldives,2040,MV,MDV,SEA,12451,26155,38606,36311,33990,28278,70814,52832,41258,263483,11818,24840,36658,34586,32258,26603,43710,33362,32661,203180,466663,541917,541917
Maldives,2041,MV,MDV,SEA,12679,25564,38243,35432,35698,26078,67575,56719,43779,265281,12031,24277,36308,33683,33639,25464,42678,35396,34221,205081,470362,544920,544920
Maldives,2042,MV,MDV,SEA,12928,25123,38051,34454,37098,24711,63559,60620,46462,266904,12268,23857,36125,32699,34762,24790,41331,37407,35842,206831,473735,547913,547913
Maldives,2043,MV,MDV,SEA,13190,24840,38030,33403,38126,24156,58973,64274,49403,268335,12515,23590,36105,31657,35600,24604,39734,39283,37547,208425,476760,550899,550899
Maldives,2044,MV,MDV,SEA,13464,24702,38166,32301,38782,24359,54057,67489,52618,269606,12772,23459,36231,30584,36159,24883,37917,40949,39384,209876,479482,553876,553876
Maldives,2045,MV,MDV,SEA,13730,24706,38436,31176,39092,25231,48991,70068,56143,270701,13025,23460,36485,29497,36476,25590,35925,42304,41406,211198,481899,556821,556821
Maldives,2046,MV,MDV,SEA,13971,24830,38801,30067,39109,26646,43980,71900,59962,271664,13254,23573,36827,28435,36574,26640,33841,43273,43641,212404,484068,559692,559692
Maldives,2047,MV,MDV,SEA,14178,25060,39238,29012,38848,28454,39242,72883,64046,272485,13448,23783,37231,27428,36486,27920,31781,43844,46052,213511,485996,562457,562457
Maldives,2048,MV,MDV,SEA,14336,25380,39716,28040,38372,30476,34950,72853,68490,273181,13597,24084,37681,26505,36223,29329,29823,43995,48640,214515,487696,565094,565094
Maldives,2049,MV,MDV,SEA,14434,25777,40211,27189,37759,32499,31264,71718,73347,273776,13692,24462,38154,25697,35695,30859,28048,43730,51423,215452,489228,567593,567593
Maldives,2050,MV,MDV,SEA,14470,26225,40695,26465,37026,34403,28295,69506,78581,274276,13725,24885,38610,25009,34927,32407,26545,43083,54356,216327,490603,569909,569909
Mexico,1970,MX,MEX,AMR,4805672,7269060,12074732,4930270,3082692,2062150,1421298,932943,738700,13168053,4678684,7104505,11783189,4738290,3056096,2225410,1458377,985969,799188,13263330,26431383,50289306,50289306
Mexico,1971,MX,MEX,AMR,4913584,7501829,12415413,5094783,3193674,2124556,1472100,953532,772639,13611284,4783018,7361328,12144346,4919701,3166404,2276677,1515780,1008831,839246,13726639,27337923,51897675,51897675
Mexico,1972,MX,MEX,AMR,5004844,7718683,12723527,5237325,3318831,2208421,1530819,977241,815640,14088277,4870675,7616898,12487573,5110794,3300644,2334504,1578459,1031043,888610,14244054,28332331,53543436,53543436
Mexico,1973,MX,MEX,AMR,5096675,7945885,13042560,5381275,3445065,2296736,1590211,1002124,860265,14575676,4958472,7867537,12826009,5309609,3439061,2397862,1643708,1053728,939988,14783956,29359632,55228203,55228203
Mexico,1974,MX,MEX,AMR,5193066,8174756,13367822,5530264,3563781,2392752,1649438,1029582,905872,15071689,5050921,8108495,13159416,5520371,3573254,2473096,1709067,1078299,992866,15346953,30418642,56945880,56945880
Mexico,1975,MX,MEX,AMR,5295866,8401707,13697573,5687974,3671115,2494084,1709368,1060099,952021,15574661,5148446,8338994,13487440,5744780,3700297,2561383,1773221,1105652,1046870,15932203,31506864,58691882,58691882
Mexico,1976,MX,MEX,AMR,5391541,8634867,14026408,5847470,3768507,2598366,1772334,1095247,998131,16080055,5239246,8567092,13806338,5977194,3826357,2661468,1835923,1137594,1101211,16539747,32619802,60452543,60452543
Mexico,1977,MX,MEX,AMR,5475720,8884573,14360293,6027650,3873640,2695449,1835059,1134718,1043696,16610212,5319384,8799008,14118392,6217937,3963528,2763003,1899086,1175156,1154899,17173609,33783821,62262505,62262505
Mexico,1978,MX,MEX,AMR,5552125,9142007,14694132,6234975,3993501,2781773,1897162,1177930,1088543,17173884,5391143,9030027,14421170,6466565,4117342,2861260,1964170,1218061,1207415,17834813,35008697,64123997,64123997
Mexico,1979,MX,MEX,AMR,5605809,9397907,15003716,6450922,4115856,2864182,1963285,1224819,1133092,17752156,5441579,9256237,14697816,6719228,4283203,2961229,2031425,1265068,1259072,18519225,36271381,65972912,65972912
Mexico,1980,MX,MEX,AMR,5629302,9627580,15256882,6670123,4247229,2937351,2028743,1271630,1172435,18327511,5463709,9465395,14929104,6960888,4458542,3052893,2100310,1313061,1305992,19191686,37519197,67705186,67705186
Mexico,1981,MX,MEX,AMR,5628987,9804471,15433458,6876422,4396388,2998515,2086940,1316133,1203065,18877463,5463216,9646841,15110057,7170817,4640667,3127663,2167105,1361389,1345148,19812789,38690252,69233769,69233769
Mexico,1982,MX,MEX,AMR,5617893,9952195,15570088,7063529,4559776,3057309,2141095,1360430,1231983,19414122,5452016,9812042,15264058,7354971,4830631,3196478,2231870,1412420,1382137,20408507,39822629,70656783,70656783
Mexico,1983,MX,MEX,AMR,5606462,10089827,15696289,7242260,4730239,3123017,2196831,1405404,1264178,19961929,5441792,9962667,15404459,7532304,5028336,3272059,2297531,1466292,1421117,21017639,40979568,72080310,72080310
Mexico,1984,MX,MEX,AMR,5599626,10206586,15806212,7416552,4901207,3197799,2253778,1449957,1299812,20519105,5437944,10084874,15522818,7710196,5226765,3357009,2363678,1521287,1462588,21641523,42160628,73489654,73489654
Mexico,1985,MX,MEX,AMR,5594608,10305925,15900533,7585697,5062695,3286928,2309768,1493856,1339289,21078233,5435021,10181102,15616123,7892149,5415875,3456904,2428322,1576121,1507747,22277118,43355351,74872006,74872006
Mexico,1986,MX,MEX,AMR,5582161,10389910,15972071,7756802,5212167,3393404,2362561,1537117,1382505,21644556,5423653,10255091,15678744,8083206,5594370,3574948,2489346,1630035,1557097,22929002,44573558,76224365,76224365
Mexico,1987,MX,MEX,AMR,5571234,10445783,16017017,7936961,5353700,3513398,2412283,1580132,1428647,22225121,5412519,10298366,15710885,8285579,5766727,3708133,2546815,1683288,1609941,23600483,45825604,77553504,77553504
Mexico,1988,MX,MEX,AMR,5578202,10476495,16054697,8123319,5489861,3643213,2461443,1624059,1476204,22818099,5416515,10314163,15730678,8493246,5935507,3854593,2603201,1737208,1664790,24288545,47106644,78892015,78892015
Mexico,1989,MX,MEX,AMR,5595797,10494137,16089934,8312361,5617976,3779335,2512508,1667940,1524748,23414868,5431175,10311798,15742973,8701346,6100337,4011218,2660851,1790675,1721548,24985975,48400843,80233749,80233749
Mexico,1990,MX,MEX,AMR,5629714,10506107,16135821,8519547,5768102,3922759,2575204,1715012,1574421,24075045,5463037,10312281,15775318,8911172,6284303,4178348,2731531,1846222,1782667,25734243,49809288,81720428,81720428
Mexico,1991,MX,MEX,AMR,5679185,10508012,16187197,8724260,5957676,4071753,2651403,1769287,1626350,24800729,5508791,10329313,15838104,9101013,6497290,4352212,2817458,1908762,1848829,26525564,51326293,83351595,83351595
Mexico,1992,MX,MEX,AMR,5725128,10521823,16246951,8892565,6161604,4223777,2732959,1828290,1682026,25521221,5551115,10366821,15917936,9253330,6719156,4529712,2908904,1977215,1918742,27307059,52828280,84993164,84993164
Mexico,1993,MX,MEX,AMR,5764940,10569461,16334401,9021257,6368281,4381610,2819588,1889318,1741605,26221659,5589713,10426666,16016379,9373483,6941578,4714199,3005851,2048781,1992108,28076000,54297659,86648447,86648447
Mexico,1994,MX,MEX,AMR,5799108,10641765,16440873,9122926,6571901,4545696,2912289,1951167,1805194,26909173,5623997,10496940,16120937,9477341,7159537,4905907,3109910,2121749,2068998,28843442,55752615,88314424,88314424
Mexico,1995,MX,MEX,AMR,5818448,10737998,16556446,9202106,6765568,4712670,3015294,2013145,1873114,27581897,5642869,10577457,16220326,9572449,7367800,5100878,3225132,2194787,2149854,29610900,57192797,89969572,89969572
Mexico,1996,MX,MEX,AMR,5814117,10850426,16664543,9257300,6950044,4884732,3129923,2073657,1946003,28241659,5638681,10664691,16303372,9655434,7567112,5300948,3352247,2265882,2235355,30376978,58618637,91586555,91586555
Mexico,1997,MX,MEX,AMR,5793993,10964591,16758584,9307781,7124618,5064273,3252968,2132865,2024281,28906786,5619613,10748098,16367711,9733654,7758290,5508888,3488684,2334813,2325688,31150017,60056803,93183094,93183094
Mexico,1998,MX,MEX,AMR,5769300,11077605,16846905,9362383,7279549,5247323,3383626,2193801,2107003,29573685,5594444,10829369,16423813,9809172,7935257,5720523,3634038,2404142,2419744,31922876,61496561,94767284,94767284
Mexico,1999,MX,MEX,AMR,5741142,11185337,16926479,9431214,7406395,5432310,3520382,2257825,2193678,30241804,5565554,10907519,16473073,9888237,8093041,5933769,3786353,2474994,2517067,32693461,62935265,96334810,96334810
Mexico,2000,MX,MEX,AMR,5729953,11257967,16987920,9497318,7528834,5615261,3663588,2325686,2281447,30912134,5553636,10969347,16522983,9953145,8243657,6141781,3947270,2548112,2616437,33450402,64362536,97873442,97873442
Mexico,2001,MX,MEX,AMR,5748418,11292473,17040891,9558921,7662578,5790931,3812121,2398198,2371899,31594648,5568456,11005636,16574092,9998031,8389950,6333822,4114768,2625346,2722746,34184663,65779311,99394288,99394288
Mexico,2002,MX,MEX,AMR,5777436,11311786,17089222,9637379,7790615,5961930,3965011,2475675,2466524,32297134,5592683,11025000,16617683,10041986,8525123,6514621,4286705,2708131,2836474,34913040,67210174,100917081,100917081
Mexico,2003,MX,MEX,AMR,5803122,11325622,17128744,9718564,7909026,6131756,4124918,2557592,2562001,33003857,5615203,11041283,16656486,10081572,8652184,6692015,4466829,2796377,2951281,35640258,68644115,102429341,102429341
Mexico,2004,MX,MEX,AMR,5815964,11340242,17156206,9812742,8021531,6299107,4291282,2643645,2656728,33725035,5626335,11054959,16681294,10131697,8773406,6866513,4655260,2890471,3065930,36383277,70108312,103945813,103945813
Mexico,2005,MX,MEX,AMR,5807906,11356583,17164489,9923345,8120487,6464161,4457280,2739668,2749865,34454806,5617351,11065101,16682452,10201244,8880692,7038525,4844580,2996275,3179336,37140652,71595458,105442402,105442402
Mexico,2006,MX,MEX,AMR,5783894,11371681,17155575,10028475,8203693,6630772,4622802,2846603,2841775,35174120,5593092,11071311,16664403,10273494,8969132,7210575,5033603,3114359,3291531,37892694,73066814,106886790,106886790
Mexico,2007,MX,MEX,AMR,5757357,11380833,17138190,10121721,8283136,6797363,4790057,2961310,2932533,35886120,5566564,11071977,16638541,10338930,9048356,7383015,5224807,3242148,3402865,38640121,74526241,108302973,108302973
Mexico,2008,MX,MEX,AMR,5731428,11385172,17116600,10204950,8355978,6958462,4956127,3083607,3023573,36582697,5540611,11068724,16609335,10400192,9115235,7550698,5415179,3379877,3514675,39375856,75958553,109684489,109684489
Mexico,2009,MX,MEX,AMR,5708022,11383318,17091340,10286818,8427893,7109372,5122447,3210986,3114836,37272352,5517056,11059435,16576491,10463015,9176051,7711279,5605638,3525369,3627888,40109240,77381592,111049428,111049428
Mexico,2010,MX,MEX,AMR,5690165,11388542,17078707,10404758,8523288,7247012,5290848,3340576,3201219,38007701,5498740,11053601,16552341,10544591,9259216,7871924,5799515,3677084,3741318,40893648,78901349,112532401,112532401
Mexico,2011,MX,MEX,AMR,5680615,11405375,17085990,10525648,8635884,7382611,5464267,3480428,3307249,38796087,5488375,11057288,16545663,10622858,9356246,8035249,5996278,3840197,3871917,41722745,80518832,114150481,114150481
Mexico,2012,MX,MEX,AMR,5671633,11404598,17076231,10599960,8763946,7521790,5641919,3634259,3436006,39597880,5479317,11052648,16531965,10669510,9449748,8195488,6193965,4017510,4023612,42549833,82147713,115755909,115755909
Mexico,2013,MX,MEX,AMR,5650824,11377345,17028169,10651364,8904223,7659726,5820761,3796297,3567326,40399697,5460203,11030224,16490427,10700662,9541845,8349214,6391795,4206066,4182808,43372390,83772087,117290686,117290686
Mexico,2014,MX,MEX,AMR,5614203,11336344,16950547,10686036,9041489,7795870,6000073,3964146,3707199,41194813,5427490,10994499,16421989,10719082,9635168,8492505,6587743,4403165,4350873,44188536,85383349,118755887,118755887
Mexico,2015,MX,MEX,AMR,5563026,11282292,16845318,10706154,9175649,7926543,6180754,4131104,3859257,41979461,5383816,10944579,16328395,10725152,9734035,8621438,6783193,4601094,4531812,44996724,86976185,120149897,120149897
Mexico,2016,MX,MEX,AMR,5502228,11234549,16736777,10733993,9299608,8042687,6361093,4292520,4022956,42752857,5331111,10897648,16228759,10733224,9832288,8737170,6978226,4795105,4724826,45800839,88553696,121519221,121519221
Mexico,2017,MX,MEX,AMR,5431847,11194715,16626562,10758745,9403141,8153695,6539425,4450707,4194336,43500049,5269503,10857885,16127388,10737294,9918992,8845870,7170065,4986896,4926130,46585247,90085296,122839258,122839258
Mexico,2018,MX,MEX,AMR,5340893,11142014,16482907,10753218,9477152,8271404,6717927,4609364,4373194,44202259,5192562,10809668,16002230,10721649,9986137,8947125,7356909,5178212,5136438,47326470,91528729,124013861,124013861
Mexico,2019,MX,MEX,AMR,5234315,11097379,16331694,10752972,9558004,8371896,6884077,4762581,4526002,44855532,5092686,10769986,15862672,10706297,10056294,9041059,7534317,5364341,5333105,48035413,92890945,125085311,125085311
Mexico,2020,MX,MEX,AMR,5130815,11066376,16197191,10771978,9655211,8448329,7017128,4886786,4610832,45390264,4984496,10742258,15726754,10701270,10131883,9129086,7693637,5532433,5495794,48684103,94074367,125998302,125998302
Mexico,2021,MX,MEX,AMR,5021850,11022225,16044075,10780097,9738587,8517807,7130833,4988679,4656062,45812065,4870662,10702166,15572828,10691876,10192789,9209431,7841749,5690650,5649679,49276174,95088239,126705138,126705138
Mexico,2022,MX,MEX,AMR,4909540,10947835,15857375,10779867,9813214,8599623,7256130,5123440,4765302,46337576,4754419,10635761,15390180,10679168,10244412,9290436,7990759,5867172,5847048,49918995,96256571,127504125,127504125
Mexico,2023,MX,MEX,AMR,4819931,10836889,15656820,10780564,9884414,8695609,7387826,5291883,4944252,46984548,4659990,10537538,15197528,10667062,10291129,9375508,8136013,6059418,6087543,50616673,97601221,128455567,128455567
Mexico,2024,MX,MEX,AMR,4753490,10698687,15452177,10776835,9948742,8795240,7511755,5461037,5132404,47626013,4592730,10408872,15001602,10652729,10329404,9461722,8272658,6251212,6340952,51308677,98934690,129388467,129388467
Mexico,2025,MX,MEX,AMR,4693480,10551710,15245190,10766510,10007417,8901294,7625303,5629510,5329612,48259646,4536570,10266737,14803307,10634672,10359453,9552467,8398390,6441643,6606630,51993255,100252901,130301391,130301391
Mexico,2026,MX,MEX,AMR,4651083,10386664,15037747,10749825,10059644,9010329,7729461,5799437,5534705,48883401,4496908,10106801,14603709,10613166,10381743,9644822,8514003,6631751,6883707,52669192,101552593,131194049,131194049
Mexico,2027,MX,MEX,AMR,4627770,10203160,14830930,10724350,10102566,9119457,7830357,5968567,5748533,49493830,4475002,9928415,14403417,10587077,10395087,9734980,8623852,6819421,7172582,53332999,102826829,132061171,132061171
Mexico,2028,MX,MEX,AMR,4606067,10021751,14627818,10689945,10137586,9229800,7927659,6132423,5970979,50088392,4454104,9751419,14205523,10555699,10401318,9823496,8727134,7001623,7472847,53982117,104070509,132903856,132903856
Mexico,2029,MX,MEX,AMR,4587513,9846380,14433893,10650022,10161683,9339624,8022981,6289575,6201361,50665246,4436053,9579104,14015157,10520626,10399183,9908756,8825723,7176907,7783756,54614951,105280197,133729252,133729252
Mexico,2030,MX,MEX,AMR,4571302,9678897,14250199,10605169,10175421,9441582,8120422,6439140,6440001,51221735,4420289,9412535,13832824,10481701,10390919,9984186,8923055,7344235,8105262,55229358,106451093,134534107,134534107
Mexico,1950,MX,MEX,AMR,2590675,3593142,6183817,2504230,1818666,1365811,934426,534698,400114,7557945,2539731,3458827,5998558,2684616,1863566,1389398,934221,563370,424640,7859811,15417756,27600133,27600133
Mexico,1951,MX,MEX,AMR,2678721,3710246,6388967,2565952,1867954,1378732,960054,542837,407486,7723015,2620780,3577213,6197993,2725065,1923494,1404990,960193,570321,433978,8018041,15741056,28328015,28328015
Mexico,1952,MX,MEX,AMR,2762824,3834990,6597814,2629769,1919645,1389191,982574,554663,417497,7893339,2697890,3707091,6404981,2759793,1984500,1414159,982218,578818,446036,8165524,16058863,29061666,29061666
Mexico,1953,MX,MEX,AMR,2839741,3975355,6815096,2697352,1972059,1400821,1004058,569916,427919,8072125,2768584,3853168,6621752,2792847,2047692,1421559,1002901,589926,458195,8313120,16385245,29822095,29822095
Mexico,1954,MX,MEX,AMR,2915932,4124224,7040156,2773035,2022942,1415299,1024909,587782,438807,8262774,2839497,4004635,6844132,2832701,2111076,1429480,1022919,603168,470492,8469836,16732610,30616896,30616896
Mexico,1955,MX,MEX,AMR,3000688,4273325,7274013,2857246,2072303,1433083,1044306,608676,450231,8465845,2919418,4150511,7069929,2884832,2173226,1439888,1041873,619480,483063,8642362,17108207,31452141,31452141
Mexico,1956,MX,MEX,AMR,3090946,4424223,7515169,2949571,2120446,1455895,1061873,631937,462047,8681769,3004481,4291848,7296329,2951277,2232637,1455539,1059206,638237,495784,8832680,17514449,32325944,32325944
Mexico,1957,MX,MEX,AMR,3183471,4581992,7765463,3048028,2166671,1485993,1077965,656403,474067,8909127,3092206,4433552,7525758,3030582,2287673,1479182,1075310,657910,508526,9039183,17948310,33239529,33239529
Mexico,1958,MX,MEX,AMR,3277967,4747704,8025671,3148909,2210231,1523140,1092022,681606,486307,9142215,3181533,4577977,7759510,3119075,2335819,1509655,1089222,677623,521306,9252700,18394915,34180095,34180095
Mexico,1959,MX,MEX,AMR,3376118,4923854,8299972,3255264,2253864,1566741,1106395,706792,498952,9388008,3276329,4731881,8008210,3216550,2381712,1548759,1103980,698023,534216,9483240,18871248,35179431,35179431
Mexico,1960,MX,MEX,AMR,3483090,5113007,8596097,3364693,2299208,1613735,1123747,731044,510622,9643049,3385790,4904229,8290019,3316445,2429902,1599686,1124767,721842,546256,9738898,19381947,36268055,36268055
Mexico,1961,MX,MEX,AMR,3598474,5310575,8909049,3478241,2351644,1663297,1142708,753967,523609,9913466,3505968,5092923,8598891,3421326,2479521,1660384,1148645,748175,559855,10017906,19931372,37439317,37439317
Mexico,1962,MX,MEX,AMR,3720316,5508612,9228928,3607012,2411610,1716113,1162137,775900,540947,10213719,3629865,5289338,8919203,3543152,2526541,1727572,1171703,774577,577888,10321433,20535152,38683283,38683283
Mexico,1963,MX,MEX,AMR,3849408,5701836,9551244,3753402,2475617,1768673,1183150,797676,560969,10539487,3757973,5486923,9244896,3682309,2570164,1798422,1195061,801612,598920,10646488,21185975,39982118,39982118
Mexico,1964,MX,MEX,AMR,3985363,5896664,9882027,3909536,2546684,1818676,1206476,819465,582950,10883787,3890245,5690499,9580744,3828598,2617327,1870071,1219585,829413,622332,10987326,21871113,41333878,41333878
Mexico,1965,MX,MEX,AMR,4125920,6103802,10229722,4066863,2625219,1866142,1231960,840403,607199,11237786,4025696,5907916,9933612,3971778,2673252,1940284,1245932,856911,648715,11336872,22574658,42737991,42737991
Mexico,1966,MX,MEX,AMR,4268059,6320495,10588554,4225516,2709816,1910779,1260776,860202,633040,11600129,4162247,6134123,10296370,4112280,2738316,2007349,1276391,883610,677438,11695384,23295513,44180437,44180437
Mexico,1967,MX,MEX,AMR,4408465,6543906,10952371,4390392,2798890,1951945,1294876,879168,659448,11974719,4296950,6365971,10662921,4255608,2810953,2069888,1313503,909899,707111,12066962,24041681,45656963,45656963
Mexico,1968,MX,MEX,AMR,4545413,6776408,11321821,4563931,2890508,1989557,1334552,897356,686155,12362059,4428389,6605150,11033539,4406671,2888402,2127158,1357369,936001,737316,12452917,24814976,47170337,47170337
Mexico,1969,MX,MEX,AMR,4678399,7018088,11696487,4744587,2985004,2024357,1377540,915236,712662,12759386,4556128,6851351,11407479,4567319,2969549,2178515,1406081,961699,767882,12851045,25610431,48714394,48714394
Mexico,2031,MX,MEX,AMR,4556746,9524933,14081679,10549546,10186418,9531064,8215127,6584403,6686255,51752813,4406146,9258249,13664395,10431692,10383141,10047472,9015042,7505512,8436490,55819349,107572162,135318243,135318243
Mexico,2032,MX,MEX,AMR,4545178,9389721,13934899,10473389,10195918,9610668,8309366,6722832,6940020,52252193,4394788,9121125,13515913,10362533,10375455,10102079,9102445,7659185,8776855,56378552,108630745,136081567,136081567
Mexico,2033,MX,MEX,AMR,4532989,9280327,13813316,10366835,10201583,9683960,8407279,6851724,7201277,52712658,4382760,9007280,13390040,10266591,10365309,10149936,9188869,7803518,9126136,56900359,109613017,136816372,136816372
Mexico,2034,MX,MEX,AMR,4517635,9196553,13714188,10232224,10202789,9750871,8509011,6974113,7468714,53137722,4367696,8922945,13290641,10139674,10352713,10189346,9276513,7939991,9482944,57381181,110518903,137523732,137523732
Mexico,2035,MX,MEX,AMR,4498669,9120951,13619620,10087788,10197411,9812762,8617143,7087536,7741386,53544026,4349145,8851519,13200664,9998638,10336159,10220579,9368689,8066386,9846174,57836625,111380651,138200922,138200922
Mexico,2036,MX,MEX,AMR,4475081,9064126,13539207,9924571,10185352,9868636,8728386,7192928,8020313,53920186,4326033,8797859,13123892,9839349,10315819,10244029,9462472,8183411,10215935,58261015,112181201,138844304,138844304
Mexico,2037,MX,MEX,AMR,4447532,9029540,13477072,9743876,10165706,9915696,8839361,7295398,8302835,54262872,4299059,8764837,13063896,9662236,10291581,10258926,9554076,8294905,10589737,58651461,112914333,139455296,139455296
Mexico,2038,MX,MEX,AMR,4416601,8996203,13412804,9565753,10137284,9955103,8951419,7394620,8585895,54590074,4268749,8732323,13001072,9486772,10262140,10266848,9643975,8400059,10965089,59024883,113614957,140028842,140028842
Mexico,2039,MX,MEX,AMR,4379748,8962762,13342510,9393164,10102727,9984012,9063240,7492344,8868682,54904169,4232708,8699545,12932253,9315632,10228567,10266394,9730629,8500841,11340521,59382584,114286753,140561518,140561518
Mexico,2040,MX,MEX,AMR,4338952,8928087,13267039,9228436,10063554,10003157,9167508,7592239,9150373,55205267,4192863,8665543,12858406,9150231,10191275,10260016,9807619,8600485,11714821,59724447,114929714,141055171,141055171
Mexico,2041,MX,MEX,AMR,4295589,8890654,13186243,9077035,10012664,10019348,9260155,7690059,9434214,55493475,4150482,8628746,12779228,8996923,10142364,10253883,9872579,8695150,12090006,60050905,115544380,141509850,141509850
Mexico,2042,MX,MEX,AMR,4249140,8852308,13101448,8944086,9940357,10033565,9343731,7787809,9717912,55767460,4105224,8590947,12696171,8860530,10073756,10247478,9928906,8785493,12464090,60360253,116127713,141925337,141925337
Mexico,2043,MX,MEX,AMR,4200665,8809784,13010449,8836552,9837980,10043897,9421464,7889203,9998836,56027932,4058214,8549043,12607257,8747215,9978386,10238506,9978610,8874938,12834649,60652304,116680236,142297951,142297951
Mexico,2044,MX,MEX,AMR,4151549,8758163,12909712,8754719,9708735,10049905,9492969,7994236,10277742,56278306,4010679,8498363,12509042,8663540,9852645,10227214,10020090,8965598,13201692,60930779,117209085,142627834,142627834
Mexico,2045,MX,MEX,AMR,4103020,8699001,12802021,8681401,9570893,10049701,9559407,8105094,10551466,56517962,3963628,8440386,12404014,8593035,9713463,10212236,10053625,9060553,13562196,61195108,117713070,142919109,142919109
Mexico,2046,MX,MEX,AMR,4054833,8632647,12687480,8626921,9415133,10043185,9619945,8218873,10822494,56746551,3916946,8375290,12292236,8540424,9556469,10193691,10079577,9157055,13917511,61444727,118191278,143170995,143170995
Mexico,2047,MX,MEX,AMR,4007402,8559155,12566557,8594173,9241706,10029268,9672204,8332744,11094119,56964214,3871029,8303398,12174427,8508215,9381501,10171222,10097143,9251555,14269557,61679193,118643407,143384384,143384384
Mexico,2048,MX,MEX,AMR,3959188,8480185,12439373,8562268,9070221,10006729,9717367,8447890,11363820,57168295,3824324,8226372,12050696,8476260,9207842,10143464,10107846,9344439,14615702,61895553,119063848,143553921,143553921
Mexico,2049,MX,MEX,AMR,3910543,8394669,12305212,8530285,8904244,9978178,9752375,8562898,11631895,57359875,3777146,8143095,11920241,8444072,9038543,10111629,10110291,9434140,14956433,62095108,119454983,143680430,143680430
Mexico,2050,MX,MEX,AMR,3863485,8305828,12169313,8497109,8746070,9945059,9777783,8670891,11900919,57537831,3731558,8056510,11788068,8410714,8875032,10076125,10106835,9514457,15293994,62277157,119814988,143772364,143772364
Marshall Islands,1970,MH,MHL,WPR,2477,3453,5930,2087,1469,1280,991,570,394,6791,2336,3260,5596,2042,1089,927,755,453,392,5658,12449,23969,23969
Marshall Islands,1971,MH,MHL,WPR,2552,3577,6129,2207,1468,1241,987,595,394,6892,2404,3396,5800,2162,1116,922,765,484,406,5855,12747,24680,24680
Marshall Islands,1972,MH,MHL,WPR,2622,3649,6271,2344,1422,1122,906,604,428,6826,2469,3485,5954,2267,1161,889,756,517,447,6037,12863,25084,25084
Marshall Islands,1973,MH,MHL,WPR,2705,3704,6409,2483,1404,1008,813,608,450,6766,2548,3558,6106,2370,1232,857,744,541,494,6238,13004,25522,25522
Marshall Islands,1974,MH,MHL,WPR,2814,3785,6599,2579,1458,945,780,616,461,6839,2651,3650,6301,2459,1331,835,738,559,518,6440,13279,26174,26174
Marshall Islands,1975,MH,MHL,WPR,2950,3915,6865,2625,1558,940,793,631,457,7004,2779,3770,6549,2542,1426,835,742,573,512,6630,13634,27047,27047
Marshall Islands,1976,MH,MHL,WPR,3079,4080,7159,2650,1661,947,798,646,453,7155,2906,3905,6811,2633,1521,835,748,584,515,6836,13991,27964,27964
Marshall Islands,1977,MH,MHL,WPR,3209,4272,7481,2654,1768,962,805,662,450,7301,3030,4055,7085,2715,1619,850,751,593,516,7044,14345,28912,28912
Marshall Islands,1978,MH,MHL,WPR,3339,4485,7824,2649,1879,984,807,676,447,7442,3153,4222,7375,2786,1722,874,750,601,514,7247,14689,29892,29892
Marshall Islands,1979,MH,MHL,WPR,3455,4711,8166,2654,1981,1015,817,681,451,7599,3262,4410,7672,2852,1821,905,750,608,522,7458,15057,30902,30902
Marshall Islands,1980,MH,MHL,WPR,3566,4939,8505,2704,2076,1061,826,681,461,7809,3362,4617,7979,2927,1931,939,760,615,525,7697,15506,31988,31988
Marshall Islands,1981,MH,MHL,WPR,3692,5145,8837,2829,2172,1128,828,670,479,8106,3477,4821,8298,3016,2047,992,767,621,534,7977,16083,33219,33219
Marshall Islands,1982,MH,MHL,WPR,3843,5339,9182,2993,2271,1212,823,658,508,8465,3614,5015,8629,3119,2157,1060,775,627,550,8288,16753,34569,34569
Marshall Islands,1983,MH,MHL,WPR,4000,5545,9545,3158,2363,1308,822,656,530,8837,3767,5210,8977,3231,2266,1145,778,632,561,8613,17450,35975,35975
Marshall Islands,1984,MH,MHL,WPR,4162,5770,9932,3314,2449,1415,822,659,545,9204,3922,5415,9337,3354,2361,1249,777,640,580,8961,18165,37437,37437
Marshall Islands,1985,MH,MHL,WPR,4321,6019,10340,3466,2538,1534,831,663,560,9592,4070,5650,9720,3480,2456,1351,769,653,599,9308,18900,38962,38962
Marshall Islands,1986,MH,MHL,WPR,4461,6305,10766,3601,2633,1656,850,672,570,9982,4203,5918,10121,3597,2559,1450,767,665,615,9653,19635,40527,40527
Marshall Islands,1987,MH,MHL,WPR,4580,6633,11213,3715,2736,1782,881,677,578,10369,4313,6221,10534,3703,2658,1563,779,671,631,10005,20374,42122,42122
Marshall Islands,1988,MH,MHL,WPR,4659,6970,11629,3830,2837,1914,919,678,591,10769,4391,6539,10930,3806,2763,1681,801,667,648,10366,21135,43687,43687
Marshall Islands,1989,MH,MHL,WPR,4688,7230,11918,3977,2905,2037,958,675,590,11142,4416,6801,11217,3919,2853,1787,832,657,659,10707,21849,44988,44988
Marshall Islands,1990,MH,MHL,WPR,4683,7406,12089,4158,2948,2152,997,674,584,11513,4406,7000,11406,4042,2927,1886,869,649,670,11043,22556,46047,46047
Marshall Islands,1991,MH,MHL,WPR,4669,7564,12233,4332,2994,2254,1049,675,579,11883,4384,7173,11557,4176,2992,1987,910,646,673,11384,23267,47053,47053
Marshall Islands,1992,MH,MHL,WPR,4653,7710,12363,4497,3050,2341,1114,669,573,12244,4365,7323,11688,4315,3053,2077,964,641,675,11725,23969,48015,48015
Marshall Islands,1993,MH,MHL,WPR,4644,7823,12467,4657,3114,2411,1196,667,577,12622,4355,7439,11794,4462,3108,2159,1028,640,668,12065,24687,48944,48944
Marshall Islands,1994,MH,MHL,WPR,4635,7914,12549,4816,3182,2470,1292,666,576,13002,4345,7522,11867,4623,3163,2229,1110,635,660,12420,25422,49840,49840
Marshall Islands,1995,MH,MHL,WPR,4614,7988,12602,4976,3258,2517,1403,660,578,13392,4330,7584,11914,4788,3224,2300,1193,631,653,12789,26181,50702,50702
Marshall Islands,1996,MH,MHL,WPR,4592,8057,12649,5123,3341,2558,1517,665,577,13781,4314,7634,11948,4956,3280,2375,1275,631,644,13161,26942,51538,51538
Marshall Islands,1997,MH,MHL,WPR,4572,8122,12694,5269,3424,2590,1634,675,569,14161,4295,7673,11968,5122,3341,2442,1364,641,623,13533,27694,52358,52358
Marshall Islands,1998,MH,MHL,WPR,4558,8186,12744,5398,3494,2623,1756,691,562,14524,4284,7708,11992,5274,3407,2504,1458,659,598,13900,28424,53164,53164
Marshall Islands,1999,MH,MHL,WPR,4530,8192,12722,5536,3563,2655,1863,717,560,14894,4260,7699,11959,5425,3474,2552,1542,679,588,14260,29154,53834,53834
Marshall Islands,2000,MH,MHL,WPR,4475,8094,12569,5688,3619,2687,1946,747,561,15248,4204,7597,11801,5575,3537,2589,1628,688,596,14613,29861,54224,54224
Marshall Islands,2001,MH,MHL,WPR,4400,7931,12331,5828,3672,2723,2008,785,561,15577,4127,7442,11569,5704,3603,2610,1714,699,604,14934,30511,54413,54413
Marshall Islands,2002,MH,MHL,WPR,4317,7760,12077,5935,3726,2762,2058,839,554,15874,4036,7278,11314,5801,3666,2645,1780,724,619,15235,31109,54496,54496
Marshall Islands,2003,MH,MHL,WPR,4224,7594,11818,5996,3785,2795,2087,906,545,16114,3937,7121,11058,5853,3732,2691,1826,765,630,15497,31611,54493,54493
Marshall Islands,2004,MH,MHL,WPR,4126,7438,11564,6016,3856,2834,2106,986,541,16339,3841,6972,10813,5865,3799,2740,1865,825,625,15719,32058,54435,54435
Marshall Islands,2005,MH,MHL,WPR,4037,7284,11321,5996,3926,2874,2123,1073,530,16522,3762,6836,10598,5829,3878,2785,1905,887,614,15898,32420,54337,54337
Marshall Islands,2006,MH,MHL,WPR,3988,7146,11134,5928,3986,2921,2128,1144,524,16631,3718,6694,10412,5746,3969,2826,1950,933,605,16029,32660,54208,54208
Marshall Islands,2007,MH,MHL,WPR,3964,7051,11015,5796,4049,2959,2131,1212,519,16666,3716,6564,10280,5601,4055,2861,1989,975,599,16080,32746,54038,54038
Marshall Islands,2008,MH,MHL,WPR,3940,6998,10938,5613,4082,2979,2140,1279,520,16613,3730,6474,10204,5416,4117,2894,2023,1019,591,16060,32673,53816,53816
Marshall Islands,2009,MH,MHL,WPR,3937,6976,10913,5414,4092,2992,2157,1338,523,16516,3736,6438,10174,5212,4156,2912,2049,1079,578,15986,32502,53593,53593
Marshall Islands,2010,MH,MHL,WPR,3983,6985,10968,5213,4069,3008,2176,1392,530,16388,3728,6452,10180,4995,4176,2927,2066,1155,563,15882,32270,53416,53416
Marshall Islands,2011,MH,MHL,WPR,3967,6930,10897,5007,4047,3036,2189,1435,533,16247,3681,6398,10079,4768,4188,2936,2079,1229,548,15748,31995,52971,52971
Marshall Islands,2012,MH,MHL,WPR,3866,6758,10624,4801,4050,3053,2194,1471,551,16120,3586,6249,9835,4544,4199,2951,2100,1274,558,15626,31746,52203,52203
Marshall Islands,2013,MH,MHL,WPR,3762,6549,10311,4609,4051,3059,2205,1490,586,16000,3472,6080,9552,4343,4191,2968,2130,1293,574,15499,31499,51352,51352
Marshall Islands,2014,MH,MHL,WPR,3616,6348,9964,4413,4026,3062,2230,1496,631,15858,3323,5898,9221,4170,4146,2987,2165,1305,604,15377,31235,50419,50419
Marshall Islands,2015,MH,MHL,WPR,3383,6208,9591,4219,3969,3079,2265,1499,679,15710,3144,5728,8872,4005,4048,3036,2193,1324,631,15237,30947,49410,49410
Marshall Islands,2016,MH,MHL,WPR,3141,6081,9222,4046,3855,3104,2302,1493,714,15514,2956,5578,8534,3838,3903,3099,2204,1355,653,15052,30566,48329,48329
Marshall Islands,2017,MH,MHL,WPR,2947,5916,8863,3907,3674,3136,2324,1492,750,15283,2772,5451,8223,3667,3712,3157,2222,1382,677,14817,30100,47187,47187
Marshall Islands,2018,MH,MHL,WPR,2763,5732,8495,3787,3459,3164,2327,1496,801,15034,2597,5298,7895,3515,3500,3197,2235,1406,709,14562,29596,45989,45989
Marshall Islands,2019,MH,MHL,WPR,2593,5517,8110,3656,3251,3171,2328,1513,842,14761,2437,5088,7525,3394,3287,3231,2237,1425,752,14326,29087,44728,44728
Marshall Islands,2020,MH,MHL,WPR,2429,5267,7696,3518,3050,3169,2341,1526,887,14491,2284,4830,7114,3284,3081,3259,2243,1430,812,14109,28600,43413,43413
Marshall Islands,2021,MH,MHL,WPR,2277,4975,7252,3384,2847,3167,2370,1537,922,14227,2141,4561,6702,3165,2862,3279,2254,1444,868,13872,28099,42050,42050
Marshall Islands,2022,MH,MHL,WPR,2162,4853,7015,3367,2715,3198,2410,1558,965,14213,2031,4447,6478,3151,2705,3315,2291,1482,922,13866,28079,41569,41569
Marshall Islands,2023,MH,MHL,WPR,2085,4896,6981,3475,2658,3250,2450,1593,1015,14441,1961,4477,6438,3257,2635,3365,2353,1541,980,14131,28572,41996,41996
Marshall Islands,2024,MH,MHL,WPR,2017,4888,6905,3608,2616,3283,2494,1639,1071,14711,1899,4469,6368,3370,2601,3381,2428,1609,1036,14425,29136,42415,42415
Marshall Islands,2025,MH,MHL,WPR,1962,4787,6749,3814,2595,3292,2550,1700,1116,15067,1846,4421,6267,3506,2595,3348,2526,1674,1099,14748,29815,42819,42819
Marshall Islands,2026,MH,MHL,WPR,1919,4657,6576,4037,2607,3243,2618,1757,1149,15411,1805,4345,6150,3671,2594,3276,2636,1725,1165,15067,30478,43209,43209
Marshall Islands,2027,MH,MHL,WPR,1900,4550,6450,4231,2675,3133,2694,1806,1186,15725,1787,4251,6038,3870,2603,3164,2741,1775,1227,15380,31105,43594,43594
Marshall Islands,2028,MH,MHL,WPR,1899,4434,6333,4408,2775,2999,2759,1840,1234,16015,1787,4151,5938,4054,2645,3039,2830,1830,1297,15695,31710,43978,43978
Marshall Islands,2029,MH,MHL,WPR,1901,4323,6224,4563,2885,2877,2815,1870,1295,16305,1790,4054,5844,4183,2729,2920,2911,1875,1368,15986,32291,44358,44358
Marshall Islands,2030,MH,MHL,WPR,1914,4215,6129,4672,3004,2775,2855,1917,1346,16569,1803,3962,5765,4266,2841,2814,2986,1924,1445,16276,32845,44733,44733
Marshall Islands,1950,MH,MHL,WPR,1341,1877,3218,817,825,633,480,395,373,3523,1225,1601,2826,857,790,641,471,376,363,3498,7021,13066,13066
Marshall Islands,1951,MH,MHL,WPR,1355,2031,3386,866,799,621,471,352,320,3429,1260,1729,2989,888,793,650,465,376,338,3510,6939,13316,13316
Marshall Islands,1952,MH,MHL,WPR,1369,2181,3550,946,764,605,449,289,249,3302,1285,1867,3152,943,804,654,455,373,306,3535,6837,13540,13540
Marshall Islands,1953,MH,MHL,WPR,1385,2319,3704,1059,715,578,420,223,175,3170,1307,2008,3315,1013,810,657,443,359,273,3555,6725,13747,13747
Marshall Islands,1954,MH,MHL,WPR,1401,2315,3716,1152,700,581,416,211,161,3221,1326,2039,3365,1077,807,659,445,358,272,3618,6839,13916,13916
Marshall Islands,1955,MH,MHL,WPR,1420,2192,3612,1195,720,611,443,255,223,3447,1342,1975,3317,1103,800,661,464,362,299,3689,7136,14062,14062
Marshall Islands,1956,MH,MHL,WPR,1440,2101,3541,1190,747,642,467,307,288,3641,1361,1925,3286,1102,790,659,477,372,331,3731,7372,14200,14200
Marshall Islands,1957,MH,MHL,WPR,1462,2053,3515,1130,779,668,490,358,359,3784,1378,1910,3288,1064,792,657,487,381,364,3745,7529,14329,14329
Marshall Islands,1958,MH,MHL,WPR,1485,2071,3556,1063,807,692,510,396,416,3884,1397,1938,3335,1028,802,656,495,391,384,3756,7640,14536,14536
Marshall Islands,1959,MH,MHL,WPR,1521,2150,3671,1073,820,703,522,413,436,3967,1431,2016,3447,1044,813,665,506,399,396,3823,7790,14905,14905
Marshall Islands,1960,MH,MHL,WPR,1569,2241,3810,1130,829,708,535,420,443,4065,1477,2108,3585,1092,821,677,517,398,407,3912,7977,15374,15374
Marshall Islands,1961,MH,MHL,WPR,1622,2335,3957,1197,837,715,549,425,449,4172,1527,2195,3722,1152,833,688,525,400,422,4020,8192,15867,15867
Marshall Islands,1962,MH,MHL,WPR,1681,2427,4108,1268,847,720,560,430,455,4280,1583,2283,3866,1223,844,696,534,404,430,4131,8411,16387,16387
Marshall Islands,1963,MH,MHL,WPR,1748,2516,4264,1341,859,728,570,439,474,4411,1650,2366,4016,1296,859,707,547,407,440,4256,8667,16947,16947
Marshall Islands,1964,MH,MHL,WPR,1814,2610,4424,1424,873,732,579,450,492,4550,1715,2449,4164,1380,874,718,559,411,463,4405,8955,17537,17537
Marshall Islands,1965,MH,MHL,WPR,1888,2705,4593,1509,894,737,584,457,518,4699,1783,2541,4324,1466,888,730,567,413,481,4545,9244,18154,18154
Marshall Islands,1966,MH,MHL,WPR,1960,2811,4771,1593,917,742,588,467,537,4844,1850,2637,4487,1543,910,741,580,419,495,4688,9532,18794,18794
Marshall Islands,1967,MH,MHL,WPR,2054,2929,4983,1696,991,793,624,473,539,5116,1938,2751,4689,1635,949,762,600,420,501,4867,9983,19665,19665
Marshall Islands,1968,MH,MHL,WPR,2198,3078,5276,1831,1151,948,726,492,502,5650,2070,2899,4969,1758,999,814,651,420,468,5110,10760,21001,21001
Marshall Islands,1969,MH,MHL,WPR,2358,3265,5623,1968,1344,1154,879,527,439,6311,2226,3077,5303,1900,1050,880,710,426,421,5387,11698,22623,22623
Marshall Islands,2031,MH,MHL,WPR,1932,4118,6050,4739,3149,2676,2900,1970,1387,16821,1820,3872,5692,4328,2957,2700,3051,1978,1523,16537,33358,45107,45107
Marshall Islands,2032,MH,MHL,WPR,1954,4030,5984,4789,3274,2604,2956,2018,1429,17070,1839,3791,5630,4381,3070,2604,3114,2035,1601,16805,33875,45484,45484
Marshall Islands,2033,MH,MHL,WPR,1977,3952,5929,4834,3385,2552,3003,2051,1469,17294,1862,3718,5580,4415,3174,2538,3164,2091,1675,17057,34351,45863,45863
Marshall Islands,2034,MH,MHL,WPR,2001,3889,5890,4828,3511,2515,3037,2095,1524,17510,1884,3660,5544,4408,3288,2507,3179,2159,1749,17290,34800,46235,46235
Marshall Islands,2035,MH,MHL,WPR,2026,3844,5870,4729,3714,2497,3040,2146,1578,17704,1905,3621,5526,4362,3419,2504,3155,2248,1824,17512,35216,46611,46611
Marshall Islands,2036,MH,MHL,WPR,2049,3822,5871,4598,3934,2511,3000,2205,1624,17872,1930,3600,5530,4288,3588,2507,3085,2351,1889,17708,35580,46988,46988
Marshall Islands,2037,MH,MHL,WPR,2072,3824,5896,4493,4126,2575,2896,2269,1660,18019,1951,3602,5553,4197,3782,2518,2983,2446,1961,17887,35906,47356,47356
Marshall Islands,2038,MH,MHL,WPR,2088,3846,5934,4378,4301,2674,2772,2328,1701,18154,1967,3623,5590,4098,3962,2558,2862,2528,2030,18038,36192,47719,47719
Marshall Islands,2039,MH,MHL,WPR,2102,3875,5977,4269,4451,2779,2661,2376,1750,18286,1983,3652,5635,4002,4093,2640,2751,2602,2100,18188,36474,48078,48078
Marshall Islands,2040,MH,MHL,WPR,2115,3912,6027,4164,4559,2899,2563,2412,1800,18397,1991,3686,5677,3912,4172,2752,2649,2668,2173,18326,36723,48434,48434
Marshall Islands,2041,MH,MHL,WPR,2121,3954,6075,4070,4623,3037,2476,2452,1860,18518,1999,3725,5724,3824,4239,2868,2549,2731,2258,18469,36987,48779,48779
Marshall Islands,2042,MH,MHL,WPR,2124,3996,6120,3981,4675,3160,2410,2497,1901,18624,2001,3763,5764,3746,4291,2976,2462,2787,2331,18593,37217,49109,49109
Marshall Islands,2043,MH,MHL,WPR,2122,4037,6159,3905,4716,3265,2369,2542,1937,18734,1999,3804,5803,3676,4325,3083,2404,2832,2407,18727,37461,49431,49431
Marshall Islands,2044,MH,MHL,WPR,2115,4076,6191,3847,4712,3394,2337,2570,1989,18849,1993,3842,5835,3623,4318,3194,2378,2845,2502,18860,37709,49737,49737
Marshall Islands,2045,MH,MHL,WPR,2102,4110,6212,3803,4617,3590,2322,2576,2053,18961,1981,3877,5858,3585,4277,3324,2375,2824,2603,18988,37949,50023,50023
Marshall Islands,2046,MH,MHL,WPR,2085,4139,6224,3778,4491,3803,2343,2539,2115,19069,1966,3908,5874,3561,4205,3490,2381,2767,2716,19120,38189,50294,50294
Marshall Islands,2047,MH,MHL,WPR,2064,4165,6229,3784,4390,3990,2406,2449,2176,19195,1948,3930,5878,3564,4119,3677,2390,2674,2825,19249,38444,50553,50553
Marshall Islands,2048,MH,MHL,WPR,2038,4181,6219,3806,4280,4162,2496,2344,2229,19317,1925,3945,5870,3588,4023,3856,2433,2564,2918,19382,38699,50791,50791
Marshall Islands,2049,MH,MHL,WPR,2013,4189,6202,3834,4175,4306,2596,2246,2281,19438,1899,3952,5851,3615,3933,3984,2512,2466,3006,19516,38954,51008,51008
Marshall Islands,2050,MH,MHL,WPR,1987,4188,6175,3871,4073,4410,2708,2165,2331,19558,1872,3954,5826,3649,3842,4064,2617,2376,3095,19643,39201,51211,51211
North Macedonia,1970,MK,MKD,EUR,89184,189817,279001,172062,124002,104248,66338,55423,36526,558599,84557,188062,272619,157945,111359,102797,69983,56647,47824,546555,1105154,1656783,1656783
North Macedonia,1971,MK,MKD,EUR,88429,188716,277145,175658,126990,106410,69909,55137,37857,571961,83719,186930,270649,162663,112791,103997,73830,56831,49141,559253,1131214,1679012,1679012
North Macedonia,1972,MK,MKD,EUR,88074,187140,275214,178683,130728,108219,73749,54465,39680,585524,83395,185045,268440,166901,115131,104856,77825,56762,50851,572326,1157850,1701498,1701498
North Macedonia,1973,MK,MKD,EUR,87978,185120,273098,181041,135548,109764,77648,53817,41993,599811,83207,182578,265785,170942,118945,105540,81634,56529,52948,586538,1186349,1725228,1725228
North Macedonia,1974,MK,MKD,EUR,88229,182828,271057,183134,140756,111023,81430,53183,44690,614216,83372,179643,263015,174800,123445,105965,85157,56312,55367,601046,1215262,1749329,1749329
North Macedonia,1975,MK,MKD,EUR,88907,180426,269333,185175,145882,112184,85041,52781,47535,628598,83900,176361,260261,178663,128287,106253,88349,56303,57960,615815,1244413,1774013,1774013
North Macedonia,1976,MK,MKD,EUR,89990,177986,267976,187199,150748,113418,88454,52817,50300,642936,84842,172724,257566,182517,133348,106500,91218,56703,60563,630849,1273785,1799332,1799332
North Macedonia,1977,MK,MKD,EUR,91334,175939,267273,188566,155579,114832,91664,53473,52785,656899,86052,169565,255617,185385,138759,106767,93781,57745,63069,645506,1302405,1825299,1825299
North Macedonia,1978,MK,MKD,EUR,92901,174717,267618,188763,160459,116555,94675,54919,54826,670197,87395,167509,254904,186659,144528,107183,96042,59584,65267,659263,1329460,1851978,1851978
North Macedonia,1979,MK,MKD,EUR,94650,174216,268866,188216,165115,118681,97449,57151,56351,682963,88879,166263,255142,186918,150350,107878,97994,62226,67021,672387,1355350,1879354,1879354
North Macedonia,1980,MK,MKD,EUR,96416,174232,270648,187426,169322,121256,99932,60007,57342,695285,90420,165711,256131,186562,155910,109029,99628,65482,68345,684956,1380241,1907023,1907023
North Macedonia,1981,MK,MKD,EUR,98244,174798,273042,186467,172877,124415,102090,63305,58077,707231,92132,165859,257991,185620,160949,110864,100954,69120,69433,696940,1404171,1935200,1935200
North Macedonia,1982,MK,MKD,EUR,99940,174803,274743,184329,175489,128154,103918,66718,58805,717413,93893,165621,259514,182914,165003,113512,102117,72599,70459,706604,1424017,1958275,1958275
North Macedonia,1983,MK,MKD,EUR,101129,174113,275242,180834,177092,132510,105370,70015,59558,725379,95283,164878,260161,178384,167980,117047,103113,75691,71444,713659,1439038,1974441,1974441
North Macedonia,1984,MK,MKD,EUR,101737,173762,275499,176881,178300,137213,106478,73229,60461,732562,96074,164571,260645,173200,170572,121206,103815,78621,72555,719969,1452531,1988682,1988682
North Macedonia,1985,MK,MKD,EUR,101674,173824,275498,172690,179348,141822,107441,76349,61593,739243,96132,164772,260904,167572,172995,125656,104332,81398,73901,725854,1465097,2001504,2001504
North Macedonia,1986,MK,MKD,EUR,100833,174389,275222,168343,180286,146160,108432,79371,62960,745552,95318,165635,260953,161519,175246,130264,104732,84028,75415,731204,1476756,2012926,2012926
North Macedonia,1987,MK,MKD,EUR,99128,175564,274692,164266,180485,150442,109546,82284,64538,751561,93579,167164,260743,155896,176375,135145,105066,86506,77111,736099,1487660,2023097,2023097
North Macedonia,1988,MK,MKD,EUR,96778,176997,273775,160889,179442,154733,110912,85046,66256,757278,91183,168906,260089,151349,175787,140294,105477,88831,79050,740788,1498066,2031932,2031932
North Macedonia,1989,MK,MKD,EUR,94142,178131,272273,158123,177595,158761,112623,87623,68100,762825,88504,170331,258835,147617,174096,145402,106098,90989,81294,745496,1508321,2039426,2039426
North Macedonia,1990,MK,MKD,EUR,91339,178447,269786,155614,175352,162253,114733,89889,69975,767816,85727,170965,256692,144380,171586,150127,107140,92863,83775,749871,1517687,2044174,2044174
North Macedonia,1991,MK,MKD,EUR,87958,175983,263941,152156,172182,164716,117376,91623,71965,770018,82757,169039,251796,139952,167494,154020,109091,93954,86417,750928,1520946,2036686,2036686
North Macedonia,1992,MK,MKD,EUR,84515,174425,258940,149569,167071,163558,118676,91691,73942,764507,79806,167710,247516,137277,162180,155062,110114,93519,88909,747061,1511568,2018023,2018023
North Macedonia,1993,MK,MKD,EUR,81527,175496,257023,149255,160649,158902,118479,90112,75803,753200,77100,168516,245616,138018,156712,153322,109981,91816,91209,741058,1494258,1996893,1996893
North Macedonia,1994,MK,MKD,EUR,79383,175710,255093,149974,154981,155274,119120,88765,77554,745668,75069,168570,243639,139503,151529,152310,110996,90370,93356,738064,1483732,1982458,1982458
North Macedonia,1995,MK,MKD,EUR,77597,175619,253216,152236,150758,155327,121855,89341,79246,748763,73044,168475,241519,141221,146542,153651,113499,90273,95282,740468,1489231,1983964,1983964
North Macedonia,1996,MK,MKD,EUR,75610,174795,250405,155631,147613,157361,125352,91013,81058,758028,70747,167650,238397,143944,141765,156429,116818,91113,97327,747396,1505424,1994226,1994226
North Macedonia,1997,MK,MKD,EUR,73969,172182,246151,159581,145397,158486,128459,92395,82995,767313,68916,165049,233965,148178,138082,158379,120497,92029,99640,756805,1524118,2004234,2004234
North Macedonia,1998,MK,MKD,EUR,72478,168515,240993,163759,143928,158427,131864,93779,85133,776890,67321,161326,228647,152628,135445,158684,124600,92743,102209,766309,1543199,2012844,2012844
North Macedonia,1999,MK,MKD,EUR,71439,165615,237054,167623,144707,156843,133722,94408,87461,784764,66250,158340,224590,157355,136054,156668,128374,93746,105176,777373,1562137,2023778,2023778
North Macedonia,2000,MK,MKD,EUR,71203,164171,235374,170313,147752,154599,134152,93767,89808,790391,66006,156696,222702,161418,140140,153288,131437,94866,108323,789472,1579863,2037936,2037936
North Macedonia,2001,MK,MKD,EUR,71558,163739,235297,171317,151547,152997,134859,92311,92017,795048,66404,155779,222183,163668,145364,150641,133945,95651,111587,800856,1595904,2053384,2053384
North Macedonia,2002,MK,MKD,EUR,71333,162518,233851,171694,153926,152121,136569,92230,93792,800332,66324,154032,220356,164756,148315,149346,136245,96898,114631,810191,1610523,2064737,2064737
North Macedonia,2003,MK,MKD,EUR,70420,159945,230365,171954,154719,151579,138816,94372,95188,806628,65623,151044,216667,165294,148598,148938,138247,99258,117144,817479,1624107,2071142,2071142
North Macedonia,2004,MK,MKD,EUR,69018,157295,226313,171579,155939,150765,140747,97022,96699,812751,64431,148025,212456,165260,149239,148162,139900,102285,119516,824362,1637113,2075874,2075874
North Macedonia,2005,MK,MKD,EUR,66837,154733,221570,170651,157618,149771,142639,99575,98320,818574,62474,145108,207582,164642,150428,147015,141666,105292,121891,830934,1649508,2078662,2078662
North Macedonia,2006,MK,MKD,EUR,64431,152235,216666,169574,159532,148965,144236,102143,99890,824340,60286,142263,202549,163766,152050,145916,143313,108237,124240,837522,1661862,2081075,2081075
North Macedonia,2007,MK,MKD,EUR,62066,150074,212140,168113,161500,148590,145170,105052,101338,829763,58112,139752,197864,162445,153871,145266,144333,111336,126483,843734,1673497,2083488,2083488
North Macedonia,2008,MK,MKD,EUR,60001,147912,207913,166480,163401,148508,145481,108450,102779,835099,56169,137491,193660,160696,155692,144937,144751,114800,128676,849552,1684651,2086227,2086227
North Macedonia,2009,MK,MKD,EUR,59178,144595,203773,165151,165031,148547,145592,112218,104230,840769,55362,134426,189788,158866,157389,144641,145034,118640,130883,855453,1696222,2089787,2089787
North Macedonia,2010,MK,MKD,EUR,59755,140291,200046,163957,166137,148759,145732,116095,105562,846242,55843,130544,186387,156964,158732,144482,145364,122587,133018,861147,1707389,2093828,2093828
North Macedonia,2011,MK,MKD,EUR,60379,136107,196486,162617,166769,149259,145854,119742,106933,851174,56350,126827,183177,154846,159726,144652,145569,126256,135214,866263,1717437,2097099,2097099
North Macedonia,2012,MK,MKD,EUR,60747,132513,193260,160685,167373,150026,145830,122724,108750,855388,56621,123652,180273,152277,160647,145021,145524,129162,137925,870556,1725944,2099478,2099478
North Macedonia,2013,MK,MKD,EUR,61056,129581,190637,158185,167869,151072,145599,125023,111410,859158,56844,121047,177891,149350,161423,145510,145279,131216,141755,874533,1733691,2102215,2102215
North Macedonia,2014,MK,MKD,EUR,61101,127394,188495,155610,167720,152535,145113,127077,114542,862597,56842,119084,175926,146387,161608,146356,144687,132984,146252,878274,1740871,2105291,2105291
North Macedonia,2015,MK,MKD,EUR,60786,125844,186630,153128,166997,154415,144439,129043,117576,865598,56536,117645,174181,143534,161179,147716,143718,134803,150599,881549,1747147,2107962,2107962
North Macedonia,2016,MK,MKD,EUR,60494,124110,184604,150726,166088,156488,143922,130741,120569,868534,56263,116000,172263,140777,160453,149467,142776,136474,154850,884797,1753331,2110196,2110196
North Macedonia,2017,MK,MKD,EUR,60063,122152,182215,148669,164771,158572,143810,131902,123898,871622,55860,114129,169989,138358,159259,151375,142277,137566,159312,888147,1759769,2111979,2111979
North Macedonia,2018,MK,MKD,EUR,59205,120421,179626,146609,163270,160577,143985,132592,127783,874816,55037,112437,167474,136190,157622,153268,142089,138130,164282,891581,1766397,2113491,2113491
North Macedonia,2019,MK,MKD,EUR,57912,119664,177576,143381,162074,162299,144275,133143,131889,877061,53793,111648,165441,133212,155902,155027,141929,138587,169440,894097,1771158,2114176,2114176
North Macedonia,2020,MK,MKD,EUR,56273,119960,176233,139189,161059,163503,144668,133503,134725,876647,52238,111850,164088,129443,154171,156449,141880,138973,173183,894099,1770746,2111072,2111072
North Macedonia,2021,MK,MKD,EUR,54707,120332,175039,135131,159950,164230,145221,133458,135668,873658,50763,112115,162878,125855,152274,157539,142090,139040,174959,891757,1765415,2103330,2103330
North Macedonia,2022,MK,MKD,EUR,53370,120303,173673,131606,158217,164904,145967,133141,136020,869855,49516,112009,161525,122754,149910,158550,142457,138778,176097,888546,1758401,2093599,2093599
North Macedonia,2023,MK,MKD,EUR,52297,119774,172071,128694,155877,165490,147017,132818,137384,867280,48539,111436,159975,120172,147144,159415,142963,138435,178224,886353,1753633,2085679,2085679
North Macedonia,2024,MK,MKD,EUR,51545,118557,170102,126526,153449,165467,148569,132666,140998,867675,47869,110220,158089,118219,144334,159711,143881,138012,182687,886844,1754519,2082706,2082706
North Macedonia,2025,MK,MKD,EUR,51054,116621,167675,124982,151083,164869,150573,132561,145850,869918,47437,108378,155815,116786,141601,159386,145338,137361,188535,889007,1758925,2082425,2082425
North Macedonia,2026,MK,MKD,EUR,50550,114764,165314,123252,148754,164061,152731,132550,150487,871835,46990,106626,153616,115142,138907,158743,147164,136709,194145,890810,1762645,2081573,2081573
North Macedonia,2027,MK,MKD,EUR,50020,113005,163025,121293,146732,162811,154888,132840,154831,873395,46517,104979,151496,113264,136519,157597,149125,136440,199279,892224,1765619,2080144,2080144
North Macedonia,2028,MK,MKD,EUR,49469,111093,160562,119557,144688,161352,156944,133324,158974,874839,46019,103197,149216,111562,134360,155998,151051,136441,204089,893501,1768340,2078115,2078115
North Macedonia,2029,MK,MKD,EUR,48907,109061,157968,118801,141464,160194,158709,133880,163064,876112,45514,101302,146816,110771,131383,154315,152838,136449,208836,894592,1770704,2075487,2075487
North Macedonia,2030,MK,MKD,EUR,48329,106941,155270,119090,137242,159181,159968,134569,167152,877202,44989,99323,144312,110963,127571,152578,154283,136580,213498,895473,1772675,2072256,2072256
North Macedonia,1950,MK,MKD,EUR,92560,144126,236686,125887,80772,70348,46754,31170,33452,388383,87832,139077,226909,127783,82525,65935,47170,36061,39971,399445,787828,1251433,1251433
North Macedonia,1951,MK,MKD,EUR,95516,145786,241302,129612,86243,70347,49171,30319,34214,399906,90733,140065,230798,130954,88695,66375,48844,35258,40388,410514,810420,1282525,1282525
North Macedonia,1952,MK,MKD,EUR,97955,148118,246073,132452,91578,69905,51662,29654,34937,410188,93170,141784,234954,133202,94642,66481,50588,34542,40822,420277,830465,1311488,1311488
North Macedonia,1953,MK,MKD,EUR,100088,151364,251452,134387,96462,69215,54296,29610,35464,419434,95296,144464,239760,134552,100017,66379,52465,34301,41224,428938,848372,1339581,1339581
North Macedonia,1954,MK,MKD,EUR,101689,154518,256207,135027,100314,68194,56810,30245,35664,426254,96974,147209,244183,134782,104271,65989,54225,34622,41425,435314,861568,1361960,1361960
North Macedonia,1955,MK,MKD,EUR,102761,157255,260016,134713,103313,67118,59067,31398,35587,431196,98158,149767,247925,134246,107577,65590,55789,35366,41440,440008,871204,1379140,1379140
North Macedonia,1956,MK,MKD,EUR,103347,160166,263513,134173,106065,66507,61098,32844,35323,436010,98776,152671,251447,133475,110486,65689,57251,36330,41297,444528,880538,1395504,1395504
North Macedonia,1957,MK,MKD,EUR,103476,163463,266939,133475,108573,66595,62696,34459,35074,440872,98901,156058,254959,132490,113007,66529,58452,37409,41159,449046,889918,1411818,1411818
North Macedonia,1958,MK,MKD,EUR,103144,167193,270337,132764,110865,67584,63674,36111,34971,445969,98574,159906,258480,131421,115156,68333,59275,38506,41128,453819,899788,1428602,1428602
North Macedonia,1959,MK,MKD,EUR,102563,171040,273603,132175,112935,69513,63950,37734,35020,451327,97964,163886,261850,130408,116958,71119,59644,39562,41208,458899,910226,1445685,1445685
North Macedonia,1960,MK,MKD,EUR,101603,174749,276352,131905,114804,72245,63625,39324,35096,456999,97018,167699,264717,129694,118459,74706,59632,40569,41235,464295,921294,1462368,1462368
North Macedonia,1961,MK,MKD,EUR,100573,178244,278817,132434,116659,75680,62961,40999,35321,464054,95989,171244,267233,129736,119870,78941,59439,41631,41388,471005,935059,1481112,1481112
North Macedonia,1962,MK,MKD,EUR,100207,181295,281502,134935,117130,79186,62031,41683,35439,470404,96513,174033,270546,129173,118567,82756,59654,43068,41674,474892,945296,1497338,1497338
North Macedonia,1963,MK,MKD,EUR,99509,183703,283212,139180,116815,82632,60942,42412,35251,477232,96969,176370,273339,129280,115867,86080,59971,44878,42003,478079,955311,1511854,1511854
North Macedonia,1964,MK,MKD,EUR,97807,185882,283689,143877,116995,86202,59965,44450,35013,486502,95654,179100,274754,131416,114319,89404,60023,46915,42482,484559,971061,1529507,1529507
North Macedonia,1965,MK,MKD,EUR,96101,187943,284044,148753,117052,89596,59262,46800,34830,496293,94004,182009,276013,134128,112600,92306,60276,49169,43151,491630,987923,1547982,1547982
North Macedonia,1966,MK,MKD,EUR,94341,189910,284251,153553,117311,92822,59046,49283,34774,506789,91821,185105,276926,137474,111070,94863,60884,51438,44013,499742,1006531,1567707,1567707
North Macedonia,1967,MK,MKD,EUR,92677,191178,283855,158409,118006,95909,59542,51639,34870,518375,89630,187440,277070,141698,110009,97154,62046,53480,44953,509340,1027715,1588649,1588649
North Macedonia,1968,MK,MKD,EUR,91367,191265,282632,163314,119321,98870,60930,53556,35127,531118,87832,188380,276212,146798,109651,99235,63946,55072,45873,520575,1051693,1610537,1610537
North Macedonia,1969,MK,MKD,EUR,90276,190654,280930,167933,121353,101678,63252,54854,35644,544714,86127,188497,274624,152408,110148,101139,66635,56113,46788,533231,1077945,1633502,1633502
North Macedonia,2031,MK,MKD,EUR,47746,104864,152610,119447,133126,158041,160774,135500,171089,877977,44457,97394,141851,111212,123907,150643,155394,137004,217844,896004,1773981,2068443,2068443
North Macedonia,2032,MK,MKD,EUR,47151,102994,150145,119414,129583,156321,161557,136632,174766,878273,43914,95666,139580,111102,120774,148280,156457,137602,221825,896040,1774313,2064037,2064037
North Macedonia,2033,MK,MKD,EUR,46549,101377,147926,118889,126691,154032,162242,137984,178198,878036,43364,94192,137556,110529,118201,145547,157372,138297,225569,895515,1773551,2059037,2059037
North Macedonia,2034,MK,MKD,EUR,45970,100069,146039,117673,124535,151633,162280,139688,181412,877221,42830,93023,135853,109317,116257,142757,157698,139315,229051,894395,1771616,2053511,2053511
North Macedonia,2035,MK,MKD,EUR,45419,99006,144425,115743,123000,149290,161731,141742,184385,875891,42319,92070,134389,107474,114829,140038,157400,140808,232202,892751,1768642,2047455,2047455
North Macedonia,2036,MK,MKD,EUR,44883,97923,142806,113886,121280,146981,160976,143935,187262,874320,41826,91096,132922,105725,113187,137359,156778,142657,235121,890827,1765147,2040880,2040880
North Macedonia,2037,MK,MKD,EUR,44392,96805,141197,112131,119326,144975,159787,146130,190191,872540,41372,90083,131455,104083,111314,134988,155662,144637,237976,888660,1761200,2033842,2033842
North Macedonia,2038,MK,MKD,EUR,43956,95653,139609,110221,117599,142948,158397,148225,193142,870532,40966,89037,130003,102304,109620,132840,154098,146581,240785,886228,1756760,2026372,2026372
North Macedonia,2039,MK,MKD,EUR,43532,94518,138050,108193,116848,139749,157299,150046,196159,868294,40572,88004,128576,100407,108828,129878,152449,148389,243582,883533,1751827,2018461,2018461
North Macedonia,2040,MK,MKD,EUR,43109,93395,136504,106078,117140,135554,156344,151377,199362,865855,40180,86972,127152,98427,109021,126084,150750,149864,246458,880604,1746459,2010114,2010114
North Macedonia,2041,MK,MKD,EUR,42692,92280,134972,104007,117500,131464,155263,152283,202705,863222,39792,85951,125743,96501,109273,122438,148852,151012,249360,877436,1740658,2001364,2001364
North Macedonia,2042,MK,MKD,EUR,42291,91201,133492,102139,117473,127945,153606,153166,206060,860389,39421,84957,124378,94775,109165,119319,146527,152105,252135,874026,1734415,1992276,1992276
North Macedonia,2043,MK,MKD,EUR,41905,90165,132070,100525,116954,125074,151388,153955,209459,857355,39062,84003,123065,93304,108595,116755,143839,153053,254842,870388,1727743,1982876,1982876
North Macedonia,2044,MK,MKD,EUR,41526,89166,130692,99216,115741,122936,149062,154129,213055,854139,38714,83078,121792,92136,107382,114819,141087,153427,257682,866533,1720672,1973157,1973157
North Macedonia,2045,MK,MKD,EUR,41171,88195,129366,98157,113818,121415,146778,153745,216832,850745,38381,82179,120560,91185,105545,113401,138407,153189,260757,862484,1713229,1963152,1963152
North Macedonia,2046,MK,MKD,EUR,40840,87246,128086,97076,111968,119708,144535,153167,220731,847185,38073,81299,119372,90208,103798,111770,135768,152642,264051,858237,1705422,1952886,1952886
North Macedonia,2047,MK,MKD,EUR,40510,86358,126868,95960,110219,117777,142593,152178,224745,843472,37761,80474,118235,89198,102155,109910,133433,151613,267491,853800,1697272,1942373,1942373
North Macedonia,2048,MK,MKD,EUR,40149,85540,125689,94811,108315,116068,140627,151002,228775,839598,37428,79714,117142,88153,100379,108226,131322,150142,270953,849175,1688773,1931608,1931608
North Macedonia,2049,MK,MKD,EUR,39776,84743,124519,93680,106293,115327,137501,150107,232685,835593,37076,78974,116050,87116,98490,107444,128397,148599,274373,844419,1680012,1920582,1920582
North Macedonia,2050,MK,MKD,EUR,39386,83966,123352,92555,104182,115627,133387,149343,236379,831473,36714,78252,114966,86090,96514,107641,124644,146998,277633,839520,1670993,1909309,1909309
Mali,1970,ML,MLI,AFR,537009,736187,1273196,575003,412826,313873,260673,172737,86352,1821464,532070,737756,1269826,572959,406670,294483,246472,176688,91836,1789108,3610572,6153587,6153587
Mali,1971,ML,MLI,AFR,548332,750416,1298748,584001,418978,313118,260850,176035,89043,1842025,542777,751521,1294298,581809,414171,295343,246474,179641,95367,1812805,3654830,6247878,6247878
Mali,1972,ML,MLI,AFR,560220,765980,1326200,592205,426350,312640,260743,179281,91869,1863088,553998,766685,1320683,590077,422619,296455,246321,182598,99117,1837187,3700275,6347158,6347158
Mali,1973,ML,MLI,AFR,572901,783025,1355926,600485,434868,312906,260514,182458,94865,1886096,565972,783452,1349424,598443,432184,298295,246216,185545,103125,1863808,3749904,6455257,6455257
Mali,1974,ML,MLI,AFR,586424,801125,1387549,609700,442634,314105,260124,185375,98065,1910003,578727,801337,1380064,607655,441081,301043,246241,188275,107364,1891659,3801662,6569273,6569273
Mali,1975,ML,MLI,AFR,600800,820178,1420978,618991,449205,316860,259560,187973,101490,1934079,592192,820180,1412372,616948,448552,305462,246389,190686,111820,1919857,3853936,6687293,6687293
Mali,1976,ML,MLI,AFR,615821,840633,1456454,627643,454536,321005,258897,190247,105155,1957483,606218,840333,1446551,625488,454422,311434,246672,192742,116403,1947161,3904644,6807648,6807648
Mali,1977,ML,MLI,AFR,631648,862712,1494360,637007,459543,326130,258416,192237,109039,1982372,621075,861939,1483014,634666,459696,318381,247325,194465,121055,1975588,3957960,6935336,6935336
Mali,1978,ML,MLI,AFR,648381,886522,1534903,647551,465062,331970,258148,193984,113121,2009836,636852,885046,1521898,644995,465293,326006,248297,195919,125788,2006298,4016134,7072938,7072938
Mali,1979,ML,MLI,AFR,666064,912067,1578131,658963,471146,337790,257865,195538,117362,2038664,653640,909585,1563225,656110,471274,333549,249296,197174,130654,2038057,4076721,7218079,7218079
Mali,1980,ML,MLI,AFR,684517,939279,1623796,671896,478613,343288,257705,196942,121721,2070165,671318,935439,1606757,668641,478453,340582,250381,198258,135548,2071863,4142028,7372581,7372581
Mali,1981,ML,MLI,AFR,703158,967895,1671053,686181,486579,348810,257704,198116,126095,2103485,689328,962275,1651603,682400,486037,347350,251563,199093,140283,2106726,4210211,7532864,7532864
Mali,1982,ML,MLI,AFR,721443,997717,1719160,701582,493691,355351,257849,199008,130371,2137852,707214,989960,1697174,697229,492809,354801,252836,199664,144825,2142164,4280016,7696349,7696349
Mali,1983,ML,MLI,AFR,739069,1028700,1767769,718446,500669,362571,258405,199630,134482,2174203,724586,1018499,1743085,713470,499245,362753,254453,199997,148968,2178886,4353089,7863944,7863944
Mali,1984,ML,MLI,AFR,756037,1061059,1817096,735451,507654,368623,259507,199921,138269,2209425,741356,1048205,1789561,729692,505446,369521,256574,200190,152592,2214015,4423440,8030099,8030099
Mali,1985,ML,MLI,AFR,772053,1094685,1866738,751471,512825,372776,261569,199829,141674,2240144,757154,1079127,1836281,744678,509767,374167,259839,200285,155746,2244482,4484626,8187651,8187651
Mali,1986,ML,MLI,AFR,787254,1129037,1916291,766833,515261,375035,264513,199444,144717,2265803,772031,1110857,1882888,758686,511226,376640,264224,200347,158481,2269604,4535407,8334588,8334588
Mali,1987,ML,MLI,AFR,801749,1163661,1965410,782434,515986,375733,267740,198927,147434,2288254,786097,1143162,1929259,772667,510884,377385,269017,200542,160910,2291405,4579659,8474329,8474329
Mali,1988,ML,MLI,AFR,816063,1198225,2014288,800134,516803,376056,271182,198351,149945,2312471,800060,1175794,1975854,788565,510579,377599,274064,200872,163184,2314863,4627334,8617474,8617474
Mali,1989,ML,MLI,AFR,830199,1233149,2063348,821582,519658,377300,274747,197811,152450,2343548,814023,1208897,2022920,807962,512176,378486,279116,201218,165339,2344297,4687845,8774122,8774122
Mali,1990,ML,MLI,AFR,843340,1268416,2111756,846747,525303,380065,278084,197404,155031,2382634,827140,1242467,2069607,830932,516486,380690,283753,201662,167509,2381032,4763666,8945026,8945026
Mali,1991,ML,MLI,AFR,857061,1303632,2160693,873731,532426,383060,281336,197128,157593,2425274,840896,1276227,2117123,855487,522229,383098,288086,202249,169738,2420887,4846161,9123969,9123969
Mali,1992,ML,MLI,AFR,872451,1338243,2210694,902217,541052,385204,285452,196965,159969,2470859,856233,1309626,2165859,881261,529432,384694,292996,202922,171848,2463153,4934012,9310572,9310572
Mali,1993,ML,MLI,AFR,888434,1371990,2260424,932646,552072,387203,290098,197050,162011,2521080,872050,1342611,2214661,909030,539128,386045,298374,203905,173860,2510342,5031422,9506510,9506510
Mali,1994,ML,MLI,AFR,905721,1404434,2310155,965091,565163,390143,294058,197696,163666,2575817,888945,1374606,2263551,938919,550978,388179,303076,205469,175647,2562268,5138085,9711797,9711797
Mali,1995,ML,MLI,AFR,924136,1434784,2358920,999068,579908,393391,297216,199493,164994,2634070,906599,1404504,2311103,970211,564367,390497,306647,208260,177011,2616993,5251063,9921094,9921094
Mali,1996,ML,MLI,AFR,942274,1464803,2407077,1033614,596374,396376,299727,202428,166073,2694592,923650,1433719,2357369,1001875,579220,392360,309158,212292,177970,2672875,5367467,10131906,10131906
Mali,1997,ML,MLI,AFR,962141,1495956,2458097,1069436,615975,400299,302006,206065,167143,2760924,942248,1463790,2406038,1035038,597059,395015,311154,217047,178926,2734239,5495163,10359301,10359301
Mali,1998,ML,MLI,AFR,986210,1528129,2514339,1107881,640931,406445,304933,210303,168445,2838938,964850,1494967,2459817,1071320,620129,399730,313545,222396,180255,2807375,5646313,10620475,10620475
Mali,1999,ML,MLI,AFR,1015705,1561685,2577390,1148513,671068,415013,308896,214728,169953,2928171,992550,1527527,2520077,1110113,648164,406696,316740,227834,181816,2891363,5819534,10916993,10916993
Mali,2000,ML,MLI,AFR,1051293,1595735,2647028,1189386,704527,425607,313908,218788,171593,3023809,1026310,1560414,2586724,1149370,679337,415592,320848,232789,183596,2981532,6005341,11239101,11239101
Mali,2001,ML,MLI,AFR,1092013,1630443,2722456,1229947,740739,438370,319451,222857,173348,3124712,1065457,1593841,2659298,1188686,713174,426665,325494,237628,185711,3077358,6202070,11583824,11583824
Mali,2002,ML,MLI,AFR,1136461,1668293,2804754,1269681,779382,453446,324663,227836,175215,3230223,1108379,1630572,2738951,1227699,749482,440151,329901,243245,188243,3178721,6408944,11952660,11952660
Mali,2003,ML,MLI,AFR,1183680,1710566,2894246,1307761,819575,470703,329767,233289,177284,3338379,1154040,1671778,2825818,1265511,787453,455963,334132,249368,191288,3283715,6622094,12342165,12342165
Mali,2004,ML,MLI,AFR,1232685,1759161,2991846,1343664,861212,489859,335720,238174,179697,3448326,1201584,1719077,2920661,1301421,826994,473776,339106,254951,194918,3391166,6839492,12751995,12751995
Mali,2005,ML,MLI,AFR,1283396,1815051,3098447,1376510,903772,510774,342082,242492,182870,3558500,1250977,1773408,3024385,1334414,867586,493408,344466,259745,199598,3499217,7057717,13180551,13180551
Mali,2006,ML,MLI,AFR,1334607,1876054,3210661,1408183,946390,533814,348514,246480,186877,3670258,1301062,1832738,3133800,1366092,908416,515193,349841,263903,205375,3608820,7279078,13623541,13623541
Mali,2007,ML,MLI,AFR,1384614,1942157,3326771,1440376,988734,559244,355572,250187,191298,3785411,1350325,1896947,3247272,1397983,949214,539315,355777,267543,211625,3721457,7506868,14080912,14080912
Mali,2008,ML,MLI,AFR,1433649,2014502,3448151,1472339,1029731,586885,363326,253848,195765,3901894,1398883,1966969,3365852,1429545,988919,565538,362366,270962,217884,3835214,7737108,14551117,14551117
Mali,2009,ML,MLI,AFR,1481810,2093098,3574908,1504087,1068767,616379,371875,257734,199915,4018757,1446408,2043033,3489441,1460905,1026882,593521,369778,274565,223873,3949524,7968281,15032635,15032635
Mali,2010,ML,MLI,AFR,1529186,2178979,3708165,1535645,1106059,647627,381632,262146,203499,4136608,1492910,2126510,3619420,1491993,1063338,623200,378441,278692,229330,4064994,8201602,15529181,15529181
Mali,2011,ML,MLI,AFR,1576726,2270447,3847173,1567424,1141486,680329,392850,266709,206860,4255658,1539451,2215826,3755277,1523109,1098159,654255,388614,283007,234482,4181626,8437284,16039734,16039734
Mali,2012,ML,MLI,AFR,1623826,2363211,3987037,1594779,1166822,710281,403946,270032,210146,4356006,1585478,2306485,3891963,1549150,1123043,682742,398976,286239,239538,4279688,8635694,16514687,16514687
Mali,2013,ML,MLI,AFR,1669648,2457901,4127549,1627668,1190125,741110,416767,273165,213825,4462660,1630407,2399072,4029479,1580726,1146170,712126,411181,289169,244973,4384345,8847005,17004033,17004033
Mali,2014,ML,MLI,AFR,1714230,2554574,4268804,1674573,1218436,776482,432713,277650,217888,4597742,1674489,2493667,4168156,1626539,1174480,745862,426376,293217,250647,4517121,9114863,17551814,17551814
Mali,2015,ML,MLI,AFR,1757414,2651982,4409396,1728699,1243893,812648,450250,282542,222137,4740169,1717464,2589016,4306480,1679189,1199957,780455,443206,297624,256435,4656866,9397035,18112907,18112907
Mali,2016,ML,MLI,AFR,1799906,2750627,4550533,1789861,1270673,849998,470247,287729,226872,4895380,1759768,2685603,4445371,1738802,1226581,816277,462441,302194,262528,4808823,9704203,18700106,18700106
Mali,2017,ML,MLI,AFR,1842167,2849669,4691836,1857240,1299723,887672,492692,293565,231746,5062638,1801594,2782743,4584337,1804594,1255263,852652,484084,307347,268601,4972541,10035179,19311355,19311355
Mali,2018,ML,MLI,AFR,1885838,2946695,4832533,1929728,1328550,923942,517098,300013,236613,5235944,1844413,2878326,4722739,1875387,1283955,888066,507731,313190,274755,5143084,10379028,19934298,19934298
Mali,2019,ML,MLI,AFR,1930888,3040512,4971400,2007466,1357770,958847,543424,307243,241433,5416183,1888284,2970896,4859180,1951214,1313197,922377,533256,319854,280765,5320663,10736846,20567424,20567424
Mali,2020,ML,MLI,AFR,1976838,3132727,5109565,2094112,1389877,993456,571629,315079,244623,5608776,1932832,3061942,4994774,2036099,1345326,956566,560598,327237,285096,5510922,11119698,21224040,21224040
Mali,2021,ML,MLI,AFR,2024844,3224593,5249437,2187545,1424997,1027601,601351,323742,246073,5811309,1979330,3152788,5132118,2128153,1380466,990558,589485,335612,287848,5712122,11523431,21904983,21904983
Mali,2022,ML,MLI,AFR,2073902,3316883,5390785,2281283,1461900,1059537,632041,333794,247482,6016037,2027035,3243872,5270907,2220463,1417392,1022628,619372,345485,290525,5915865,11931902,22593590,22593590
Mali,2023,ML,MLI,AFR,2122438,3409511,5531949,2375319,1502275,1089527,663853,345785,250071,6226830,2074726,3334912,5409638,2312871,1457658,1052942,650353,357388,294081,6125293,12352123,23293698,23293698
Mali,2024,ML,MLI,AFR,2171081,3501150,5672231,2470107,1549186,1118136,697436,360078,255007,6449950,2122885,3424856,5547741,2405816,1504089,1081888,682998,371555,299522,6345868,12795818,24015789,24015789
Mali,2025,ML,MLI,AFR,2220660,3591615,5812275,2565778,1603444,1144790,732362,376277,261317,6683968,2171980,3513708,5685688,2499545,1557559,1108892,716980,387643,306116,6576735,13260703,24758658,24758658
Mali,2026,ML,MLI,AFR,2269840,3682165,5952005,2662470,1662802,1171212,767709,394295,267946,6926434,2220741,3602723,5823464,2594391,1616039,1135582,751539,405651,312966,6816168,13742602,25518081,25518081
Mali,2027,ML,MLI,AFR,2318364,3772638,6091002,2759475,1727025,1198663,802834,414194,274946,7177137,2268737,3691815,5960552,2689785,1679274,1163107,786140,425611,320161,7064078,14241215,26292781,26292781
Mali,2028,ML,MLI,AFR,2367237,3864175,6231412,2854872,1797155,1226849,837135,435971,282409,7434391,2316859,3782080,6098939,2783893,1748142,1191388,820169,447469,327821,7318882,14753273,27083625,27083625
Mali,2029,ML,MLI,AFR,2415780,3957898,6373678,2947468,1873166,1256316,870648,459597,290454,7697649,2364637,3874455,6239092,2875461,1822706,1221072,853578,471164,336108,7580089,15277738,27890510,27890510
Mali,2030,ML,MLI,AFR,2462892,4053014,6515906,3038215,1955885,1286666,903247,484877,299321,7968211,2411082,3968044,6379126,2965388,1904009,1251630,886248,496514,345260,7849049,15817260,28712294,28712294
Mali,1950,ML,MLI,AFR,395743,538193,933936,440615,376348,287269,182407,108340,70661,1465640,395256,535797,931053,414339,345132,268777,175418,100658,59962,1364286,2829926,4694916,4694916
Mali,1951,ML,MLI,AFR,402734,547282,950016,441709,377811,292908,188246,109234,70494,1480402,402057,546440,948497,417315,346105,273203,181665,102816,60145,1381249,2861651,4760160,4760160
Mali,1952,ML,MLI,AFR,408335,557855,966190,442964,378693,298298,194193,110207,70418,1494773,407695,558188,965883,420380,346675,277398,188034,105095,60395,1397977,2892750,4824822,4824822
Mali,1953,ML,MLI,AFR,413133,569195,982328,444475,378823,303207,200074,111417,70391,1508387,412484,570632,983116,423655,346758,281183,194311,107603,60763,1414273,2922660,4888110,4888110
Mali,1954,ML,MLI,AFR,418444,579587,998031,446962,378460,307463,205773,113154,70333,1522145,417624,582177,999801,427815,346754,284384,200250,110531,61278,1431012,2953157,4950987,4950987
Mali,1955,ML,MLI,AFR,423554,588899,1012453,451606,377886,311065,211280,115499,70243,1537579,422565,592312,1014877,434228,346942,286979,205771,113927,61921,1449768,2987347,5014680,5014680
Mali,1956,ML,MLI,AFR,428126,597433,1025559,458351,377219,313989,216542,118390,70177,1554668,427025,601304,1028329,442939,347401,289017,210840,117759,62748,1470704,3025372,5079258,5079258
Mali,1957,ML,MLI,AFR,432908,605384,1038292,466197,376597,316197,221488,121792,70153,1572424,431744,609513,1041257,452811,348253,290493,215375,121988,63786,1492706,3065130,5144686,5144686
Mali,1958,ML,MLI,AFR,437934,613266,1051200,474339,375665,317614,226113,125576,70214,1589521,436663,617468,1054131,462905,348996,291293,219400,126501,64951,1514046,3103567,5208910,5208910
Mali,1959,ML,MLI,AFR,443654,621801,1065455,482630,374750,318581,230616,129566,70400,1606543,442202,625930,1068132,473080,349825,291746,223204,131194,66195,1535244,3141787,5275377,5275377
Mali,1960,ML,MLI,AFR,450195,631566,1081761,490845,374370,319379,235093,133663,70740,1624090,448484,635536,1084020,483081,351231,292145,226952,135977,67539,1556925,3181015,5346792,5346792
Mali,1961,ML,MLI,AFR,457093,641762,1098855,499227,374375,319843,239435,137848,71201,1641929,455142,645617,1100759,492985,353005,292354,230545,140841,68969,1578699,3220628,5420247,5420247
Mali,1962,ML,MLI,AFR,464225,651003,1115228,508973,374733,319929,243614,142095,71761,1661105,462052,654917,1116969,503909,355074,292327,233989,145784,70456,1601539,3262644,5494845,5494845
Mali,1963,ML,MLI,AFR,471605,659790,1131395,519399,375618,319650,247537,146358,72537,1681099,469226,663647,1132873,515395,357611,292124,237186,150674,72104,1625094,3306193,5570462,5570462
Mali,1964,ML,MLI,AFR,479184,669605,1148789,528880,377485,319090,251018,150562,73662,1700697,476479,673211,1149690,525929,361013,291948,239929,155326,74061,1648206,3348903,5647380,5647380
Mali,1965,ML,MLI,AFR,487152,679796,1166948,537307,381221,318309,253935,154640,75113,1720525,484144,683164,1167308,535127,366374,291904,242147,159679,76374,1671605,3392130,5726382,5726382
Mali,1966,ML,MLI,AFR,495804,689796,1185600,544826,386631,317369,256257,158544,76858,1740485,492549,692882,1185431,543024,373572,291998,243829,163655,78977,1695055,3435540,5806572,5806572
Mali,1967,ML,MLI,AFR,505226,700249,1205475,551709,392900,316456,257995,162255,78925,1760240,501656,703000,1204656,550026,381636,292381,244994,167215,81881,1718133,3478373,5888497,5888497
Mali,1968,ML,MLI,AFR,515439,711320,1226759,558663,399708,315612,259249,165823,81253,1780308,511506,713704,1225210,556944,390225,293031,245755,170477,85044,1741476,3521784,5973762,5973762
Mali,1969,ML,MLI,AFR,526096,723189,1249285,566219,406478,314699,260115,169314,83751,1800576,521702,725182,1246884,564369,398722,293697,246214,173617,88398,1765017,3565593,6061764,6061764
Mali,2031,ML,MLI,AFR,2510107,4148853,6658960,3128390,2043698,1318181,934835,511584,309209,8245897,2457672,4062432,6520104,3054732,1990590,1283254,918085,523274,355511,8125446,16371343,29550408,29550408
Mali,2032,ML,MLI,AFR,2557920,4244535,6802455,3219297,2133778,1353084,965125,539492,320238,8531014,2504898,4156923,6661821,3144488,2079537,1318282,948795,551210,367007,8409319,16940333,30404609,30404609
Mali,2033,ML,MLI,AFR,2604805,4340220,6945025,3310784,2225526,1392541,994029,568374,332539,8823793,2551234,4251750,6802984,3234528,2170129,1357813,978298,580179,379936,8700883,17524676,31272674,31272674
Mali,2034,ML,MLI,AFR,2651201,4436410,7087611,3401434,2318089,1438229,1021392,598330,346087,9123561,2597100,4347377,6944477,3323823,2261446,1403342,1006370,610319,394284,8999584,18123145,32155238,32155238
Mali,2035,ML,MLI,AFR,2697144,4532412,7229556,3491000,2411544,1490936,1046805,629215,360946,9430446,2642467,4442944,7085411,3412229,2353653,1455691,1032542,641509,410105,9305729,18736175,33051142,33051142
Mali,2036,ML,MLI,AFR,2741515,4628194,7369709,3580683,2506039,1548564,1072054,660477,377335,9745152,2686287,4538387,7224674,3500838,2447014,1512912,1058450,673248,427628,9620090,19365242,33959625,33959625
Mali,2037,ML,MLI,AFR,2784961,4723954,7508915,3670317,2600877,1610901,1098315,691558,395321,10067289,2729245,4633773,7363018,3589561,2540966,1574759,1085193,705042,446905,9942426,20009715,34881647,34881647
Mali,2038,ML,MLI,AFR,2825701,4819192,7644893,3761016,2694202,1678929,1125282,721915,414922,10396266,2769571,4728457,7498028,3679471,2633735,1642089,1112673,736324,467938,10272230,20668496,35811410,35811410
Mali,2039,ML,MLI,AFR,2861773,4913657,7775430,3853883,2784865,1752638,1153484,751589,436160,10732619,2805336,4822392,7627728,3771494,2724105,1714968,1141515,767054,490757,10609893,21342512,36745659,36745659
Mali,2040,ML,MLI,AFR,2895448,5006328,7901776,3948151,2873800,1832820,1182543,780492,459031,11076837,2838764,4914603,7753367,3864762,2812958,1794406,1171214,797130,515339,10955809,22032646,37687790,37687790
Mali,2041,ML,MLI,AFR,2928398,5097614,8026012,4043168,2962239,1917925,1212727,808538,483484,11428081,2871438,5005481,7876919,3958870,2901320,1878997,1201959,826467,541640,11309253,22737334,38640264,38640264
Mali,2042,ML,MLI,AFR,2959571,5188605,8148176,4138049,3051434,2005229,1246120,835467,509371,11785670,2902250,5096173,7998423,4053128,2990152,1965932,1235974,854792,569553,11669531,23455201,39601808,39601808
Mali,2043,ML,MLI,AFR,2990475,5276120,8266595,4232960,3141233,2094174,1283821,861203,536564,12149955,2932733,5183500,8116233,4147755,3079327,2054518,1274323,882053,599047,12037023,24186978,40569803,40569803
Mali,2044,ML,MLI,AFR,3022882,5358661,8381543,4328393,3230277,2183958,1327425,885629,565118,12520800,2964634,5265960,8230594,4243196,3167834,2143878,1318426,908040,630183,12411557,24932357,41544497,41544497
Mali,2045,ML,MLI,AFR,3055308,5438408,8493716,4423656,3318318,2274663,1377646,908396,594931,12897610,2996622,5345657,8342279,4338614,3255545,2234179,1369060,932336,662860,12792594,25690204,42526196,42526196
Mali,2046,ML,MLI,AFR,3083387,5515884,8599271,4518725,3406523,2366425,1432528,931108,625689,13280998,3024406,5423083,8447489,4433954,3343526,2325670,1424397,956470,696807,13180824,26461822,43508588,43508588
Mali,2047,ML,MLI,AFR,3106644,5590699,8697343,4613807,3494733,2458574,1491890,954799,656952,13670755,3047507,5497840,8545347,4529281,3431687,2417820,1484204,981448,731619,13576059,27246814,44489503,44489503
Mali,2048,ML,MLI,AFR,3128567,5662698,8791265,4708371,3583999,2549304,1556627,979155,688319,14065775,3069483,5569784,8639267,4623952,3521062,2508890,1549290,1007149,766799,13977142,28042917,45473455,45473455
Mali,2049,ML,MLI,AFR,3147575,5731691,8879266,4802190,3675395,2637513,1626750,1004679,719882,14466409,3088699,5638744,8727443,4717909,3612544,2597698,1619731,1034158,802328,14384368,28850777,46457488,46457488
Mali,2050,ML,MLI,AFR,3162737,5798343,8961080,4894256,3768167,2724105,1702967,1031011,751538,14872044,3104039,5705499,8809538,4810181,3705278,2685103,1696471,1061994,838112,14797139,29669183,47439802,47439802
Malta,1970,MT,MLT,EUR,12164,31607,43771,31412,18955,16661,15252,13135,11858,107273,11530,30270,41800,33096,22814,19855,16518,14581,15710,122574,229847,315414,315414
Malta,1971,MT,MLT,EUR,12260,30436,42696,31272,19822,16733,15526,12881,12051,108285,11620,29067,40687,32527,23701,19889,16891,14299,16124,123431,231716,315099,315099
Malta,1972,MT,MLT,EUR,12440,29276,41716,31198,20860,16816,15727,12666,12287,109554,11788,27882,39670,32013,24724,19880,17221,14060,16541,124439,233993,315373,315373
Malta,1973,MT,MLT,EUR,12702,28163,40865,31155,22024,16911,15854,12525,12544,111013,12036,26739,38775,31577,25791,19837,17501,13906,16924,125536,236549,316193,316193
Malta,1974,MT,MLT,EUR,13095,27159,40254,31106,23285,16997,15925,12488,12837,112638,12404,25703,38107,31174,26841,19753,17751,13857,17240,126616,239254,317609,317609
Malta,1975,MT,MLT,EUR,13542,26255,39797,31205,24507,17095,15965,12558,13120,114450,12807,24808,37615,30898,27775,19662,17984,13934,17505,127758,242208,319619,319619
Malta,1976,MT,MLT,EUR,13937,25643,39580,31347,25585,17244,16017,12709,13351,116253,13172,24239,37411,30662,28489,19599,18225,14106,17681,128762,245015,322010,322010
Malta,1977,MT,MLT,EUR,14285,25294,39579,31372,26517,17533,16086,12927,13529,117964,13488,23933,37421,30377,29000,19661,18476,14351,17818,129683,247647,324648,324648
Malta,1978,MT,MLT,EUR,14554,25164,39718,31238,27224,18125,16162,13194,13647,119590,13715,23831,37546,30006,29251,20034,18685,14679,17962,130617,250207,327466,327466
Malta,1979,MT,MLT,EUR,14709,25313,40022,30929,27756,18972,16251,13505,13709,121122,13856,23957,37813,29527,29277,20674,18872,15065,18096,131511,252633,330471,330471
Malta,1980,MT,MLT,EUR,14736,25737,40473,30441,28173,19964,16396,13827,13730,122531,13886,24324,38210,28935,29162,21486,19077,15488,18227,132375,254906,333587,333587
Malta,1981,MT,MLT,EUR,14587,26369,40956,29782,28471,21129,16599,14125,13784,123890,13761,24872,38633,28219,28930,22472,19284,15911,18325,133141,257031,336617,336617
Malta,1982,MT,MLT,EUR,14519,27025,41544,29049,28699,22445,16814,14366,13852,125225,13720,25418,39138,27466,28689,23582,19464,16270,18297,133768,258993,339668,339668
Malta,1983,MT,MLT,EUR,14554,27700,42254,28273,28855,23816,17050,14539,13974,126507,13790,25969,39759,26698,28491,24687,19614,16571,18309,134370,260877,342886,342886
Malta,1984,MT,MLT,EUR,14477,28358,42835,27553,28935,25180,17260,14662,14222,127812,13761,26519,40280,25987,28324,25754,19696,16867,18528,135156,262968,346086,346086
Malta,1985,MT,MLT,EUR,14352,28879,43231,26869,29133,26434,17411,14738,14488,129073,13666,26984,40650,25366,28295,26738,19686,17148,18936,136169,265242,349118,349118
Malta,1986,MT,MLT,EUR,14300,29149,43449,26390,29372,27528,17513,14810,14800,130413,13600,27244,40844,24994,28334,27603,19586,17429,19433,137379,267792,352091,352091
Malta,1987,MT,MLT,EUR,14189,29415,43604,26111,29500,28455,17716,14907,15197,131886,13474,27478,40952,24833,28330,28327,19570,17705,19958,138723,270609,355169,355169
Malta,1988,MT,MLT,EUR,14084,29680,43764,26016,29445,28994,18359,14981,15627,133422,13363,27704,41067,24792,28229,28724,19982,17891,20566,140184,273606,358439,358439
Malta,1989,MT,MLT,EUR,14135,29704,43839,26190,29194,29249,19324,15066,16102,135125,13405,27776,41181,24902,28033,28833,20721,18039,21225,141753,276878,361894,361894
Malta,1990,MT,MLT,EUR,14190,29586,43776,26602,28763,29404,20333,15256,16597,136955,13466,27680,41146,25227,27706,28828,21576,18247,21926,143510,280465,365392,365392
Malta,1991,MT,MLT,EUR,14183,29421,43604,27162,28196,29438,21449,15516,17029,138790,13460,27550,41010,25673,27235,28719,22577,18482,22587,145273,284063,368670,368670
Malta,1992,MT,MLT,EUR,14160,29286,43446,27719,27609,29401,22679,15791,17393,140592,13406,27499,40905,26078,26703,28615,23679,18731,23117,146923,287515,371880,371880
Malta,1993,MT,MLT,EUR,14017,29243,43260,28320,27042,29331,23916,16111,17771,142491,13215,27543,40758,26551,26108,28613,24753,18984,23727,148736,291227,375241,375241
Malta,1994,MT,MLT,EUR,13655,29259,42914,28921,26574,29268,25218,16366,18234,144581,12825,27617,40442,27055,25518,28665,25852,19104,24429,150623,295204,378563,378563
Malta,1995,MT,MLT,EUR,13198,29301,42499,29402,26148,29448,26524,16505,18749,146776,12369,27639,40008,27501,25013,28802,27003,19050,25195,152564,299340,381849,381849
Malta,1996,MT,MLT,EUR,12901,29338,42239,29712,25935,29737,27725,16526,19200,148835,12055,27593,39648,27845,24741,28967,28119,18834,26043,154549,303384,385269,385269
Malta,1997,MT,MLT,EUR,12699,29256,41955,30109,25920,29939,28718,16662,19637,150985,11849,27457,39306,28181,24684,29049,29036,18763,26882,156595,307580,388839,388839
Malta,1998,MT,MLT,EUR,12450,29046,41496,30514,26088,29977,29152,17480,20136,153347,11630,27261,38891,28501,24769,28989,29431,19347,27708,158745,312092,392483,392483
Malta,1999,MT,MLT,EUR,12209,28759,40968,30652,26549,29796,29321,18709,20689,155716,11444,27003,38447,28671,25001,28826,29471,20358,28527,160854,316570,395983,395983
Malta,2000,MT,MLT,EUR,11970,28356,40326,30654,27242,29443,29516,19870,21286,158011,11296,26680,37976,28646,25488,28546,29436,21390,29400,162906,320917,399212,399212
Malta,2001,MT,MLT,EUR,11541,27991,39532,30595,28034,28953,29612,21115,21927,160236,10991,26360,37351,28596,26104,28114,29320,22550,30345,165029,325265,402151,402151
Malta,2002,MT,MLT,EUR,10952,27628,38580,30517,28764,28454,29626,22479,22592,162432,10521,25999,36520,28645,26636,27616,29242,23796,31228,167163,329595,404699,404699
Malta,2003,MT,MLT,EUR,10515,27023,37538,30482,29441,27959,29590,23815,23249,164536,10143,25442,35585,28720,27226,27029,29290,24960,32039,169264,333800,406919,406919
Malta,2004,MT,MLT,EUR,10231,26213,36444,30380,30043,27502,29539,25179,23854,166497,9839,24754,34593,28751,27826,26429,29357,26132,32764,171259,337756,408798,408798
Malta,2005,MT,MLT,EUR,10010,25345,35355,30208,30442,26989,29663,26556,24347,168205,9575,24035,33610,28647,28276,25923,29447,27385,33349,173027,341232,410208,410208
Malta,2006,MT,MLT,EUR,9900,24472,34372,29994,30601,26623,29817,27863,24684,169582,9452,23249,32701,28391,28587,25631,29526,28633,33779,174547,344129,411197,411197
Malta,2007,MT,MLT,EUR,9909,23536,33445,29673,30853,26439,29877,28907,25122,170871,9423,22413,31836,28052,28850,25532,29552,29638,34307,175931,346802,412081,412081
Malta,2008,MT,MLT,EUR,9974,22710,32684,29346,31189,26434,29827,29262,26228,172286,9422,21675,31097,27781,29068,25575,29488,29994,35424,177330,349616,413401,413401
Malta,2009,MT,MLT,EUR,10090,22078,32168,29136,31402,26777,29604,29256,27778,173953,9493,21108,30601,27590,29234,25757,29333,29914,36949,178777,352730,415500,415500
Malta,2010,MT,MLT,EUR,10212,21564,31776,29049,31750,27439,29252,29308,29425,176223,9609,20660,30269,27485,29363,26207,29075,29768,38586,180484,356707,418755,418755
Malta,2011,MT,MLT,EUR,10378,21086,31464,29252,32391,28351,28860,29328,31186,179368,9809,20248,30057,27531,29697,26853,28703,29550,40351,182685,362053,423571,423571
Malta,2012,MT,MLT,EUR,10627,20693,31320,29641,33391,29424,28561,29295,32949,183261,10081,19876,29957,27644,30431,27507,28291,29373,42124,185370,368631,429907,429907
Malta,2013,MT,MLT,EUR,10817,20557,31374,29903,34857,30671,28380,29274,34687,187772,10274,19660,29934,27661,31521,28310,27857,29354,43742,188445,376217,437525,437525
Malta,2014,MT,MLT,EUR,10994,20644,31638,30029,36673,32120,28354,29320,36375,192871,10413,19625,30038,27541,32904,29299,27448,29420,45274,191886,384757,446441,446441
Malta,2015,MT,MLT,EUR,11292,20796,32088,30086,38788,33709,28385,29602,37997,198567,10635,19656,30291,27367,34482,30350,27128,29583,46726,195636,394203,456579,456579
Malta,2016,MT,MLT,EUR,11610,21088,32698,30044,41227,35319,28657,30047,39475,204769,10875,19870,30745,27064,36163,31422,27075,29798,47969,199491,404260,467705,467705
Malta,2017,MT,MLT,EUR,11823,21589,33412,29774,43769,37234,29181,30524,40811,211293,11034,20301,31335,26549,37840,32679,27219,30040,49124,203451,414744,479497,479497
Malta,2018,MT,MLT,EUR,11992,22084,34076,29403,46326,39426,29914,30902,42106,218077,11185,20658,31843,26003,39530,34038,27520,30212,50291,207594,425671,491586,491586
Malta,2019,MT,MLT,EUR,12102,22568,34670,29046,48837,41575,30964,31123,43421,224966,11297,20990,32287,25549,41159,35340,28010,30267,51388,211713,436679,503635,503635
Malta,2020,MT,MLT,EUR,12152,23109,35261,28594,51116,43734,32336,31217,44654,231651,11319,21442,32761,25132,42542,36595,28725,30250,52445,215689,447340,515358,515358
Malta,2021,MT,MLT,EUR,12206,23676,35882,27939,53196,46023,33887,31195,45856,238096,11338,21966,33304,24663,43678,37871,29651,30080,53524,219467,457563,526748,526748
Malta,2022,MT,MLT,EUR,12238,24121,36359,26661,53646,47844,35269,31030,47196,241646,11368,22395,33763,23808,43689,39028,30456,29729,54814,221524,463170,533286,533286
Malta,2023,MT,MLT,EUR,12248,24361,36609,25190,52165,49282,36437,30786,48546,242406,11407,22624,34031,22820,42427,40082,31199,29280,56207,222015,464421,535064,535064
Malta,2024,MT,MLT,EUR,12312,24481,36793,24282,50009,50775,37687,30618,49818,243189,11505,22711,34216,22190,40659,41252,32109,28801,57533,222544,465733,536740,536740
Malta,2025,MT,MLT,EUR,12425,24605,37030,23686,47419,52159,38984,30448,51161,243857,11621,22779,34400,21744,38639,42421,32995,28338,58872,223009,466866,538297,538297
Malta,2026,MT,MLT,EUR,12465,24734,37199,23431,44529,53550,40127,30476,52414,244527,11672,22844,34516,21592,36386,43517,33825,28110,60045,223475,468002,539715,539715
Malta,2027,MT,MLT,EUR,12414,24819,37233,23534,41375,54674,41461,30666,53525,245235,11633,22892,34525,21731,33911,44386,34801,28012,61122,223963,469198,540956,540956
Malta,2028,MT,MLT,EUR,12294,24929,37223,23706,38247,55491,42924,30987,54525,245880,11521,23008,34529,21849,31560,45033,35768,28069,62084,224363,470243,541996,541996
Malta,2029,MT,MLT,EUR,12116,24999,37115,23933,35418,55969,44195,31570,55427,246512,11356,23136,34492,21997,29451,45415,36649,28291,62894,224697,471209,542824,542824
Malta,2030,MT,MLT,EUR,11885,24995,36880,24243,32908,55944,45424,32424,56214,247157,11140,23195,34335,22243,27660,45387,37446,28718,63601,225055,472212,543425,543425
Malta,1950,MT,MLT,EUR,22440,28093,50533,19362,17241,16101,13885,11043,10377,88009,21709,30459,52168,25282,19662,17257,15190,12507,11263,101161,189170,291873,291873
Malta,1951,MT,MLT,EUR,22409,30381,52790,19825,17642,16007,14121,11198,10044,88837,21588,31994,53582,26021,20365,17239,15389,12854,11111,102979,191816,298188,298188
Malta,1952,MT,MLT,EUR,22210,32772,54982,20400,18001,15888,14401,11339,9857,89886,21304,33675,54979,26706,21084,17216,15640,13149,11074,104869,194755,304707,304707
Malta,1953,MT,MLT,EUR,22000,35157,57157,21046,18271,15800,14695,11486,9834,91132,21015,35425,56440,27253,21773,17234,15913,13372,11149,106694,197826,311417,311417
Malta,1954,MT,MLT,EUR,21753,37474,59227,21695,18435,15768,14964,11592,9861,92315,20699,37216,57915,27574,22390,17328,16177,13510,11314,108293,200608,317760,317760
Malta,1955,MT,MLT,EUR,21629,39482,61111,22336,18508,15817,15176,11671,9943,93451,20526,38801,59327,27704,22905,17519,16394,13592,11591,109705,203156,323596,323596
Malta,1956,MT,MLT,EUR,21718,40929,62647,23032,18514,15939,15314,11751,10093,94643,20570,39944,60514,27767,23301,17790,16520,13623,11917,110918,205561,328721,328721
Malta,1957,MT,MLT,EUR,21833,41773,63606,23835,18471,16120,15348,11814,10193,95781,20678,40606,61284,27878,23567,18101,16546,13625,12210,111927,207708,332598,332598
Malta,1958,MT,MLT,EUR,21837,41993,63830,24763,18424,16331,15299,11937,10358,97112,20687,40751,61438,28149,23714,18426,16474,13660,12544,112967,210079,335351,335351
Malta,1959,MT,MLT,EUR,21691,41690,63381,25771,18374,16551,15168,12120,10537,98521,20564,40429,60993,28609,23741,18741,16306,13775,12900,114072,212593,336970,336970
Malta,1960,MT,MLT,EUR,21465,41009,62474,26789,18292,16771,14954,12347,10684,99837,20379,39753,60132,29246,23637,19026,16057,13974,13239,115179,215016,337628,337628
Malta,1961,MT,MLT,EUR,20961,40097,61058,27779,18180,16947,14714,12631,10848,101099,19895,38843,58738,30040,23410,19267,15777,14229,13506,116229,217328,337120,337120
Malta,1962,MT,MLT,EUR,20075,39138,59213,28713,18020,17041,14489,12921,10974,102158,19021,37899,56920,30924,23063,19442,15519,14504,13707,117159,219317,335452,335452
Malta,1963,MT,MLT,EUR,18927,38157,57084,29592,17807,17033,14316,13182,11044,102974,17908,36959,54867,31837,22609,19542,15330,14775,13878,117971,220945,332894,332894
Malta,1964,MT,MLT,EUR,17633,37147,54780,30417,17564,16942,14218,13410,11119,103670,16648,35992,52640,32741,22108,19579,15231,15005,14005,118669,222339,329757,329757
Malta,1965,MT,MLT,EUR,16183,36294,52477,31064,17352,16815,14217,13568,11188,104204,15254,35144,50398,33482,21670,19584,15246,15167,14172,119321,223525,326401,326401
Malta,1966,MT,MLT,EUR,14799,35493,50292,31441,17260,16689,14292,13639,11264,104585,13949,34314,48263,33920,21387,19592,15355,15229,14354,119837,224422,322983,322983
Malta,1967,MT,MLT,EUR,13734,34626,48360,31622,17356,16614,14457,13633,11393,105075,12955,33416,46371,34069,21329,19641,15548,15182,14573,120342,225417,320151,320151
Malta,1968,MT,MLT,EUR,12949,33698,46647,31638,17707,16595,14687,13544,11557,105728,12229,32452,44681,33931,21578,19710,15819,15053,14910,121001,226729,318055,318055
Malta,1969,MT,MLT,EUR,12404,32691,45095,31542,18258,16614,14959,13369,11707,106449,11741,31401,43142,33585,22103,19790,16151,14848,15299,121776,228225,316457,316457
Malta,2031,MT,MLT,EUR,11610,24893,36503,24612,30616,55592,46711,33395,56885,247811,10880,23176,34056,22552,26144,45020,38192,29362,64144,225414,473225,543793,543793
Malta,2032,MT,MLT,EUR,11301,24780,36081,24968,28636,54794,48009,34458,57534,248399,10591,23128,33719,22878,24845,44252,39080,30004,64667,225726,474125,543919,543919
Malta,2033,MT,MLT,EUR,10965,24671,35636,25207,27171,53321,49439,35611,58123,248872,10276,23055,33331,23107,23858,42990,40127,30743,65135,225960,474832,543800,543800
Malta,2034,MT,MLT,EUR,10617,24558,35175,25327,26262,51172,50924,36840,58710,249235,9952,22987,32939,23193,23227,41228,41292,31642,65508,226090,475325,543443,543443
Malta,2035,MT,MLT,EUR,10273,24438,34711,25450,25672,48588,52302,38118,59363,249493,9628,22886,32514,23266,22782,39211,42460,32522,65913,226154,475647,542874,542874
Malta,2036,MT,MLT,EUR,9939,24201,34140,25581,25416,45706,53684,39243,60130,249760,9314,22679,31993,23327,22629,36963,43553,33348,66399,226219,475979,542106,542106
Malta,2037,MT,MLT,EUR,9632,23842,33474,25666,25518,42561,54800,40559,60916,250020,9026,22351,31377,23373,22772,34493,44419,34316,66918,226291,476311,541163,541163
Malta,2038,MT,MLT,EUR,9363,23391,32754,25773,25691,39447,55615,41996,61748,250270,8776,21925,30701,23494,22888,32146,45067,35276,67481,226352,476622,540076,540076
Malta,2039,MT,MLT,EUR,9146,22867,32013,25844,25920,36629,56090,43250,62743,250476,8572,21437,30009,23621,23039,30043,45445,36149,68081,226378,476854,538874,538874
Malta,2040,MT,MLT,EUR,8979,22289,31268,25837,26224,34126,56064,44467,63909,250627,8415,20893,29308,23676,23285,28254,45419,36944,68781,226359,476986,537574,537574
Malta,2041,MT,MLT,EUR,8854,21682,30536,25740,26595,31845,55720,45739,65095,250734,8299,20322,28621,23658,23592,26741,45055,37687,69555,226288,477022,536189,536189
Malta,2042,MT,MLT,EUR,8781,21065,29846,25625,26948,29873,54934,47020,66373,250773,8230,19745,27975,23611,23917,25446,44288,38567,70331,226160,476933,534754,534754
Malta,2043,MT,MLT,EUR,8741,20464,29205,25518,27190,28414,53470,48434,67710,250736,8194,19182,27376,23540,24147,24462,43034,39610,71161,225954,476690,533270,533270
Malta,2044,MT,MLT,EUR,8734,19900,28634,25405,27310,27513,51339,49897,69146,250610,8189,18654,26843,23471,24232,23833,41280,40769,72087,225672,476282,531758,531758
Malta,2045,MT,MLT,EUR,8762,19384,28146,25286,27430,26923,48778,51262,70716,250395,8216,18173,26389,23369,24302,23390,39276,41933,73045,225315,475710,530247,530247
Malta,2046,MT,MLT,EUR,8819,18929,27748,25050,27563,26670,45922,52630,72270,250105,8268,17744,26012,23164,24364,23237,37040,43018,74055,224878,474983,528737,528737
Malta,2047,MT,MLT,EUR,8888,18545,27433,24688,27648,26773,42807,53734,74056,249706,8332,17390,25722,22836,24414,23377,34585,43882,75259,224353,474059,527222,527222
Malta,2048,MT,MLT,EUR,8970,18238,27208,24235,27754,26945,39719,54548,76028,249229,8411,17104,25515,22409,24531,23497,32254,44529,76545,223765,472994,525713,525713
Malta,2049,MT,MLT,EUR,9060,18017,27077,23711,27824,27171,36931,55023,78002,248662,8493,16895,25388,21920,24659,23649,30162,44913,77794,223097,471759,524226,524226
Malta,2050,MT,MLT,EUR,9147,17876,27023,23137,27821,27478,34454,55008,80113,248011,8576,16763,25339,21378,24718,23894,28385,44884,79101,222360,470371,522737,522737
Myanmar,1970,MM,MMR,SEA,2188286,3491390,5679676,2495730,1749142,1499416,1097703,693398,461037,7996426,2091298,3394377,5485675,2460201,1703974,1495244,1123148,757685,582085,8122337,16118763,27284112,27284112
Myanmar,1971,MM,MMR,SEA,2225727,3572468,5798195,2596115,1772757,1519316,1119459,711131,475501,8194279,2125481,3468660,5594141,2562794,1727401,1513241,1147460,776589,600852,8328337,16522616,27914953,27914953
Myanmar,1972,MM,MMR,SEA,2261492,3653689,5915181,2699243,1800149,1536482,1140575,730971,489947,8397367,2158351,3542751,5701102,2666564,1754802,1527836,1171952,797652,619499,8538305,16935672,28551949,28551949
Myanmar,1973,MM,MMR,SEA,2294323,3734723,6029046,2801555,1825534,1548487,1160673,751526,503754,8591529,2188691,3616524,5805215,2763949,1784834,1537365,1196049,819664,637702,8739563,17331092,29165356,29165356
Myanmar,1974,MM,MMR,SEA,2323709,3815286,6138995,2888854,1862403,1555038,1180766,771427,517037,8775525,2215994,3689893,5905887,2843342,1829185,1542121,1219972,841236,655681,8931537,17707062,29751936,29751936
Myanmar,1975,MM,MMR,SEA,2350699,3896149,6246848,2964294,1918215,1559326,1202162,790680,530620,8965297,2241064,3763475,6004539,2912277,1890566,1544951,1244187,861974,673629,9127584,18092881,30344276,30344276
Myanmar,1976,MM,MMR,SEA,2376440,3976977,6353417,3038789,1980385,1561498,1224702,809340,544289,9159003,2264971,3837260,6102231,2980200,1957754,1546243,1268790,882158,691584,9326729,18485732,30941375,30941375
Myanmar,1977,MM,MMR,SEA,2401843,4056461,6458304,3113970,2050539,1563065,1249077,827358,557711,9361720,2288744,3910201,6198945,3049328,2032495,1547912,1294452,901854,709581,9535622,18897342,31554598,31554598
Myanmar,1978,MM,MMR,SEA,2427294,4133508,6560802,3190420,2128554,1566369,1274145,844894,571384,9575766,2312689,3981034,6293723,3120240,2114533,1551871,1319824,921134,727714,9755316,19331082,32185601,32185601
Myanmar,1979,MM,MMR,SEA,2454475,4206135,6660610,3266391,2210909,1572951,1296636,862244,585961,9795092,2338287,4048023,6386310,3190670,2200358,1558884,1342121,940813,746920,9979766,19774858,32821779,32821779
Myanmar,1980,MM,MMR,SEA,2482684,4273598,6756282,3343918,2296684,1584623,1315414,879794,601622,10022055,2364923,4110573,6475496,3262561,2289151,1570624,1360443,961469,767697,10211945,20234000,33465781,33465781
Myanmar,1981,MM,MMR,SEA,2509103,4337993,6847096,3422170,2384588,1600917,1331182,897262,618539,10254658,2389743,4170503,6560246,3334735,2379207,1586712,1375083,982553,789808,10448098,20702756,34110098,34110098
Myanmar,1982,MM,MMR,SEA,2535964,4399668,6935632,3497752,2472750,1619017,1343665,913995,636489,10483668,2414690,4228370,6643060,3403866,2468266,1605074,1385978,1003741,813301,10680226,21163894,34742586,34742586
Myanmar,1983,MM,MMR,SEA,2567547,4459995,7027542,3579476,2570668,1642119,1354633,931274,655451,10733621,2443983,4285525,6729508,3479666,2562313,1632750,1395087,1025811,837961,10933588,21667209,35424262,35424262
Myanmar,1984,MM,MMR,SEA,2600857,4520811,7121668,3667876,2666672,1684333,1364524,950128,674636,11008169,2474937,4343524,6818461,3562700,2651879,1682134,1403152,1048975,862702,11211542,22219711,36159838,36159838
Myanmar,1985,MM,MMR,SEA,2627108,4580096,7207204,3754416,2750556,1743910,1372166,969867,693107,11284022,2499244,4400002,6899246,3643916,2730794,1747549,1409398,1072308,886580,11490545,22774567,36881020,36881020
Myanmar,1986,MM,MMR,SEA,2641204,4636352,7277556,3838483,2832432,1809363,1377892,990431,710877,11559478,2512073,4453573,6965646,3722876,2808008,1818725,1414338,1095939,909771,11769657,23329135,37572340,37572340
Myanmar,1987,MM,MMR,SEA,2639765,4692892,7332657,3918905,2912305,1880665,1382421,1012104,727777,11834177,2510292,4507312,7017604,3798400,2883711,1895542,1418937,1120060,932078,12048728,23882905,38233171,38233171
Myanmar,1988,MM,MMR,SEA,2621271,4752833,7374104,3995540,2991067,1957479,1387661,1033765,744066,12109578,2492404,4563960,7056364,3870362,2958611,1977377,1424782,1143345,953748,12328225,24437803,38868270,38868270
Myanmar,1989,MM,MMR,SEA,2595086,4814843,7409929,4066535,3068551,2038360,1395909,1053192,760747,12383294,2467125,4622549,7089674,3937086,3032420,2062996,1433568,1163936,976514,12606520,24989814,39489419,39489419
Myanmar,1990,MM,MMR,SEA,2573199,4871223,7444422,4130511,3145114,2121495,1408382,1069349,778229,12653080,2445829,4675692,7121521,3996891,3105173,2150567,1446357,1180794,1000747,12880529,25533609,40099553,40099553
Myanmar,1991,MM,MMR,SEA,2558793,4914217,7473010,4187731,3218110,2205012,1424283,1082622,796063,12913821,2431634,4715911,7147545,4050284,3174242,2238248,1462813,1194356,1026213,13146156,26059977,40680533,40680533
Myanmar,1992,MM,MMR,SEA,2551867,4943082,7494949,4240615,3287542,2290287,1442687,1093588,814346,13169065,2424612,4742334,7166946,4099831,3239623,2326796,1482347,1205154,1053102,13406853,26575918,41237813,41237813
Myanmar,1993,MM,MMR,SEA,2552083,4958786,7510869,4292255,3356445,2379094,1463043,1102297,832960,13426094,2424379,4756223,7180602,4148730,3304463,2414559,1508235,1213626,1081120,13670733,27096827,41788302,41788302
Myanmar,1994,MM,MMR,SEA,2551957,4967173,7519130,4345238,3425493,2459424,1497568,1108856,851894,13688473,2423781,4763337,7187118,4199703,3369684,2491461,1551568,1220286,1109681,13942383,27630856,42337109,42337109
Myanmar,1995,MM,MMR,SEA,2545781,4973445,7519226,4398696,3494538,2529282,1548191,1113804,871106,13955617,2417418,4768369,7185787,4251495,3435064,2559092,1610252,1225594,1138060,14219557,28175174,42880186,42880186
Myanmar,1996,MM,MMR,SEA,2537023,4976802,7513825,4451218,3563853,2598796,1604816,1117743,890779,14227205,2408591,4770821,7179412,4302626,3500937,2626624,1675070,1230426,1167244,14502927,28730132,43423369,43423369
Myanmar,1997,MM,MMR,SEA,2527052,4973740,7500792,4506447,3633061,2668315,1667578,1121339,910973,14507713,2398462,4767547,7166009,4356689,3567119,2694686,1746117,1235693,1197226,14797530,29305243,43972046,43972046
Myanmar,1998,MM,MMR,SEA,2515069,4961391,7476460,4565966,3700267,2737397,1735605,1125949,931100,14796284,2386119,4755655,7141774,4415116,3631903,2762894,1822392,1242564,1226796,15101665,29897949,44516185,44516185
Myanmar,1999,MM,MMR,SEA,2502823,4940454,7443277,4626239,3762073,2805269,1807271,1133162,949889,15083903,2373194,4735570,7108764,4474232,3691823,2830215,1902327,1252128,1254964,15405689,30489592,45041636,45041636
Myanmar,2000,MM,MMR,SEA,2493221,4916838,7410059,4678250,3816104,2872202,1880903,1143860,966702,15358021,2362653,4712535,7075188,4524779,3743935,2896451,1984035,1265025,1280837,15695062,31053083,45538332,45538332
Myanmar,2001,MM,MMR,SEA,2489261,4897776,7387037,4714825,3863999,2937634,1955793,1157835,981861,15611947,2357610,4693545,7051155,4559904,3790293,2961104,2066793,1281522,1305073,15964689,31576636,46014826,46014826
Myanmar,2002,MM,MMR,SEA,2493923,4884470,7378393,4735683,3907104,3000850,2032764,1174090,995698,15846189,2360974,4679629,7040603,4579318,3832283,3023395,2150975,1300971,1328094,16215036,32061225,46480230,46480230
Myanmar,2003,MM,MMR,SEA,2500903,4875546,7376449,4742442,3946113,3062279,2112308,1191727,1008250,16063119,2366826,4669488,7036314,4584747,3870386,3083752,2233892,1325876,1349753,16448406,32511525,46924293,46924293
Myanmar,2004,MM,MMR,SEA,2501765,4865570,7367335,4742075,3983712,3122065,2183712,1221300,1019661,16272525,2367161,4657931,7025092,4583018,3907062,3142155,2305719,1366092,1369446,16673492,32946017,47338446,47338446
Myanmar,2005,MM,MMR,SEA,2495059,4852274,7347333,4739898,4019456,3180183,2245324,1264458,1030244,16479563,2360526,4642704,7003230,4579162,3941501,3198539,2368060,1419759,1387328,16894349,33373912,47724471,47724471
Myanmar,2006,MM,MMR,SEA,2478698,4841950,7320648,4735435,4052383,3236838,2305972,1312298,1040516,16683442,2344817,4629904,6974721,4572789,3972495,3253007,2429094,1478113,1403972,17109470,33792912,48088274,48088274
Myanmar,2007,MM,MMR,SEA,2453002,4838905,7291907,4726439,4086988,3291664,2366059,1365060,1051374,16887584,2320280,4623684,6943964,4562046,4004364,3305058,2489256,1541211,1420255,17322190,34209774,48445647,48445647
Myanmar,2008,MM,MMR,SEA,2416800,4828423,7245223,4707933,4125169,3342345,2423972,1420635,1061438,17081492,2285554,4610011,6895565,4541047,4036341,3349385,2544167,1604638,1431632,17507210,34588702,48729486,48729486
Myanmar,2009,MM,MMR,SEA,2385004,4811756,7196760,4684273,4168631,3390053,2481963,1479770,1073310,17278000,2255085,4590616,6845701,4515577,4073604,3390752,2598942,1671549,1444949,17695373,34973373,49015836,49015836
Myanmar,2010,MM,MMR,SEA,2365952,4798963,7164915,4665979,4214567,3437187,2543229,1543068,1089403,17493433,2237067,4575510,6812577,4497315,4116701,3434923,2659735,1744861,1466531,17920066,35413499,49390988,49390988
Myanmar,2011,MM,MMR,SEA,2350127,4783263,7133390,4657953,4256230,3484967,2606175,1608628,1107986,17721939,2222218,4558070,6780288,4489540,4155965,3479962,2721849,1820235,1491351,18158902,35880841,49794522,49794522
Myanmar,2012,MM,MMR,SEA,2335263,4767065,7102328,4658907,4291369,3533831,2669747,1676884,1128257,17958995,2208188,4540822,6749010,4490623,4189177,3526553,2784331,1897972,1519192,18407848,36366843,50218185,50218185
Myanmar,2013,MM,MMR,SEA,2322323,4751106,7073429,4664381,4318338,3583050,2733855,1748065,1149502,18197191,2195748,4524252,6720000,4495676,4214505,3573619,2846955,1975472,1551483,18657710,36854901,50648334,50648334
Myanmar,2014,MM,MMR,SEA,2312299,4734902,7047201,4666164,4339776,3632901,2797592,1813394,1179500,18429327,2185887,4507822,6693709,4496596,4234694,3621568,2908977,2044225,1596140,18902200,37331527,51072436,51072436
Myanmar,2015,MM,MMR,SEA,2306881,4716590,7023471,4660645,4358596,3681913,2860318,1871305,1219190,18651967,2180088,4489729,6669817,4489791,4252722,3668954,2970079,2105542,1651611,19138699,37790666,51483949,51483949
Myanmar,2016,MM,MMR,SEA,2308420,4690946,6999366,4655769,4375063,3729576,2922340,1928631,1261750,18873129,2180704,4464817,6645521,4483066,4268830,3715002,3030490,2166311,1710637,19374336,38247465,51892349,51892349
Myanmar,2017,MM,MMR,SEA,2313548,4655296,6968844,4655829,4385196,3778604,2982328,1985144,1307280,19094381,2184876,4430373,6615249,4480534,4279095,3762274,3088787,2226266,1772911,19609867,38704248,52288341,52288341
Myanmar,2018,MM,MMR,SEA,2318211,4617718,6935929,4653926,4385088,3831606,3039772,2041407,1356561,19308360,2188785,4393919,6582704,4475690,4279411,3813404,3144597,2286112,1839807,19839021,39147381,52666014,52666014
Myanmar,2019,MM,MMR,SEA,2320732,4588106,6908838,4646490,4377550,3888649,3094215,2097983,1409591,19514478,2190786,4364878,6555664,4465610,4272453,3868537,3197353,2346097,1911187,20061237,39575715,53040212,53040212
Myanmar,2020,MM,MMR,SEA,2318767,4568798,6887565,4638776,4371709,3944722,3145606,2154687,1463109,19718609,2188795,4345480,6534275,4455408,4266741,3922501,3246841,2406355,1984903,20282749,40001358,53423198,53423198
Myanmar,2021,MM,MMR,SEA,2310512,4559320,6869832,4631312,4374116,3992884,3194437,2208904,1511178,19912831,2180884,4335249,6516133,4446646,4269563,3968974,3294584,2464859,2054659,20499285,40412116,53798084,53798084
Myanmar,2022,MM,MMR,SEA,2297998,4553975,6851973,4623979,4383036,4031548,3243124,2264610,1564292,20110589,2169327,4328873,6498200,4438901,4278844,4006196,3342435,2523793,2128369,20718538,40829127,54179306,54179306
Myanmar,2023,MM,MMR,SEA,2284510,4549960,6834470,4616456,4395979,4061535,3293153,2324105,1627264,20318492,2157440,4323787,6481227,4430691,4291008,4034491,3391120,2584995,2211497,20943802,41262294,54577997,54577997
Myanmar,2024,MM,MMR,SEA,2270504,4546610,6817114,4607821,4406767,4087072,3343998,2383143,1691119,20519920,2145148,4319378,6464526,4421628,4300562,4058565,3440835,2645504,2296037,21163131,41683051,54964694,54964694
Myanmar,2025,MM,MMR,SEA,2255507,4543002,6798509,4596451,4413257,4112680,3395178,2441602,1755726,20714894,2132018,4314788,6446806,4410151,4305361,4082958,3490949,2705357,2381796,21376572,42091466,55336783,55336783
Myanmar,2026,MM,MMR,SEA,2241581,4539157,6780738,4577037,4421517,4137265,3445641,2499603,1821217,20902280,2120010,4310101,6430111,4390956,4311443,4106724,3540288,2764694,2468753,21582858,42485138,55695986,55695986
Myanmar,2027,MM,MMR,SEA,2228704,4534472,6763176,4547184,4435558,4157195,3498234,2556283,1887926,21082380,2108727,4305147,6413874,4361588,4322753,4126292,3591634,2822539,2557361,21782167,42864547,56041605,56041605
Myanmar,2028,MM,MMR,SEA,2215076,4528948,6744024,4514904,4449215,4169626,3555561,2610960,1955912,21256178,2096412,4300003,6396415,4329606,4333479,4138575,3647690,2878315,2647735,21975400,43231578,56372008,56372008
Myanmar,2029,MM,MMR,SEA,2200950,4520782,6721732,4489642,4456366,4174991,3616561,2662799,2025255,21425614,2083566,4292647,6376213,4304128,4337845,4143821,3707559,2931130,2739760,22164243,43589857,56687802,56687802
Myanmar,2030,MM,MMR,SEA,2186871,4506554,6693425,4473594,4458504,4178244,3674777,2711546,2096274,21592939,2070698,4279937,6350635,4287241,4337382,4146927,3764781,2980594,2833711,22350636,43943575,56987625,56987625
Myanmar,1950,MM,MMR,SEA,1327528,1940847,3268375,1763497,1396713,1029415,729949,434124,250334,5604032,1288459,1882162,3170621,1734060,1372639,1023885,756173,483120,318915,5688792,11292824,17731818,17731818
Myanmar,1951,MM,MMR,SEA,1382452,1961074,3343526,1779529,1417153,1048311,745365,443399,257135,5690892,1348857,1899012,3247869,1745151,1394069,1041765,771202,492807,326446,5771440,11462332,18053722,18053722
Myanmar,1952,MM,MMR,SEA,1440636,1986334,3426970,1792509,1436654,1070236,760835,452846,264394,5777474,1410937,1921540,3332477,1752616,1415787,1062710,786371,502839,334753,5855076,11632550,18391995,18391995
Myanmar,1953,MM,MMR,SEA,1505987,2015411,3521398,1802111,1455903,1094031,776090,462859,272151,5863145,1473767,1953087,3426854,1756585,1437729,1085436,801331,513453,343705,5938239,11801384,18749629,18749629
Myanmar,1954,MM,MMR,SEA,1562767,2063524,3626291,1808684,1476683,1117933,790657,473864,280198,5948019,1524624,2006790,3531414,1758002,1460517,1108183,815692,525111,353200,6020705,11968724,19126425,19126425
Myanmar,1955,MM,MMR,SEA,1607686,2132963,3740649,1813268,1499528,1141225,804793,485983,288542,6033339,1565035,2080106,3645141,1758258,1484253,1130369,829662,537890,363221,6103653,12136992,19522788,19522788
Myanmar,1956,MM,MMR,SEA,1652254,2210527,3862781,1816341,1524317,1164085,818309,499143,297232,6119427,1605109,2161121,3766230,1757836,1508847,1152126,842930,551632,373707,6187078,12306505,19935514,19935514
Myanmar,1957,MM,MMR,SEA,1695300,2295891,3991191,1818650,1551416,1186372,830751,513265,306215,6206669,1644181,2249446,3893627,1757866,1534558,1173298,855170,566362,384767,6272021,12478690,20363510,20363510
Myanmar,1958,MM,MMR,SEA,1735558,2387824,4123382,1821954,1578576,1207727,843026,527940,315478,6294701,1680938,2343797,4024735,1759793,1559259,1193840,867318,581730,396416,6358356,12653057,20801170,20801170
Myanmar,1959,MM,MMR,SEA,1772427,2484856,4257283,1830362,1603299,1228980,857197,542608,324996,6387442,1714641,2442814,4157455,1766692,1581009,1215063,881338,597185,408585,6449872,12837314,21252042,21252042
Myanmar,1960,MM,MMR,SEA,1806858,2585299,4392157,1846537,1624989,1250976,874040,557000,334849,6488391,1746060,2544750,4290810,1780911,1599344,1237722,897865,612349,421151,6549342,13037733,21720697,21720697
Myanmar,1961,MM,MMR,SEA,1839763,2688085,4527848,1869374,1643844,1272875,893397,571250,345010,6595750,1775952,2648212,4424164,1801726,1614374,1261076,916829,627322,434025,6655352,13251102,22203109,22203109
Myanmar,1962,MM,MMR,SEA,1872074,2794116,4666190,1897053,1660171,1294103,915367,585433,355308,6707435,1805248,2753514,4558762,1827973,1626514,1284891,938493,642281,447162,6767314,13474749,22699703,22699703
Myanmar,1963,MM,MMR,SEA,1905144,2903960,4809104,1928201,1673862,1315538,939013,599372,365986,6821972,1835102,2857012,4692114,1862607,1635987,1309361,961839,656994,460703,6887491,13709463,23210687,23210687
Myanmar,1964,MM,MMR,SEA,1940329,3002410,4942739,1977397,1684823,1338481,962742,612803,377376,6953622,1866845,2946235,4813080,1918284,1643445,1334917,985297,671284,475134,7028361,13981983,23737818,23737818
Myanmar,1965,MM,MMR,SEA,1979036,3087054,5066090,2047135,1693969,1363271,985932,625993,389594,7105894,1901891,3023592,4925483,1992968,1650161,1361603,1008421,685482,490778,7189413,14295307,24286878,24286878
Myanmar,1966,MM,MMR,SEA,2020487,3170068,5190555,2124567,1701719,1389927,1008815,638872,402762,7266662,1939466,3099393,5038859,2074935,1656285,1389293,1031304,699293,507522,7358632,14625294,24854704,24854704
Myanmar,1967,MM,MMR,SEA,2063150,3251553,5314703,2209477,1708895,1418951,1031390,651165,416919,7436797,1978083,3173908,5151991,2163826,1662833,1418242,1053803,712428,525403,7536535,14973332,25440029,25440029
Myanmar,1968,MM,MMR,SEA,2106578,3331690,5438268,2300850,1717642,1448830,1053595,663639,431710,7616266,2017297,3247626,5264923,2258929,1672032,1447283,1076266,725860,544282,7724652,15340918,26044111,26044111
Myanmar,1969,MM,MMR,SEA,2148836,3411071,5559907,2396781,1730436,1476114,1075584,677590,446510,7803015,2055497,3320660,5376157,2358292,1685281,1473393,1099281,740835,563316,7920398,15723413,26659479,26659479
Myanmar,2031,MM,MMR,SEA,2171684,4486181,6657865,4466251,4456118,4185420,3724063,2758893,2168358,21759103,2056708,4261734,6318442,4278518,4332720,4153772,3813012,3028745,2928764,22535531,44294634,57270951,57270951
Myanmar,2032,MM,MMR,SEA,2155897,4462315,6618212,4462430,4451780,4197129,3763548,2805624,2240827,21921338,2042165,4240264,6282429,4273125,4326541,4164773,3851333,3076568,3024147,22716487,44637825,57538458,57538458
Myanmar,2033,MM,MMR,SEA,2140522,4436848,6577370,4459816,4446431,4211773,3793833,2851892,2313398,22077143,2028026,4217304,6245330,4268873,4319699,4178297,3880474,3124122,3119666,22891131,44968274,57790976,57790976
Myanmar,2034,MM,MMR,SEA,2124649,4410315,6534964,4457804,4439919,4224246,3819928,2898957,2385417,22226271,2013394,4193373,6206767,4265254,4311952,4189202,3905534,3172711,3214594,23059247,45285518,58027255,58027255
Myanmar,2035,MM,MMR,SEA,2109099,4382824,6491923,4455484,4430662,4232538,3846151,2946355,2456751,22367941,1999049,4168552,6167601,4261431,4301765,4195404,3930936,3221709,3308783,23220028,45587969,58247490,58247490
Myanmar,2036,MM,MMR,SEA,2095488,4355262,6450750,4452876,4413488,4242548,3871447,2993191,2527750,22501300,1986515,4143692,6130207,4257479,4283905,4202864,3955746,3270053,3402631,23372678,45873978,58454929,58454929
Myanmar,2037,MM,MMR,SEA,2081873,4328104,6409977,4449384,4386076,4258192,3892489,3042070,2598177,22626388,1973899,4118958,6092857,4253230,4255951,4215476,3976565,3320404,3495933,23517559,46143947,58646780,58646780
Myanmar,2038,MM,MMR,SEA,2068011,4300560,6368571,4445011,4356253,4273454,3906677,3095286,2667604,22744285,1960943,4093554,6054497,4248767,4225389,4227504,3990464,3375299,3588321,23655744,46400029,58823107,58823107
Myanmar,2039,MM,MMR,SEA,2055376,4271982,6327358,4437997,4333248,4282354,3914380,3151757,2735417,22855153,1949151,4067101,6016252,4242090,4201238,4233245,3997661,3433806,3678999,23787039,46642192,58985810,58985810
Myanmar,2040,MM,MMR,SEA,2043041,4243741,6286782,4424979,4319219,4286315,3920092,3205564,2801828,22957997,1937607,4040866,5978473,4230064,4185562,4234181,4002779,3489770,3768208,23910564,46868561,59133816,59133816
Myanmar,2041,MM,MMR,SEA,2029617,4216287,6245904,4405888,4313674,4285833,3929386,3251227,2867864,23053872,1924926,4015270,5940196,4212553,4177950,4230933,4011442,3537231,3857202,24027311,47081183,59267283,59267283
Myanmar,2042,MM,MMR,SEA,2017199,4188191,6205390,4383321,4311542,4283408,3942796,3288018,2933778,23142863,1913219,3988999,5902218,4191772,4173608,4226153,4024039,3575327,3946243,24137142,47280005,59387605,59387605
Myanmar,2043,MM,MMR,SEA,2006285,4160217,6166502,4359153,4310552,4279958,3958806,3316562,2999635,23224666,1903004,3962750,5865754,4169494,4170368,4220687,4038974,3604801,4035418,24239742,47464408,59496666,59496666
Myanmar,2044,MM,MMR,SEA,1996390,4132931,6129321,4333908,4310126,4275342,3972747,3341596,3066046,23299765,1893721,3937136,5830857,4146224,4167737,4214301,4051347,3630592,4125451,24335652,47635417,59595599,59595599
Myanmar,2045,MM,MMR,SEA,1987407,4106231,6093638,4307686,4309364,4268034,3982841,3367022,3132554,23367501,1885304,3912014,5797318,4122051,4164871,4205481,4059215,3656895,4215787,24424300,47791801,59682760,59682760
Myanmar,2046,MM,MMR,SEA,1978005,4080333,6058338,4281359,4308281,4253044,3994707,3391801,3198592,23427784,1876519,3887528,5764047,4097812,4161851,4189086,4068374,3682754,4305735,24505612,47933396,59755787,59755787
Myanmar,2047,MM,MMR,SEA,1968491,4055397,6023888,4255392,4306286,4228144,4012074,3413182,3266333,23481411,1867541,3863902,5731443,4073669,4158487,4162730,4082628,3705108,4397771,24580393,48061804,59817137,59817137
Myanmar,2048,MM,MMR,SEA,1958288,4031676,5989964,4228992,4303367,4200895,4029123,3429068,3337612,23529057,1857813,3841386,5699199,4048825,4154856,4133760,4096315,3721311,4494200,24649267,48178324,59867490,59867490
Myanmar,2049,MM,MMR,SEA,1945440,4010134,5955574,4201527,4297811,4180216,4040027,3439707,3411036,23570324,1845516,3820918,5666434,4022894,4148974,4111051,4103785,3731526,4593586,24711816,48282140,59904146,59904146
Myanmar,2050,MM,MMR,SEA,1931782,3989779,5921561,4174350,4286304,4168223,4046104,3448685,3481908,23605574,1832396,3801518,5633914,3997153,4137739,4096653,4106466,3739839,4690502,24768352,48373926,59929399,59929399
Montenegro,2005,ME,MNE,EUR,21593,44700,66293,49825,45017,42436,43448,27280,32647,240653,20140,43212,63352,49170,46388,43934,44104,32011,46975,262582,503235,632875,632875
Montenegro,2006,ME,MNE,EUR,21278,44245,65523,49019,45370,42101,43750,28104,33220,241564,19747,42714,62461,48116,46695,43496,44354,32647,47690,262998,504562,632545,632545
Montenegro,2007,ME,MNE,EUR,20805,43852,64657,48204,45690,41780,43974,29287,33497,242432,19282,42265,61547,47000,46912,43192,44604,33508,48072,263288,505720,631923,631923
Montenegro,2008,ME,MNE,EUR,20412,43480,63892,47340,46091,41391,43947,30863,33611,243243,18923,41803,60726,45839,47054,42946,44687,34689,48395,263610,506853,631466,631466
Montenegro,2009,ME,MNE,EUR,20292,42998,63290,46471,46378,41125,43666,32700,33600,243940,18795,41236,60031,44826,47005,42783,44521,36187,48602,263924,507864,631182,631182
Montenegro,2010,ME,MNE,EUR,20429,42216,62645,45808,46506,40921,43302,34728,33428,244693,18979,40391,59370,44099,46755,42709,44251,37919,48596,264329,509022,631044,631044
Montenegro,2011,ME,MNE,EUR,20587,41396,61983,45418,46742,40826,42954,36394,33462,245796,19159,39519,58678,43689,46597,42782,44051,39339,48875,265333,511129,631788,631788
Montenegro,2012,ME,MNE,EUR,20599,40905,61504,45035,47042,40981,42490,37520,33945,247013,19121,38942,58063,43325,46545,43004,43820,40220,49560,266474,513487,633051,633051
Montenegro,2013,ME,MNE,EUR,20472,40676,61148,44616,47024,41314,41897,38524,34558,247933,18989,38592,57581,42894,46232,43370,43390,40967,50431,267284,515217,633946,633946
Montenegro,2014,ME,MNE,EUR,20250,40651,60901,44221,46640,41690,41271,39257,35296,248375,18783,38403,57186,42441,45651,43745,42911,41453,51630,267831,516206,634294,634294
Montenegro,2015,ME,MNE,EUR,20033,40633,60666,43784,46071,42081,40733,39541,36263,248473,18510,38264,56774,41980,44901,44054,42494,41607,53012,268048,516521,633966,633966
Montenegro,2016,ME,MNE,EUR,19991,40383,60374,43310,45487,42462,40288,39723,37190,248460,18418,37886,56304,41590,44083,44303,42073,41872,54200,268121,516581,633264,633264
Montenegro,2017,ME,MNE,EUR,20017,40037,60054,42761,44917,42909,39837,39832,38118,248374,18468,37418,55886,41056,43319,44524,41718,42162,55342,268121,516495,632438,632438
Montenegro,2018,ME,MNE,EUR,19905,39849,59754,42156,44242,43484,39398,39709,39200,248189,18388,37132,55520,40418,42496,44740,41473,42256,56611,267994,516183,631455,631455
Montenegro,2019,ME,MNE,EUR,19717,39872,59589,41514,43510,43967,39133,39357,40308,247789,18232,37029,55261,39729,41733,44836,41355,42129,57973,267755,515544,630396,630396
Montenegro,2020,ME,MNE,EUR,19451,39998,59449,40760,42964,44357,38954,38914,41220,247169,18012,37064,55076,38889,41207,44842,41319,41887,59218,267362,514531,629048,629048
Montenegro,2021,ME,MNE,EUR,19093,40173,59266,40107,42604,44672,38865,38500,41875,246623,17713,37180,54893,38166,40854,44765,41396,41684,60209,267074,513697,627859,627859
Montenegro,2022,ME,MNE,EUR,18679,40222,58901,39778,42234,44884,38988,38032,42533,246449,17360,37209,54569,37766,40487,44620,41599,41446,61247,267165,513614,627082,627082
Montenegro,2023,ME,MNE,EUR,18278,40002,58280,39680,41892,44843,39315,37511,43472,246713,17017,37019,54036,37559,40130,44278,41959,41056,62475,267457,514170,626485,626485
Montenegro,2024,ME,MNE,EUR,17900,39627,57527,39778,41683,44529,39735,37021,44554,247300,16700,36690,53390,37508,39860,43764,42367,40643,63750,267892,515192,626102,626102
Montenegro,2025,ME,MNE,EUR,17584,39185,56769,39877,41509,44120,40202,36624,45511,247843,16432,36241,52673,37490,39677,43161,42736,40312,64961,268337,516180,625623,625623
Montenegro,2026,ME,MNE,EUR,17343,38819,56162,39723,41325,43739,40674,36331,46403,248195,16236,35879,52115,37218,39593,42536,43070,39984,66169,268570,516765,625039,625039
Montenegro,2027,ME,MNE,EUR,17126,38453,55579,39456,41063,43389,41221,36039,47302,248470,16052,35598,51650,36835,39366,41982,43382,39724,67350,268639,517109,624343,624343
Montenegro,2028,ME,MNE,EUR,16924,37971,54895,39328,40735,42936,41895,35757,48161,248812,15887,35205,51092,36611,39021,41381,43696,39574,68473,268756,517568,623549,623549
Montenegro,2029,ME,MNE,EUR,16739,37435,54174,39396,40332,42415,42472,35625,48909,249149,15730,34758,50488,36555,38580,40829,43884,39534,69479,268861,518010,622668,622668
Montenegro,2030,ME,MNE,EUR,16559,36883,53442,39547,39750,42036,42935,35570,49612,249450,15580,34305,49885,36622,37922,40461,43961,39570,70386,268922,518372,621696,621696
Montenegro,2031,ME,MNE,EUR,16388,36294,52682,39727,39141,41729,43282,35579,50285,249743,15432,33809,49241,36744,37242,40156,43913,39686,71223,268964,518707,620632,620632
Montenegro,2032,ME,MNE,EUR,16230,35658,51888,39774,38787,41340,43495,35770,50859,250025,15297,33276,48573,36769,36813,39762,43763,39903,71979,268989,519014,619469,619469
Montenegro,2033,ME,MNE,EUR,16079,35055,51134,39558,38695,41008,43471,36145,51338,250215,15164,32764,47928,36577,36604,39412,43434,40279,72616,268922,519137,618208,618208
Montenegro,2034,ME,MNE,EUR,15930,34492,50422,39184,38798,40806,43177,36589,51767,250321,15032,32290,47322,36249,36557,39148,42934,40694,73201,268783,519104,616859,616859
Montenegro,2035,ME,MNE,EUR,15793,34000,49793,38747,38896,40638,42794,37084,52164,250323,14911,31873,46784,35802,36541,38966,42345,41074,73803,268531,518854,615427,615427
Montenegro,2036,ME,MNE,EUR,15663,33588,49251,38382,38747,40463,42437,37585,52581,250195,14794,31531,46325,35440,36271,38886,41738,41419,74394,268148,518343,613922,613922
Montenegro,2037,ME,MNE,EUR,15550,33214,48764,38017,38485,40209,42116,38154,53008,249989,14692,31213,45905,35161,35891,38664,41205,41744,75024,267689,517678,612346,612346
Montenegro,2038,ME,MNE,EUR,15451,32861,48312,37538,38360,39888,41695,38836,53384,249701,14605,30917,45522,34772,35670,38321,40617,42076,75701,267157,516858,610696,610696
Montenegro,2039,ME,MNE,EUR,15363,32531,47894,37005,38430,39493,41206,39426,53814,249374,14525,30630,45155,34327,35615,37889,40079,42277,76374,266561,515935,608976,608976
Montenegro,2040,ME,MNE,EUR,15282,32214,47496,36454,38588,38920,40858,39910,54275,249005,14450,30355,44805,33871,35683,37235,39726,42373,77013,265901,514906,607201,607201
Montenegro,2041,ME,MNE,EUR,15200,31914,47114,35866,38768,38322,40577,40280,54780,248593,14377,30095,44472,33379,35804,36559,39438,42349,77660,265189,513782,605364,605364
Montenegro,2042,ME,MNE,EUR,15114,31641,46755,35234,38818,37979,40217,40524,55358,248130,14296,29853,44149,32843,35828,36131,39057,42222,78328,264409,512539,603442,603442
Montenegro,2043,ME,MNE,EUR,15029,31393,46422,34634,38605,37892,39913,40547,56036,247627,14216,29637,43853,32334,35639,35930,38720,41922,79027,263572,511199,601475,601475
Montenegro,2044,ME,MNE,EUR,14943,31158,46101,34070,38235,37999,39729,40315,56754,247102,14138,29426,43564,31861,35315,35884,38464,41458,79721,262703,509805,599465,599465
Montenegro,2045,ME,MNE,EUR,14855,30939,45794,33581,37798,38102,39575,39998,57496,246550,14055,29230,43285,31443,34867,35868,38290,40908,80394,261770,508320,597396,597396
Montenegro,2046,ME,MNE,EUR,14762,30728,45490,33170,37439,37961,39419,39710,58284,245983,13970,29040,43010,31101,34507,35601,38215,40335,81039,260798,506781,595288,595288
Montenegro,2047,ME,MNE,EUR,14671,30529,45200,32797,37078,37706,39187,39460,59162,245390,13883,28856,42739,30787,34231,35225,38004,39835,81714,259796,505186,593128,593128
Montenegro,2048,ME,MNE,EUR,14572,30346,44918,32449,36602,37588,38889,39123,60130,244781,13786,28690,42476,30488,33843,35008,37667,39291,82443,258740,503521,590925,590925
Montenegro,2049,ME,MNE,EUR,14463,30176,44639,32116,36073,37661,38514,38714,61068,244146,13686,28534,42220,30201,33398,34959,37245,38792,83075,257670,501816,588678,588678
Montenegro,2050,ME,MNE,EUR,14348,30003,44351,31802,35528,37823,37965,38442,61953,243513,13579,28375,41954,29930,32942,35025,36605,38472,83595,256569,500082,586385,586385
Mongolia,1970,MN,MNG,WPR,112050,182420,294470,94675,76294,61739,48290,37363,33177,351538,113230,180299,293529,92404,72939,57856,47469,43431,40252,354351,705889,1293880,1293880
Mongolia,1971,MN,MNG,WPR,113874,189403,303277,100996,77025,62849,48546,37100,33032,359548,114628,187483,302111,98908,73798,58928,47577,43046,40588,362845,722393,1327781,1327781
Mongolia,1972,MN,MNG,WPR,116982,195452,312434,107676,77771,64189,48874,36986,32963,368459,116927,193733,310660,105958,74655,60203,47662,42730,41079,372287,740746,1363835,1363835
Mongolia,1973,MN,MNG,WPR,121333,200457,321790,114868,78508,65818,49306,37033,32994,378527,120230,198939,319169,113557,75498,61740,47798,42522,41710,382825,761352,1402309,1402309
Mongolia,1974,MN,MNG,WPR,126074,205078,331152,122594,79344,67694,49820,37264,33165,389881,123979,203665,327644,121581,76453,63451,48064,42460,42440,394449,784330,1443130,1443130
Mongolia,1975,MN,MNG,WPR,130282,209792,340074,130952,80408,69698,50459,37621,33444,402582,127582,208302,335884,130008,77700,65177,48513,42504,43253,407155,809737,1485691,1485691
Mongolia,1976,MN,MNG,WPR,133802,214499,348301,139829,81884,71642,51270,37983,33747,416355,130845,212767,343612,138750,79463,66774,49165,42574,44080,420806,837161,1529084,1529084
Mongolia,1977,MN,MNG,WPR,136411,219246,355657,149173,83959,73341,52238,38277,33972,430960,133457,217181,350638,147701,82014,68090,49951,42680,44829,435265,866225,1572516,1572516
Mongolia,1978,MN,MNG,WPR,137621,224441,362062,158900,86701,74748,53319,38491,34090,446249,135248,221816,357064,156791,85513,69105,50823,42759,45498,450489,896738,1615868,1615868
Mongolia,1979,MN,MNG,WPR,138007,229497,367504,168444,90087,75503,54458,38637,34226,461355,136302,226407,362709,165888,89640,69711,51865,42578,46193,465875,927230,1657448,1657448
Mongolia,1980,MN,MNG,WPR,138859,233991,372850,177105,94269,75741,55527,38824,34358,475824,137309,230806,368115,174501,94333,70082,53016,42224,46831,480987,956811,1697780,1697780
Mongolia,1981,MN,MNG,WPR,140590,238336,378926,184543,99470,76053,56565,39076,34416,490123,138979,235154,374133,182162,99829,70609,54219,41914,47310,496043,986166,1739221,1739221
Mongolia,1982,MN,MNG,WPR,143092,242468,385560,190792,105768,76470,57709,39303,34401,504443,141270,239387,380657,188868,106142,71340,55536,41653,47607,511146,1015589,1781797,1781797
Mongolia,1983,MN,MNG,WPR,146232,246458,392690,196005,113142,76972,58989,39519,34358,518985,143997,243693,387690,194558,113361,72241,56944,41523,47790,526417,1045402,1825773,1825773
Mongolia,1984,MN,MNG,WPR,149771,250539,400310,200510,121352,77529,60368,39769,34413,533941,147249,248165,395414,199302,121422,73261,58391,41560,48044,541980,1075921,1871652,1871652
Mongolia,1985,MN,MNG,WPR,153692,254856,408548,204578,130184,78182,61723,40090,34577,549334,151190,252843,404033,203281,130208,74433,59686,41842,48384,557834,1107168,1919744,1919744
Mongolia,1986,MN,MNG,WPR,158115,259375,417490,208263,139300,79201,62878,40605,34678,564925,155819,257741,413560,206673,139519,75964,60646,42469,48666,573937,1138862,1969912,1969912
Mongolia,1987,MN,MNG,WPR,162606,264180,426786,211764,148400,80928,63711,41265,34678,580746,160786,262736,423522,209864,149029,78168,61202,43352,48831,590446,1171192,2021502,2021502
Mongolia,1988,MN,MNG,WPR,166465,269411,435876,215449,157173,83633,64200,41947,34589,596991,165375,267910,433285,213349,158356,81284,61432,44359,48834,607614,1204605,2073771,2073771
Mongolia,1989,MN,MNG,WPR,168914,274341,443255,219462,164632,86894,64495,42602,34473,612558,168045,272620,440665,217360,166364,85080,61585,45240,48715,624344,1236902,2120825,2120825
Mongolia,1990,MN,MNG,WPR,169520,279063,448583,223714,170680,90568,64689,43180,34370,627201,168268,277094,445362,221789,172837,89399,61875,45877,48517,640294,1267495,2161433,2161433
Mongolia,1991,MN,MNG,WPR,168425,284440,452865,228045,175961,94997,64835,43744,34249,641831,166770,282304,449074,226358,178470,94408,62338,46463,48268,656305,1298136,2200077,2200077
Mongolia,1992,MN,MNG,WPR,165831,290126,455957,232304,180604,100109,65003,44421,34064,656505,163704,287977,451681,230861,183347,100119,62994,47110,47917,672348,1328853,2236494,2236494
Mongolia,1993,MN,MNG,WPR,161788,295775,457563,236467,184818,105817,65171,45254,33845,671372,159165,293770,452935,235183,187560,106502,63826,47838,47535,688444,1359816,2270311,2270311
Mongolia,1994,MN,MNG,WPR,156315,301281,457596,240589,188599,112064,65227,46275,33730,686484,153454,299362,452816,239296,191136,113442,64791,48636,47313,704614,1391098,2301510,2301510
Mongolia,1995,MN,MNG,WPR,149943,306359,456302,244574,192025,118726,65087,47466,33848,701726,147069,304484,451553,243127,194252,120765,65779,49447,47375,720745,1422471,2330334,2330334
Mongolia,1996,MN,MNG,WPR,143601,310480,454081,248268,195389,125589,64917,48542,34107,716812,140748,308731,449479,246560,197371,128301,66694,50121,47611,736658,1453470,2357033,2357033
Mongolia,1997,MN,MNG,WPR,138062,312892,450954,251695,198751,132653,65166,49134,34329,731728,135289,311286,446575,249527,200800,136022,67785,50502,47876,752512,1484240,2381771,2381771
Mongolia,1998,MN,MNG,WPR,133559,313060,446619,255060,202212,139901,66237,49205,34508,747123,130913,311533,442446,252308,204476,143872,69544,50621,48143,768964,1516087,2405148,2405148
Mongolia,1999,MN,MNG,WPR,130340,310868,441208,258808,206068,146930,68180,48953,34683,763622,127824,309278,437102,255533,208453,151432,72095,50688,48358,786559,1550181,2428488,2428488
Mongolia,2000,MN,MNG,WPR,127720,306070,433790,263391,210234,153472,71497,48784,35199,782577,125150,303918,429068,259598,212336,158267,75675,50940,48732,805548,1588125,2450979,2450979
Mongolia,2001,MN,MNG,WPR,125394,299344,424738,268808,214231,159362,76233,48807,36038,803479,122580,296242,418822,264505,215628,164243,80495,51345,49354,825570,1629049,2472601,2472601
Mongolia,2002,MN,MNG,WPR,123980,291596,415576,274636,217915,164561,81631,48819,36814,824376,120880,287604,408484,270038,218461,169478,86250,51873,50089,846189,1670565,2494617,2494617
Mongolia,2003,MN,MNG,WPR,123168,282950,406118,280522,221520,169198,87547,48811,37548,845146,119779,278184,397963,275775,221024,174081,92705,52649,50990,867224,1712370,2516454,2516454
Mongolia,2004,MN,MNG,WPR,122491,274025,396516,286189,225030,173238,94043,48760,38458,865718,118825,268657,387482,281320,223396,177929,99763,53631,52194,888233,1753951,2537949,2537949
Mongolia,2005,MN,MNG,WPR,122300,265182,387482,291230,228281,176839,100893,48695,39653,885591,118351,259345,377696,286145,225637,181098,107221,54652,53730,908483,1794074,2559255,2559255
Mongolia,2006,MN,MNG,WPR,123120,257218,380338,294921,231270,180205,107856,48839,40851,903942,118895,251036,369931,289389,227830,183933,114862,55702,55316,927032,1830974,2581242,2581242
Mongolia,2007,MN,MNG,WPR,125516,250997,376513,296476,234129,183368,114956,49545,41798,920272,121027,244557,365584,290277,229994,186631,122581,57098,56688,943269,1863541,2605643,2605643
Mongolia,2008,MN,MNG,WPR,130458,246020,376478,295762,237137,186401,122063,50983,42489,934835,125744,239319,365063,288784,232356,189226,130168,59184,57795,957513,1892348,2633887,2633887
Mongolia,2009,MN,MNG,WPR,138309,241799,380108,293100,240579,189439,128800,53155,42987,948060,133428,234768,368196,285303,235229,191769,137284,62069,58698,970352,1918412,2666713,2666713
Mongolia,2010,MN,MNG,WPR,147381,238383,385764,288982,244764,192534,134910,56039,43383,960612,142444,230936,373380,280451,238967,194333,143740,65763,59514,982768,1943380,2702520,2702520
Mongolia,2011,MN,MNG,WPR,155370,236891,392261,284184,250338,196002,140391,59653,43714,974282,150306,228981,379287,275388,244365,197545,149923,70366,60514,998101,1972383,2743938,2743938
Mongolia,2012,MN,MNG,WPR,162164,238649,400813,278502,257053,199914,145295,63958,44074,988796,156785,230192,386977,269907,251035,201373,155819,75843,61784,1015761,2004557,2792349,2792349
Mongolia,2013,MN,MNG,WPR,168406,243874,412280,271567,264070,204018,149711,68829,44600,1002795,162477,234769,397246,263284,257871,205193,161094,82044,63339,1032825,2035620,2845153,2845153
Mongolia,2014,MN,MNG,WPR,174571,252005,426576,263791,271387,208296,153660,74244,45256,1016634,167752,242235,409987,255799,264940,209030,165728,88951,65182,1049630,2066264,2902823,2902823
Mongolia,2015,MN,MNG,WPR,181784,261540,443324,255825,278417,212632,157184,79992,46270,1030320,173855,251091,424946,248020,271728,212941,169582,96338,67548,1066157,2096477,2964749,2964749
Mongolia,2016,MN,MNG,WPR,189868,272315,462183,248258,284289,216964,160722,85783,47439,1043455,180772,260961,441733,240514,277319,217172,173243,103832,70108,1082188,2125643,3029555,3029555
Mongolia,2017,MN,MNG,WPR,196812,285954,482766,241631,288211,221288,164068,91785,48850,1055833,186525,273491,460016,233876,280903,221316,176912,111585,72815,1097407,2153240,3096030,3096030
Mongolia,2018,MN,MNG,WPR,201344,303278,504622,237583,288713,225304,167389,98000,50722,1067711,190066,289532,479598,229527,281195,225061,180346,119655,76278,1112062,2179773,3163991,3163991
Mongolia,2019,MN,MNG,WPR,202800,323901,526701,234725,286801,229752,170988,104330,52802,1079398,191069,308466,499535,226309,279206,229217,183866,127730,80475,1126803,2206201,3232430,3232430
Mongolia,2020,MN,MNG,WPR,200228,344402,544630,231973,283918,235376,175177,109888,55131,1091463,188792,327418,516210,223225,276261,234465,188002,134858,85221,1142032,2233495,3294335,3294335
Mongolia,2021,MN,MNG,WPR,195308,361959,557267,231387,279295,241930,179587,114350,57644,1104193,184682,343776,528458,222089,271686,240740,192203,140860,90282,1157860,2262053,3347782,3347782
Mongolia,2022,MN,MNG,WPR,190124,375998,566122,234367,272918,248888,183667,118745,60681,1119266,180558,356602,537160,224391,265771,247157,196062,146431,96005,1175817,2295083,3398366,3398366
Mongolia,2023,MN,MNG,WPR,184357,385930,570287,241189,265532,255807,188106,123126,64398,1138158,175982,365498,541480,230477,258894,253489,200036,151633,102698,1197227,2335385,3447157,3447157
Mongolia,2024,MN,MNG,WPR,178335,392354,570689,250342,257468,263362,192771,127011,68665,1159619,170980,371231,542211,239077,250891,260809,203941,156171,110223,1221112,2380731,3493629,3493629
Mongolia,2025,MN,MNG,WPR,172902,396054,568956,260543,249493,270739,197260,130500,73576,1182111,166182,374704,540886,248808,242802,268178,207794,159698,118723,1246003,2428114,3537947,3537947
Mongolia,2026,MN,MNG,WPR,168097,397163,565260,272401,242242,276637,201632,134218,78432,1205562,161740,376001,537741,259914,235420,274005,212069,163239,127115,1271762,2477324,3580318,3580318
Mongolia,2027,MN,MNG,WPR,163660,395130,558790,287013,236150,280406,205950,137749,83614,1230882,157586,374394,531980,273654,229254,277601,216164,166981,135630,1299284,2530166,3620933,3620933
Mongolia,2028,MN,MNG,WPR,159788,389714,549502,304320,233016,280454,209843,141209,89483,1258325,153923,369699,523622,290103,225870,277551,219668,170394,145128,1328714,2587039,3660164,3660164
Mongolia,2029,MN,MNG,WPR,156697,381635,538332,323413,230928,278218,214191,144975,95495,1287220,150998,362648,513646,308104,223531,275297,223676,173904,154828,1359340,2646560,3698535,3698535
Mongolia,2030,MN,MNG,WPR,154449,372185,526634,342688,228361,275332,219748,149073,101157,1316359,148874,354323,503197,326178,220696,272324,228867,177991,164078,1390134,2706493,3736327,3736327
Mongolia,1950,MN,MNG,WPR,49147,78833,127980,68245,58985,50679,39440,26419,11938,255706,49401,79395,128796,67513,58597,51082,43192,30086,18314,268784,524490,781260,781260
Mongolia,1951,MN,MNG,WPR,51956,79643,131599,69217,59317,50845,39612,26565,11999,257555,52654,80298,132952,68525,58997,50688,43535,30718,18477,270940,528495,793053,793053
Mongolia,1952,MN,MNG,WPR,54698,80425,135123,70231,59576,51036,39996,26711,12043,259593,55858,81183,137041,69579,59092,50346,44166,31472,18612,273267,532860,805031,805031
Mongolia,1953,MN,MNG,WPR,57535,81237,138772,71233,59841,51260,40513,26832,12111,261790,59124,82124,141248,70638,59057,50070,44947,32240,18752,275704,537494,817516,817516
Mongolia,1954,MN,MNG,WPR,60828,81875,142703,72155,60224,51541,41004,26897,12246,264067,62717,83031,145748,71644,59167,50012,45568,32833,18960,278184,542251,830702,830702
Mongolia,1955,MN,MNG,WPR,63644,83505,147149,72975,60772,51872,41404,26920,12461,266404,65644,85141,150785,72571,59509,50220,45893,33211,19263,280667,547071,844997,844997
Mongolia,1956,MN,MNG,WPR,66492,86093,152585,73830,61696,52414,42119,27691,13320,271070,68090,87882,155972,73485,60059,50857,46245,33799,20306,284751,555821,864379,864379
Mongolia,1957,MN,MNG,WPR,70751,88444,159195,74631,63044,53114,43077,29184,14970,278020,71559,89901,161460,74302,60844,51740,46608,34617,22175,290286,568306,888961,888961
Mongolia,1958,MN,MNG,WPR,75973,91014,166987,75130,64594,53766,43906,30651,16945,284992,76027,92044,168071,74813,61802,52344,46898,35458,24326,295641,580633,915702,915702
Mongolia,1959,MN,MNG,WPR,81889,94303,176192,75376,66211,54410,44712,32182,19258,292149,81297,94824,176121,74974,62788,52513,47333,36592,26774,300974,593123,945438,945438
Mongolia,1960,MN,MNG,WPR,87765,98899,186664,75484,67759,55071,45482,33758,21854,299408,86799,98804,185603,74782,63804,52282,47927,38034,29399,306228,605636,977903,977903
Mongolia,1961,MN,MNG,WPR,92263,105308,197571,75660,69189,55725,46179,35286,24688,306727,91409,104435,195844,74337,64934,51874,48566,39556,32086,311353,618080,1011502,1011502
Mongolia,1962,MN,MNG,WPR,94845,113523,208368,76042,70499,56430,46770,36618,27826,314185,94585,111700,206285,73790,66252,51622,49111,40840,34870,316485,630670,1045315,1045315
Mongolia,1963,MN,MNG,WPR,97225,122087,219312,76782,71345,57003,47075,37280,29582,319067,97407,119715,217122,73978,67491,51978,49191,41389,36359,320386,639453,1075888,1075888
Mongolia,1964,MN,MNG,WPR,100583,130302,230885,77614,71866,57458,47165,37419,29862,321384,100683,127865,228548,74988,68460,52844,48838,41451,36613,323194,644578,1104017,1104017
Mongolia,1965,MN,MNG,WPR,104439,138638,243077,78275,72551,58112,47253,37595,30347,324133,104180,136232,240412,76118,69300,53790,48399,41695,37145,326447,650580,1134072,1134072
Mongolia,1966,MN,MNG,WPR,108328,147000,255328,79213,73342,58875,47380,37800,31030,327640,107731,144735,252466,77508,70036,54691,47961,42211,37895,330302,657942,1165746,1165746
Mongolia,1967,MN,MNG,WPR,111223,155786,267009,80936,74124,59599,47580,37952,31852,332043,110743,153589,264332,79433,70645,55509,47595,42905,38732,334819,666862,1198197,1198197
Mongolia,1968,MN,MNG,WPR,111944,165438,277382,83878,74878,60176,47776,37996,32791,337495,112246,163087,275333,82211,71267,56225,47331,43592,39563,340189,677684,1230406,1230406
Mongolia,1969,MN,MNG,WPR,111557,174616,286173,88635,75601,60818,48018,37762,33267,344101,112619,172265,284884,86563,72068,56954,47315,43771,40057,346728,690829,1261887,1261887
Mongolia,2031,MN,MNG,WPR,153044,362504,515548,360173,227687,270790,226188,153322,106576,1344736,147557,345815,493372,342488,219454,267727,235124,182189,173141,1420123,2764859,3773768,3773768
Mongolia,2032,MN,MNG,WPR,152536,352928,505464,374169,230620,264622,233039,157333,112309,1372092,147100,337575,484675,355291,221708,261871,241527,186091,182449,1448937,2821029,3811167,3811167
Mongolia,2033,MN,MNG,WPR,152910,343333,496243,384091,237457,257572,239877,161618,118143,1398758,147487,329364,476851,364186,227807,255130,247847,190072,191957,1476999,2875757,3848847,3848847
Mongolia,2034,MN,MNG,WPR,153998,334262,488260,390514,246605,249883,247331,166117,124005,1424455,148561,321459,470020,369921,236406,247280,255144,193983,201537,1504271,2928726,3887004,3887004
Mongolia,2035,MN,MNG,WPR,155707,326616,482323,394223,256791,242287,254598,170476,130053,1448428,150231,314555,464786,373401,246132,239346,262471,197842,211006,1530198,2978626,3925745,3925745
Mongolia,2036,MN,MNG,WPR,157914,320437,478351,395345,268621,235385,260430,174749,136244,1470774,152376,308813,461189,374703,257220,232104,268286,202098,220314,1554725,3025499,3965043,3965043
Mongolia,2037,MN,MNG,WPR,160489,315520,476009,393336,283176,229584,264199,178982,142554,1491831,154873,304219,459092,373107,270930,226058,271892,206189,229843,1578019,3069850,4004952,4004952
Mongolia,2038,MN,MNG,WPR,163265,312046,475311,387952,300397,226638,264375,182892,149353,1511607,157560,300958,458518,368432,287337,222746,271896,209730,239910,1600051,3111658,4045479,4045479
Mongolia,2039,MN,MNG,WPR,166076,310061,476137,379920,319381,224691,262387,187258,156499,1530136,160275,299117,459392,361405,305282,220464,269735,213769,250154,1620809,3150945,4086469,4086469
Mongolia,2040,MN,MNG,WPR,168806,309538,478344,370518,338537,222286,259829,192722,163615,1547507,162910,298669,461579,353101,323295,217696,266881,218958,260443,1640374,3187881,4127814,4127814
Mongolia,2041,MN,MNG,WPR,171341,310354,481695,360886,355916,221740,255722,198977,170637,1563878,165351,299507,464858,344615,339557,216507,262436,225174,270560,1658849,3222727,4169279,4169279
Mongolia,2042,MN,MNG,WPR,173572,312433,486005,351358,369830,224735,250088,205600,177707,1579318,167491,301552,469043,336397,352319,218787,256747,231520,280547,1676317,3255635,4210687,4210687
Mongolia,2043,MN,MNG,WPR,175392,315595,490987,341811,379715,231571,243639,212233,185062,1594031,169237,304630,473867,328205,361195,224882,250200,237793,290694,1692969,3287000,4251855,4251855
Mongolia,2044,MN,MNG,WPR,176752,319500,496252,332789,386131,240690,236637,219439,192613,1608299,170540,308419,478959,320323,366928,233463,242569,245009,300750,1709042,3317341,4292546,4292546
Mongolia,2045,MN,MNG,WPR,177660,323949,501609,325179,389849,250828,229750,226459,200180,1622245,171407,312730,484137,313439,370410,243162,234863,252235,310571,1724680,3346925,4332667,4332667
Mongolia,2046,MN,MNG,WPR,178176,328697,506873,319039,390996,262567,223498,232136,207777,1636013,171899,317320,489219,307717,371727,254208,227835,257987,320529,1740003,3376016,4372111,4372111
Mongolia,2047,MN,MNG,WPR,178267,333509,511776,314157,389037,276978,218263,235904,215440,1649779,171986,321959,493945,303137,370153,267854,221971,261581,330466,1755162,3404941,4410654,4410654
Mongolia,2048,MN,MNG,WPR,177921,338114,516035,310711,383734,293994,215670,236344,223242,1663695,171645,326395,498040,299887,365516,284172,218775,261653,340325,1770328,3434023,4448092,4448092
Mongolia,2049,MN,MNG,WPR,177118,342292,519410,308751,375806,312743,214006,234853,231733,1677892,170863,330414,501277,298058,358533,302010,216585,259638,350784,1785608,3463500,4484188,4484188
Mongolia,2050,MN,MNG,WPR,175870,345936,521806,308250,366522,331644,211932,232935,241139,1692422,169649,333919,503568,297624,350286,319918,213923,256987,362317,1801055,3493477,4518856,4518856
Northern Mariana Islands,1970,MP,MNP,WPR,913,1623,2536,1039,521,415,319,234,123,2651,931,1523,2454,1010,465,377,294,208,149,2503,5154,10143,10143
Northern Mariana Islands,1971,MP,MNP,WPR,1043,1736,2779,1141,645,507,360,251,133,3037,1038,1623,2661,1150,533,415,314,224,166,2802,5839,11279,11279
Northern Mariana Islands,1972,MP,MNP,WPR,1210,1899,3109,1245,799,621,421,272,147,3505,1166,1779,2945,1321,626,464,337,242,186,3176,6681,12730,12730
Northern Mariana Islands,1973,MP,MNP,WPR,1352,2061,3413,1345,939,726,482,294,163,3949,1273,1933,3206,1468,725,515,356,264,208,3536,7485,14094,14094
Northern Mariana Islands,1974,MP,MNP,WPR,1393,2150,3543,1431,1033,794,521,304,175,4258,1314,2027,3341,1559,806,543,361,278,221,3768,8026,14905,14905
Northern Mariana Islands,1975,MP,MNP,WPR,1351,2180,3531,1494,1095,840,538,304,186,4457,1295,2067,3362,1598,873,565,364,284,225,3909,8366,15269,15269
Northern Mariana Islands,1976,MP,MNP,WPR,1299,2204,3503,1535,1170,883,568,310,199,4665,1264,2109,3373,1629,951,582,371,288,235,4056,8721,15595,15595
Northern Mariana Islands,1977,MP,MNP,WPR,1252,2220,3472,1553,1260,921,597,315,212,4858,1231,2147,3378,1643,1037,596,384,289,244,4193,9051,15901,15901
Northern Mariana Islands,1978,MP,MNP,WPR,1227,2217,3444,1560,1352,959,630,320,220,5041,1204,2177,3381,1648,1124,614,397,287,256,4326,9367,16194,16194
Northern Mariana Islands,1979,MP,MNP,WPR,1240,2185,3425,1559,1434,999,674,332,232,5230,1189,2188,3377,1657,1203,639,415,286,264,4464,9694,16494,16494
Northern Mariana Islands,1980,MP,MNP,WPR,1299,2184,3483,1764,1614,1091,719,349,241,5778,1212,2292,3504,1838,1334,679,440,289,271,4851,10629,17613,17613
Northern Mariana Islands,1981,MP,MNP,WPR,1423,2229,3652,2215,1950,1257,777,375,249,6823,1307,2491,3798,2263,1563,753,475,294,284,5632,12455,19902,19902
Northern Mariana Islands,1982,MP,MNP,WPR,1636,2264,3900,2683,2356,1479,848,409,256,8031,1493,2613,4106,2798,1855,852,512,303,292,6612,14643,22647,22647
Northern Mariana Islands,1983,MP,MNP,WPR,1923,2306,4229,3060,2812,1747,933,440,262,9254,1756,2644,4400,3371,2195,982,548,317,296,7709,16963,25594,25594
Northern Mariana Islands,1984,MP,MNP,WPR,2265,2395,4660,3328,3318,2058,1044,468,267,10483,2073,2636,4709,3946,2571,1136,591,331,308,8883,19366,28735,28735
Northern Mariana Islands,1985,MP,MNP,WPR,2617,2562,5179,3483,3863,2413,1174,497,277,11707,2396,2663,5059,4479,2989,1321,641,347,318,10095,21802,32041,32041
Northern Mariana Islands,1986,MP,MNP,WPR,2924,2838,5762,3524,4446,2810,1327,529,294,12930,2669,2805,5474,4920,3444,1541,693,366,328,11292,24222,35459,35459
Northern Mariana Islands,1987,MP,MNP,WPR,3132,3249,6381,3469,5034,3251,1509,560,316,14139,2850,3096,5946,5239,3935,1804,742,393,343,12456,26595,38923,38923
Northern Mariana Islands,1988,MP,MNP,WPR,3214,3780,6994,3342,5602,3734,1729,604,341,15352,2920,3530,6450,5413,4466,2113,812,426,355,13585,28937,42381,42381
Northern Mariana Islands,1989,MP,MNP,WPR,3209,4397,7606,3178,6125,4257,1990,670,361,16581,2912,4073,6985,5429,5068,2466,896,466,367,14692,31273,45859,45859
Northern Mariana Islands,1990,MP,MNP,WPR,3108,4867,7975,3072,6316,4608,2190,738,383,17307,2827,4515,7342,5146,5554,2805,991,507,383,15386,32693,48002,48002
Northern Mariana Islands,1991,MP,MNP,WPR,2971,5024,7995,3065,6128,4699,2259,798,396,17345,2717,4677,7394,4648,5816,3084,1089,536,396,15569,32914,48302,48302
Northern Mariana Islands,1992,MP,MNP,WPR,2918,4954,7872,3118,5888,4719,2275,848,408,17256,2689,4638,7327,4195,5964,3337,1198,561,413,15668,32924,48128,48128
Northern Mariana Islands,1993,MP,MNP,WPR,2941,4749,7690,3182,5709,4729,2283,888,419,17210,2737,4485,7222,3864,6022,3581,1332,586,436,15821,33031,47948,47948
Northern Mariana Islands,1994,MP,MNP,WPR,3001,4476,7477,3242,5597,4739,2280,916,426,17200,2822,4284,7106,3658,5986,3793,1482,622,456,15997,33197,47780,47780
Northern Mariana Islands,1995,MP,MNP,WPR,3226,4285,7511,3317,5614,4802,2305,931,439,17408,3046,4161,7207,3806,6003,4003,1645,659,467,16583,33991,48717,48717
Northern Mariana Islands,1996,MP,MNP,WPR,3952,4481,8433,3499,5897,5087,2461,958,449,18351,3660,4349,8009,4793,6540,4255,1810,696,481,18575,36926,53367,53367
Northern Mariana Islands,1997,MP,MNP,WPR,4919,5157,10076,3716,6363,5540,2732,1011,458,19820,4453,4913,9366,6138,7667,4551,1980,728,496,21560,41380,60817,60817
Northern Mariana Islands,1998,MP,MNP,WPR,5602,6242,11844,3823,6861,6028,3042,1070,468,21292,5004,5818,10822,7075,9145,4887,2166,762,509,24544,45836,68501,68501
Northern Mariana Islands,1999,MP,MNP,WPR,5899,7733,13632,3831,7362,6564,3388,1143,484,22772,5228,7093,12321,7564,10939,5305,2373,803,530,27514,50286,76237,76237
Northern Mariana Islands,2000,MP,MNP,WPR,5650,9027,14677,3686,7466,6941,3694,1240,511,23538,4981,8210,13191,7169,12062,5718,2585,851,558,28943,52481,80338,80338
Northern Mariana Islands,2001,MP,MNP,WPR,5030,9636,14666,3440,7039,7053,3912,1338,562,23344,4425,8730,13155,6052,11948,6040,2790,903,585,28318,51662,79479,79479
Northern Mariana Islands,2002,MP,MNP,WPR,4461,9785,14246,3256,6467,7070,4099,1438,609,22939,3920,8833,12753,5033,11294,6324,2993,966,619,27229,50168,77162,77162
Northern Mariana Islands,2003,MP,MNP,WPR,4025,9615,13640,3185,5885,7039,4277,1546,657,22589,3543,8652,12195,4318,10425,6573,3189,1044,643,26192,48781,74623,74623
Northern Mariana Islands,2004,MP,MNP,WPR,3670,9179,12849,3229,5335,6958,4446,1664,703,22335,3244,8244,11488,3889,9389,6768,3376,1138,666,25226,47561,71898,71898
Northern Mariana Islands,2005,MP,MNP,WPR,3362,8547,11909,3373,4819,6824,4601,1776,736,22129,2990,7668,10658,3720,8252,6881,3544,1239,689,24325,46454,69025,69025
Northern Mariana Islands,2006,MP,MNP,WPR,3118,7781,10899,3560,4367,6636,4743,1894,766,21966,2786,6985,9771,3716,7092,6877,3692,1351,703,23431,45397,66060,66060
Northern Mariana Islands,2007,MP,MNP,WPR,2968,6955,9923,3711,3979,6388,4862,2009,779,21728,2650,6260,8910,3747,5996,6724,3825,1475,718,22485,44213,63050,63050
Northern Mariana Islands,2008,MP,MNP,WPR,2921,6157,9078,3757,3650,6084,4955,2125,799,21370,2586,5578,8164,3727,5031,6388,3938,1605,729,21418,42788,60032,60032
Northern Mariana Islands,2009,MP,MNP,WPR,2987,5458,8445,3661,3359,5737,5023,2235,818,20833,2592,4987,7579,3591,4241,5856,4026,1741,745,20200,41033,57056,57056
Northern Mariana Islands,2010,MP,MNP,WPR,3001,4779,7780,3614,3059,5355,5069,2365,868,20330,2561,4410,6971,3477,3455,5294,4118,1889,776,19009,39339,54087,54087
Northern Mariana Islands,2011,MP,MNP,WPR,2930,4359,7289,3740,2818,5028,5148,2553,944,20231,2479,4048,6527,3526,2871,4912,4250,2071,840,18470,38701,52520,52520
Northern Mariana Islands,2012,MP,MNP,WPR,2855,4267,7122,3902,2666,4745,5258,2780,1053,20404,2405,3959,6364,3651,2597,4611,4412,2284,919,18474,38878,52359,52359
Northern Mariana Islands,2013,MP,MNP,WPR,2714,4239,6953,4024,2559,4447,5336,3010,1168,20544,2286,3913,6199,3746,2375,4266,4559,2496,1005,18447,38991,52141,52141
Northern Mariana Islands,2014,MP,MNP,WPR,2490,4296,6786,4086,2503,4140,5374,3240,1297,20640,2113,3919,6032,3791,2204,3900,4688,2697,1116,18396,39036,51856,51856
Northern Mariana Islands,2015,MP,MNP,WPR,2260,4361,6621,4073,2519,3833,5375,3468,1437,20705,1933,3932,5865,3773,2112,3520,4791,2897,1232,18325,39030,51514,51514
Northern Mariana Islands,2016,MP,MNP,WPR,2095,4375,6470,3990,2597,3538,5335,3693,1575,20728,1792,3910,5702,3695,2090,3142,4860,3079,1365,18231,38959,51133,51133
Northern Mariana Islands,2017,MP,MNP,WPR,1957,4369,6326,3849,2732,3268,5249,3905,1727,20730,1674,3867,5541,3572,2128,2774,4890,3255,1512,18131,38861,50729,50729
Northern Mariana Islands,2018,MP,MNP,WPR,1833,4352,6185,3675,2899,3022,5125,4101,1896,20718,1570,3812,5382,3427,2211,2410,4866,3425,1679,18018,38736,50304,50304
Northern Mariana Islands,2019,MP,MNP,WPR,1737,4300,6037,3495,3095,2784,4957,4285,2082,20698,1493,3723,5216,3275,2332,2072,4771,3596,1865,17911,38609,49858,49858
Northern Mariana Islands,2020,MP,MNP,WPR,1673,4232,5905,3338,3304,2578,4759,4448,2300,20727,1443,3634,5077,3145,2510,1771,4612,3768,2074,17880,38607,49587,49587
Northern Mariana Islands,2021,MP,MNP,WPR,1633,4149,5782,3232,3509,2415,4537,4582,2541,20816,1413,3539,4952,3061,2719,1527,4389,3934,2302,17932,38748,49481,49481
Northern Mariana Islands,2022,MP,MNP,WPR,1612,4050,5662,3197,3686,2299,4287,4697,2799,20965,1400,3445,4845,3021,2945,1344,4115,4095,2551,18071,39036,49551,49551
Northern Mariana Islands,2023,MP,MNP,WPR,1610,3931,5541,3249,3815,2236,4030,4794,3074,21198,1399,3346,4745,3047,3160,1239,3808,4249,2802,18305,39503,49796,49796
Northern Mariana Islands,2024,MP,MNP,WPR,1613,3746,5359,3398,3890,2227,3770,4855,3352,21492,1399,3209,4608,3131,3312,1202,3479,4381,3064,18569,40061,50025,50025
Northern Mariana Islands,2025,MP,MNP,WPR,1617,3568,5185,3565,3888,2279,3506,4877,3640,21755,1403,3072,4475,3234,3387,1248,3142,4494,3326,18831,40586,50255,50255
Northern Mariana Islands,2026,MP,MNP,WPR,1622,3462,5084,3698,3811,2398,3259,4865,3925,21956,1409,2982,4391,3309,3382,1369,2810,4573,3594,19037,40993,50470,50470
Northern Mariana Islands,2027,MP,MNP,WPR,1629,3380,5009,3818,3677,2566,3031,4810,4212,22114,1417,2914,4331,3380,3323,1551,2490,4613,3863,19220,41334,50668,50668
Northern Mariana Islands,2028,MP,MNP,WPR,1639,3310,4949,3936,3518,2761,2829,4718,4484,22246,1425,2858,4283,3441,3226,1781,2184,4606,4140,19378,41624,50859,50859
Northern Mariana Islands,2029,MP,MNP,WPR,1646,3263,4909,4019,3356,2979,2636,4589,4769,22348,1430,2822,4252,3477,3120,2047,1907,4533,4433,19517,41865,51028,51028
Northern Mariana Islands,2030,MP,MNP,WPR,1651,3238,4889,4063,3213,3209,2464,4425,5047,22421,1435,2801,4236,3481,3018,2332,1664,4394,4742,19631,42052,51178,51178
Northern Mariana Islands,1950,MP,MNP,WPR,624,895,1519,575,606,436,319,147,97,2180,595,933,1528,630,523,269,187,121,108,1838,4018,7063,7063
Northern Mariana Islands,1951,MP,MNP,WPR,711,901,1612,523,567,436,334,160,99,2119,658,960,1618,576,514,276,203,113,101,1783,3902,7127,7127
Northern Mariana Islands,1952,MP,MNP,WPR,725,930,1655,545,536,428,331,169,98,2107,685,963,1648,588,501,294,208,114,100,1805,3912,7214,7214
Northern Mariana Islands,1953,MP,MNP,WPR,738,965,1703,572,508,426,324,181,95,2106,708,975,1683,606,489,316,211,116,106,1844,3950,7335,7335
Northern Mariana Islands,1954,MP,MNP,WPR,740,1019,1759,604,486,418,317,187,94,2106,723,1012,1735,624,475,332,220,125,104,1880,3986,7474,7474
Northern Mariana Islands,1955,MP,MNP,WPR,746,1075,1821,628,466,405,309,186,96,2090,741,1062,1803,638,464,348,229,137,104,1920,4010,7635,7635
Northern Mariana Islands,1956,MP,MNP,WPR,772,1129,1901,652,454,391,296,182,102,2077,778,1114,1892,648,452,353,238,144,105,1940,4017,7813,7813
Northern Mariana Islands,1957,MP,MNP,WPR,809,1186,1995,667,455,375,280,174,109,2060,827,1171,1998,647,442,350,248,154,106,1947,4007,8003,8003
Northern Mariana Islands,1958,MP,MNP,WPR,836,1239,2075,686,462,364,273,168,111,2064,863,1236,2099,660,446,348,258,167,109,1988,4052,8227,8227
Northern Mariana Islands,1959,MP,MNP,WPR,847,1286,2133,713,475,363,279,170,115,2115,863,1303,2166,683,455,352,268,176,117,2051,4166,8463,8463
Northern Mariana Islands,1960,MP,MNP,WPR,854,1333,2187,742,482,366,291,178,118,2177,845,1378,2223,711,472,356,279,178,115,2111,4288,8702,8702
Northern Mariana Islands,1961,MP,MNP,WPR,869,1391,2260,766,489,373,299,181,117,2225,833,1457,2290,745,487,359,288,183,119,2181,4406,8965,8965
Northern Mariana Islands,1962,MP,MNP,WPR,889,1458,2347,789,502,382,307,185,122,2287,825,1538,2363,777,495,369,292,188,128,2249,4536,9252,9252
Northern Mariana Islands,1963,MP,MNP,WPR,916,1523,2439,813,517,390,318,195,129,2362,832,1605,2437,817,503,381,301,192,133,2327,4689,9561,9561
Northern Mariana Islands,1964,MP,MNP,WPR,951,1593,2544,835,539,390,323,208,125,2420,856,1656,2512,869,515,390,309,198,142,2423,4843,9890,9890
Northern Mariana Islands,1965,MP,MNP,WPR,981,1663,2644,862,563,389,322,222,131,2489,882,1695,2577,934,529,397,310,204,149,2523,5012,10229,10229
Northern Mariana Islands,1966,MP,MNP,WPR,997,1743,2740,903,582,391,319,238,132,2565,900,1733,2633,1015,542,407,314,213,153,2644,5209,10577,10577
Northern Mariana Islands,1967,MP,MNP,WPR,982,1784,2766,947,585,388,317,250,134,2621,901,1729,2630,1075,533,408,315,217,155,2703,5324,10720,10720
Northern Mariana Islands,1968,MP,MNP,WPR,933,1736,2669,978,554,386,314,244,132,2608,876,1654,2530,1061,506,392,307,216,153,2635,5243,10440,10440
Northern Mariana Islands,1969,MP,MNP,WPR,888,1640,2528,991,498,378,308,233,121,2529,874,1546,2420,995,465,373,293,207,146,2479,5008,9952,9952
Northern Mariana Islands,2031,MP,MNP,WPR,1653,3228,4881,4059,3118,3421,2325,4232,5324,22479,1437,2797,4234,3458,2950,2611,1456,4188,5058,19721,42200,51313,51313
Northern Mariana Islands,2032,MP,MNP,WPR,1655,3226,4881,4000,3090,3596,2224,4008,5591,22509,1437,2799,4236,3392,2920,2871,1296,3930,5387,19796,42305,51428,51428
Northern Mariana Islands,2033,MP,MNP,WPR,1656,3233,4889,3879,3145,3727,2163,3772,5847,22533,1439,2807,4246,3298,2948,3085,1194,3638,5700,19863,42396,51525,51525
Northern Mariana Islands,2034,MP,MNP,WPR,1657,3242,4899,3695,3289,3801,2155,3526,6075,22541,1442,2814,4256,3157,3030,3235,1159,3325,6004,19910,42451,51605,51605
Northern Mariana Islands,2035,MP,MNP,WPR,1658,3250,4908,3516,3463,3798,2210,3284,6265,22536,1442,2820,4262,3025,3131,3310,1206,3001,6288,19961,42497,51666,51666
Northern Mariana Islands,2036,MP,MNP,WPR,1660,3259,4919,3413,3589,3722,2328,3050,6425,22527,1444,2830,4274,2932,3210,3306,1324,2689,6527,19988,42515,51712,51712
Northern Mariana Islands,2037,MP,MNP,WPR,1664,3267,4931,3327,3710,3593,2494,2842,6544,22510,1445,2839,4284,2868,3277,3243,1506,2379,6737,20010,42520,51736,51736
Northern Mariana Islands,2038,MP,MNP,WPR,1664,3277,4941,3260,3824,3431,2687,2652,6617,22471,1446,2846,4292,2809,3339,3151,1738,2087,6900,20024,42495,51736,51736
Northern Mariana Islands,2039,MP,MNP,WPR,1658,3287,4945,3213,3912,3271,2904,2480,6668,22448,1442,2854,4296,2776,3372,3046,1996,1826,7026,20042,42490,51722,51722
Northern Mariana Islands,2040,MP,MNP,WPR,1650,3294,4944,3189,3957,3132,3126,2318,6687,22409,1433,2861,4294,2755,3381,2943,2277,1589,7093,20038,42447,51682,51682
Northern Mariana Islands,2041,MP,MNP,WPR,1635,3301,4936,3179,3953,3035,3338,2187,6670,22362,1421,2865,4286,2751,3355,2874,2558,1389,7102,20029,42391,51618,51618
Northern Mariana Islands,2042,MP,MNP,WPR,1618,3303,4921,3179,3893,3011,3509,2095,6624,22311,1407,2868,4275,2753,3292,2850,2809,1239,7071,20014,42325,51528,51528
Northern Mariana Islands,2043,MP,MNP,WPR,1599,3303,4902,3184,3775,3067,3639,2044,6558,22267,1389,2869,4258,2762,3196,2875,3020,1142,6998,19993,42260,51410,51410
Northern Mariana Islands,2044,MP,MNP,WPR,1575,3301,4876,3194,3591,3209,3708,2035,6462,22199,1370,2865,4235,2768,3055,2958,3171,1113,6897,19962,42161,51272,51272
Northern Mariana Islands,2045,MP,MNP,WPR,1548,3295,4843,3203,3414,3380,3708,2092,6342,22139,1346,2860,4206,2777,2928,3059,3242,1156,6763,19925,42064,51111,51111
Northern Mariana Islands,2046,MP,MNP,WPR,1522,3283,4805,3212,3309,3512,3632,2211,6212,22088,1322,2851,4173,2784,2836,3136,3238,1275,6604,19873,41961,50931,50931
Northern Mariana Islands,2047,MP,MNP,WPR,1495,3267,4762,3223,3228,3627,3502,2371,6064,22015,1300,2837,4137,2793,2771,3207,3179,1455,6418,19823,41838,50735,50735
Northern Mariana Islands,2048,MP,MNP,WPR,1468,3247,4715,3230,3161,3744,3348,2561,5906,21950,1276,2819,4095,2800,2714,3269,3085,1680,6214,19762,41712,50518,50518
Northern Mariana Islands,2049,MP,MNP,WPR,1444,3220,4664,3241,3111,3832,3191,2769,5738,21882,1253,2796,4049,2807,2678,3302,2981,1933,5993,19694,41576,50288,50288
Northern Mariana Islands,2050,MP,MNP,WPR,1423,3183,4606,3246,3090,3873,3053,2986,5571,21819,1235,2765,4000,2813,2660,3308,2885,2208,5753,19627,41446,50050,50050
Mozambique,1970,MZ,MOZ,AFR,747968,1145782,1893750,737931,559728,415454,292977,172400,102655,2281145,743198,1077982,1821180,693290,591679,479684,331085,192715,127144,2415597,4696742,8411676,8411676
Mozambique,1971,MZ,MOZ,AFR,761430,1177813,1939243,765249,568237,421633,300557,178014,106191,2339881,758905,1117751,1876656,714031,596511,486535,340526,200120,129389,2467112,4806993,8622890,8622890
Mozambique,1972,MZ,MOZ,AFR,780636,1210716,1991352,793725,575501,429500,308325,184391,109966,2401408,779332,1157859,1937191,744098,603787,493150,349305,208056,132244,2530640,4932048,8860585,8860585
Mozambique,1973,MZ,MOZ,AFR,805908,1245352,2051260,820379,585723,437384,315954,191310,113980,2464730,804700,1197455,2002155,781606,617595,497827,356789,216057,135649,2605523,5070253,9123668,9123668
Mozambique,1974,MZ,MOZ,AFR,833755,1281869,2115624,846754,598620,445657,323752,198574,118280,2531637,832174,1236963,2069137,823258,635664,501655,363702,224021,139523,2687823,5219460,9404221,9404221
Mozambique,1975,MZ,MOZ,AFR,863862,1320551,2184413,875886,611811,454854,331758,206147,122903,2603359,861742,1276725,2138467,870968,655458,505206,370082,231892,143887,2777493,5380852,9703732,9703732
Mozambique,1976,MZ,MOZ,AFR,895624,1362181,2257805,906508,625066,465533,339403,213833,127823,2678166,893173,1317764,2210937,921491,677300,509470,375721,239578,148743,2872303,5550469,10019210,10019210
Mozambique,1977,MZ,MOZ,AFR,933174,1408677,2341851,934743,640637,478096,345908,221662,132987,2754033,929974,1361110,2291084,976556,705710,514125,379176,246997,154050,2976614,5730647,10363575,10363575
Mozambique,1978,MZ,MOZ,AFR,977158,1461425,2438583,960060,659246,492254,351090,229637,138431,2830718,972821,1407752,2380573,1035741,742358,519322,379959,254081,159794,3091255,5921973,10741128,10741128
Mozambique,1979,MZ,MOZ,AFR,1020343,1519451,2539794,984620,679954,506892,355270,237196,144185,2908117,1015567,1458737,2474304,1089107,783316,526962,379633,260679,165925,3205622,6113739,11127844,11127844
Mozambique,1980,MZ,MOZ,AFR,1044465,1568290,2612755,1008524,696864,516955,357855,241728,149159,2971085,1041306,1505209,2546515,1115028,814941,536648,380186,265138,171297,3283238,6254323,11413587,11413587
Mozambique,1981,MZ,MOZ,AFR,1053113,1610180,2663293,1037430,712735,522687,362019,244382,153562,3032815,1052342,1550978,2603320,1123282,839409,548442,384546,268597,176311,3340587,6373402,11640015,11640015
Mozambique,1982,MZ,MOZ,AFR,1064470,1652427,2716897,1073223,731780,528777,368722,247713,158163,3108378,1064573,1600440,2665013,1136771,866076,562668,391410,272756,181853,3411534,6519912,11901827,11901827
Mozambique,1983,MZ,MOZ,AFR,1079031,1688016,2767047,1112316,749464,536680,375248,251061,162527,3187296,1078862,1645702,2724564,1152512,889768,579850,398153,276831,187309,3484423,6671719,12163328,12163328
Mozambique,1984,MZ,MOZ,AFR,1097946,1719245,2817191,1152034,763517,544697,380935,254126,166280,3261589,1096902,1687675,2784577,1172558,911876,599342,405086,281220,192780,3562862,6824451,12426223,12426223
Mozambique,1985,MZ,MOZ,AFR,1117519,1747202,2864721,1190889,776048,549876,385693,256773,169324,3328603,1115741,1726190,2841931,1196349,934131,618104,412167,285860,198193,3644804,6973407,12680065,12680065
Mozambique,1986,MZ,MOZ,AFR,1137552,1768251,2905803,1228955,787586,552740,390184,258821,172069,3390355,1135298,1756928,2892226,1221449,952587,635067,418998,289947,203368,3721416,7111771,12909797,12909797
Mozambique,1987,MZ,MOZ,AFR,1146435,1762130,2908565,1250449,787275,548298,389875,256722,172423,3405042,1143684,1759264,2902948,1233513,954433,643901,420825,289730,205827,3748229,7153271,12964793,12964793
Mozambique,1988,MZ,MOZ,AFR,1149003,1745949,2894952,1267940,785938,543452,388674,252940,171972,3410916,1145710,1749650,2895360,1242297,947801,650238,421188,287219,206794,3755537,7166453,12956772,12956772
Mozambique,1989,MZ,MOZ,AFR,1161667,1748764,2910431,1300062,796647,547151,392245,251669,173477,3461251,1157824,1757094,2914918,1266539,947507,664018,426679,286813,209449,3801005,7262256,13087604,13087604
Mozambique,1990,MZ,MOZ,AFR,1180346,1765197,2945543,1338078,814509,555882,397057,252130,175866,3533522,1175986,1776566,2952552,1301136,951360,682738,435317,288100,213188,3871839,7405361,13303459,13303459
Mozambique,1991,MZ,MOZ,AFR,1200621,1790017,2990638,1376633,837789,567602,400476,254949,178798,3616247,1195823,1802972,2998795,1340337,957695,703651,444629,291577,217597,3955486,7571733,13561175,13561175
Mozambique,1992,MZ,MOZ,AFR,1218999,1818405,3037404,1409667,864141,579455,402793,258620,181682,3696358,1214009,1831620,3045629,1377555,964611,723370,454188,295809,221965,4037498,7733856,13816881,13816881
Mozambique,1993,MZ,MOZ,AFR,1248744,1867861,3116605,1450085,902596,595391,410826,264471,186239,3809608,1243857,1880479,3124336,1424319,982663,747031,470947,302490,228257,4155707,7965315,14206254,14206254
Mozambique,1994,MZ,MOZ,AFR,1306058,1961489,3267547,1517314,965083,623686,429337,276200,194958,4006578,1301550,1973376,3274926,1498697,1025276,784701,500088,315683,239382,4363827,8370405,14912873,14912873
Mozambique,1995,MZ,MOZ,AFR,1361005,2052426,3413431,1578500,1028803,652789,445929,287484,203307,4196812,1357173,2063788,3420961,1567567,1069192,821002,527539,328349,249980,4563629,8760441,15594830,15594830
Mozambique,1996,MZ,MOZ,AFR,1399729,2117747,3517476,1616155,1081912,674749,455710,295435,208713,4332674,1396800,2128643,3525443,1613038,1103248,845434,547830,337270,257136,4703956,9036630,16079553,16079553
Mozambique,1997,MZ,MOZ,AFR,1439681,2181022,3620703,1642938,1128591,692516,463941,302888,213206,4444080,1437611,2191546,3629157,1649522,1136806,863962,567698,346308,263487,4827783,9271863,16521724,16521724
Mozambique,1998,MZ,MOZ,AFR,1480297,2241816,3722113,1662067,1167366,706626,470751,309496,216680,4532986,1478877,2252087,3730964,1679374,1169414,876820,587129,355443,268946,4937126,9470112,16923195,16923195
Mozambique,1999,MZ,MOZ,AFR,1523200,2304268,3827468,1684123,1204865,721404,478337,315856,219576,4624161,1522150,2314400,3836550,1710418,1205570,887052,607490,365333,273860,5049723,9673884,17337893,17337893
Mozambique,2000,MZ,MOZ,AFR,1568711,2368039,3936750,1710491,1240339,737798,486971,321066,222503,4719168,1567649,2378251,3945900,1743828,1244492,895588,628568,375545,278669,5166690,9885858,17768505,17768505
Mozambique,2001,MZ,MOZ,AFR,1615783,2433926,4049709,1743356,1274244,757360,496833,324239,226463,4822495,1614384,2444397,4058781,1781131,1285292,903917,649836,385209,284355,5289740,10112235,18220716,18220716
Mozambique,2002,MZ,MOZ,AFR,1661898,2504281,4166179,1783818,1305440,780633,507132,326619,231081,4934723,1659853,2515141,4174994,1823511,1325966,913330,670333,395227,290692,5419059,10353782,18694946,18694946
Mozambique,2003,MZ,MOZ,AFR,1707603,2579648,4287251,1830504,1331939,807343,516272,330346,235530,5051934,1704622,2591025,4295647,1870563,1364024,924694,688309,407452,296880,5551922,10603856,19186754,19186754
Mozambique,2004,MZ,MOZ,AFR,1752839,2658660,4411499,1882628,1354944,837387,524974,335114,240000,5175047,1748772,2670581,4419353,1922067,1399168,938909,704370,420945,303050,5688509,10863556,19694411,19694411
Mozambique,2005,MZ,MOZ,AFR,1795932,2741260,4537192,1936879,1375997,869568,535186,339202,244617,5301449,1790676,2753691,4544367,1975865,1432284,956221,720445,433841,309447,5828103,11129552,20211114,20211114
Mozambique,2006,MZ,MOZ,AFR,1837720,2827333,4665053,1992532,1395222,903355,546172,342780,249433,5429494,1831300,2840221,4671521,2031513,1463146,977233,735156,446645,316227,5969920,11399414,20735982,20735982
Mozambique,2007,MZ,MOZ,AFR,1879678,2916721,4796399,2052357,1414785,938874,557251,346942,254295,5564504,1872083,2929792,4801875,2090929,1492815,1002783,747338,460477,323402,6117744,11682248,21280513,21280513
Mozambique,2008,MZ,MOZ,AFR,1926064,3009262,4935326,2113273,1434683,973897,568537,351590,258923,5700903,1917116,3022186,4939302,2152247,1522121,1032154,757196,475363,330949,6270030,11970933,21845571,21845571
Mozambique,2009,MZ,MOZ,AFR,1981114,3103404,5084518,2174291,1456325,1007804,580535,356894,263095,5838944,1970564,3115779,5086343,2214596,1552356,1064978,764990,491131,338807,6426858,12265802,22436660,22436660
Mozambique,2010,MZ,MOZ,AFR,2044218,3198282,5242500,2240186,1486030,1042341,595140,363420,266603,5993720,2031872,3209546,5241418,2280478,1587165,1101688,772029,507756,346964,6596080,12589800,23073723,23073723
Mozambique,2011,MZ,MOZ,AFR,2111813,3293699,5405512,2313172,1526739,1077740,613579,371283,269510,6172023,2097355,3303447,5400802,2351414,1628576,1141611,779837,524992,355651,6782081,12954104,23760421,23760421
Mozambique,2012,MZ,MOZ,AFR,2180848,3387998,5568846,2393763,1578248,1112337,636085,379946,272502,6372881,2164194,3395848,5560042,2428734,1677152,1182732,789546,542216,365467,6985847,13358728,24487611,24487611
Mozambique,2013,MZ,MOZ,AFR,2246050,3485759,5731809,2481285,1639661,1145214,662890,388540,276634,6594224,2227432,3491332,5718764,2512357,1732869,1223500,802370,558417,377410,7206923,13801147,25251731,25251731
Mozambique,2014,MZ,MOZ,AFR,2299424,3591274,5890698,2572987,1709064,1176921,693689,397568,281832,6832061,2279059,3594275,5873334,2600057,1794918,1263467,819095,574126,390961,7442624,14274685,26038704,26038704
Mozambique,2015,MZ,MOZ,AFR,2343064,3702887,6045951,2667322,1782756,1209115,727640,408541,287008,7082382,2321273,3702817,6024090,2690935,1860951,1303557,839909,590738,404732,7690822,14773204,26843246,26843246
Mozambique,2016,MZ,MOZ,AFR,2386059,3818687,6204746,2768056,1864648,1244633,765545,421194,292391,7356467,2363192,3814876,6178068,2786996,1932864,1344843,865922,607307,419271,7957203,15313670,27696493,27696493
Mozambique,2017,MZ,MOZ,AFR,2431269,3935492,6366761,2868120,1948692,1280540,805428,434235,298666,7635681,2407311,3927937,6335248,2883944,2007776,1385576,896702,622389,435372,8231759,15867440,28569441,28569441
Mozambique,2018,MZ,MOZ,AFR,2478000,4051167,6529167,2960287,2025185,1314636,844449,447558,305604,7897719,2452571,4040348,6492919,2977741,2080510,1425501,931238,636064,453022,8504076,16401795,29423878,29423878
Mozambique,2019,MZ,MOZ,AFR,2530066,4162996,6693062,3050115,2098954,1351272,883360,461961,313060,8158722,2502985,4149053,6652038,3070667,2153111,1467286,969852,648737,472117,8781770,16940492,30285595,30285595
Mozambique,2020,MZ,MOZ,AFR,2587521,4273288,6860809,3143228,2175973,1394199,922126,477503,319461,8432490,2558990,4256055,6815045,3165108,2228408,1512908,1011887,660367,491211,9069889,17502379,31178239,31178239
Mozambique,2021,MZ,MOZ,AFR,2645007,4386569,7031576,3236970,2253669,1441586,957766,493192,322465,8705648,2615346,4365835,6981181,3259346,2304834,1561511,1054765,670630,507584,9358670,18064318,32077072,32077072
Mozambique,2022,MZ,MOZ,AFR,2699125,4502564,7201689,3326972,2330730,1492877,989309,510369,324272,8974529,2668595,4478411,7147006,3350199,2382557,1613243,1096652,681143,522499,9646293,18620822,32969518,32969518
Mozambique,2023,MZ,MOZ,AFR,2749797,4616736,7366533,3421541,2411734,1551494,1020087,532779,330505,9268140,2718729,4589262,7307991,3444648,2464696,1670451,1138278,695457,541157,9954687,19222827,33897354,33897354
Mozambique,2024,MZ,MOZ,AFR,2799254,4724772,7524026,3524635,2494904,1616131,1050475,559961,340738,9586844,2767938,4694142,7462080,3546891,2549592,1732637,1179218,714048,563070,10285456,19872300,34858402,34858402
Mozambique,2025,MZ,MOZ,AFR,2847245,4827766,7675011,3634286,2579721,1683399,1080646,589498,351936,9919486,2815844,4794529,7610373,3654813,2636770,1797496,1219590,735834,585183,10629686,20549172,35834558,35834558
Mozambique,2026,MZ,MOZ,AFR,2893888,4928386,7822274,3748030,2666313,1752823,1111044,621137,363867,10263214,2862591,4893182,7755773,3765935,2726249,1864677,1259339,761304,606931,10984435,21247649,36825701,36825701
Mozambique,2027,MZ,MOZ,AFR,2940034,5028138,7968172,3863355,2754558,1824919,1141802,654252,376416,10615302,2908965,4991308,7900273,3878334,2817596,1934711,1298253,790576,627914,11347384,21962686,37831124,37831124
Mozambique,2028,MZ,MOZ,AFR,2985581,5127031,8112612,3978819,2844912,1898733,1174844,688096,389781,10975185,2954694,5088694,8043388,3991002,2911002,2006819,1337926,823400,648185,11718334,22693519,38849522,38849522
Mozambique,2029,MZ,MOZ,AFR,3029882,5229804,8259686,4090854,2936304,1973244,1211585,722250,404130,11338367,2999129,5190169,8189298,4100297,3005195,2080177,1379713,859613,667816,12092811,23431178,39880166,39880166
Mozambique,2030,MZ,MOZ,AFR,3071895,5335986,8407881,4200968,3027845,2047776,1252682,756042,419833,11705146,3041305,5295471,8336776,4207582,3099033,2154284,1424311,898532,687163,12470905,24176051,40920707,40920707
Mozambique,1950,MZ,MOZ,AFR,510693,784353,1295046,489596,413581,334263,196870,96508,71858,1602676,501073,654928,1156001,481924,491417,397661,239565,142342,113591,1866500,3469176,5920215,5920215
Mozambique,1951,MZ,MOZ,AFR,514177,798076,1312253,496484,415858,339672,202987,99154,71866,1626021,508923,673144,1182067,483395,493196,404073,243872,143569,113839,1881944,3507965,6002280,6002280
Mozambique,1952,MZ,MOZ,AFR,519785,807093,1326878,505105,418666,344355,208703,101954,71935,1650718,516057,689650,1205707,487287,495666,409454,247811,144801,114054,1899073,3549791,6082380,6082380
Mozambique,1953,MZ,MOZ,AFR,525161,815530,1340691,513173,422322,348289,213781,104797,72117,1674479,521006,706983,1227989,492119,499351,413733,251090,145926,114299,1916518,3590997,6159685,6159685
Mozambique,1954,MZ,MOZ,AFR,530301,823991,1354292,521143,426882,351730,218477,107687,72454,1698373,525264,724493,1249757,497574,504164,417338,254107,146969,114622,1934774,3633147,6237194,6237194
Mozambique,1955,MZ,MOZ,AFR,537939,830513,1368452,529970,432139,354926,223128,110682,72991,1723836,532320,739838,1272158,503632,509665,420720,257393,147997,115054,1954461,3678297,6318904,6318904
Mozambique,1956,MZ,MOZ,AFR,547688,835170,1382858,540397,437472,357830,227602,113733,73734,1750768,541479,753201,1294680,511204,515412,423796,260815,148977,115644,1975848,3726616,6404163,6404163
Mozambique,1957,MZ,MOZ,AFR,557858,840065,1397923,552714,442074,360492,231833,116820,74720,1778653,551186,766188,1317374,520883,520822,426615,264262,149898,116389,1998869,3777522,6492820,6492820
Mozambique,1958,MZ,MOZ,AFR,568456,844978,1413434,565439,445907,362785,235319,119822,75928,1805200,560970,777878,1338848,533051,526168,428772,266935,150665,117256,2022847,3828047,6580333,6580333
Mozambique,1959,MZ,MOZ,AFR,579868,852899,1432767,578645,448707,365337,238896,122950,77337,1831872,571933,790958,1362891,546492,530365,431377,270004,151639,118253,2048130,3880002,6675660,6675660
Mozambique,1960,MZ,MOZ,AFR,592556,866585,1459141,591929,451210,368662,243453,126482,78920,1860656,585151,808237,1393388,559581,532893,435428,274748,153233,119310,2075193,3935849,6788375,6788375
Mozambique,1961,MZ,MOZ,AFR,609536,885900,1495436,603366,457100,372631,247985,130471,80623,1892176,601795,825945,1427740,571678,536753,439073,279518,154884,120265,2102171,3994347,6917521,6917521
Mozambique,1962,MZ,MOZ,AFR,629860,909353,1539213,614234,465970,377230,252347,134867,82430,1927078,621042,843532,1464574,583529,542087,442208,283997,156685,120999,2129505,4056583,7060376,7060376
Mozambique,1963,MZ,MOZ,AFR,649610,933224,1582834,627031,475075,382306,256831,139434,84376,1965053,640148,861777,1501925,597510,547208,445894,288679,159147,121556,2159994,4125047,7209807,7209807
Mozambique,1964,MZ,MOZ,AFR,667540,958088,1625628,641255,484395,387832,261333,144034,86421,2005270,657842,882249,1540091,612419,552219,450272,293543,162239,121958,2192650,4197920,7363639,7363639
Mozambique,1965,MZ,MOZ,AFR,682166,987670,1669836,654627,493914,393917,266300,148713,88587,2046058,673168,909747,1582915,624908,556818,455936,299262,166109,122315,2225348,4271406,7524154,7524154
Mozambique,1966,MZ,MOZ,AFR,695474,1019787,1715261,667212,504925,399815,271270,153382,90950,2087554,687256,941126,1628382,636244,562125,461699,305076,170544,122755,2258443,4345997,7689643,7689643
Mozambique,1967,MZ,MOZ,AFR,708592,1051656,1760248,680878,517926,404801,276143,158004,93534,2131286,700966,973473,1674439,648361,568741,466825,310797,175393,123376,2293493,4424779,7859471,7859471
Mozambique,1968,MZ,MOZ,AFR,721442,1083426,1804868,696623,532256,408774,281270,162668,96345,2177936,714492,1007184,1721676,661608,576277,471389,316873,180650,124256,2331053,4508989,8035529,8035529
Mozambique,1969,MZ,MOZ,AFR,734985,1114460,1849445,715097,547048,411847,286583,167395,99384,2227354,728622,1041235,1769857,676645,584593,475087,323175,186297,125482,2371279,4598633,8217930,8217930
Mozambique,2031,MZ,MOZ,AFR,3112514,5440266,8552780,4313876,3119581,2122630,1298579,788792,437264,12080722,3082061,5399354,8481415,4317460,3192563,2229522,1472287,939048,706885,12857765,24938487,41972677,41972677
Mozambique,2032,MZ,MOZ,AFR,3152171,5541406,8693577,4429793,3210369,2199759,1349894,819524,456638,12465977,3121762,5500480,8622242,4430399,3284468,2307911,1524470,979564,727634,13254446,25720423,43036239,43036239
Mozambique,2033,MZ,MOZ,AFR,3189155,5638956,8828111,4543901,3304875,2279664,1406380,847708,478158,12860686,3158769,5598321,8757090,4541659,3379387,2389936,1580979,1018748,750102,13660811,26521497,44106698,44106698
Mozambique,2034,MZ,MOZ,AFR,3224855,5733686,8958541,4651933,3407348,2361108,1467252,874096,501940,13263677,3194596,5693563,8888159,4646985,3481700,2474217,1641535,1056436,774953,14075826,27339503,45186202,45186202
Mozambique,2035,MZ,MOZ,AFR,3259936,5824726,9084662,4755051,3516280,2444221,1530617,900525,527887,13674581,3229875,5785283,9015158,4747899,3589670,2560801,1704698,1093736,802519,14499323,28173904,46273717,46273717
Mozambique,2036,MZ,MOZ,AFR,3292038,5913036,9205074,4855871,3629247,2529111,1596017,927359,555598,14093203,3262137,5874409,9136546,4847122,3700835,2649689,1770128,1130609,832750,14931133,29024336,47365952,47365952
Mozambique,2037,MZ,MOZ,AFR,3323022,5999910,9322932,4955864,3743802,2615666,1663914,954649,584454,14518349,3293292,5962107,9255399,4945845,3813314,2740464,1838315,1166852,865416,15370206,29888555,48466889,48466889
Mozambique,2038,MZ,MOZ,AFR,3354245,6083558,9437803,5055023,3858541,2704332,1733471,984031,614019,14949417,3324836,6046517,9371353,5043850,3926099,2833319,1908557,1203937,900360,15816122,30765539,49574698,49574698
Mozambique,2039,MZ,MOZ,AFR,3382634,6164669,9547303,5157974,3969934,2794057,1803792,1016731,644114,15386602,3353676,6128436,9482112,5145903,4035578,2926994,1980087,1243121,937427,16269110,31655712,50685124,50685124
Mozambique,2040,MZ,MOZ,AFR,3409841,6242920,9652761,5264261,4079456,2883982,1874271,1053279,674487,15829736,3381351,6207552,9588903,5251744,4143087,3020379,2052436,1285017,976338,16729001,32558737,51800400,51800400
Mozambique,2041,MZ,MOZ,AFR,3435898,6316854,9752752,5368677,4191742,2974168,1945194,1094016,704855,16278652,3407942,6282245,9690187,5356181,4253187,3113522,2125976,1330139,1016705,17195710,33474362,52917300,52917300
Mozambique,2042,MZ,MOZ,AFR,3458387,6388660,9847047,5469994,4306998,3063545,2018381,1139378,734667,16732963,3431123,6354718,9785841,5457903,4366349,3205155,2202657,1379161,1057643,17668868,34401831,54034719,54034719
Mozambique,2043,MZ,MOZ,AFR,3480733,6458031,9938764,5567769,4420554,3156619,2094277,1189087,763690,17191996,3454143,6424914,9879057,5556369,4477898,3299845,2282935,1432131,1098635,18147813,35339809,55157639,55157639
Mozambique,2044,MZ,MOZ,AFR,3504273,6523315,10027588,5662746,4528249,3257482,2171725,1242520,792667,17655389,3478125,6491206,9969331,5652248,4583633,3401853,2365477,1488839,1140191,18632241,36287630,56284548,56284548
Mozambique,2045,MZ,MOZ,AFR,3526026,6586794,10112820,5754065,4631215,3364665,2250847,1298163,822975,18121930,3500166,6555740,10055906,5744617,4685053,3509501,2450331,1548022,1183500,19121024,37242954,57411685,57411685
Mozambique,2046,MZ,MOZ,AFR,3547311,6646192,10193503,5842682,4731983,3475817,2331709,1355579,854572,18592342,3521730,6616197,10137927,5834404,4784825,3620340,2537481,1609350,1228436,19614836,38207178,58538611,58538611
Mozambique,2047,MZ,MOZ,AFR,3570586,6700889,10271475,5929880,4831972,3588561,2414202,1415119,887028,19066762,3545100,6672070,10217170,5922756,4884104,3732497,2626497,1673218,1274539,20113611,39180373,59669022,59669022
Mozambique,2048,MZ,MOZ,AFR,3591182,6755620,10346802,6013874,4931157,3701551,2498759,1476145,921327,19542813,3565576,6728102,10293678,6007823,4982686,3845017,2717599,1739052,1322917,20615094,40157907,60798387,60798387
Mozambique,2049,MZ,MOZ,AFR,3607319,6808748,10416067,6095343,5034029,3811315,2584386,1537962,958288,20021323,3581622,6782383,10364005,6090401,5085260,3954292,2809564,1806210,1374533,21120260,41141583,61921656,61921656
Mozambique,2050,MZ,MOZ,AFR,3623742,6858935,10482677,6173951,5140115,3919230,2670223,1600054,998141,20501714,3598072,6833529,10431601,6170170,5191556,4061612,2901272,1874262,1429630,21628502,42130216,63044497,63044497
Mauritania,1970,MR,MRT,AFR,105947,150510,256457,102039,73934,52530,36394,22861,14453,302211,103167,147060,250227,101702,77542,55030,38347,24783,15893,313297,615508,1122198,1122198
Mauritania,1971,MR,MRT,AFR,109012,156439,265451,104764,76025,53815,37324,23492,14967,310387,106098,152877,258975,103798,79784,56435,39371,25545,16620,321553,631940,1156361,1156361
Mauritania,1972,MR,MRT,AFR,111972,162546,274518,107716,78133,55143,38272,24126,15487,318877,108925,158880,267805,106123,82057,57888,40427,26314,17364,330173,649050,1191376,1191376
Mauritania,1973,MR,MRT,AFR,114936,168736,283672,111017,80203,56505,39242,24780,16010,327757,111750,164968,276718,108875,84218,59379,41523,27091,18125,339211,666968,1227358,1227358
Mauritania,1974,MR,MRT,AFR,117955,174959,292914,114860,82100,57853,40235,25445,16547,337040,114642,171078,285720,112481,85899,60858,42654,27883,18899,348674,685714,1264352,1264352
Mauritania,1975,MR,MRT,AFR,121069,181185,302254,119111,83865,59315,41251,26134,17097,346773,117644,177182,294826,116723,87196,62470,43817,28694,19687,358587,705360,1302436,1302436
Mauritania,1976,MR,MRT,AFR,124336,187344,311680,123561,85703,60907,42295,26840,17656,356962,120804,183205,304009,121160,88544,64223,45015,29519,20491,368952,725914,1341604,1341604
Mauritania,1977,MR,MRT,AFR,127771,193463,321234,128182,87572,62468,43357,27552,18216,367347,124125,189164,313289,125753,89896,65949,46227,30344,21291,379460,746807,1381329,1381329
Mauritania,1978,MR,MRT,AFR,131346,199580,330926,133002,89445,64039,44431,28275,18777,377969,127586,195106,322692,130532,91243,67689,47453,31181,22107,390205,768174,1421786,1421786
Mauritania,1979,MR,MRT,AFR,134962,205725,340687,138118,91441,65704,45526,29025,19354,389168,131089,201071,332160,135610,92705,69518,48701,32044,22931,401509,790677,1463514,1463514
Mauritania,1980,MR,MRT,AFR,138656,211895,350551,143524,93596,67472,46641,29797,19955,400985,134658,207065,341723,140977,94316,71462,49964,32942,23772,413433,814418,1506694,1506694
Mauritania,1981,MR,MRT,AFR,142562,218109,360671,149211,95950,69326,47799,30591,20569,413446,138453,213094,351547,146627,96113,73493,51260,33876,24640,426009,839455,1551687,1551687
Mauritania,1982,MR,MRT,AFR,146541,224448,370989,155121,98558,71213,49014,31417,21209,426532,142349,219241,361590,152508,98158,75569,52612,34842,25542,439231,865763,1598332,1598332
Mauritania,1983,MR,MRT,AFR,150476,230975,381451,161149,101531,73066,50257,32261,21864,440128,146236,225567,371803,158499,100630,77536,54000,35840,26457,452962,893090,1646343,1646343
Mauritania,1984,MR,MRT,AFR,154471,237650,392121,167242,105047,74762,51491,33126,22523,454191,150201,232023,382224,164536,103936,79033,55366,36869,27390,467130,921321,1695675,1695675
Mauritania,1985,MR,MRT,AFR,158433,244535,402968,173364,108990,76337,52832,34007,23214,468744,154154,238685,392839,170572,107879,80161,56850,37918,28340,481720,950464,1746265,1746265
Mauritania,1986,MR,MRT,AFR,162158,251821,413979,179452,113168,77992,54292,34911,23914,483729,157885,245733,403618,176541,112044,81339,58467,38987,29302,496680,980409,1798009,1798009
Mauritania,1987,MR,MRT,AFR,165764,259405,425169,185532,117642,79791,55782,35852,24634,499233,161499,253096,414595,182479,116495,82631,60106,40091,30290,512092,1011325,1851092,1851092
Mauritania,1988,MR,MRT,AFR,169488,267151,436639,191645,122424,81701,57334,36832,25381,515317,165212,260648,425860,188426,121244,84015,61807,41229,31309,528030,1043347,1905847,1905847
Mauritania,1989,MR,MRT,AFR,173304,274825,448129,196700,126295,83131,58706,37712,26053,528597,168976,268143,437119,193225,125078,84962,63363,42293,32273,541194,1069791,1955040,1955040
Mauritania,1990,MR,MRT,AFR,177417,282543,459960,201904,130392,84667,60155,38602,26745,542465,173001,275691,448692,198171,129117,85991,65004,43358,33269,554910,1097375,2006027,2006027
Mauritania,1991,MR,MRT,AFR,182102,290402,472504,208365,135915,86932,61923,39635,27569,560339,177551,283403,460954,204436,134569,87689,66917,44526,34369,572506,1132845,2066302,2066302
Mauritania,1992,MR,MRT,AFR,187856,298660,486516,217672,144654,90916,64362,41002,28675,587281,183111,291554,474665,213748,143268,90990,69414,45968,35675,599063,1186344,2147527,2147527
Mauritania,1993,MR,MRT,AFR,194886,307077,501963,227534,154409,95721,66981,42491,29858,616994,189891,299865,489756,223649,153006,95157,71993,47503,37053,628361,1245355,2237064,2237064
Mauritania,1994,MR,MRT,AFR,202225,315469,517694,235004,162082,100042,68998,43762,30830,640718,196944,308125,505069,230971,160648,99193,73742,48868,38282,651704,1292422,2315191,2315191
Mauritania,1995,MR,MRT,AFR,209121,323780,532901,240357,167490,103663,70414,44904,31616,658444,203561,316298,519859,235997,166004,102832,74737,50170,39394,669134,1327578,2380341,2380341
Mauritania,1996,MR,MRT,AFR,214905,331783,546688,243660,170036,106130,71299,45880,32206,669211,209118,324150,533268,238783,168454,105402,75269,51380,40363,679651,1348862,2428816,2428816
Mauritania,1997,MR,MRT,AFR,219602,340339,559941,248688,173532,109332,72507,46961,32940,683960,213684,332543,546227,243414,171829,108673,76085,52694,41456,694151,1378111,2484278,2484278
Mauritania,1998,MR,MRT,AFR,223091,350208,573299,255650,178517,113532,74128,48240,33841,703908,217155,342210,559365,250162,176690,112902,77272,54183,42708,713917,1417825,2550501,2550501
Mauritania,1999,MR,MRT,AFR,225768,360976,586744,263267,183868,118184,75945,49635,34822,725721,219888,352716,572604,257641,181912,117568,78629,55776,44012,735538,1461259,2620611,2620611
Mauritania,2000,MR,MRT,AFR,228420,372029,600449,271453,189645,123320,78002,51167,35869,749456,222617,363476,586093,265731,187541,122685,80193,57494,45360,759004,1508460,2695003,2695003
Mauritania,2001,MR,MRT,AFR,231277,382662,613939,277786,193370,127684,79795,52572,36784,767991,225538,373855,599393,272971,192244,127629,81753,59212,46690,780499,1548490,2761823,2761823
Mauritania,2002,MR,MRT,AFR,234619,392458,627077,282643,195268,131248,81376,53810,37603,781948,228887,383454,612341,279528,196174,132365,83367,60891,48019,800344,1582292,2821703,2821703
Mauritania,2003,MR,MRT,AFR,238150,401847,639997,288147,197415,134855,83244,55005,38469,797135,232374,392673,625047,286448,200321,137168,85350,62470,49391,821148,1618283,2883326,2883326
Mauritania,2004,MR,MRT,AFR,241936,410946,652882,294332,199608,138349,85521,56018,39332,813160,236085,401641,637726,293831,204578,141939,88055,63627,50772,842802,1655962,2946575,2946575
Mauritania,2005,MR,MRT,AFR,246226,419876,666102,301140,202041,141701,88096,56905,40278,830161,240277,410450,650727,301604,209099,146640,91301,64459,52263,865366,1695527,3012360,3012360
Mauritania,2006,MR,MRT,AFR,251190,428612,679802,308434,205037,144875,90820,57854,41313,848333,245127,419080,664207,309583,214142,151212,94736,65345,53870,888888,1737221,3081229,3081229
Mauritania,2007,MR,MRT,AFR,256920,436846,693766,316475,208653,147928,93764,58901,42386,868107,250739,427217,677956,318006,219713,155690,98413,66330,55519,913671,1781778,3153508,3153508
Mauritania,2008,MR,MRT,AFR,265516,441249,706765,323582,212734,150738,97509,60667,45447,890677,259580,434616,694196,327441,226459,160091,102497,67118,58097,941703,1832380,3233336,3233336
Mauritania,2009,MR,MRT,AFR,277329,444070,721399,328552,217027,153201,101791,63188,50565,914324,271627,443136,714763,337152,234254,164530,106864,67862,61463,972125,1886449,3322616,3322616
Mauritania,2010,MR,MRT,AFR,290643,450814,741457,332172,221318,155456,105720,65916,55874,936456,284446,454674,739120,346142,242198,169207,111192,69066,64617,1002422,1938878,3419461,3419461
Mauritania,2011,MR,MRT,AFR,305228,462014,767242,334533,225515,157589,109197,68888,61336,957058,297818,469548,767366,354427,250239,174202,115408,70798,67512,1032586,1989644,3524249,3524249
Mauritania,2012,MR,MRT,AFR,320279,477882,798161,335993,229511,159656,112159,72097,66913,976329,311044,487772,798816,362211,258346,179582,119446,73113,70110,1062808,2039137,3636113,3636113
Mauritania,2013,MR,MRT,AFR,328663,496584,825247,342011,235582,162873,115112,74872,69327,999777,318231,505596,823827,371231,266668,185370,123653,75922,71264,1094108,2093885,3742959,3742959
Mauritania,2014,MR,MRT,AFR,330155,516233,846388,353042,243955,167377,118403,77196,68669,1028642,319582,521714,841296,381687,275265,191411,128198,79044,71240,1126845,2155487,3843174,3843174
Mauritania,2015,MR,MRT,AFR,330944,536529,867473,364590,252516,172127,121830,79613,68342,1059018,320605,538260,858865,392469,284028,197606,132905,82325,71541,1160874,2219892,3946220,3946220
Mauritania,2016,MR,MRT,AFR,330976,557229,888205,376776,261261,177227,125373,82060,68358,1091055,321270,555039,876309,403666,292946,204022,137772,85701,72218,1196325,2287380,4051890,4051890
Mauritania,2017,MR,MRT,AFR,330475,577876,908351,389713,270210,182768,129021,84544,68676,1124932,321782,571637,893419,415343,302031,210713,142801,89182,73245,1233315,2358247,4160015,4160015
Mauritania,2018,MR,MRT,AFR,333271,594549,927820,403480,279406,188825,132755,87041,69270,1160777,325098,585092,910190,427537,311314,217724,147989,92749,74604,1271917,2432694,4270712,4270712
Mauritania,2019,MR,MRT,AFR,339393,607043,946436,418167,288854,195428,136567,89555,70121,1198692,331042,595429,926471,440330,320796,225077,153339,96405,76302,1312249,2510941,4383849,4383849
Mauritania,2020,MR,MRT,AFR,345451,618679,964130,433954,298670,202544,140413,91961,70746,1238288,336897,605308,942205,453897,330574,232780,158787,100028,77916,1353982,2592270,4498604,4498604
Mauritania,2021,MR,MRT,AFR,351720,629414,981134,450846,308858,210083,144294,94281,71092,1279454,342959,614641,957600,468236,340615,240758,164266,103578,79327,1396780,2676234,4614974,4614974
Mauritania,2022,MR,MRT,AFR,358366,639277,997643,469034,319673,218123,148346,96733,71676,1323585,349414,623442,972856,483593,351192,249129,169907,107249,80984,1442054,2765639,4736139,4736139
Mauritania,2023,MR,MRT,AFR,365123,648363,1013486,488462,331188,226629,152658,99465,72824,1371226,356015,631832,987847,499936,362386,257919,175784,111205,83200,1490430,2861656,4862989,4862989
Mauritania,2024,MR,MRT,AFR,371828,656564,1028392,508661,343151,235428,157257,102541,74751,1421789,362636,639718,1002354,516807,373911,267003,181906,115536,86212,1541375,2963164,4993922,4993922
Mauritania,2025,MR,MRT,AFR,378628,663901,1042529,529412,355660,244479,162171,105855,77138,1474715,369403,647121,1016524,534021,385828,276334,188282,120148,89762,1594375,3069090,5128141,5128141
Mauritania,2026,MR,MRT,AFR,385344,670633,1055977,550469,368814,253757,167440,109277,79645,1529402,376094,654317,1030411,551360,398179,285865,194886,124914,93539,1648743,3178145,5264526,5264526
Mauritania,2027,MR,MRT,AFR,392012,677075,1069087,571389,382705,263282,173146,112789,82255,1585566,382748,661639,1044387,568422,411010,295608,201778,129830,97509,1704157,3289723,5403200,5403200
Mauritania,2028,MR,MRT,AFR,398632,686845,1085477,588305,397394,273090,179373,116384,84956,1639502,389348,671854,1061202,582280,424346,305600,209003,134900,101679,1757808,3397310,5543997,5543997
Mauritania,2029,MR,MRT,AFR,405109,699908,1105017,601024,412956,283199,186141,120051,87749,1691120,395785,684750,1080535,592953,438245,315832,216581,140117,106047,1809775,3500895,5686445,5686445
Mauritania,2030,MR,MRT,AFR,411447,712965,1124412,612818,429442,293595,193397,123795,90662,1743709,402065,697667,1099732,603085,452748,326295,224490,145475,110622,1862715,3606424,5830563,5830563
Mauritania,1950,MR,MRT,AFR,57670,84955,142625,63471,46439,33042,21755,11935,5137,181779,58994,89396,148390,66434,48134,33714,21737,11381,4365,185765,367544,658555,658555
Mauritania,1951,MR,MRT,AFR,58441,87168,145609,64782,47407,33793,22371,12464,5525,186342,58957,91624,150581,67787,49167,34566,22476,12014,4776,190786,377128,673322,673322
Mauritania,1952,MR,MRT,AFR,59340,89419,148759,66159,48399,34552,22986,12993,5919,191008,59077,93899,152976,69209,50239,35423,23218,12665,5202,195956,386964,688702,688702
Mauritania,1953,MR,MRT,AFR,60443,91642,152085,67576,49410,35319,23603,13520,6330,195758,59503,96059,155562,70672,51342,36286,23967,13320,5648,201235,396993,704643,704643
Mauritania,1954,MR,MRT,AFR,61981,93689,155670,68986,50445,36101,24227,14041,6748,200548,60725,97692,158417,72127,52487,37159,24719,13978,6121,206591,407139,721227,721227
Mauritania,1955,MR,MRT,AFR,63821,95603,159424,70531,51508,36903,24861,14559,7173,205535,62506,98925,161431,73738,53669,38052,25489,14628,6603,212179,417714,738577,738577
Mauritania,1956,MR,MRT,AFR,65725,97617,163342,72243,52608,37726,25505,15070,7608,210760,64344,100240,164584,75524,54894,38961,26268,15275,7110,218032,428792,756727,756727
Mauritania,1957,MR,MRT,AFR,67769,99788,167557,73987,53752,38566,26165,15575,8051,216096,66320,101704,168024,77355,56164,39885,27061,15916,7638,224019,440115,775698,775698
Mauritania,1958,MR,MRT,AFR,69992,102075,172067,75813,54944,39433,26836,16080,8505,221611,68475,103281,171756,79257,57472,40831,27863,16550,8181,230154,451765,795593,795593
Mauritania,1959,MR,MRT,AFR,72370,104496,176866,77764,56175,40340,27525,16588,8971,227363,70781,104980,175761,81277,58811,41809,28666,17190,8740,236493,463856,816484,816484
Mauritania,1960,MR,MRT,AFR,74883,107082,181965,79862,57453,41286,28243,17109,9448,233401,73217,106837,180054,83436,60167,42821,29478,17838,9323,243063,476464,838478,838478
Mauritania,1961,MR,MRT,AFR,77560,109872,187432,82070,58785,42272,28975,17641,9936,239679,75812,108884,184696,85708,61572,43868,30299,18488,9923,249858,489537,861663,861663
Mauritania,1962,MR,MRT,AFR,80363,112912,193275,84319,60190,43288,29717,18176,10434,246124,78533,111172,189705,88028,63037,44953,31123,19141,10544,256826,502950,885938,885938
Mauritania,1963,MR,MRT,AFR,83271,116318,199589,86543,61635,44329,30476,18722,10935,252640,81350,113902,195252,90243,64551,46075,31954,19800,11180,263803,516443,911290,911290
Mauritania,1964,MR,MRT,AFR,86292,120293,206585,88611,63082,45395,31257,19275,11434,259054,84274,117530,201804,91975,66063,47240,32805,20472,11829,270384,529438,937830,937830
Mauritania,1965,MR,MRT,AFR,89448,124696,214144,90546,64663,46494,32060,19839,11939,265541,87313,121825,209138,93323,67722,48441,33674,21160,12482,276802,542343,965621,965621
Mauritania,1966,MR,MRT,AFR,92714,129317,222031,92580,66392,47630,32884,20415,12443,272344,90457,126333,216790,94745,69544,49683,34563,21862,13138,283535,555879,994697,994697
Mauritania,1967,MR,MRT,AFR,96068,134212,230280,94765,68148,48809,33726,21006,12943,279397,93675,131111,224786,96308,71405,50968,35465,22573,13805,290524,569921,1024992,1024992
Mauritania,1968,MR,MRT,AFR,99424,139385,238809,97063,69979,50029,34590,21614,13447,286722,96899,136163,233062,97981,73341,52298,36395,23302,14485,297802,584524,1056393,1056393
Mauritania,1969,MR,MRT,AFR,102730,144820,247550,99480,71907,51275,35482,22232,13951,294327,100080,141487,241567,99773,75386,53660,37355,24035,15183,305392,599719,1088832,1088832
Mauritania,2031,MR,MRT,AFR,417585,726115,1143700,623664,446859,304288,201055,127633,93697,1797196,408149,710696,1118845,612626,467875,336983,232696,150956,115422,1916558,3713754,5976298,5976298
Mauritania,2032,MR,MRT,AFR,423525,739474,1162999,633572,465186,315288,209049,131579,96896,1851570,414050,723972,1138022,621551,483617,347892,241158,156554,120448,1971220,3822790,6123818,6123818
Mauritania,2033,MR,MRT,AFR,429358,752866,1182224,642652,484381,326638,217308,135657,100270,1906906,419839,737309,1157148,630001,499940,359057,249850,162259,125711,2026818,3933724,6273096,6273096
Mauritania,2034,MR,MRT,AFR,435274,766118,1201392,650879,504329,338405,225797,139904,103813,1963127,425703,750552,1176255,637949,516759,370509,258761,168091,131215,2083284,4046411,6424061,6424061
Mauritania,2035,MR,MRT,AFR,441144,779326,1220470,658257,524813,350696,234508,144389,107514,2020177,431506,763760,1195266,645402,533901,382328,267878,174092,136950,2140551,4160728,6576462,6576462
Mauritania,2036,MR,MRT,AFR,446824,792252,1239076,665041,545598,363621,243437,149206,111336,2078239,437126,776702,1213828,652658,551160,394578,277193,180322,142930,2198841,4277080,6729985,6729985
Mauritania,2037,MR,MRT,AFR,452057,804940,1256997,671549,566253,377271,252608,154428,115270,2137379,442318,789425,1231743,660034,568155,407301,286720,186831,149121,2258162,4395541,6884282,6884282
Mauritania,2038,MR,MRT,AFR,456586,817463,1274049,681342,582979,391707,262060,160120,119282,2197490,446828,801975,1248803,670292,581968,420531,296496,193662,155532,2318481,4515971,7038820,7038820
Mauritania,2039,MR,MRT,AFR,460334,829941,1290275,694367,595578,407006,271804,166306,123371,2258432,450583,814436,1265019,683206,592638,434321,306518,200827,162161,2379671,4638103,7193387,7193387
Mauritania,2040,MR,MRT,AFR,463559,842235,1305794,707389,607277,423205,281836,172924,127561,2320192,453845,826686,1280531,696143,602771,448715,316772,208313,169003,2441717,4761909,7348229,7348229
Mauritania,2041,MR,MRT,AFR,466560,854141,1320701,720504,618046,440326,292156,179906,131884,2382822,456890,838560,1295450,709193,612324,463729,327250,216080,176069,2504645,4887467,7503613,7503613
Mauritania,2042,MR,MRT,AFR,469504,865409,1334913,733828,627894,458336,302777,187184,136366,2446385,459860,849834,1309694,722486,621272,479355,337952,224098,183347,2568510,5014895,7659504,7659504
Mauritania,2043,MR,MRT,AFR,472709,875870,1348579,747186,636934,477203,313732,194700,141052,2510807,463066,860309,1323375,735850,629749,495556,348905,232332,190858,2633250,5144057,7816017,7816017
Mauritania,2044,MR,MRT,AFR,476150,885640,1361790,760409,645138,496812,325096,202424,145986,2575865,466491,870104,1336595,749116,637735,512255,360150,240781,198618,2698655,5274520,7972905,7972905
Mauritania,2045,MR,MRT,AFR,479575,894852,1374427,773582,652501,516941,336962,210350,151190,2641526,469909,879345,1349254,762348,645234,529273,371751,249431,206674,2764711,5406237,8129917,8129917
Mauritania,2046,MR,MRT,AFR,482818,903645,1386463,786482,659287,537376,349445,218481,156715,2707786,473134,888179,1361313,775320,652539,546416,383780,258274,215066,2831395,5539181,8286960,8286960
Mauritania,2047,MR,MRT,AFR,485818,911944,1397762,799146,665801,557683,362635,226840,162612,2774717,476110,896514,1372624,788068,659966,563300,396287,267335,223834,2898790,5673507,8443897,8443897
Mauritania,2048,MR,MRT,AFR,488432,919803,1408235,811652,675544,574132,376592,235473,168905,2842298,478701,904405,1383106,800653,670244,577042,409294,276644,233018,2966895,5809193,8600535,8600535
Mauritania,2049,MR,MRT,AFR,491021,927124,1418145,824112,688470,586536,391388,244390,175613,2910509,481243,911760,1393003,813143,683161,587681,422858,286201,242625,3035669,5946178,8757322,8757322
Mauritania,2050,MR,MRT,AFR,493914,933913,1427827,836392,701399,598063,407062,253586,182699,2979201,484056,918607,1402663,825425,696102,597801,437020,295993,252642,3104983,6084184,8914673,8914673
Montserrat,1970,MS,MSR,AMR,770,1506,2276,1033,483,335,370,430,424,3075,770,1469,2239,990,453,443,557,592,782,3817,6892,11402,11402
Montserrat,1971,MS,MSR,AMR,739,1507,2246,1052,519,332,359,430,436,3128,743,1466,2209,1012,476,428,553,573,785,3827,6955,11411,11411
Montserrat,1972,MS,MSR,AMR,710,1499,2209,1071,568,333,351,425,450,3198,711,1456,2167,1037,512,420,544,564,791,3868,7066,11444,11444
Montserrat,1973,MS,MSR,AMR,687,1486,2173,1085,619,336,349,415,467,3271,683,1442,2125,1058,553,413,524,562,798,3908,7179,11476,11476
Montserrat,1974,MS,MSR,AMR,667,1464,2131,1098,667,341,350,402,485,3343,659,1429,2088,1074,596,408,502,557,805,3942,7285,11506,11506
Montserrat,1975,MS,MSR,AMR,647,1441,2088,1111,708,347,351,388,506,3411,643,1413,2056,1088,636,399,487,552,811,3973,7384,11533,11533
Montserrat,1976,MS,MSR,AMR,625,1413,2038,1120,749,355,346,378,525,3473,627,1392,2019,1100,674,393,476,551,819,4013,7486,11553,11553
Montserrat,1977,MS,MSR,AMR,600,1388,1988,1125,785,369,332,373,549,3533,605,1377,1982,1106,705,395,466,548,826,4046,7579,11553,11553
Montserrat,1978,MS,MSR,AMR,569,1356,1925,1131,812,395,321,366,568,3593,579,1361,1940,1114,732,404,452,539,833,4074,7667,11543,11543
Montserrat,1979,MS,MSR,AMR,536,1322,1858,1142,830,423,315,359,594,3663,545,1347,1892,1118,754,420,437,533,845,4107,7770,11519,11519
Montserrat,1980,MS,MSR,AMR,498,1282,1780,1150,844,454,314,352,599,3713,510,1320,1830,1126,774,438,424,521,847,4130,7843,11452,11452
Montserrat,1981,MS,MSR,AMR,481,1231,1712,1164,858,488,313,353,589,3765,487,1266,1753,1137,795,452,413,513,839,4149,7914,11369,11369
Montserrat,1982,MS,MSR,AMR,481,1166,1647,1172,864,524,312,357,571,3800,478,1205,1683,1149,811,471,405,499,833,4168,7968,11298,11298
Montserrat,1983,MS,MSR,AMR,488,1109,1597,1171,871,560,316,363,560,3841,477,1140,1617,1153,823,487,399,486,830,4178,8019,11232,11232
Montserrat,1984,MS,MSR,AMR,508,1047,1555,1164,880,587,320,366,548,3865,484,1075,1559,1152,831,514,393,473,820,4183,8048,11168,11168
Montserrat,1985,MS,MSR,AMR,532,995,1527,1152,890,609,328,368,541,3888,499,1016,1515,1139,841,537,385,463,812,4177,8065,11113,11113
Montserrat,1986,MS,MSR,AMR,548,952,1500,1130,897,640,338,364,546,3915,510,970,1480,1121,849,559,378,456,805,4168,8083,11070,11070
Montserrat,1987,MS,MSR,AMR,556,932,1488,1102,897,669,351,352,558,3929,516,934,1450,1095,859,575,376,450,797,4152,8081,11020,11020
Montserrat,1988,MS,MSR,AMR,555,920,1475,1060,908,683,375,330,571,3927,512,912,1424,1055,869,589,380,438,796,4127,8054,10961,10961
Montserrat,1989,MS,MSR,AMR,540,928,1468,1011,917,696,398,315,579,3916,500,903,1403,1020,876,605,385,419,805,4110,8026,10894,10894
Montserrat,1990,MS,MSR,AMR,513,944,1457,961,918,710,418,302,587,3896,474,912,1386,971,884,618,388,399,810,4070,7966,10805,10805
Montserrat,1991,MS,MSR,AMR,469,956,1425,896,912,714,436,288,589,3835,432,906,1338,908,879,620,390,374,800,3971,7806,10569,10569
Montserrat,1992,MS,MSR,AMR,415,930,1345,821,886,698,448,275,579,3707,384,871,1255,829,853,610,384,353,769,3798,7505,10108,10108
Montserrat,1993,MS,MSR,AMR,360,882,1242,757,839,673,454,267,555,3545,335,815,1150,751,814,588,379,332,742,3606,7151,9547,9547
Montserrat,1994,MS,MSR,AMR,313,823,1136,696,787,652,453,262,529,3379,289,753,1042,673,771,565,378,315,699,3401,6780,8959,8959
Montserrat,1995,MS,MSR,AMR,273,753,1026,632,732,626,445,259,505,3199,251,684,935,604,716,537,374,301,652,3184,6383,8342,8342
Montserrat,1996,MS,MSR,AMR,240,677,917,569,677,596,447,253,477,3019,214,612,826,539,655,506,368,283,601,2952,5971,7715,7715
Montserrat,1997,MS,MSR,AMR,208,599,807,508,618,554,451,250,446,2827,185,539,724,474,588,476,353,265,554,2710,5537,7069,7069
Montserrat,1998,MS,MSR,AMR,184,520,704,452,553,509,442,256,406,2618,167,464,631,411,521,440,337,249,497,2455,5073,6409,6409
Montserrat,1999,MS,MSR,AMR,170,438,608,397,487,471,425,257,378,2415,158,390,548,350,456,402,316,235,441,2200,4615,5767,5767
Montserrat,2000,MS,MSR,AMR,161,365,526,344,427,423,405,253,345,2197,157,324,481,290,385,360,294,217,386,1932,4129,5138,5138
Montserrat,2001,MS,MSR,AMR,155,320,475,306,375,396,389,256,322,2044,157,291,448,248,333,339,276,205,345,1746,3790,4704,4704
Montserrat,2002,MS,MSR,AMR,149,314,463,298,347,390,386,263,304,1988,154,281,435,243,317,344,272,201,331,1708,3696,4601,4601
Montserrat,2003,MS,MSR,AMR,145,321,466,302,342,387,386,275,304,1996,148,283,431,254,313,363,274,203,327,1734,3730,4627,4627
Montserrat,2004,MS,MSR,AMR,139,326,465,311,339,383,386,277,298,1994,147,286,433,267,301,375,274,213,330,1760,3754,4656,4656
Montserrat,2005,MS,MSR,AMR,136,335,471,317,329,385,389,284,306,2010,140,292,432,278,300,381,278,223,324,1784,3794,4693,4693
Montserrat,2006,MS,MSR,AMR,133,341,474,320,315,387,388,297,303,2010,138,300,438,282,299,389,280,232,323,1805,3815,4731,4731
Montserrat,2007,MS,MSR,AMR,138,346,484,325,301,388,382,319,294,2009,140,305,445,284,302,396,286,238,324,1830,3839,4769,4769
Montserrat,2008,MS,MSR,AMR,141,350,491,324,292,385,379,336,301,2017,142,313,455,282,299,404,292,242,316,1835,3852,4814,4814
Montserrat,2009,MS,MSR,AMR,149,355,504,323,293,377,384,346,310,2033,147,320,467,284,303,416,300,247,317,1867,3900,4871,4871
Montserrat,2010,MS,MSR,AMR,154,351,505,327,298,372,384,354,317,2052,150,320,470,291,301,419,315,255,325,1906,3958,4938,4938
Montserrat,2011,MS,MSR,AMR,152,346,498,333,307,359,388,358,321,2066,147,322,469,297,300,410,336,258,324,1925,3991,4961,4961
Montserrat,2012,MS,MSR,AMR,145,343,488,342,312,344,385,363,331,2077,142,325,467,301,298,403,360,257,327,1946,4023,4975,4975
Montserrat,2013,MS,MSR,AMR,143,339,482,353,310,342,379,366,338,2088,137,328,465,301,309,393,378,260,332,1973,4061,5010,5010
Montserrat,2014,MS,MSR,AMR,135,338,473,364,310,346,375,366,341,2102,135,330,465,303,326,386,395,260,335,2005,4107,5051,5051
Montserrat,2015,MS,MSR,AMR,125,336,461,373,313,336,375,368,353,2118,127,333,460,306,330,378,405,262,344,2025,4143,5059,5059
Montserrat,2016,MS,MSR,AMR,126,333,459,380,320,320,377,364,363,2124,122,329,451,313,331,377,414,263,355,2053,4177,5085,5085
Montserrat,2017,MS,MSR,AMR,100,279,379,365,310,298,371,352,371,2067,89,290,379,308,241,316,417,267,324,1873,3940,4699,4699
Montserrat,2018,MS,MSR,AMR,78,226,304,353,295,283,360,346,376,2013,64,250,314,308,158,257,416,273,308,1720,3733,4359,4359
Montserrat,2019,MS,MSR,AMR,93,231,324,353,301,283,356,352,395,2040,84,238,322,323,198,260,418,278,331,1808,3848,4505,4505
Montserrat,2020,MS,MSR,AMR,98,220,318,342,304,286,350,348,409,2039,92,221,313,322,211,246,408,288,341,1816,3855,4500,4500
Montserrat,2021,MS,MSR,AMR,99,198,297,327,308,291,337,351,419,2033,94,196,290,318,211,224,390,309,342,1794,3827,4417,4417
Montserrat,2022,MS,MSR,AMR,96,189,285,314,317,293,326,352,427,2029,95,183,278,318,215,206,371,337,345,1792,3821,4390,4390
Montserrat,2023,MS,MSR,AMR,94,185,279,300,329,290,328,344,436,2027,92,177,269,317,224,200,351,358,353,1803,3830,4386,4386
Montserrat,2024,MS,MSR,AMR,99,174,273,287,339,289,332,338,434,2019,96,167,263,311,235,198,328,374,364,1810,3829,4372,4372
Montserrat,2025,MS,MSR,AMR,101,167,268,278,346,290,323,337,443,2017,98,159,257,301,253,193,310,384,370,1811,3828,4359,4359
Montserrat,2026,MS,MSR,AMR,102,167,269,266,351,295,305,340,451,2008,99,156,255,287,273,185,297,390,385,1817,3825,4353,4353
Montserrat,2027,MS,MSR,AMR,103,171,274,250,355,299,285,341,465,1995,100,159,259,271,290,179,282,395,403,1820,3815,4343,4343
Montserrat,2028,MS,MSR,AMR,104,175,279,238,355,298,275,337,473,1976,100,165,265,255,304,177,264,398,409,1807,3783,4332,4332
Montserrat,2029,MS,MSR,AMR,105,181,286,224,351,296,274,330,483,1958,100,173,273,235,314,181,246,398,422,1796,3754,4319,4319
Montserrat,2030,MS,MSR,AMR,105,189,294,208,341,299,278,323,486,1935,100,181,281,216,315,191,232,390,441,1785,3720,4301,4301
Montserrat,1950,MS,MSR,AMR,1166,1784,2950,935,859,558,390,309,535,3586,1070,1656,2726,1043,863,605,426,297,491,3725,7311,12989,12989
Montserrat,1951,MS,MSR,AMR,1120,1837,2957,930,829,587,400,315,512,3573,1044,1683,2727,1022,846,629,432,309,482,3720,7293,12974,12974
Montserrat,1952,MS,MSR,AMR,1072,1889,2961,929,788,624,412,318,493,3564,1006,1709,2715,998,819,650,439,323,478,3707,7271,12940,12940
Montserrat,1953,MS,MSR,AMR,1020,1968,2988,977,749,661,419,316,471,3593,964,1770,2734,1030,805,670,449,330,466,3750,7343,13052,13052
Montserrat,1954,MS,MSR,AMR,1005,2042,3047,1081,727,693,418,308,444,3671,953,1834,2787,1117,818,691,460,333,437,3856,7527,13363,13363
Montserrat,1955,MS,MSR,AMR,1015,2021,3036,1124,688,690,423,301,416,3642,972,1833,2805,1155,804,701,490,354,440,3944,7586,13432,13432
Montserrat,1956,MS,MSR,AMR,1009,1937,2946,1093,621,648,430,305,389,3486,983,1787,2770,1134,758,693,538,396,481,4000,7486,13204,13204
Montserrat,1957,MS,MSR,AMR,986,1857,2843,1062,560,593,437,312,369,3333,978,1753,2731,1111,708,671,579,441,524,4034,7367,12938,12938
Montserrat,1958,MS,MSR,AMR,953,1783,2736,1030,494,527,433,320,342,3146,955,1724,2679,1094,655,642,611,484,581,4067,7213,12633,12633
Montserrat,1959,MS,MSR,AMR,917,1718,2635,1001,438,452,425,325,326,2967,913,1701,2614,1082,602,609,633,534,649,4109,7076,12319,12319
Montserrat,1960,MS,MSR,AMR,893,1666,2559,999,404,398,417,336,308,2862,870,1683,2553,1080,570,584,638,565,685,4122,6984,12100,12100
Montserrat,1961,MS,MSR,AMR,880,1621,2501,1028,404,384,417,349,304,2886,838,1649,2487,1089,566,571,627,574,694,4121,7007,11996,11996
Montserrat,1962,MS,MSR,AMR,870,1574,2444,1061,417,378,415,361,303,2935,819,1607,2426,1092,568,566,616,584,694,4120,7055,11927,11927
Montserrat,1963,MS,MSR,AMR,867,1532,2399,1081,430,373,415,377,303,2979,810,1565,2375,1080,572,555,610,593,695,4105,7084,11862,11862
Montserrat,1964,MS,MSR,AMR,859,1501,2360,1097,443,368,412,390,313,3023,808,1521,2329,1071,575,541,593,608,698,4086,7109,11797,11797
Montserrat,1965,MS,MSR,AMR,848,1482,2330,1101,460,363,405,403,319,3051,801,1492,2293,1056,566,527,583,615,706,4053,7104,11725,11725
Montserrat,1966,MS,MSR,AMR,836,1473,2309,1091,467,359,398,415,329,3059,795,1474,2269,1039,547,516,576,616,717,4011,7070,11653,11653
Montserrat,1967,MS,MSR,AMR,829,1469,2298,1079,470,353,390,422,350,3064,790,1460,2250,1026,525,506,569,618,734,3978,7042,11588,11588
Montserrat,1968,MS,MSR,AMR,815,1476,2291,1057,476,345,385,424,377,3064,787,1457,2244,1010,497,487,564,617,744,3919,6983,11523,11523
Montserrat,1969,MS,MSR,AMR,795,1495,2290,1033,470,339,380,427,401,3050,785,1465,2250,990,467,464,561,606,769,3857,6907,11450,11450
Montserrat,2031,MS,MSR,AMR,105,198,303,193,327,304,283,315,494,1916,100,191,291,196,314,204,218,373,470,1775,3691,4287,4287
Montserrat,2032,MS,MSR,AMR,103,199,302,186,313,313,286,306,505,1909,100,194,294,183,316,215,205,356,495,1770,3679,4271,4271
Montserrat,2033,MS,MSR,AMR,102,198,300,181,299,325,283,306,498,1892,99,192,291,177,316,222,198,338,513,1764,3656,4247,4247
Montserrat,2034,MS,MSR,AMR,101,203,304,171,284,336,283,308,491,1873,98,196,294,167,310,234,195,315,533,1754,3627,4229,4229
Montserrat,2035,MS,MSR,AMR,100,206,306,165,274,343,287,298,494,1861,96,198,294,159,301,251,190,297,550,1748,3609,4210,4210
Montserrat,2036,MS,MSR,AMR,98,206,304,166,261,347,291,282,494,1841,94,199,293,156,287,270,182,283,555,1733,3574,4182,4182
Montserrat,2037,MS,MSR,AMR,96,206,302,170,245,349,294,267,505,1830,92,200,292,159,271,287,175,268,569,1729,3559,4159,4159
Montserrat,2038,MS,MSR,AMR,94,206,300,175,232,351,291,259,508,1816,91,199,290,165,255,303,170,251,577,1721,3537,4135,4135
Montserrat,2039,MS,MSR,AMR,92,206,298,181,219,346,289,259,507,1801,89,198,287,173,235,312,173,233,586,1712,3513,4107,4107
Montserrat,2040,MS,MSR,AMR,90,204,294,189,205,336,290,261,513,1794,87,196,283,180,216,312,185,219,590,1702,3496,4080,4080
Montserrat,2041,MS,MSR,AMR,88,202,290,198,191,323,295,266,504,1777,85,194,279,190,196,312,199,207,596,1700,3477,4054,4054
Montserrat,2042,MS,MSR,AMR,86,199,285,199,185,311,304,267,501,1767,83,192,275,193,183,314,211,195,600,1696,3463,4027,4027
Montserrat,2043,MS,MSR,AMR,84,196,280,198,181,298,316,266,497,1756,81,190,271,191,177,314,219,187,599,1687,3443,3997,3997
Montserrat,2044,MS,MSR,AMR,82,193,275,203,171,284,327,267,493,1745,79,187,266,195,167,308,231,186,591,1678,3423,3969,3969
Montserrat,2045,MS,MSR,AMR,81,189,270,206,165,273,335,271,489,1739,78,183,261,197,159,299,248,182,586,1671,3410,3939,3939
Montserrat,2046,MS,MSR,AMR,79,186,265,206,166,261,339,274,478,1724,77,179,256,198,156,285,268,176,576,1659,3383,3905,3905
Montserrat,2047,MS,MSR,AMR,78,182,260,206,170,245,343,275,474,1713,75,175,250,199,159,269,286,170,573,1656,3369,3873,3873
Montserrat,2048,MS,MSR,AMR,77,178,255,206,175,232,344,274,464,1695,73,172,245,199,164,253,302,166,562,1646,3341,3841,3841
Montserrat,2049,MS,MSR,AMR,76,174,250,206,181,219,340,271,469,1686,72,168,240,198,172,234,310,171,546,1631,3317,3809,3809
Montserrat,2050,MS,MSR,AMR,75,171,246,204,189,205,331,275,475,1679,71,165,236,196,180,216,310,182,538,1622,3301,3781,3781
Mauritius,1970,MU,MUS,AFR,58043,118399,176442,87197,48280,41367,33501,21192,11769,243306,55826,114629,170455,84988,47697,38616,30133,21022,17467,239923,483229,830115,830115
Mauritius,1971,MU,MUS,AFR,56112,119498,175610,91021,49277,41083,34573,21776,12361,250091,53918,115523,169441,88737,48896,38674,31173,21755,18032,247267,497358,842412,842412
Mauritius,1972,MU,MUS,AFR,54261,120015,174276,94749,50690,40842,35597,22253,12891,257022,52198,115805,168003,92375,50400,38810,32241,22338,18568,254732,511754,854036,854036
Mauritius,1973,MU,MUS,AFR,52905,119884,172789,98017,52853,40759,36511,22657,13256,264053,51006,115430,166436,95496,52492,39076,33300,22730,18995,262089,526142,865368,865368
Mauritius,1974,MU,MUS,AFR,52111,119207,171318,100621,55802,40886,37210,23035,13553,271107,50353,114575,164928,97923,55268,39464,34241,23061,19433,269390,540497,876740,876740
Mauritius,1975,MU,MUS,AFR,51848,118026,169874,102666,59405,41183,37602,23438,13861,278155,50190,113301,163491,99822,58615,39963,34928,23466,19973,276767,554922,888292,888292
Mauritius,1976,MU,MUS,AFR,52196,116277,168473,104395,63496,41606,37685,23910,14182,285274,50557,111575,162132,101401,62374,40573,35337,24003,20597,284285,569559,900166,900166
Mauritius,1977,MU,MUS,AFR,53035,114088,167123,106156,67726,42094,37568,24477,14584,292605,51323,109504,160827,102944,66284,41294,35531,24658,21312,292023,584628,912574,912574
Mauritius,1978,MU,MUS,AFR,54185,111724,165909,108194,71691,42672,37411,25184,15121,300273,52341,107281,159622,104653,70000,42158,35667,25410,22148,300036,600309,925835,925835
Mauritius,1979,MU,MUS,AFR,55568,109402,164970,110457,75215,43427,37246,26060,15783,308188,53560,105079,158639,106537,73299,43209,35791,26289,23112,308237,616425,940034,940034
Mauritius,1980,MU,MUS,AFR,56994,107392,164386,112603,78556,44364,37016,27085,16507,316131,54821,103131,157952,108396,76318,44383,35856,27360,24083,316396,632527,954865,954865
Mauritius,1981,MU,MUS,AFR,58118,105988,164106,114245,81995,45471,36752,28145,17265,323873,55823,101720,157543,109892,79345,45626,35867,28562,24987,324279,648152,969807,969807
Mauritius,1982,MU,MUS,AFR,58505,105417,163922,115329,85284,46917,36573,29103,18086,331292,56186,101091,157277,110833,82268,47107,35929,29710,25831,331678,662970,984176,984176
Mauritius,1983,MU,MUS,AFR,57937,105865,163802,115894,88263,48932,36567,29927,18836,338419,55720,101465,157185,111076,84949,49113,36182,30663,26609,338592,677011,998000,998000
Mauritius,1984,MU,MUS,AFR,56792,107220,164012,115746,91122,51696,36795,30599,19404,345362,54716,102796,157512,110456,87450,51742,36704,31404,27298,345054,690416,1011941,1011941
Mauritius,1985,MU,MUS,AFR,55489,109034,164523,114860,93716,55228,37275,30978,19931,351988,53492,104642,158134,109190,89640,54936,37409,31914,28038,351127,703115,1025769,1025769
Mauritius,1986,MU,MUS,AFR,54210,110856,165066,113413,96046,59309,37901,31049,20590,358308,52234,106508,158742,107542,91563,58532,38198,32186,28894,356915,715223,1039028,1039028
Mauritius,1987,MU,MUS,AFR,53153,112328,165481,111590,98467,63513,38543,31006,21408,364527,51151,108001,159152,105663,93497,62231,39047,32367,29843,362648,727175,1051809,1051809
Mauritius,1988,MU,MUS,AFR,52401,113226,165627,109722,101073,67428,39239,31036,22379,370877,50360,108888,159248,103835,95523,65653,40029,32613,30933,368586,739463,1064330,1064330
Mauritius,1989,MU,MUS,AFR,52151,113528,165679,107949,103725,70938,40161,31099,23470,377342,50099,109168,159267,102108,97560,68630,41264,32883,32227,374672,752014,1076961,1076961
Mauritius,1990,MU,MUS,AFR,52595,113261,165856,106453,106082,74423,41302,31085,24652,383997,50561,108885,159446,100651,99410,71483,42660,33084,33705,380993,764990,1090290,1090290
Mauritius,1991,MU,MUS,AFR,53504,112276,165780,105610,107730,78119,42566,31006,25850,390881,51505,107961,159466,100144,100962,74572,44043,33260,35148,388129,779010,1104259,1104259
Mauritius,1992,MU,MUS,AFR,54697,110732,165429,105581,108674,81676,44120,30980,26942,397973,52761,106522,159283,100701,102097,77720,45586,33517,36401,396022,793995,1118714,1118714
Mauritius,1993,MU,MUS,AFR,55789,109069,164858,106296,109141,84799,46161,31074,27844,405315,53971,104927,158898,101952,102677,80587,47580,33900,37493,404189,809504,1133252,1133252
Mauritius,1994,MU,MUS,AFR,56372,107484,163856,107524,109157,87428,48756,31299,28569,412733,54675,103432,158107,103687,102763,83086,50086,34391,38456,412469,825202,1147161,1147161
Mauritius,1995,MU,MUS,AFR,56197,106311,162508,108941,108677,89600,51985,31705,29132,420040,54581,102378,156959,105594,102441,85215,53126,34995,39330,420701,840741,1160207,1160207
Mauritius,1996,MU,MUS,AFR,55514,105627,161141,110326,107672,91516,55700,32208,29539,426961,53985,101793,155778,107397,101766,87164,56566,35695,40070,428658,855619,1172542,1172542
Mauritius,1997,MU,MUS,AFR,54500,105520,160020,111398,106225,93562,59496,32700,29942,433323,53017,101791,154808,108794,100774,89238,60101,36460,40742,436109,869432,1184257,1184257
Mauritius,1998,MU,MUS,AFR,52987,105956,158943,111856,104588,95884,63003,33260,30514,439105,51504,102355,153859,109523,99662,91521,63393,37355,41508,442962,882067,1194880,1194880
Mauritius,1999,MU,MUS,AFR,51815,106519,158334,111628,102999,98310,66115,34061,31291,444404,50279,103065,153344,109567,98638,93913,66286,38492,42438,449334,893738,1205413,1205413
Mauritius,2000,MU,MUS,AFR,51266,106911,158177,110763,101598,100421,69190,35061,32182,449215,49625,103641,153266,109024,97842,96125,69067,39786,43425,455269,904484,1215930,1215930
Mauritius,2001,MU,MUS,AFR,50796,107157,157953,109372,100701,101805,72579,36224,32970,453651,49127,104061,153188,107769,97363,97695,72053,41066,44532,460478,914129,1225272,1225272
Mauritius,2002,MU,MUS,AFR,50510,107250,157760,107594,100570,102459,75952,37718,33612,457905,48911,104303,153214,105907,97404,98484,75064,42489,45752,465100,923005,1233972,1233972
Mauritius,2003,MU,MUS,AFR,50599,106772,157371,105657,101150,102617,78872,39637,34229,462162,49065,104016,153081,103868,98131,98653,77811,44318,46935,469716,931878,1242340,1242340
Mauritius,2004,MU,MUS,AFR,50466,106182,156648,103784,102231,102363,81304,42049,34869,466600,48981,103594,152575,101942,99377,98290,80205,46633,48110,474557,941157,1250380,1250380
Mauritius,2005,MU,MUS,AFR,49914,105518,155432,102320,103492,101671,83271,45023,35535,471312,48458,103068,151526,100478,100838,97492,82233,49449,49282,479772,951084,1258048,1258048
Mauritius,2006,MU,MUS,AFR,49118,104433,153551,101370,104735,100523,84969,48405,36190,476192,47674,102146,149820,99523,102224,96330,84066,52644,50423,485210,961402,1264767,1264767
Mauritius,2007,MU,MUS,AFR,47929,103171,151100,101032,105683,98985,86765,51825,36849,481139,46511,101030,147541,99201,103231,94838,86018,55926,51597,490811,971950,1270584,1270584
Mauritius,2008,MU,MUS,AFR,46460,101795,148255,101283,106026,97298,88800,54963,37685,486055,45092,99758,144850,99511,103605,93215,88161,59002,53028,496522,982577,1275684,1275684
Mauritius,2009,MU,MUS,AFR,44696,100541,145237,101721,105705,95735,90919,57756,38852,490688,43406,98588,141994,100027,103282,91715,90387,61714,54825,501950,992638,1279868,1279868
Mauritius,2010,MU,MUS,AFR,42765,99511,142276,102075,104801,94486,92794,60539,40248,494943,41556,97625,139181,100482,102342,90530,92419,64333,56824,506930,1001873,1283330,1283330
Mauritius,2011,MU,MUS,AFR,41125,98279,139404,102312,103402,93745,94073,63586,41764,498882,39996,96471,136467,100845,100855,89893,93891,67193,58802,511479,1010361,1286236,1286236
Mauritius,2012,MU,MUS,AFR,39818,96799,136617,102392,101653,93712,94724,66595,43520,502596,38741,95102,133843,101065,98982,89982,94676,70122,60862,515689,1018285,1288745,1288745
Mauritius,2013,MU,MUS,AFR,38512,95433,133945,101942,99796,94412,94918,69240,45607,505915,37458,93845,131303,100786,97000,90793,94874,72812,63255,519520,1025435,1290691,1290691
Mauritius,2014,MU,MUS,AFR,37326,93568,130894,101406,98031,95610,94727,71469,48086,509329,36276,92088,128364,100402,95175,92119,94555,75178,66088,523517,1032846,1292113,1292113
Mauritius,2015,MU,MUS,AFR,36299,91133,127432,100815,96694,96997,94135,73322,51000,512963,35238,89741,124979,99936,93838,93667,93810,77182,69343,527776,1040739,1293153,1293153
Mauritius,2016,MU,MUS,AFR,35321,88757,124078,99825,95880,98373,93107,74972,54183,516340,34248,87410,121658,99092,93037,95153,92697,79011,72839,531829,1048169,1293911,1293911
Mauritius,2017,MU,MUS,AFR,34550,86332,120882,98687,95687,99479,91703,76719,57313,519588,33474,85010,118484,98079,92896,96293,91257,80945,76323,535793,1055381,1294741,1294741
Mauritius,2018,MU,MUS,AFR,34096,83630,117726,97460,96097,100012,90189,78648,60308,522714,33013,82329,115342,96927,93408,96827,89686,83040,79708,539596,1062310,1295381,1295381
Mauritius,2019,MU,MUS,AFR,33817,80805,114622,96454,96786,99966,88836,80626,63237,525905,32734,79494,112228,95960,94280,96765,88268,85200,83060,543533,1069438,1296279,1296279
Mauritius,2020,MU,MUS,AFR,33705,78024,111729,95771,97468,99342,87823,82397,66343,529144,32629,76657,109286,95296,95270,96183,87172,87170,86577,547668,1076812,1297828,1297828
Mauritius,2021,MU,MUS,AFR,33732,75573,109305,94908,98044,98225,87317,83622,69524,531640,32666,74139,106805,94451,96225,95138,86617,88567,90163,551161,1082801,1298915,1298915
Mauritius,2022,MU,MUS,AFR,33590,73656,107246,93851,98534,96856,87494,84205,72567,533507,32540,72132,104672,93399,97074,93816,86812,89279,93669,554049,1087556,1299469,1299469
Mauritius,2023,MU,MUS,AFR,33409,72052,105461,92947,98554,95464,88377,84345,75678,535365,32375,70400,102775,92469,97446,92459,87748,89468,97370,556960,1092325,1300557,1300557
Mauritius,2024,MU,MUS,AFR,33350,70715,104065,91536,98492,94190,89750,84150,78877,536995,32321,68940,101261,91000,97663,91283,89213,89198,101305,559662,1096657,1301978,1301978
Mauritius,2025,MU,MUS,AFR,33310,69666,102976,89522,98351,93319,91297,83613,82109,538211,32276,67797,100073,88899,97736,90584,90890,88532,105299,561940,1100151,1303210,1303210
Mauritius,2026,MU,MUS,AFR,33227,68785,102012,87526,97786,92937,92838,82706,85389,539182,32191,66837,99028,86781,97378,90403,92515,87538,109359,563974,1103156,1304199,1304199
Mauritius,2027,MU,MUS,AFR,33166,67920,101086,85441,97048,93135,94113,81497,88747,539981,32126,65925,98051,84554,96798,90852,93801,86247,113538,565790,1105771,1304905,1304905
Mauritius,2028,MU,MUS,AFR,33152,67319,100471,83036,96197,93903,94833,80220,92153,540342,32113,65288,97401,82013,96030,91923,94508,84861,117829,567164,1107506,1305373,1305373
Mauritius,2029,MU,MUS,AFR,33129,67003,100132,80417,95466,94845,94935,79121,95520,540304,32092,64940,97032,79275,95324,93184,94585,83626,122116,568110,1108414,1305569,1305569
Mauritius,2030,MU,MUS,AFR,33037,66861,99898,77749,94960,95703,94497,78360,98726,539995,32000,64787,96787,76490,94798,94376,94115,82728,126247,568754,1108749,1305425,1305425
Mauritius,1950,MU,MUS,AFR,50484,63670,114154,47085,38668,29254,20229,11940,6074,153250,49270,62204,111474,45925,35021,24339,17386,13262,10637,146570,299820,525443,525443
Mauritius,1951,MU,MUS,AFR,50797,68753,119550,47822,39769,29735,20385,11742,5761,155214,49580,67130,116710,46785,36459,25143,17590,12939,10220,149136,304350,540608,540608
Mauritius,1952,MU,MUS,AFR,50859,73978,124837,48778,40840,30187,20546,11540,5436,157327,49640,72186,121826,47804,37898,25975,17828,12614,9777,151896,309223,555889,555889
Mauritius,1953,MU,MUS,AFR,50986,78311,129297,49255,41830,30723,20973,11666,5448,159895,49678,76341,126019,48287,39058,26722,18241,12613,9810,154731,314626,569936,569936
Mauritius,1954,MU,MUS,AFR,51661,81495,133156,49103,42719,31386,21668,12158,5793,162827,50160,79398,129558,48107,39917,27394,18814,12981,10286,157499,320326,583040,583040
Mauritius,1955,MU,MUS,AFR,52720,84575,137295,49060,43478,32125,22393,12678,6113,165847,51031,82370,133401,48017,40680,28124,19410,13401,10686,160318,326165,596866,596866
Mauritius,1956,MU,MUS,AFR,53816,87721,141537,49417,44048,32967,23117,13178,6399,169126,52000,85379,137379,48293,41342,28934,20036,13844,11034,163483,332609,611531,611531
Mauritius,1957,MU,MUS,AFR,55003,90683,145686,50370,44463,33868,23806,13617,6612,172736,53139,88164,141303,49151,41909,29815,20681,14283,11332,167171,339907,626896,626896
Mauritius,1958,MU,MUS,AFR,56272,93371,149643,51995,44763,34820,24441,14007,6749,176775,54421,90641,145062,50670,42400,30758,21332,14706,11552,171418,348193,642896,642896
Mauritius,1959,MU,MUS,AFR,57651,95715,153366,54319,44985,35851,25047,14364,6847,181413,55841,92774,148615,52874,42841,31803,21983,15103,11730,176334,357747,659729,659729
Mauritius,1960,MU,MUS,AFR,59365,97443,156808,56587,44966,37047,25863,14980,7196,186639,57433,94336,151769,55046,42917,32855,22682,15731,12233,181464,368103,676683,676683
Mauritius,1961,MU,MUS,AFR,61044,99441,160485,58026,44639,38416,26854,15861,7861,191657,58915,96098,155013,56441,42602,33911,23418,16562,13150,186084,377741,693243,693243
Mauritius,1962,MU,MUS,AFR,62130,102447,164577,59235,44347,39754,27680,16608,8512,196136,60030,98727,158757,57648,42407,35035,24093,17189,13985,190357,386493,709822,709822
Mauritius,1963,MU,MUS,AFR,62755,105439,168194,61301,44350,40800,28273,17097,8936,200757,60794,101426,162220,59758,42599,36107,24712,17489,14419,195084,395841,726250,726250
Mauritius,1964,MU,MUS,AFR,63106,107861,170967,64315,44634,41510,28775,17502,9241,205977,61220,103786,165006,62789,43061,36993,25319,17686,14681,200529,406506,742480,742480
Mauritius,1965,MU,MUS,AFR,63223,109915,173138,67833,45056,41924,29333,17984,9608,211738,61325,105931,167256,66246,43597,37653,25963,17975,15062,206496,418234,758628,758628
Mauritius,1966,MU,MUS,AFR,63065,111679,174744,71717,45563,42068,29981,18556,9984,217869,61087,107899,168986,69998,44175,38107,26672,18380,15532,212864,430733,774462,774462
Mauritius,1967,MU,MUS,AFR,62467,113372,175839,75724,46135,42011,30695,19192,10370,224127,60406,109772,170178,73846,44847,38375,27425,18902,16027,219422,443549,789577,789577
Mauritius,1968,MU,MUS,AFR,61337,115156,176493,79614,46775,41841,31516,19860,10781,230387,59213,111607,170820,77603,45668,38510,28245,19539,16498,226063,456450,803759,803759
Mauritius,1969,MU,MUS,AFR,59809,116903,176712,83400,47474,41621,32458,20534,11235,236722,57632,113282,170914,81286,46628,38576,29142,20256,16962,232850,469572,817197,817197
Mauritius,2031,MU,MUS,AFR,32892,66814,99706,75372,94259,96469,93644,78103,101629,539476,31858,64735,96593,74000,94053,95477,93220,82385,130018,569153,1108629,1304935,1304935
Mauritius,2032,MU,MUS,AFR,32719,66622,99341,73499,93309,97085,92509,78471,104103,538976,31690,64549,96239,72010,93058,96416,92031,82739,133287,569541,1108517,1304094,1304094
Mauritius,2033,MU,MUS,AFR,32492,66433,98925,71901,92441,97146,91279,79453,106139,538359,31465,64377,95842,70281,92142,96801,90750,83753,136055,569782,1108141,1302906,1302906
Mauritius,2034,MU,MUS,AFR,32219,66356,98575,70565,91039,97094,90137,80848,107837,537520,31198,64302,95500,68826,90683,97020,89621,85227,138383,569760,1107280,1301364,1301364
Mauritius,2035,MU,MUS,AFR,31930,66225,98155,69524,89039,96967,89389,82389,109279,536587,30916,64168,95084,67688,88594,97101,88968,86896,140376,569623,1106210,1299451,1299451
Mauritius,2036,MU,MUS,AFR,31610,65999,97609,68643,87057,96429,89113,83899,110459,535600,30606,63947,94553,66730,86483,96751,88829,88500,142084,569377,1104977,1297139,1297139
Mauritius,2037,MU,MUS,AFR,31261,65769,97030,67785,84986,95724,89392,85146,111450,534483,30264,63715,93979,65822,84264,96180,89307,89766,143610,568949,1103432,1294443,1294443
Mauritius,2038,MU,MUS,AFR,30887,65532,96419,67186,82600,94909,90208,85878,112449,533230,29900,63477,93377,65187,81738,95427,90387,90471,145131,568341,1101571,1291363,1291363
Mauritius,2039,MU,MUS,AFR,30477,65237,95714,66871,80001,94209,91172,86035,113599,531887,29502,63194,92696,64842,79010,94729,91652,90570,146778,567581,1099468,1287886,1287886
Mauritius,2040,MU,MUS,AFR,30029,64859,94888,66732,77351,93728,92049,85712,114930,530502,29066,62825,91891,64689,76238,94216,92841,90146,148591,566721,1097223,1284007,1284007
Mauritius,2041,MU,MUS,AFR,29553,64396,93949,66689,74997,93056,92827,85022,116457,529048,28608,62373,90981,64638,73761,93485,93940,89319,150594,565737,1094785,1279715,1279715
Mauritius,2042,MU,MUS,AFR,29037,63878,92915,66500,73136,92135,93454,84092,118195,527512,28106,61864,89970,64454,71777,92500,94873,88221,152784,564609,1092121,1275002,1275002
Mauritius,2043,MU,MUS,AFR,28481,63278,91759,66314,71552,91286,93547,83098,120120,525917,27565,61281,88846,64284,70057,91590,95260,87042,155136,563369,1089286,1269892,1269892
Mauritius,2044,MU,MUS,AFR,27916,62600,90516,66233,70229,89917,93536,82203,122145,524263,27016,60618,87634,64213,68612,90143,95487,86023,157545,562023,1086286,1264437,1264437
Mauritius,2045,MU,MUS,AFR,27364,61864,89228,66103,69197,87954,93470,81688,124111,522523,26479,59901,86380,64079,67477,88068,95585,85476,159842,560527,1083050,1258664,1258664
Mauritius,2046,MU,MUS,AFR,26825,61073,87898,65884,68327,86009,93007,81609,125877,520713,25956,59132,85088,63857,66528,85977,95260,85422,161855,558899,1079612,1252597,1252597
Mauritius,2047,MU,MUS,AFR,26340,60211,86551,65651,67482,83982,92388,82031,127296,518830,25488,58293,83781,63627,65628,83779,94717,85956,163425,557132,1075962,1246298,1246298
Mauritius,2048,MU,MUS,AFR,25913,59282,85195,65419,66887,81639,91672,82933,128324,516874,25072,57389,82461,63395,64997,81274,94001,87064,164529,555260,1072134,1239794,1239794
Mauritius,2049,MU,MUS,AFR,25517,58313,83830,65127,66578,79088,91066,83955,129041,514855,24686,56446,81132,63110,64655,78566,93340,88342,165248,553261,1068116,1233085,1233085
Mauritius,2050,MU,MUS,AFR,25169,57314,82483,64750,66446,76485,90659,84873,129562,512775,24351,55476,79827,62743,64505,75814,92858,89534,165699,551153,1063928,1226235,1226235
Malawi,1970,MW,MWI,AFR,432701,570853,1003554,402761,315904,217621,150932,83281,59408,1229907,441653,596924,1038577,431893,343337,238055,170043,97776,72000,1353104,2583011,4625141,4625141
Malawi,1971,MW,MWI,AFR,443969,589864,1033833,407195,324917,223743,153676,87497,60344,1257372,453036,616371,1069407,435472,353097,244307,173346,102570,73081,1381873,2639245,4742480,4742480
Malawi,1972,MW,MWI,AFR,455783,609295,1065078,413010,333958,230124,156173,92578,61148,1286991,464822,636256,1101078,440273,362883,250972,176483,108219,73995,1412825,2699816,4865978,4865978
Malawi,1973,MW,MWI,AFR,468328,629251,1097579,421939,341396,236733,158748,98066,61996,1318878,477209,656643,1133852,448056,371060,257968,179669,114231,74943,1445927,2764805,4996239,4996239
Malawi,1974,MW,MWI,AFR,481837,649608,1131445,433968,347639,243577,161887,103295,63098,1353464,490504,677377,1167881,458144,378748,265207,183212,119914,76178,1481403,2834867,5134199,5134199
Malawi,1975,MW,MWI,AFR,496668,670362,1167030,448638,353047,250672,165743,107936,64571,1390607,505100,698464,1203564,471671,384931,272784,187301,125068,78009,1519764,2910371,5280965,5280965
Malawi,1976,MW,MWI,AFR,512964,691785,1204749,465711,357788,258094,170390,112003,66354,1430340,521211,720176,1241387,489220,389131,280966,192124,129803,80505,1561749,2992089,5438226,5438226
Malawi,1977,MW,MWI,AFR,530914,714298,1245212,484454,364012,266320,176052,115634,68473,1474945,539026,742899,1281925,508629,395006,290241,197868,134186,83699,1609629,3084574,5611712,5611712
Malawi,1978,MW,MWI,AFR,551875,739342,1291217,504632,371266,275260,182407,119335,72563,1525463,559637,768250,1327887,531812,400798,300049,204093,138629,88863,1664244,3189707,5808810,5808810
Malawi,1979,MW,MWI,AFR,576151,767936,1344087,525703,378846,284802,188985,123279,78893,1580508,583289,797007,1380296,559028,405418,309987,210423,143286,96110,1724252,3304760,6029140,6029140
Malawi,1980,MW,MWI,AFR,602663,799917,1402580,547412,387342,295189,195707,127221,85846,1638717,609138,828495,1437633,588299,410669,320514,216982,147937,104036,1788437,3427154,6267369,6267369
Malawi,1981,MW,MWI,AFR,630353,835212,1465565,569400,397034,306106,202688,130951,93230,1699409,636238,862662,1498900,618726,417227,331339,223883,152401,112444,1856020,3555429,6519891,6519891
Malawi,1982,MW,MWI,AFR,658160,873721,1531881,591751,408345,317030,209988,134407,101070,1762591,663454,899565,1563019,650082,425705,341943,231185,156602,121344,1926861,3689452,6784347,6784347
Malawi,1983,MW,MWI,AFR,685328,915039,1600367,614547,422786,326462,217570,137819,109101,1828285,689913,938969,1628882,682025,437958,350750,238842,160709,130505,2000789,3829074,7058317,7058317
Malawi,1984,MW,MWI,AFR,710728,959070,1669798,637719,440185,334693,225364,141553,116952,1896466,714547,980920,1695467,714106,453403,358636,246686,164951,139495,2077277,3973743,7339002,7339002
Malawi,1985,MW,MWI,AFR,733973,1005971,1739944,661307,459986,342054,233310,145695,124405,1966757,736961,1025695,1762656,745988,473127,364489,254633,169350,148142,2155729,4122486,7625078,7625078
Malawi,1986,MW,MWI,AFR,755189,1054348,1809537,685065,481270,348427,241293,150097,130804,2036956,757433,1071973,1829406,776307,497548,367606,262733,173801,155927,2233922,4270878,7909819,7909819
Malawi,1987,MW,MWI,AFR,783903,1111304,1895207,718594,509922,358506,250855,157931,145920,2141728,784471,1128234,1912705,827487,524117,371842,271209,180859,170831,2346345,4488073,8295993,8295993
Malawi,1988,MW,MWI,AFR,819292,1180562,1999854,758572,543298,372176,263279,166626,158224,2262175,819192,1195073,2014265,882567,559539,380127,283144,189045,184061,2478483,4740658,8754781,8754781
Malawi,1989,MW,MWI,AFR,852346,1251617,2103963,795965,573018,385332,276828,172662,158472,2362277,853523,1261707,2115230,917978,603069,390738,298124,195627,187883,2593419,4955696,9174895,9174895
Malawi,1990,MW,MWI,AFR,880624,1312535,2193159,831509,597992,396077,288708,177565,158487,2450338,882795,1320336,2203131,946915,643868,398854,311334,201107,190955,2693033,5143371,9539665,9539665
Malawi,1991,MW,MWI,AFR,903762,1359755,2263517,864001,616751,404064,297985,181154,157758,2521713,906512,1367330,2273842,968644,679501,404540,321829,205264,192736,2772514,5294227,9831584,9831584
Malawi,1992,MW,MWI,AFR,929192,1400973,2330165,899126,633335,412378,306034,184740,157228,2592841,932121,1410066,2342187,990682,713157,411297,331099,209567,194422,2850224,5443065,10115420,10115420
Malawi,1993,MW,MWI,AFR,941792,1420627,2362419,924571,639610,416934,307438,185894,154710,2629157,944911,1431978,2376889,1000838,734397,415610,333308,211242,193374,2888769,5517926,10257233,10257233
Malawi,1994,MW,MWI,AFR,928929,1402604,2331533,928415,628017,412498,298845,182312,148324,2598411,932366,1416175,2348541,987870,733099,412129,325345,207634,187234,2853311,5451722,10131799,10131799
Malawi,1995,MW,MWI,AFR,925375,1391680,2317055,945231,624953,413417,292271,181792,147897,2605561,929154,1409683,2338837,993823,733475,413997,317041,206763,186269,2851368,5456929,10112816,10112816
Malawi,1996,MW,MWI,AFR,940892,1404853,2345745,983527,638432,423742,291254,186116,154511,2677582,945009,1428869,2373878,1028906,744491,425782,311380,210613,192149,2913321,5590903,10310528,10310528
Malawi,1997,MW,MWI,AFR,958061,1419818,2377879,1020535,653367,433808,290305,190088,160146,2748249,962429,1448468,2410897,1065879,753919,439173,305404,214048,197226,2975649,5723898,10512678,10512678
Malawi,1998,MW,MWI,AFR,979737,1440467,2420204,1055663,669891,443802,289661,193503,163735,2816255,984224,1471932,2456156,1102727,763905,455251,300115,217097,200749,3039844,5856099,10732456,10732456
Malawi,1999,MW,MWI,AFR,1003620,1465360,2468980,1088147,687314,448476,287931,197858,171140,2880866,1009471,1501870,2511341,1144439,768207,469169,296112,222826,212015,3112768,5993634,10973956,10973956
Malawi,2000,MW,MWI,AFR,1026951,1493552,2520503,1117391,707548,448498,285207,203233,182223,2944100,1035141,1537176,2572317,1190439,768878,479463,292768,230869,230060,3192477,6136577,11229387,11229387
Malawi,2001,MW,MWI,AFR,1052591,1527326,2579917,1143012,732734,449524,283075,208157,191342,3007844,1062528,1576181,2638709,1233726,775226,489770,289934,238094,245597,3272347,6280191,11498818,11498818
Malawi,2002,MW,MWI,AFR,1081280,1566080,2647360,1164567,762206,450870,281537,212577,200172,3071929,1092621,1619566,2712187,1273857,786698,498706,288161,244743,260846,3353011,6424940,11784498,11784498
Malawi,2003,MW,MWI,AFR,1112722,1607489,2720211,1185305,795154,452658,281492,215572,209225,3139406,1125228,1666076,2791304,1313293,803299,505333,288740,249804,276582,3437051,6576457,12087965,12087965
Malawi,2004,MW,MWI,AFR,1147012,1650945,2797957,1206662,831115,455476,282840,217375,218342,3211810,1160615,1715004,2875619,1352471,826084,509583,291334,253953,292529,3525954,6737764,12411342,12411342
Malawi,2005,MW,MWI,AFR,1184641,1697762,2882403,1227073,869883,460274,285405,218203,227005,3287843,1199276,1766876,2966152,1388825,856662,512318,297062,256380,307994,3619241,6907084,12755648,12755648
Malawi,2006,MW,MWI,AFR,1223760,1748107,2971867,1248014,910169,468079,289090,218071,234797,3368220,1239253,1821503,3060756,1422945,894953,514413,306306,256457,322393,3717467,7085687,13118307,13118307
Malawi,2007,MW,MWI,AFR,1260889,1804312,3065201,1271131,950335,480499,293254,217580,240576,3453375,1276917,1880373,3157290,1454949,940644,517440,316965,255582,334015,3819595,7272970,13495463,13495463
Malawi,2008,MW,MWI,AFR,1296534,1871642,3168176,1297200,988694,501475,298926,215889,240103,3542287,1311790,1945947,3257737,1480470,996514,526056,329215,252105,336860,3921220,7463507,13889423,13889423
Malawi,2009,MW,MWI,AFR,1328957,1949336,3278293,1327451,1023049,530227,306005,213387,235599,3635718,1342412,2018891,3361303,1501737,1057800,540753,342924,246753,333649,4023616,7659334,14298932,14298932
Malawi,2010,MW,MWI,AFR,1354745,2031605,3386350,1363415,1052425,563065,313567,211288,232464,3736224,1366269,2096956,3463225,1525800,1116587,559267,357409,241839,331714,4132616,7868840,14718422,14718422
Malawi,2011,MW,MWI,AFR,1375050,2116574,3491624,1405234,1076467,599570,321725,209833,230375,3843204,1384486,2178205,3562691,1554006,1170837,582754,372211,237907,330860,4248575,8091779,15146094,15146094
Malawi,2012,MW,MWI,AFR,1391638,2201806,3593444,1453346,1095167,639226,330868,209262,228939,3956808,1398999,2259927,3658926,1588040,1218517,612288,387023,235454,330743,4372065,8328873,15581251,15581251
Malawi,2013,MW,MWI,AFR,1406272,2284619,3690891,1505801,1112328,681053,341472,210409,227389,4078452,1411536,2339165,3750701,1627418,1261301,648493,401558,235643,330314,4504727,8583179,16024775,16024775
Malawi,2014,MW,MWI,AFR,1419717,2364086,3783803,1561815,1130204,724193,353724,213058,225595,4208589,1422733,2414852,3837585,1672109,1300034,691981,415630,238291,329952,4647997,8856586,16477966,16477966
Malawi,2015,MW,MWI,AFR,1431139,2440707,3871846,1622198,1148358,768352,367969,216922,223525,4347324,1431771,2487225,3918996,1722905,1332969,742866,429090,244081,328870,4800781,9148105,16938942,16938942
Malawi,2016,MW,MWI,AFR,1440597,2513503,3954100,1686229,1168609,812215,384726,221931,221268,4494978,1438621,2555314,3993935,1779116,1361396,799866,442154,253294,326783,4962609,9457587,17405624,17405624
Malawi,2017,MW,MWI,AFR,1450533,2580100,4030633,1754655,1192490,854124,404420,227403,219451,4652543,1445771,2616955,4062726,1841302,1387476,861180,455562,264394,325346,5135260,9787803,17881167,17881167
Malawi,2018,MW,MWI,AFR,1463020,2639381,4102401,1828289,1220566,892727,427327,233249,218125,4820283,1455708,2670918,4126626,1909895,1412621,924439,470016,277068,324541,5318580,10138863,18367883,18367883
Malawi,2019,MW,MWI,AFR,1478760,2690682,4169442,1907646,1253380,927170,453849,239530,217323,4998898,1469497,2716584,4186081,1984976,1438473,987365,486730,290999,324369,5512912,10511810,18867337,18867337
Malawi,2020,MW,MWI,AFR,1498771,2733063,4231834,1991522,1291817,957324,484063,246007,216191,5186924,1488165,2753147,4241312,2065089,1467014,1048164,506985,305504,324238,5716994,10903918,19377061,19377061
Malawi,2021,MW,MWI,AFR,1522828,2767658,4290486,2077956,1336098,982748,517326,252455,213736,5380319,1511275,2781777,4293052,2148042,1499316,1104410,531449,319735,322944,5925896,11306215,19889742,19889742
Malawi,2022,MW,MWI,AFR,1549364,2798324,4347688,2164124,1386212,1003191,553185,259449,211013,5577174,1536947,2806536,4343483,2230714,1536607,1153814,561056,333494,321291,6136976,11714150,20405317,20405317
Malawi,2023,MW,MWI,AFR,1577065,2828809,4405874,2247299,1439932,1022222,591175,267934,210058,5778620,1563775,2831358,4395133,2310225,1578322,1198107,596716,347027,321717,6352114,12130734,20931751,20931751
Malawi,2024,MW,MWI,AFR,1604943,2860618,4465561,2326950,1496674,1042052,630929,278521,211816,5986942,1591154,2857929,4449083,2386069,1624737,1238183,639179,360499,325715,6574382,12561324,21475962,21475962
Malawi,2025,MW,MWI,AFR,1632344,2894015,4526359,2403600,1557016,1061812,671783,291150,215152,6200513,1618458,2886723,4505181,2458539,1676518,1272326,688526,373648,332387,6801944,13002457,22033992,22033992
Malawi,2026,MW,MWI,AFR,1660074,2928887,4588961,2476254,1620400,1083073,712211,305800,218948,6416686,1646237,2917492,4563729,2526658,1733077,1301783,743466,386380,340417,7031781,13448467,22601151,22601151
Malawi,2027,MW,MWI,AFR,1687332,2966138,4653470,2542631,1687815,1107465,750795,322855,223218,6634779,1673678,2951036,4624714,2588333,1795172,1328603,802173,399227,349799,7263307,13898086,23176271,23176271
Malawi,2028,MW,MWI,AFR,1713078,3006794,4719872,2601682,1760115,1135605,786450,342590,227967,6854409,1699580,2988653,4688233,2642375,1863328,1354321,862601,412959,360439,7496023,14350432,23758548,23758548
Malawi,2029,MW,MWI,AFR,1737891,3050636,4788527,2652823,1837768,1167895,818298,365231,233124,7075139,1724345,3030461,4754806,2688164,1937585,1380414,922532,428638,372062,7729395,14804534,24347875,24347875
Malawi,2030,MW,MWI,AFR,1762370,3098050,4860420,2695162,1919702,1205208,846206,390901,238759,7295938,1748686,3076716,4825402,2724912,2016601,1408811,980275,447452,384428,7962479,15258417,24944243,24944243
Malawi,1950,MW,MWI,AFR,270335,377999,648334,268104,194802,119480,85728,57782,40368,766264,286525,404761,691286,286770,211929,132287,95982,67032,49852,843852,1610116,2949739,2949739
Malawi,1951,MW,MWI,AFR,266550,388474,655024,275423,198181,125255,86819,58579,41102,785359,281135,416178,697313,294104,215763,138417,96941,67717,50473,863415,1648774,3001113,3001113
Malawi,1952,MW,MWI,AFR,264253,398645,662898,282875,201093,132234,87691,59311,41853,805057,277213,427324,704537,301791,219277,145661,97614,68382,51080,883805,1688862,3056297,3056297
Malawi,1953,MW,MWI,AFR,265288,406544,671832,290415,203956,139747,88537,60033,42631,825319,276533,436273,712806,309751,222779,153386,98284,69095,51681,904976,1730295,3114930,3114930
Malawi,1954,MW,MWI,AFR,268870,412527,681397,297962,207389,146851,89523,60903,43431,846059,277521,444253,721774,317867,226706,160712,99255,70005,52347,926892,1772951,3176123,3176123
Malawi,1955,MW,MWI,AFR,274589,417095,691684,305559,211630,153082,90881,61942,44246,867340,281574,449973,731547,326159,231229,167282,100817,71146,53118,949751,1817091,3240318,3240318
Malawi,1956,MW,MWI,AFR,282662,420412,703074,313311,216802,158511,92521,63177,45080,889402,289750,452670,742420,334768,236455,173136,102863,72556,54007,973785,1863187,3308682,3308682
Malawi,1957,MW,MWI,AFR,291381,424081,715462,321271,222953,163219,94328,64662,45984,912417,298554,455707,754261,343789,242413,178241,105268,74263,55003,998977,1911394,3381111,3381111
Malawi,1958,MW,MWI,AFR,300668,428049,728717,329588,229747,167312,96579,66247,46909,936382,307928,459055,766983,353271,248895,182735,108238,76083,56069,1025291,1961673,3457376,3457376
Malawi,1959,MW,MWI,AFR,310823,431992,742815,338477,236678,170976,99730,67651,47822,961334,318189,462347,780536,363263,255631,186890,112104,77707,57159,1052754,2014088,3537432,3537432
Malawi,1960,MW,MWI,AFR,321725,435981,757706,347976,243425,174404,103801,68787,48686,987079,329192,465647,794839,373811,262483,190951,116875,79074,58268,1081462,2068541,3621081,3621081
Malawi,1961,MW,MWI,AFR,332985,440576,773561,357773,250117,177427,108836,69623,49509,1013285,340524,469500,810024,384689,269604,194827,122641,80160,59404,1111325,2124610,3708193,3708193
Malawi,1962,MW,MWI,AFR,344561,446383,790944,367305,256909,180013,114881,70243,50288,1039639,352176,474402,826578,395371,277098,198477,129452,81033,60562,1141993,2181632,3799155,3799155
Malawi,1963,MW,MWI,AFR,356319,455296,811615,374817,263796,182582,121389,70855,51081,1064520,364033,482236,846269,404042,284813,202088,136680,81860,61738,1171221,2235741,3893628,3893628
Malawi,1964,MW,MWI,AFR,367718,467187,834905,380594,270703,185669,127525,71605,51984,1088080,375586,492188,867774,411759,292553,205969,143461,82858,62997,1199597,2287677,3990361,3990361
Malawi,1965,MW,MWI,AFR,378566,481621,860187,385060,277665,189481,132890,72686,53025,1110807,386601,505457,892058,417351,300347,210266,149459,84280,64345,1226048,2336855,4089097,4089097
Malawi,1966,MW,MWI,AFR,389275,498304,887579,388341,284745,194096,137524,74002,54215,1132923,397461,522567,920028,420120,308366,215101,154729,86067,65845,1250228,2383151,4190764,4190764
Malawi,1967,MW,MWI,AFR,400010,515692,915702,391888,292013,199565,141498,75474,55588,1156026,408391,540394,948785,423120,316703,220518,159249,88132,67537,1275259,2431285,4295762,4295762
Malawi,1968,MW,MWI,AFR,410811,533659,944470,395608,299541,205587,144932,77328,57030,1180026,419408,558818,978226,426225,325264,226265,163111,90614,69228,1300707,2480733,4403430,4403430
Malawi,1969,MW,MWI,AFR,421687,552114,973801,399148,307438,211665,147997,79917,58314,1204479,430470,577735,1008205,429057,334063,232114,166613,93816,70714,1326377,2530856,4512861,4512861
Malawi,2031,MW,MWI,AFR,1784544,3149710,4934254,2729818,2004149,1247919,870114,419456,245112,7516568,1770751,3127770,4898521,2753802,2098518,1440953,1034066,470429,397490,8195258,15711826,25544608,25544608
Malawi,2032,MW,MWI,AFR,1804733,3203342,5008075,2760666,2088726,1296384,889970,450532,252441,7738719,1790855,3181120,4971975,2778953,2180671,1478412,1081970,498464,411166,8429636,16168355,26148406,26148406
Malawi,2033,MW,MWI,AFR,1823230,3256764,5079994,2791420,2170807,1348717,908848,483377,260981,7964150,1809382,3234391,5043773,2804282,2260123,1520528,1125290,532013,425354,8667590,16631740,26755508,26755508
Malawi,2034,MW,MWI,AFR,1839237,3309441,5148678,2823452,2249427,1403951,928355,517300,270863,8193348,1825483,3287044,5112527,2831287,2335810,1566953,1164327,571333,439929,8909639,17102987,27364192,27364192
Malawi,2035,MW,MWI,AFR,1853191,3361215,5214406,2857009,2325022,1462515,947706,551886,282231,8426369,1839493,3338999,5178492,2860420,2408017,1618359,1197539,616604,454922,9155861,17582230,27975136,27975136
Malawi,2036,MW,MWI,AFR,1866928,3411027,5277955,2892019,2396727,1524006,968526,586160,295354,8662792,1853289,3389168,5242457,2891505,2475944,1674425,1226440,666921,470634,9405869,18068661,28589069,28589069
Malawi,2037,MW,MWI,AFR,1881054,3458391,5339445,2929390,2462345,1589408,992262,618925,310470,8902800,1867491,3437058,5304549,2925344,2537540,1735907,1252950,720619,487490,9659850,18562650,29206646,29206646
Malawi,2038,MW,MWI,AFR,1894557,3502585,5397142,2970124,2520867,1659528,1019426,649286,327764,9146995,1881008,3481841,5362849,2963228,2591640,1803322,1278498,775838,506026,9918552,19065547,29825538,29825538
Malawi,2039,MW,MWI,AFR,1906972,3543385,5450357,3014010,2571720,1734797,1050352,676501,347331,9394711,1893434,3523088,5416522,3005274,2637636,1876712,1304458,830566,526888,10181534,19576245,30443121,30443121
Malawi,2040,MW,MWI,AFR,1918003,3581812,5499815,3061404,2614046,1814227,1085844,700509,369258,9645288,1904576,3561832,5466408,3051723,2674740,1954783,1332659,883294,550834,10448033,20093321,31059544,31059544
Malawi,2041,MW,MWI,AFR,1927356,3617746,5545102,3112977,2648916,1896110,1126237,721290,393623,9899153,1914101,3598099,5512200,3102935,2704112,2035721,1364460,932458,578667,10718353,20617506,31674805,31674805
Malawi,2042,MW,MWI,AFR,1935296,3652091,5587387,3166489,2680099,1978158,1171846,738805,420282,10155679,1922210,3632822,5555032,3156422,2729803,2116924,1401335,976336,611055,10991875,21147554,32289974,32289974
Malawi,2043,MW,MWI,AFR,1942557,3684146,5626703,3219781,2711200,2057860,1221049,755701,448817,10414408,1929638,3665282,5594920,3209822,2755679,2195523,1442696,1016184,648258,11268162,21682570,32904194,32904194
Malawi,2044,MW,MWI,AFR,1949456,3712670,5662126,3272322,2743548,2134262,1272998,773344,478797,10675271,1936713,3694248,5630961,3262606,2783198,2270458,1488215,1052298,690327,11547102,22222373,33515465,33515465
Malawi,2045,MW,MWI,AFR,1957132,3737793,5694925,3323968,2777387,2207786,1328030,791053,510002,10938226,1944496,3719845,5664341,3314696,2812813,2341995,1538492,1083285,737386,11828667,22766893,34126156,34126156
Malawi,2046,MW,MWI,AFR,1965325,3761037,5726362,3373665,2812643,2277603,1385816,810165,541833,11201725,1952694,3743604,5696298,3364993,2844343,2409358,1593230,1110535,788832,12111291,23313016,34735673,34735673
Malawi,2047,MW,MWI,AFR,1973608,3783249,5756857,3420931,2850194,2341635,1447284,831862,573557,11465463,1960938,3766339,5727277,3413016,2878578,2470546,1653182,1135783,843572,12394677,23860140,35344273,35344273
Malawi,2048,MW,MWI,AFR,1982517,3804165,5786682,3465047,2891015,2398940,1513178,856529,604645,11729354,1969858,3787701,5757559,3457952,2916797,2524433,1718842,1160293,900421,12678738,24408092,35952327,35952327
Malawi,2049,MW,MWI,AFR,1991959,3823671,5815630,3505797,2934907,2448990,1583879,884383,634600,11992556,1979295,3807623,5786918,3499361,2959111,2570421,1790252,1185266,958159,12962570,24955126,36557676,36557676
Malawi,2050,MW,MWI,AFR,2000216,3842585,5842801,3544198,2982203,2490957,1658503,916123,663480,12255464,1987556,3826957,5814513,3538275,3005765,2607742,1866191,1212382,1016169,13246524,25501988,37159300,37159300
Malaysia,1970,MY,MYS,WPR,823508,1527353,2350861,1041058,661444,461514,345018,244948,136593,2890575,785051,1464343,2249394,1014124,649676,465930,339206,219405,127333,2815674,5706249,10306508,10306508
Malaysia,1971,MY,MYS,WPR,828601,1551474,2380075,1094724,672271,474397,350732,249481,143686,2985291,789664,1486597,2276261,1063395,660747,479495,347410,225916,133970,2910933,5896224,10552557,10552557
Malaysia,1972,MY,MYS,WPR,837211,1569575,2406786,1148215,683067,489988,357305,253529,151938,3084042,797645,1503095,2300740,1111932,673202,495325,355270,231869,142451,3010049,6094091,10801619,10801619
Malaysia,1973,MY,MYS,WPR,850247,1583754,2434001,1200984,697143,507450,364593,257366,160855,3188391,809800,1515869,2325669,1160076,689181,512451,363103,237738,152056,3114605,6302996,11062664,11062664
Malaysia,1974,MY,MYS,WPR,866030,1596334,2462364,1252968,716951,524505,372033,261315,169688,3297460,824480,1527169,2351649,1207954,710285,528507,371254,244117,161594,3223711,6521171,11335187,11335187
Malaysia,1975,MY,MYS,WPR,882388,1608032,2490420,1300836,747186,540498,379739,265560,178179,3411998,839631,1537646,2377277,1252998,740089,543127,380135,251259,170637,3338245,6750243,11617947,11617947
Malaysia,1976,MY,MYS,WPR,899307,1619173,2518480,1344082,786674,556695,387580,269956,186360,3531347,855206,1547543,2402749,1294766,777615,557201,389519,259283,179121,3457505,6988852,11910081,11910081
Malaysia,1977,MY,MYS,WPR,917239,1630402,2547641,1387285,832009,574476,395412,274530,193958,3657670,871654,1557637,2429291,1336575,820640,572194,399419,268249,187246,3584323,7241993,12218924,12218924
Malaysia,1978,MY,MYS,WPR,934557,1644284,2578841,1429386,882898,592811,403939,279567,201118,3789719,887520,1570333,2457853,1377358,868850,587767,410264,277787,195452,3717478,7507197,12543892,12543892
Malaysia,1979,MY,MYS,WPR,951425,1661714,2613139,1467291,937461,609232,414207,285210,208484,3921885,902962,1586396,2489358,1413847,920623,602104,422490,287302,204261,3850627,7772512,12875011,12875011
Malaysia,1980,MY,MYS,WPR,970511,1682139,2652650,1500047,994937,624467,426569,291496,216221,4053737,920504,1605277,2525781,1445195,975053,616517,436131,296596,214048,3983540,8037277,13215707,13215707
Malaysia,1981,MY,MYS,WPR,992494,1706103,2698597,1526388,1053567,639141,441255,298541,224441,4183333,940799,1627411,2568210,1470191,1030312,631703,451597,305795,224863,4114461,8297794,13564594,13564594
Malaysia,1982,MY,MYS,WPR,1017118,1734325,2751443,1545899,1111624,654030,458697,306517,233205,4309972,963606,1653488,2617094,1488484,1084499,648520,469401,314899,236710,4242513,8552485,13921029,13921029
Malaysia,1983,MY,MYS,WPR,1043970,1766159,2810129,1561994,1169174,672221,477948,315114,242172,4438623,988533,1682936,2671469,1503537,1138488,668875,488482,324040,249210,4372632,8811255,14292862,14292862
Malaysia,1984,MY,MYS,WPR,1072451,1800569,2873020,1577960,1227376,696690,497061,323901,251075,4574063,1015024,1714762,2729786,1518685,1193628,694936,506794,333595,261944,4509582,9083645,14686454,14686454
Malaysia,1985,MY,MYS,WPR,1100662,1838188,2938850,1595542,1284068,732408,515585,333115,260115,4720833,1041306,1749560,2790866,1535669,1248429,730559,524111,343995,274824,4657587,9378420,15108135,15108135
Malaysia,1986,MY,MYS,WPR,1126981,1879876,3006857,1615223,1339401,778708,534897,342653,269092,4879974,1065802,1788133,2853935,1554950,1303242,775287,541478,355093,287928,4817978,9697952,15558740,15558740
Malaysia,1987,MY,MYS,WPR,1150322,1925636,3075958,1636688,1396512,831091,555725,352102,277765,5049883,1087358,1830505,2917863,1576272,1359910,825718,559764,366599,301142,4989405,10039288,16033103,16033103
Malaysia,1988,MY,MYS,WPR,1170432,1973125,3143557,1661352,1453836,889072,577063,362107,286526,5229956,1105657,1874527,2980184,1600797,1416831,881361,578565,378872,314499,5170925,10400881,16524616,16524616
Malaysia,1989,MY,MYS,WPR,1186612,2021768,3208380,1688437,1508108,951628,597043,373857,295847,5414920,1119989,1919648,3039637,1627503,1470747,941562,596640,392557,328194,5357203,10772123,17020143,17020143
Malaysia,1990,MY,MYS,WPR,1201688,2071957,3273645,1716459,1557024,1017350,616101,387564,305920,5600418,1132983,1966241,3099224,1654796,1519385,1004793,614991,407570,342228,5543763,11144181,17517054,17517054
Malaysia,1991,MY,MYS,WPR,1220057,2122655,3342712,1745443,1598788,1084664,634959,403517,316864,5784235,1148856,2013283,3162139,1682533,1561003,1069436,634409,424351,356653,5728385,11512620,18017464,18017464
Malaysia,1992,MY,MYS,WPR,1243001,2172739,3415740,1777183,1633520,1152365,654590,422164,328736,5968558,1169010,2059639,3228649,1712585,1595856,1134165,655996,443516,371646,5913764,11882322,18526708,18526708
Malaysia,1993,MY,MYS,WPR,1270050,2221590,3491640,1812166,1664082,1219706,677532,442441,341305,6157232,1193111,2104657,3297768,1745550,1626700,1198934,681186,463901,387161,6103432,12260664,19050077,19050077
Malaysia,1994,MY,MYS,WPR,1300921,2268072,3568993,1849764,1692972,1287004,706129,462362,354143,6352374,1221028,2147213,3368241,1780830,1655962,1264134,711605,483414,403153,6299098,12651472,19588703,19588703
Malaysia,1995,MY,MYS,WPR,1332526,2312951,3645477,1890019,1720142,1350532,744306,481140,367076,6553215,1249912,2187981,3437893,1818438,1683523,1326675,750304,501599,419769,6500308,13053523,20136888,20136888
Malaysia,1996,MY,MYS,WPR,1359848,2358957,3718805,1933567,1745504,1409601,791045,499815,379639,6759171,1274960,2229554,3504514,1858974,1709199,1386058,796462,519253,436615,6706561,13465732,20689051,20689051
Malaysia,1997,MY,MYS,WPR,1381166,2406412,3787578,1981850,1770821,1468140,842387,519113,391219,6973530,1294454,2272326,3566780,1904034,1734839,1444978,847065,537239,453131,6921286,13894816,21249178,21249178
Malaysia,1998,MY,MYS,WPR,1394724,2454505,3849229,2032463,1798474,1525340,898126,538295,402673,7195371,1306659,2315582,3622241,1951419,1762720,1502604,901921,555327,469707,7143698,14339069,21810542,21810542
Malaysia,1999,MY,MYS,WPR,1400432,2502399,3902831,2084568,1829191,1579599,958038,556189,415817,7423402,1311443,2358595,3670038,2000273,1793446,1557313,961115,572733,487507,7372387,14795789,22368655,22368655
Malaysia,2000,MY,MYS,WPR,1396984,2569465,3966449,2154901,1858131,1623257,1021092,574569,432956,7664906,1308196,2418904,3727100,2055777,1816866,1596628,1019915,589714,507795,7586695,15251601,22945150,22945150
Malaysia,2001,MY,MYS,WPR,1387618,2649246,4036864,2246685,1887273,1655608,1084945,595372,454516,7924399,1299993,2491550,3791543,2121835,1833757,1619899,1075590,607805,530826,7789712,15714111,23542517,23542517
Malaysia,2002,MY,MYS,WPR,1378963,2715111,4094074,2345709,1923264,1683389,1147137,619369,479382,8198250,1292464,2552899,3845363,2197110,1854741,1638680,1128927,629337,555963,8004758,16203008,24142445,24142445
Malaysia,2003,MY,MYS,WPR,1371486,2765264,4136750,2448485,1966400,1709041,1206466,648050,505941,8484383,1286395,2600348,3886743,2279643,1879960,1655416,1179575,655077,581870,8231541,16715924,24739411,24739411
Malaysia,2004,MY,MYS,WPR,1364531,2801331,4165862,2552145,2017805,1734669,1262615,682493,532100,8781827,1281309,2634723,3916032,2367271,1910083,1672333,1227274,685705,606858,8469524,17251351,25333247,25333247
Malaysia,2005,MY,MYS,WPR,1358642,2824618,4183260,2651814,2080118,1760512,1314224,724011,557852,9088531,1277768,2656709,3934477,2455764,1947549,1690325,1270499,722188,630931,8717256,17805787,25923536,25923536
Malaysia,2006,MY,MYS,WPR,1352798,2837324,4190122,2742870,2156094,1787066,1361611,770805,584425,9402871,1274936,2667929,3942865,2541277,1995088,1709996,1309296,762965,654939,8973561,18376432,26509413,26509413
Malaysia,2007,MY,MYS,WPR,1345613,2843048,4188661,2822773,2247454,1815547,1406220,819604,612575,9724173,1271101,2671796,3942897,2621112,2054717,1731577,1344479,805522,679465,9236872,18961045,27092604,27092604
Malaysia,2008,MY,MYS,WPR,1336148,2839691,4175839,2890248,2353649,1847104,1447791,869166,642925,10050883,1264345,2667677,3932022,2692522,2127340,1755530,1376114,848878,705173,9505557,19556440,27664296,27664296
Malaysia,2009,MY,MYS,WPR,1321121,2827970,4149091,2945461,2472681,1882472,1486739,918315,675908,10381576,1250634,2657844,3908478,2753277,2213249,1781453,1405201,891970,732897,9778047,20159623,28217204,28217204
Malaysia,2010,MY,MYS,WPR,1302414,2811719,4114133,2974691,2584079,1921881,1526940,964673,705910,10678174,1231335,2645312,3876647,2791402,2305999,1811796,1441449,935941,762181,10048768,20726942,28717731,28717731
Malaysia,2011,MY,MYS,WPR,1288977,2796297,4085274,2979504,2679186,1965636,1568778,1009471,733273,10935848,1215578,2633218,3848796,2807361,2399350,1846502,1485250,982042,793709,10314214,21250062,29184133,29184133
Malaysia,2012,MY,MYS,WPR,1284086,2782757,4066843,2976851,2768628,2014224,1609085,1055309,764056,11188153,1207715,2622097,3829812,2813574,2492827,1883386,1527512,1029400,828705,10575404,21763557,29660212,29660212
Malaysia,2013,MY,MYS,WPR,1288652,2763648,4052300,2969485,2851697,2068019,1647867,1101218,797926,11436212,1209468,2605190,3814658,2812151,2584307,1923617,1567805,1077205,866553,10831638,22267850,30134807,30134807
Malaysia,2014,MY,MYS,WPR,1304890,2735093,4039983,2960104,2926238,2128210,1685024,1146426,834774,11680776,1223509,2579034,3802543,2805767,2670528,1968360,1606703,1124347,907441,11083146,22763922,30606459,30606459
Malaysia,2015,MY,MYS,WPR,1326613,2702589,4029202,2949911,2987559,2196398,1719889,1190882,874064,11918703,1243545,2549352,3792897,2795884,2746121,2019417,1644640,1170310,951658,11328030,23246733,31068833,31068833
Malaysia,2016,MY,MYS,WPR,1342906,2675665,4018571,2941123,3034076,2274536,1753274,1234600,915682,12153291,1258730,2525051,3783781,2785362,2809594,2079144,1682125,1215070,999486,11570781,23724072,31526418,31526418
Malaysia,2017,MY,MYS,WPR,1351376,2656973,4008349,2931367,3066534,2361567,1786493,1277014,959892,12382867,1266764,2507994,3774758,2772933,2860892,2147605,1718923,1258497,1050983,11809833,24192700,31975806,31975806
Malaysia,2018,MY,MYS,WPR,1353355,2646407,3999762,2912950,3086398,2454326,1819514,1317938,1006429,12597555,1268821,2497559,3766380,2753066,2898902,2223105,1754225,1300616,1105652,12035566,24633121,32399271,32399271
Malaysia,2019,MY,MYS,WPR,1347181,2644056,3991237,2887426,3098563,2550397,1853381,1357930,1055094,12802791,1263308,2493644,3756952,2729076,2926059,2304926,1788076,1342146,1162759,12253042,25055833,32804020,32804020
Malaysia,2020,MY,MYS,WPR,1336480,2645553,3982033,2862984,3103442,2644946,1890020,1396974,1105779,13004145,1253664,2492297,3745961,2707784,2942860,2390712,1820558,1383834,1222115,12467863,25472008,33199993,33199993
Malaysia,2021,MY,MYS,WPR,1326898,2646886,3973784,2843038,3098261,2733350,1930271,1433769,1154060,13192749,1245165,2490147,3735312,2690247,2947588,2477108,1852336,1424545,1280213,12672037,25864786,33573874,33573874
Malaysia,2022,MY,MYS,WPR,1319235,2648616,3967851,2824959,3084779,2815003,1974884,1469472,1204885,13373982,1238473,2488444,3726917,2673841,2941841,2562749,1885812,1463894,1341335,12869472,26243454,33938221,33938221
Malaysia,2023,MY,MYS,WPR,1313190,2653814,3967004,2802290,3067670,2890635,2025065,1505214,1262382,13553256,1233297,2490916,3724213,2652879,2929758,2646988,1923038,1502319,1409070,13064052,26617308,34308525,34308525
Malaysia,2024,MY,MYS,WPR,1309262,2662858,3972120,2771035,3050077,2958748,2081900,1539781,1321282,13722823,1230114,2498439,3728553,2623625,2914346,2726955,1965156,1539670,1478653,13248405,26971228,34671895,34671895
Malaysia,2025,MY,MYS,WPR,1305769,2673072,3978841,2736623,3033425,3015054,2147127,1572757,1381945,13886931,1227263,2508029,3735292,2591716,2897305,2797646,2014082,1576380,1549829,13426958,27313889,35028030,35028030
Malaysia,2026,MY,MYS,WPR,1301076,2679051,3980127,2708140,3018036,3056096,2221656,1604504,1444253,14052685,1223191,2513984,3737175,2565603,2879475,2855620,2071247,1612559,1622456,13606960,27659645,35376942,35376942
Malaysia,2027,MY,MYS,WPR,1295540,2679142,3974682,2688190,3002063,3082978,2304530,1636116,1507267,14221144,1218300,2514605,3732905,2547102,2860155,2901231,2136845,1647965,1696131,13789429,28010573,35718158,35718158
Malaysia,2028,MY,MYS,WPR,1289167,2674704,3963871,2677035,2980570,3100014,2393997,1668101,1570703,14390420,1212598,2511115,3723713,2535970,2836773,2936286,2210501,1682365,1770760,13972655,28363075,36050662,36050662
Malaysia,2029,MY,MYS,WPR,1281969,2664450,3946419,2674406,2953461,3110643,2487028,1701151,1634839,14561528,1206024,2502264,3708288,2531717,2810890,2961791,2290895,1715619,1846686,14157598,28719126,36373834,36373834
Malaysia,2030,MY,MYS,WPR,1273988,2650134,3924122,2675718,2927671,3114138,2578403,1736867,1699849,14732646,1198667,2489630,3688297,2530140,2788012,2977095,2375166,1747626,1924473,14342512,29075158,36687569,36687569
Malaysia,1950,MY,MYS,WPR,489936,740127,1230063,540389,422851,356534,234188,142164,153817,1849943,482389,723008,1205397,537919,406097,297093,179242,127926,139196,1687473,3537416,5972876,5972876
Malaysia,1951,MY,MYS,WPR,523731,753467,1277198,556527,429459,360345,242408,140053,144126,1872918,511785,736613,1248398,555429,416453,304688,185757,126257,131637,1720221,3593139,6118736,6118736
Malaysia,1952,MY,MYS,WPR,556007,766932,1322939,575093,436626,362925,251208,139553,136450,1901855,539376,751829,1291205,574786,425897,310993,193740,125614,126198,1757228,3659083,6273219,6273219
Malaysia,1953,MY,MYS,WPR,586381,783200,1369581,594686,443879,364709,260163,140466,130160,1934063,565537,770006,1335543,594323,434363,316584,202665,125865,122043,1795843,3729906,6435027,6435027
Malaysia,1954,MY,MYS,WPR,616001,804969,1420970,613206,450853,366443,268705,142574,124500,1966281,591607,792900,1384507,611886,442517,322543,211806,126602,118282,1833636,3799917,6605394,6605394
Malaysia,1955,MY,MYS,WPR,641552,836771,1478323,630066,457877,368533,276661,145667,119267,1998071,615015,823856,1438871,627277,451056,329367,220759,127734,114619,1870812,3868883,6786077,6786077
Malaysia,1956,MY,MYS,WPR,663389,877383,1540772,646645,464816,370762,283997,149676,114429,2030325,636064,861875,1497939,641477,459752,337165,229588,128965,111036,1907983,3938308,6977024,6977024
Malaysia,1957,MY,MYS,WPR,685875,921953,1607828,663861,471301,373214,290638,154422,109904,2063340,657623,903365,1560988,655523,468393,345874,238374,130317,107462,1945943,4009283,7178108,7178108
Malaysia,1958,MY,MYS,WPR,708093,970221,1678314,680351,477711,376012,296496,159780,106005,2096355,678843,948000,1626843,668778,477122,354814,246805,132318,104333,1984170,4080525,7385689,7385689
Malaysia,1959,MY,MYS,WPR,729193,1022078,1751271,695049,486213,379603,301686,165908,103443,2131902,698953,996006,1694959,680962,487516,363679,254712,135556,102387,2024812,4156714,7602942,7602942
Malaysia,1960,MY,MYS,WPR,749097,1076613,1825710,709204,497822,384316,306432,172761,102336,2172871,717821,1046323,1764144,693999,500287,372478,262244,140277,101767,2071052,4243923,7833782,7833782
Malaysia,1961,MY,MYS,WPR,767354,1132565,1899919,723224,512469,390102,310614,180363,102589,2219361,734995,1097594,1832589,708294,515511,381138,269150,146449,102397,2122939,4342300,8074805,8074805
Malaysia,1962,MY,MYS,WPR,783551,1188305,1971856,737754,530463,397086,314173,188802,104287,2272565,750138,1148058,1898196,724542,533612,389616,275310,154151,104362,2181593,4454158,8324218,8324218
Malaysia,1963,MY,MYS,WPR,797809,1242455,2040264,755092,550320,404837,317414,197660,107065,2332388,763342,1197195,1960537,743829,552996,398011,281268,162869,107180,2246153,4578541,8579350,8579350
Malaysia,1964,MY,MYS,WPR,809577,1295083,2104660,777566,569479,412658,320735,206246,110325,2397009,774143,1245292,2019435,767549,571008,406614,287786,171797,110062,2314816,4711825,8835925,8835925
Malaysia,1965,MY,MYS,WPR,817893,1342557,2160450,809462,586924,420524,324335,214318,113874,2469437,781620,1289525,2071145,798761,586935,415744,295157,180529,112861,2389987,4859424,9091016,9091016
Malaysia,1966,MY,MYS,WPR,822418,1384564,2206982,849205,603533,428101,327916,221781,117660,2548196,785406,1329673,2115079,836120,601251,424957,303378,189009,115268,2469983,5018179,9340240,9340240
Malaysia,1967,MY,MYS,WPR,823080,1424941,2248021,892197,620143,435003,331506,228503,121502,2628854,785563,1368085,2153648,876219,614833,433946,312299,197192,117074,2551563,5180417,9582086,9582086
Malaysia,1968,MY,MYS,WPR,821794,1463071,2284865,938655,636039,442092,335470,234521,125598,2712375,783958,1404169,2188127,919269,627686,443333,321546,205012,119086,2635932,5348307,9821308,9821308
Malaysia,1969,MY,MYS,WPR,821404,1497593,2318997,988479,649488,450772,339937,239948,130564,2799188,783297,1436611,2219908,965491,638784,453952,330591,212385,122387,2723590,5522778,10061684,10061684
Malaysia,2031,MY,MYS,WPR,1265610,2635941,3901551,2677093,2907456,3108706,2664220,1776462,1765732,14899669,1190944,2477117,3668061,2527991,2770126,2981439,2460525,1779428,2003994,14523503,29423172,36992784,36992784
Malaysia,2032,MY,MYS,WPR,1256653,2622922,3879575,2678984,2889847,3095928,2744046,1820363,1832193,15061361,1182653,2465689,3648342,2526406,2754105,2976112,2545469,1813079,2084223,14699394,29760755,37288666,37288666
Malaysia,2033,MY,MYS,WPR,1246742,2610588,3857330,2684291,2867562,3079591,2818167,1869275,1898888,15217774,1173429,2454882,3628311,2528932,2733301,2964344,2628887,1850147,2164516,14870127,30087901,37573537,37573537
Malaysia,2034,MY,MYS,WPR,1235980,2599540,3835520,2693408,2836754,3062823,2885056,1924456,1965558,15368055,1163410,2445191,3608601,2536494,2704232,2949282,2708101,1891979,2244890,15034978,30403033,37847164,37847164
Malaysia,2035,MY,MYS,WPR,1224704,2588144,3812848,2703676,2802821,3047003,2940578,1987522,2032188,15513788,1152908,2435043,3587951,2546115,2672520,2932612,2778183,1940446,2325529,15195405,30709193,38109999,38109999
Malaysia,2036,MY,MYS,WPR,1212879,2575148,3788027,2709725,2774793,3032419,2981401,2059319,2098973,15656630,1141839,2423306,3565145,2552101,2646592,2915152,2835749,1996934,2406439,15352967,31009597,38362771,38362771
Malaysia,2037,MY,MYS,WPR,1200968,2560731,3761699,2709909,2755248,3017246,3008611,2138929,2166120,15796063,1130655,2410181,3540836,2552764,2628257,2896214,2881158,2061597,2487104,15507094,31303157,38605692,38605692
Malaysia,2038,MY,MYS,WPR,1189967,2544521,3734488,2705585,2744440,2996622,3026415,2224678,2233893,15931633,1120313,2395309,3515622,2549323,2617267,2873237,2916201,2134032,2567192,15657252,31588885,38838995,38838995
Malaysia,2039,MY,MYS,WPR,1180314,2526632,3706946,2695472,2742113,2970471,3038129,2313742,2303213,16063140,1111232,2378773,3490005,2540529,2613141,2847772,2941865,2212948,2646999,15803254,31866394,39063349,39063349
Malaysia,2040,MY,MYS,WPR,1172096,2507451,3679547,2681308,2743706,2945621,3042961,2401257,2375633,16190486,1103475,2360972,3464447,2527956,2611684,2825290,2957480,2295565,2727011,15944986,32135472,39279459,39279459
Malaysia,2041,MY,MYS,WPR,1165223,2487320,3652543,2667271,2745353,2926238,3039073,2483585,2452204,16313724,1096960,2342233,3439193,2515505,2609658,2807754,2962285,2379175,2808089,16082466,32396190,39487920,39487920
Malaysia,2042,MY,MYS,WPR,1159276,2466522,3625798,2654398,2747499,2909388,3028040,2560345,2533102,16432772,1091322,2322810,3414132,2504136,2608183,2792055,2957546,2462340,2891258,16215518,32648290,39688220,39688220
Malaysia,2043,MY,MYS,WPR,1154252,2445677,3599929,2642207,2753030,2887897,3013580,2631830,2618638,16547182,1086581,2303291,3389872,2493383,2610802,2771596,2946470,2544008,2977379,16343638,32890820,39880624,39880624
Malaysia,2044,MY,MYS,WPR,1150457,2425334,3575791,2631288,2762326,2857975,2998765,2696660,2709717,16656731,1082993,2284244,3367237,2483744,2618427,2742903,2932174,2621603,3067787,16466638,33123369,40066400,40066400
Malaysia,2045,MY,MYS,WPR,1147059,2405908,3552967,2620017,2772757,2824970,2984887,2751010,2807817,16761458,1079797,2266030,3345827,2473647,2628102,2711573,2916299,2690390,3164509,16584520,33345978,40244776,40244776
Malaysia,2046,MY,MYS,WPR,1143835,2387278,3531113,2607154,2778999,2797823,2972175,2791790,2913915,16861856,1076803,2248493,3325296,2461959,2634149,2686002,2899634,2747127,3268841,16697712,33559568,40415981,40415981
Malaysia,2047,MY,MYS,WPR,1141161,2369481,3510642,2592866,2779418,2779084,2958833,2820026,3027312,16957539,1074324,2231714,3306038,2448888,2634892,2667993,2881495,2792178,3380529,16805975,33763514,40580199,40580199
Malaysia,2048,MY,MYS,WPR,1138939,2353517,3492456,2576793,2775355,2768980,2940163,2839702,3146807,17047800,1072247,2216673,3288920,2434069,2631539,2657282,2859359,2827287,3498868,16908404,33956204,40737582,40737582
Malaysia,2049,MY,MYS,WPR,1136635,2340125,3476760,2559044,2765535,2767264,2916133,2853922,3270720,17132618,1070090,2204044,3274134,2417588,2622853,2653407,2834767,2853415,3622961,17004991,34137609,40888501,40888501
Malaysia,2050,MY,MYS,WPR,1134478,2328561,3463039,2539998,2751694,2769430,2893358,2861733,3396003,17212216,1068066,2193120,3261186,2399841,2610397,2652188,2813119,2869844,3750605,17095994,34308210,41032433,41032433
Namibia,1970,NA,NAM,AFR,67175,96860,164035,71121,46603,29740,22982,16098,13547,200091,67764,99841,167605,73866,48397,34748,27625,20371,17718,222725,422816,754467,754467
Namibia,1971,NA,NAM,AFR,69605,100129,169734,72822,48974,30256,23376,16340,13804,205572,70184,103023,173207,75984,50401,35196,28008,20760,18135,228484,434056,776995,776995
Namibia,1972,NA,NAM,AFR,72142,103633,175775,74557,51339,30866,23805,16604,14049,211220,72720,106457,179177,78128,52461,35671,28443,21193,18540,234436,445656,800610,800610
Namibia,1973,NA,NAM,AFR,74769,107385,182154,76404,53495,31596,24221,16878,14294,216888,75348,110140,185488,80254,54476,36198,28890,21635,18941,240394,457282,824918,824918
Namibia,1974,NA,NAM,AFR,77467,111374,188841,78368,55473,32527,24574,17159,14537,222638,78050,114080,192130,82254,56603,36873,29322,22057,19370,246479,469117,850091,850091
Namibia,1975,NA,NAM,AFR,80210,115587,195797,80449,57470,33712,24874,17452,14785,228742,80801,118252,199053,84245,58927,37778,29737,22451,19846,252984,481726,876572,876572
Namibia,1976,NA,NAM,AFR,82850,119940,202790,82329,59073,34947,25060,17717,15038,234164,83447,122576,206023,86025,60900,38724,30081,22784,20345,258859,493023,901840,901840
Namibia,1977,NA,NAM,AFR,85247,124441,209688,84184,60311,36247,25175,17949,15291,239157,85853,127060,212913,87762,62538,39732,30380,23055,20880,264347,503504,926109,926109
Namibia,1978,NA,NAM,AFR,87090,128880,215970,84992,59998,37014,24980,18044,15538,240566,87704,131488,219192,88358,62634,40249,30419,23198,21442,266300,506866,942023,942023
Namibia,1979,NA,NAM,AFR,88322,133474,221796,86147,59450,37829,24764,18133,15775,242098,88952,136082,225034,89310,62494,40825,30408,23350,22021,268408,510506,957334,957334
Namibia,1980,NA,NAM,AFR,89140,138265,227405,88193,59260,38921,24690,18252,15984,245300,89788,140887,230675,91349,62844,41742,30488,23574,22614,272611,517911,975994,975994
Namibia,1981,NA,NAM,AFR,89428,142881,232309,89480,57733,39376,24387,18241,16159,245376,90102,145516,235618,92673,61962,42159,30337,23742,23222,274095,519471,987394,987394
Namibia,1982,NA,NAM,AFR,89464,147559,237023,92344,57345,40275,24363,18346,16318,248991,90153,150223,240376,95649,62197,43037,30374,24024,23845,279126,528117,1005520,1005520
Namibia,1983,NA,NAM,AFR,89694,152233,241927,96983,58657,41701,24769,18581,16483,257174,90373,154933,245306,100498,64025,44545,30726,24427,24460,288681,545855,1033085,1033085
Namibia,1984,NA,NAM,AFR,90499,156406,246905,101884,60300,43004,25362,18771,16668,265989,91163,159129,250292,105603,65955,46186,31212,24805,25047,298808,564797,1061995,1061995
Namibia,1985,NA,NAM,AFR,91913,160151,252064,107114,62378,44366,26190,18923,16867,275838,92550,162884,255434,111029,68211,48049,31907,25156,25620,309972,585810,1093311,1093311
Namibia,1986,NA,NAM,AFR,93889,163618,257507,112714,65103,45860,27277,19073,17077,287104,94483,166344,260827,116840,71137,50059,32828,25510,26179,322553,609657,1127989,1127989
Namibia,1987,NA,NAM,AFR,96725,166560,263285,118486,68420,47403,28584,19235,17297,299425,97287,169253,266540,122819,74681,52134,33961,25874,26713,336182,635607,1165430,1165430
Namibia,1988,NA,NAM,AFR,100313,169279,269592,124710,72710,49177,30181,19450,17529,313757,100852,171910,272762,129266,79243,54449,35367,26274,27234,351833,665590,1207949,1207949
Namibia,1989,NA,NAM,AFR,105425,172961,278386,136166,83269,53831,33184,20259,17843,344552,105941,175539,281480,141202,90069,59444,38017,27106,27819,383657,728209,1288070,1288070
Namibia,1990,NA,NAM,AFR,111755,176672,288427,146506,94035,58498,36284,21126,18225,374674,112260,179165,291425,151810,101062,64444,40781,27930,28467,414494,789168,1369011,1369011
Namibia,1991,NA,NAM,AFR,117872,179703,297575,150513,99292,60451,38216,21506,18612,388590,118412,182081,300493,155577,106462,66895,42583,28312,29124,428953,817543,1415617,1415617
Namibia,1992,NA,NAM,AFR,123457,183509,306966,154094,104348,62366,40070,21996,19012,401886,124090,185913,310003,158860,111613,69336,44407,28806,29809,442831,844717,1461687,1461687
Namibia,1993,NA,NAM,AFR,128202,188535,316737,157797,109308,64450,41776,22731,19419,415481,128992,191264,320256,162230,116650,71965,46352,29633,30530,457360,872841,1509834,1509834
Namibia,1994,NA,NAM,AFR,131738,194835,326573,161374,114160,66730,43327,23672,19813,429076,132693,198087,330780,165474,121519,74627,48466,30701,31234,472021,901097,1558449,1558449
Namibia,1995,NA,NAM,AFR,133090,202711,335801,164768,118838,69126,44788,24711,20177,442408,134146,206545,340691,168600,126144,77304,50661,31854,31901,486464,928872,1605370,1605370
Namibia,1996,NA,NAM,AFR,132464,211685,344149,168152,123232,71659,46120,25830,20524,455517,133543,216164,349707,171788,130398,80120,52765,33069,32549,500689,956206,1650066,1650066
Namibia,1997,NA,NAM,AFR,131407,220833,352240,171329,127284,74350,47282,27001,20870,468116,132446,225995,358441,174846,134226,83112,54735,34339,33185,514443,982559,1693242,1693242
Namibia,1998,NA,NAM,AFR,130751,229624,360375,174539,131007,77195,48284,28212,21214,480451,131726,235459,367185,178018,137644,86278,56553,35645,33800,527938,1008389,1735953,1735953
Namibia,1999,NA,NAM,AFR,130739,237541,368280,178083,134461,80150,49133,29421,21577,492825,131637,244006,375643,181624,140716,89578,58223,36976,34415,541532,1034357,1778277,1778277
Namibia,2000,NA,NAM,AFR,131254,244245,375499,181900,137719,83182,49862,30581,21963,505207,132050,251243,383293,185613,143522,92949,59744,38270,35043,555141,1060348,1819141,1819141
Namibia,2001,NA,NAM,AFR,132045,249289,381334,185833,140923,86284,50491,31559,22372,517462,132678,256542,389220,189856,146202,96285,61056,39314,35671,568384,1085846,1856402,1856402
Namibia,2002,NA,NAM,AFR,132595,252654,385249,189727,143981,89456,51157,32335,22783,529439,133018,259796,392814,194165,148741,99519,62240,40080,36282,581027,1110466,1888525,1888525
Namibia,2003,NA,NAM,AFR,132275,254838,387113,193509,146418,92591,52097,33090,23222,540927,132593,261740,394333,198383,150737,102542,63527,40950,36913,593052,1133979,1915425,1915425
Namibia,2004,NA,NAM,AFR,131328,256122,387450,197746,148065,95594,53310,33935,23719,552369,131665,262810,394475,203035,152074,105356,64897,42156,37596,605114,1157483,1939406,1939406
Namibia,2005,NA,NAM,AFR,130611,255717,386328,203337,149360,98430,54680,34814,24268,564889,131003,262180,393183,209042,153199,107969,66332,43567,38361,618470,1183359,1962865,1962865
Namibia,2006,NA,NAM,AFR,130682,253643,384325,209871,150538,101066,56236,35709,24872,578292,131106,259875,390981,215973,154360,110368,67991,45055,39215,632962,1211254,1986558,1986558
Namibia,2007,NA,NAM,AFR,131768,251039,382807,216526,151515,103505,58019,36566,25527,591658,132184,257075,389259,222992,155486,112596,69937,46559,40194,647764,1239422,2011492,2011492
Namibia,2008,NA,NAM,AFR,133925,248435,382360,222861,152586,105795,60034,37369,26249,604894,134313,254329,388642,229632,156840,114686,72167,48041,41301,662667,1267561,2038552,2038552
Namibia,2009,NA,NAM,AFR,136969,246304,383273,228416,154053,107982,62251,38109,27026,617837,137316,252066,389382,235407,158708,116690,74640,49473,42517,677435,1295272,2067919,2067919
Namibia,2010,NA,NAM,AFR,140583,245139,385722,232912,155901,110122,64655,38820,27852,630262,140882,250760,391642,240041,160993,118595,77297,50860,43859,691645,1321907,2099271,2099271
Namibia,2011,NA,NAM,AFR,144581,245137,389718,236149,158123,112241,67225,39547,28723,642008,144849,250631,395480,243331,163682,120461,80105,52254,45304,705137,1347145,2132340,2132340
Namibia,2012,NA,NAM,AFR,148764,246041,394805,238415,160860,114342,69957,40381,29617,653572,149033,251440,400473,245616,166972,122401,83072,53722,46823,718606,1372178,2167470,2167470
Namibia,2013,NA,NAM,AFR,152718,247569,400287,240194,164237,116478,72836,41401,30508,665654,152996,252900,405896,247366,170940,124455,86160,55313,48438,732672,1398326,2204510,2204510
Namibia,2014,NA,NAM,AFR,156217,249718,405935,241441,168553,118526,75822,42604,31396,678342,156464,254999,411463,248528,175832,126438,89291,56954,50220,747263,1425605,2243001,2243001
Namibia,2015,NA,NAM,AFR,159228,252748,411976,241174,174376,120557,78846,43968,32342,691263,159420,258004,417424,248125,182230,128443,92390,58677,52171,762036,1453299,2282704,2282704
Namibia,2016,NA,NAM,AFR,161670,257009,418679,239364,181231,122676,81847,45517,33327,703962,161783,262225,424008,246150,189676,130648,95410,60603,54225,776712,1480674,2323352,2323352
Namibia,2017,NA,NAM,AFR,163428,262516,425944,237059,188206,124671,84770,47272,34337,716315,163438,267648,431086,243692,197229,132822,98308,62779,56351,791181,1507496,2364534,2364534
Namibia,2018,NA,NAM,AFR,164604,268820,433424,234719,194813,126697,87586,49242,35382,728439,164513,273843,438356,241236,204341,135113,101037,65192,58546,805465,1533904,2405680,2405680
Namibia,2019,NA,NAM,AFR,165349,275458,440807,232786,200587,128992,90330,51408,36473,740576,165171,280356,445527,239200,210519,137762,103643,67814,60803,819741,1560317,2446644,2446644
Namibia,2020,NA,NAM,AFR,165959,282429,448388,232082,205741,131613,92903,53520,37409,753268,165650,287105,452755,238413,215957,140884,106083,70377,62962,834676,1587944,2489098,2489098
Namibia,2021,NA,NAM,AFR,166521,289572,456093,232713,210000,134439,95051,55252,37612,765067,166054,293917,459971,239035,220410,144378,108238,72652,64299,849012,1614079,2530151,2530151
Namibia,2022,NA,NAM,AFR,166946,296584,463530,234078,213264,137397,96638,56532,37129,775038,166301,300474,466775,240462,223770,148150,110010,74527,64758,861677,1636715,2567012,2567012
Namibia,2023,NA,NAM,AFR,167229,303185,470414,236015,216128,140854,98108,57796,36941,785842,166397,306472,472869,242488,226615,152475,111694,76293,65487,875052,1660894,2604172,2604172
Namibia,2024,NA,NAM,AFR,167321,309096,476417,238658,218637,145468,99854,59593,37730,799940,166382,311719,478101,245190,228978,157872,113548,78424,67330,891342,1691282,2645805,2645805
Namibia,2025,NA,NAM,AFR,167349,314259,481608,242266,219836,151722,101780,61686,39108,816398,166364,316176,482540,248830,229896,164865,115577,80738,69840,909746,1726144,2690284,2690284
Namibia,2026,NA,NAM,AFR,167251,318620,485871,247109,219515,158988,103732,63745,40554,833643,166266,319838,486104,253654,229237,172867,117748,82970,72407,928883,1762526,2734497,2734497
Namibia,2027,NA,NAM,AFR,167255,322022,489277,253236,218637,166435,105549,65755,42078,851690,166287,322580,488867,259678,228059,181004,119878,85084,75072,948775,1800465,2778608,2778608
Namibia,2028,NA,NAM,AFR,167402,324589,491991,260251,217636,173634,107412,67719,43698,870350,166446,324581,491027,266487,226832,188782,122160,87102,77837,969200,1839550,2822568,2822568
Namibia,2029,NA,NAM,AFR,167544,326627,494171,267737,216927,180157,109559,69661,45405,889446,166606,326136,492742,273670,225963,195751,124841,89060,80700,989985,1879431,2866354,2866354
Namibia,2030,NA,NAM,AFR,167770,328147,495917,275389,216988,185755,112002,71605,47197,908936,166861,327263,494124,280945,225919,201668,127909,90990,83646,1011077,1920013,2910056,2910056
Namibia,1950,NA,NAM,AFR,41406,60299,101705,48335,37062,26341,19423,12322,9845,153328,40830,58391,99221,47220,37522,28450,21246,14789,11276,160503,313831,514774,514774
Namibia,1951,NA,NAM,AFR,41870,61800,103670,47966,37064,26418,19613,12412,10012,153485,41929,59935,101864,47203,37703,28786,21602,14859,11654,161807,315292,520828,520828
Namibia,1952,NA,NAM,AFR,42367,63349,105716,47673,37078,26516,19732,12520,10200,153719,43005,61554,104559,47190,37918,29167,21916,14935,12032,163158,316877,527153,527153
Namibia,1953,NA,NAM,AFR,43053,64798,107851,47498,37047,26623,19795,12656,10401,154020,44091,63213,107304,47236,38141,29562,22196,15037,12404,164576,318596,533747,533747
Namibia,1954,NA,NAM,AFR,43858,66181,110039,47497,36874,26708,19829,12836,10566,154310,45016,65069,110085,47423,38311,29907,22461,15200,12743,166045,320355,540483,540483
Namibia,1955,NA,NAM,AFR,44631,67618,112249,47726,36566,26781,19860,13058,10685,154676,45759,67120,112879,47813,38412,30196,22722,15435,13047,167625,322301,547430,547430
Namibia,1956,NA,NAM,AFR,45397,69097,114494,48204,36176,26834,19885,13323,10767,155189,46488,69194,115682,48411,38475,30422,22980,15738,13306,169332,324521,554699,554699
Namibia,1957,NA,NAM,AFR,46193,70577,116770,48949,35762,26878,19904,13637,10822,155952,47246,71250,118496,49238,38547,30585,23214,16109,13534,171227,327179,562452,562452
Namibia,1958,NA,NAM,AFR,47035,72049,119084,49978,35368,26925,19938,13967,10864,157040,48046,73287,121333,50307,38628,30717,23459,16528,13738,173377,330417,570845,570845
Namibia,1959,NA,NAM,AFR,47940,73510,121450,51279,35044,27006,20000,14261,10943,158533,48910,75292,124202,51606,38719,30883,23741,16934,13958,175841,334374,580030,580030
Namibia,1960,NA,NAM,AFR,48963,74959,123922,52826,34869,27125,20107,14502,11061,160490,49889,77263,127152,53110,38850,31101,24060,17303,14194,178618,339108,590181,590181
Namibia,1961,NA,NAM,AFR,50138,76426,126564,54567,34860,27293,20261,14695,11218,162894,51026,79228,130254,54785,39034,31376,24421,17646,14446,181708,344602,601424,601424
Namibia,1962,NA,NAM,AFR,51491,77988,129479,56414,35020,27525,20453,14847,11413,165672,52337,81243,133580,56569,39279,31714,24837,17962,14712,185073,350745,613808,613808
Namibia,1963,NA,NAM,AFR,53026,79771,132797,58212,35410,27787,20684,14970,11642,168705,53833,83333,137166,58426,39641,32092,25282,18254,15000,188695,357400,627358,627358
Namibia,1964,NA,NAM,AFR,54720,81744,136464,59977,36103,28027,20945,15086,11892,172030,55493,85346,140839,60485,40209,32472,25704,18540,15313,192723,364753,642054,642054
Namibia,1965,NA,NAM,AFR,56540,83809,140349,61847,37160,28246,21241,15221,12146,175861,57275,87301,144576,62706,40994,32817,26085,18833,15661,197096,372957,657887,657887
Namibia,1966,NA,NAM,AFR,58467,86008,144475,63777,38547,28472,21561,15369,12416,180142,59165,89384,148549,64948,41991,33148,26419,19122,16036,201664,381806,674818,674818
Namibia,1967,NA,NAM,AFR,60494,88399,148893,65697,40230,28716,21891,15525,12699,184758,61158,91674,152832,67222,43267,33522,26714,19404,16449,206578,391336,693063,693063
Namibia,1968,NA,NAM,AFR,62613,91010,153623,67565,42166,28993,22234,15693,12990,189641,63246,94177,157423,69475,44782,33919,26987,19697,16879,211739,401380,712427,712427
Namibia,1969,NA,NAM,AFR,64844,93824,158668,69364,44307,29319,22600,15881,13272,194743,65453,96897,162350,71691,46500,34321,27285,20017,17307,217121,411864,732881,732881
Namibia,2031,NA,NAM,AFR,168034,329188,497222,283018,218047,190276,114778,73561,49057,928737,167150,328007,495157,288124,226931,206366,131380,92934,86659,1032394,1961131,2953517,2953517
Namibia,2032,NA,NAM,AFR,168338,329957,498295,290346,219918,193972,118011,75505,50979,948731,167486,328553,496039,294946,228804,210116,135357,94904,89710,1053837,2002568,2996909,2996909
Namibia,2033,NA,NAM,AFR,168817,330511,499328,297052,222348,197253,121779,77434,52955,968821,167998,328970,496968,301087,231261,213344,139908,96918,92800,1075318,2044139,3040441,3040441
Namibia,2034,NA,NAM,AFR,169445,330868,500313,303056,225359,200063,126329,79222,54966,988995,168651,329273,497924,306459,234316,216004,145288,98849,95888,1096804,2085799,3084032,3084032
Namibia,2035,NA,NAM,AFR,170175,331185,501360,308289,229220,201534,132161,80927,56992,1009123,169406,329606,499012,311029,238224,217182,152039,100776,98947,1118197,2127320,3127696,3127696
Namibia,2036,NA,NAM,AFR,171066,331419,502485,312731,234268,201601,138903,82653,59035,1029191,170322,329892,500214,314806,243287,216861,159745,102827,101972,1139498,2168689,3171395,3171395
Namibia,2037,NA,NAM,AFR,172093,331795,503888,316222,240553,201144,145786,84271,61083,1049059,171363,330343,501706,317675,249514,216037,167564,104848,104965,1160603,2209662,3215247,3215247
Namibia,2038,NA,NAM,AFR,173166,332475,505641,318888,247683,200562,152428,85934,63156,1068651,172444,331098,503542,319803,256502,215153,175039,107001,107953,1181451,2250102,3259286,3259286
Namibia,2039,NA,NAM,AFR,174173,333302,507475,321021,255249,200249,158454,87846,65279,1088098,173467,331995,505462,321482,263847,214607,181751,109527,110972,1202186,2290284,3303227,3303227
Namibia,2040,NA,NAM,AFR,175171,334314,509485,322645,262975,200650,163648,90013,67443,1107374,174480,333086,507566,322735,271272,214847,187474,112409,114030,1222767,2330141,3347189,3347189
Namibia,2041,NA,NAM,AFR,176148,335519,511667,323793,270668,201970,167864,92475,69671,1126441,175477,334368,509845,323599,278599,216097,192042,115661,117158,1243156,2369597,3391106,3391106
Namibia,2042,NA,NAM,AFR,177049,336895,513944,324666,278057,204052,171352,95326,71917,1145370,176403,335818,512221,324269,285567,218169,195721,119374,120345,1263445,2408815,3434985,3434985
Namibia,2043,NA,NAM,AFR,177881,338488,516369,325330,284838,206670,174487,98636,74179,1164140,177269,337481,514750,324808,291859,220811,198928,123620,123594,1283620,2447760,3478878,3478878
Namibia,2044,NA,NAM,AFR,178662,340163,518825,325788,290936,209855,177228,102589,76360,1182756,178087,339221,517308,325227,297397,224033,201611,128607,126781,1303656,2486412,3522542,3522542
Namibia,2045,NA,NAM,AFR,179362,341934,521296,326215,296284,213840,178808,107626,78481,1201254,178817,341052,519869,325680,302146,228088,202929,134837,129942,1323622,2524876,3566040,3566040
Namibia,2046,NA,NAM,AFR,180070,343840,523910,326553,300861,218946,179165,113417,80620,1219562,179546,343029,522575,326084,306111,233253,202863,141934,133182,1343427,2562989,3609486,3609486
Namibia,2047,NA,NAM,AFR,180702,345807,526509,327025,304512,225203,179050,119298,82676,1237764,180203,345057,525260,326644,309179,239539,202317,149111,136384,1363174,2600938,3652704,3652704
Namibia,2048,NA,NAM,AFR,181173,347744,528917,327795,307347,232249,178817,124941,84777,1255926,180696,347060,527756,327496,311503,246554,201719,155956,139690,1382918,2638844,3695526,3695526
Namibia,2049,NA,NAM,AFR,181626,349566,531192,328699,309659,239697,178825,130059,87088,1274027,181157,348952,530109,328482,313380,253912,201432,162105,143324,1402635,2676662,3737961,3737961
Namibia,2050,NA,NAM,AFR,181973,351295,533268,329773,311454,247284,179467,134462,89627,1292067,181512,350749,532261,329646,314823,261336,201881,167342,147291,1422319,2714386,3779918,3779918
New Caledonia,1970,NC,NCL,WPR,8592,13726,22318,11175,8484,6767,4668,3183,1702,35979,8342,13337,21679,9331,7495,5714,3869,2740,1859,31008,66987,110982,110982
New Caledonia,1971,NC,NCL,WPR,9027,14409,23436,11517,8886,7037,4773,3303,1794,37310,8737,13979,22716,9742,7843,5968,3985,2821,1970,32329,69639,115793,115793
New Caledonia,1972,NC,NCL,WPR,9466,15137,24603,11862,9330,7322,4913,3414,1889,38730,9143,14646,23789,10176,8224,6244,4121,2899,2082,33746,72476,120866,120866
New Caledonia,1973,NC,NCL,WPR,9892,15891,25783,12224,9795,7618,5090,3501,1996,40224,9545,15330,24875,10634,8616,6539,4278,2966,2206,35239,75463,126118,126118
New Caledonia,1974,NC,NCL,WPR,10266,16669,26935,12633,10262,7933,5290,3569,2111,41798,9909,16029,25938,11133,9006,6856,4454,3029,2328,36806,78604,131481,131481
New Caledonia,1975,NC,NCL,WPR,10517,17454,27971,13063,10694,8246,5513,3620,2226,43362,10153,16740,26893,11641,9361,7180,4644,3084,2458,38368,81730,136601,136601
New Caledonia,1976,NC,NCL,WPR,10573,18101,28674,13430,10999,8506,5742,3667,2337,44681,10214,17372,27586,12111,9596,7463,4843,3140,2577,39730,84411,140673,140673
New Caledonia,1977,NC,NCL,WPR,10475,18543,29018,13668,11185,8682,5931,3687,2431,45584,10126,17842,27968,12485,9755,7680,5019,3184,2675,40798,86382,143370,143370
New Caledonia,1978,NC,NCL,WPR,10316,18861,29177,13812,11316,8816,6071,3681,2514,46210,9975,18186,28161,12800,9924,7844,5159,3224,2766,41717,87927,145262,145262
New Caledonia,1979,NC,NCL,WPR,10147,19100,29247,13971,11416,8945,6201,3682,2590,46805,9817,18443,28260,13113,10099,8005,5298,3267,2854,42636,89441,146947,146947
New Caledonia,1980,NC,NCL,WPR,10000,19270,29270,14171,11485,9088,6328,3699,2664,47435,9676,18629,28305,13440,10273,8170,5439,3320,2946,43588,91023,148599,148599
New Caledonia,1981,NC,NCL,WPR,9880,19373,29253,14399,11518,9254,6452,3736,2739,48098,9558,18746,28304,13778,10453,8340,5581,3387,3037,44576,92674,150228,150228
New Caledonia,1982,NC,NCL,WPR,9789,19429,29218,14675,11528,9445,6585,3799,2806,48838,9468,18811,28279,14132,10642,8527,5733,3470,3123,45627,94465,151967,151967
New Caledonia,1983,NC,NCL,WPR,9735,19479,29214,15037,11542,9674,6748,3914,2877,49792,9406,18875,28281,14534,10832,8727,5920,3584,3221,46818,96610,154101,154101
New Caledonia,1984,NC,NCL,WPR,9695,19559,29254,15518,11567,9921,6955,4077,2961,50999,9354,18969,28323,15010,11014,8943,6155,3726,3330,48178,99177,156755,156755
New Caledonia,1985,NC,NCL,WPR,9661,19598,29259,16066,11671,10169,7181,4272,3066,52425,9311,19017,28328,15542,11238,9144,6417,3896,3448,49685,102110,159702,159702
New Caledonia,1986,NC,NCL,WPR,9693,19566,29259,16607,11895,10405,7408,4472,3162,53949,9329,18996,28325,16074,11553,9325,6680,4066,3572,51270,105219,162797,162797
New Caledonia,1987,NC,NCL,WPR,9809,19493,29302,17130,12194,10622,7634,4672,3262,55514,9425,18926,28351,16589,11917,9503,6931,4247,3709,52896,108410,166055,166055
New Caledonia,1988,NC,NCL,WPR,9995,19374,29369,17609,12621,10832,7852,4863,3367,57144,9590,18814,28404,17057,12367,9678,7164,4437,3858,54561,111705,169474,169474
New Caledonia,1989,NC,NCL,WPR,10260,19195,29455,17974,13301,11075,8072,5021,3495,58938,9822,18648,28470,17403,13023,9836,7363,4635,4034,56294,115232,173156,173156
New Caledonia,1990,NC,NCL,WPR,10563,19055,29618,18336,14030,11376,8323,5189,3624,60878,10081,18512,28593,17717,13749,10078,7578,4834,4211,58167,119045,177264,177264
New Caledonia,1991,NC,NCL,WPR,10850,19060,29910,18723,14662,11712,8615,5395,3757,62864,10325,18490,28815,18057,14422,10434,7825,5033,4364,60135,122999,181720,181720
New Caledonia,1992,NC,NCL,WPR,11094,19179,30273,19029,15305,12055,8923,5610,3894,64816,10533,18566,29099,18327,15086,10803,8091,5236,4520,62063,126879,186262,186262
New Caledonia,1993,NC,NCL,WPR,11286,19393,30679,19249,15927,12407,9248,5844,4052,66727,10698,18717,29415,18535,15720,11203,8363,5454,4693,63968,130695,190782,190782
New Caledonia,1994,NC,NCL,WPR,11451,19653,31104,19388,16526,12785,9581,6087,4217,68584,10849,18900,29749,18674,16316,11647,8638,5683,4870,65828,134412,195264,195264
New Caledonia,1995,NC,NCL,WPR,11550,19987,31537,19436,17131,13193,9912,6349,4392,70413,10939,19144,30083,18737,16894,12138,8906,5929,5061,67665,138078,199701,199701
New Caledonia,1996,NC,NCL,WPR,11548,20415,31963,19416,17732,13632,10234,6625,4579,72218,10941,19483,30424,18738,17445,12682,9166,6188,5270,69489,141707,204086,204086
New Caledonia,1997,NC,NCL,WPR,11530,20953,32483,19316,18213,14066,10550,6898,4764,73807,10945,19946,30891,18699,17934,13254,9425,6442,5488,71242,145049,208421,208421
New Caledonia,1998,NC,NCL,WPR,11515,21532,33047,19173,18575,14496,10860,7174,4973,75251,10972,20478,31450,18641,18365,13849,9692,6692,5767,73006,148257,212756,212756
New Caledonia,1999,NC,NCL,WPR,11496,22065,33561,19067,18887,14961,11165,7460,5209,76749,10985,20983,31968,18610,18744,14479,9977,6943,6094,74847,151596,217118,217118
New Caledonia,2000,NC,NCL,WPR,11499,22555,34054,19011,19131,15455,11473,7759,5468,78297,11009,21457,32466,18610,19056,15138,10283,7190,6446,76723,155020,221537,221537
New Caledonia,2001,NC,NCL,WPR,11491,22971,34462,19071,19299,15956,11790,8077,5752,79945,11008,21883,32891,18695,19304,15802,10617,7444,6819,78681,158626,225987,225987
New Caledonia,2002,NC,NCL,WPR,11428,23305,34733,19279,19403,16456,12102,8418,6055,81713,10949,22243,33192,18908,19496,16457,10962,7714,7222,80759,162472,230399,230399
New Caledonia,2003,NC,NCL,WPR,11333,23565,34898,19609,19431,16916,12419,8777,6385,83537,10851,22532,33383,19222,19618,17082,11332,7989,7627,82870,166407,234685,234685
New Caledonia,2004,NC,NCL,WPR,11220,23739,34959,20007,19381,17320,12738,9143,6744,85333,10731,22738,33469,19579,19644,17626,11740,8265,8042,84896,170229,238649,238649
New Caledonia,2005,NC,NCL,WPR,11144,23768,34912,20198,19577,17829,13090,9341,7176,87211,10625,22783,33408,19681,19778,18081,12143,8536,8394,86613,173824,242141,242141
New Caledonia,2006,NC,NCL,WPR,11100,23693,34793,20418,19795,18391,13500,9519,7658,89281,10542,22659,33201,19788,19882,18482,12648,8813,8745,88358,177639,245635,245635
New Caledonia,2007,NC,NCL,WPR,11058,23631,34689,20845,19756,18859,13968,9818,8126,91372,10472,22510,32982,20105,19784,18869,13287,9106,9167,90318,181690,249367,249367
New Caledonia,2008,NC,NCL,WPR,11033,23603,34636,21169,19746,19286,14497,10077,8619,93394,10433,22400,32833,20331,19695,19230,13925,9425,9606,92212,185606,253077,253077
New Caledonia,2009,NC,NCL,WPR,11027,23565,34592,21484,19788,19667,15065,10332,9120,95456,10423,22324,32747,20570,19664,19588,14540,9760,10058,94180,189636,256976,256976
New Caledonia,2010,NC,NCL,WPR,11100,23475,34575,21843,19917,20049,15633,10627,9565,97634,10492,22303,32795,20889,19773,20009,15142,10093,10510,96416,194050,261426,261426
New Caledonia,2011,NC,NCL,WPR,11259,23380,34639,22166,20161,20425,16189,10951,10003,99895,10640,22316,32956,21185,20044,20440,15755,10425,10970,98819,198714,266303,266303
New Caledonia,2012,NC,NCL,WPR,11446,23325,34771,22384,20527,20755,16733,11263,10474,102136,10811,22339,33150,21391,20429,20816,16386,10774,11454,101250,203386,271303,271303
New Caledonia,2013,NC,NCL,WPR,11628,23326,34954,22529,20980,21021,17275,11582,10985,104372,10985,22385,33370,21545,20883,21136,17028,11146,11964,103702,208074,276394,276394
New Caledonia,2014,NC,NCL,WPR,11744,23332,35076,22569,21377,21132,17799,11911,11515,106303,11103,22390,33493,21641,21266,21330,17645,11556,12482,105920,212223,280798,280798
New Caledonia,2015,NC,NCL,WPR,11713,23197,34910,22403,21531,20968,18253,12236,11981,107372,11090,22230,33320,21581,21400,21279,18149,12005,13015,107429,214801,283032,283032
New Caledonia,2016,NC,NCL,WPR,11584,22972,34556,22077,21490,20682,18627,12579,12372,107827,10973,21975,32948,21386,21367,21094,18566,12473,13537,108423,216250,283748,283748
New Caledonia,2017,NC,NCL,WPR,11415,22818,34233,21711,21398,20450,18929,12972,12746,108206,10815,21755,32570,21139,21339,20926,18940,12956,14048,109348,217554,284349,284349
New Caledonia,2018,NC,NCL,WPR,11224,22706,33930,21369,21257,20245,19124,13398,13121,108514,10631,21587,32218,20841,21291,20776,19289,13449,14572,110218,218732,284880,284880
New Caledonia,2019,NC,NCL,WPR,11046,22577,33623,21116,21036,20091,19251,13799,13523,108816,10459,21479,31938,20528,21180,20641,19605,13916,15136,111006,219822,285374,285374
New Caledonia,2020,NC,NCL,WPR,10903,22490,33393,21009,20725,20114,19330,14205,13970,109353,10319,21396,31715,20395,20968,20598,19845,14384,15751,111941,221294,286403,286403
New Caledonia,2021,NC,NCL,WPR,10782,22431,33213,21003,20408,20256,19338,14656,14382,110043,10202,21290,31492,20466,20646,20692,19967,14892,16383,113046,223089,287800,287800
New Caledonia,2022,NC,NCL,WPR,10686,22393,33079,21155,20189,20440,19337,15126,14871,111118,10111,21220,31331,20686,20323,20862,20064,15410,17082,114427,225545,289950,289950
New Caledonia,2023,NC,NCL,WPR,10612,22403,33015,21460,20062,20666,19347,15596,15490,112621,10043,21215,31258,20965,20086,21055,20172,15920,17896,116094,228715,292991,292991
New Caledonia,2024,NC,NCL,WPR,10540,22393,32933,21708,20001,20894,19311,16088,16120,114122,9975,21203,31178,21142,19942,21248,20228,16426,18755,117741,231863,295966,295966
New Caledonia,2025,NC,NCL,WPR,10472,22317,32789,21867,20045,21076,19290,16601,16766,115645,9910,21130,31040,21231,19935,21417,20256,16933,19629,119401,235046,298873,298873
New Caledonia,2026,NC,NCL,WPR,10414,22179,32593,21997,20163,21164,19324,17070,17469,117187,9852,20998,30850,21287,20040,21515,20287,17456,20502,121087,238274,301712,301712
New Caledonia,2027,NC,NCL,WPR,10368,22003,32371,22185,20293,21175,19366,17466,18247,118732,9806,20828,30634,21363,20170,21560,20311,17961,21402,122767,241499,304499,304499
New Caledonia,2028,NC,NCL,WPR,10335,21800,32135,22369,20501,21154,19384,17790,19061,120259,9774,20636,30410,21448,20318,21566,20329,18435,22325,124421,244680,307233,307233
New Caledonia,2029,NC,NCL,WPR,10311,21599,31910,22496,20820,21062,19454,18058,19871,121761,9749,20444,30193,21554,20510,21498,20356,18881,23239,126038,247799,309909,309909
New Caledonia,2030,NC,NCL,WPR,10293,21421,31714,22604,21177,20868,19656,18239,20659,123203,9730,20273,30003,21629,20785,21339,20461,19227,24177,127618,250821,312529,312529
New Caledonia,1950,NC,NCL,WPR,4583,7202,11785,6219,5507,4807,2866,1569,1522,22490,4379,6737,11116,5203,4228,3490,2441,1445,1663,18470,40960,63860,63860
New Caledonia,1951,NC,NCL,WPR,4705,7333,12038,6274,5496,4911,2973,1615,1470,22739,4513,6891,11404,5318,4276,3563,2503,1496,1606,18762,41501,64941,64941
New Caledonia,1952,NC,NCL,WPR,4819,7490,12309,6333,5494,4989,3095,1668,1429,23008,4630,7064,11694,5441,4332,3627,2566,1551,1553,19070,42078,66090,66090
New Caledonia,1953,NC,NCL,WPR,4931,7671,12602,6393,5508,5046,3231,1726,1391,23295,4743,7250,11993,5576,4393,3684,2633,1616,1513,19415,42710,67315,67315
New Caledonia,1954,NC,NCL,WPR,5054,7860,12914,6461,5535,5085,3370,1791,1365,23607,4860,7442,12302,5722,4463,3738,2708,1683,1481,19795,43402,68614,68614
New Caledonia,1955,NC,NCL,WPR,5190,8058,13248,6532,5572,5107,3510,1860,1344,23925,4986,7634,12620,5877,4542,3788,2785,1748,1459,20199,44124,69989,69989
New Caledonia,1956,NC,NCL,WPR,5356,8293,13649,6636,5639,5128,3652,1931,1334,24320,5135,7850,12985,6039,4641,3845,2863,1810,1454,20652,44972,71602,71602
New Caledonia,1957,NC,NCL,WPR,5559,8604,14163,6810,5776,5176,3792,1996,1327,24877,5322,8117,13439,6215,4789,3921,2941,1864,1455,21185,46062,73665,73665
New Caledonia,1958,NC,NCL,WPR,5793,8965,14758,7040,5953,5251,3925,2059,1328,25556,5535,8424,13959,6389,4963,4013,3028,1913,1466,21772,47328,76049,76049
New Caledonia,1959,NC,NCL,WPR,6041,9349,15390,7292,6139,5339,4053,2136,1325,26284,5762,8753,14515,6564,5149,4114,3110,1967,1478,22382,48666,78575,78575
New Caledonia,1960,NC,NCL,WPR,6297,9744,16041,7567,6332,5443,4168,2219,1337,27066,6002,9107,15109,6748,5337,4229,3193,2025,1494,23026,50092,81236,81236
New Caledonia,1961,NC,NCL,WPR,6556,10157,16713,7862,6525,5562,4273,2313,1344,27879,6249,9474,15723,6947,5529,4358,3271,2087,1519,23711,51590,84029,84029
New Caledonia,1962,NC,NCL,WPR,6808,10567,17375,8177,6715,5697,4364,2417,1356,28726,6498,9841,16339,7168,5726,4494,3350,2155,1548,24441,53167,86877,86877
New Caledonia,1963,NC,NCL,WPR,7034,10961,17995,8470,6882,5837,4448,2530,1382,29549,6723,10209,16932,7381,5905,4630,3427,2222,1585,25150,54699,89624,89624
New Caledonia,1964,NC,NCL,WPR,7228,11324,18552,8765,7030,5951,4513,2637,1412,30308,6927,10592,17519,7596,6083,4759,3500,2294,1618,25850,56158,92231,92231
New Caledonia,1965,NC,NCL,WPR,7405,11676,19081,9077,7173,6054,4557,2742,1452,31055,7120,10988,18108,7816,6269,4890,3559,2363,1663,26560,57615,94803,94803
New Caledonia,1966,NC,NCL,WPR,7584,12044,19628,9382,7332,6167,4598,2842,1502,31823,7311,11408,18719,8041,6457,5023,3622,2441,1701,27285,59108,97453,97453
New Caledonia,1967,NC,NCL,WPR,7766,12424,20190,9693,7506,6282,4635,2949,1548,32613,7500,11842,19342,8292,6643,5163,3686,2517,1750,28051,60664,100200,100200
New Caledonia,1968,NC,NCL,WPR,7975,12805,20780,10071,7730,6408,4664,3042,1599,33514,7712,12283,19995,8578,6847,5314,3755,2591,1795,28880,62394,103162,103162
New Caledonia,1969,NC,NCL,WPR,8231,13196,21427,10645,8082,6554,4648,3101,1638,34668,7988,12766,20754,8935,7147,5492,3800,2664,1809,29847,64515,106691,106691
New Caledonia,2031,NC,NCL,WPR,10280,21273,31553,22675,21512,20654,19931,18333,21474,124579,9718,20126,29844,21626,21165,21077,20660,19434,25159,129121,253700,315098,315098
New Caledonia,2032,NC,NCL,WPR,10272,21142,31414,22698,21840,20491,20178,18390,22311,125908,9709,20008,29717,21608,21543,20783,20878,19574,26194,130580,256488,317611,317611
New Caledonia,2033,NC,NCL,WPR,10265,21035,31300,22713,22143,20369,20405,18414,23135,127179,9701,19904,29605,21607,21822,20550,21071,19685,27243,131978,259157,320065,320065
New Caledonia,2034,NC,NCL,WPR,10267,20943,31210,22705,22392,20313,20638,18394,23982,128424,9702,19811,29513,21590,21996,20409,21265,19744,28330,133334,261758,322481,322481
New Caledonia,2035,NC,NCL,WPR,10279,20855,31134,22629,22554,20365,20823,18389,24863,129623,9712,19731,29443,21521,22090,20403,21440,19782,29431,134667,264290,324862,324862
New Caledonia,2036,NC,NCL,WPR,10290,20789,31079,22494,22685,20489,20917,18444,25756,130785,9721,19658,29379,21389,22147,20510,21537,19820,30541,135944,266729,327183,327183
New Caledonia,2037,NC,NCL,WPR,10302,20731,31033,22318,22876,20622,20934,18505,26645,131900,9731,19608,29339,21218,22223,20639,21585,19850,31661,137176,269076,329447,329447
New Caledonia,2038,NC,NCL,WPR,10311,20695,31006,22117,23062,20827,20921,18541,27499,132967,9740,19567,29307,21026,22311,20792,21593,19880,32775,138377,271344,331656,331656
New Caledonia,2039,NC,NCL,WPR,10306,20673,30979,21918,23193,21153,20841,18623,28278,134006,9736,19544,29280,20835,22415,20980,21525,19919,33853,139527,273533,333802,333802
New Caledonia,2040,NC,NCL,WPR,10292,20664,30956,21746,23303,21509,20655,18835,28970,135018,9724,19535,29259,20667,22489,21258,21371,20026,34843,140654,275672,335889,335889
New Caledonia,2041,NC,NCL,WPR,10282,20664,30946,21594,23378,21845,20455,19112,29603,135987,9712,19532,29244,20521,22488,21638,21113,20229,35750,141739,277726,337916,337916
New Caledonia,2042,NC,NCL,WPR,10268,20670,30938,21469,23404,22169,20304,19362,30218,136926,9698,19534,29232,20401,22466,22012,20826,20450,36632,142787,279713,339885,339885
New Caledonia,2043,NC,NCL,WPR,10253,20674,30927,21363,23419,22475,20189,19591,30794,137831,9684,19537,29221,20300,22467,22292,20595,20649,37504,143807,281638,341793,341793
New Caledonia,2044,NC,NCL,WPR,10240,20671,30911,21271,23416,22720,20144,19824,31356,138731,9672,19533,29205,20210,22457,22468,20458,20843,38368,144804,283535,343639,343639
New Caledonia,2045,NC,NCL,WPR,10227,20668,30895,21187,23342,22888,20202,20010,31951,139580,9660,19529,29189,20128,22385,22560,20457,21017,39213,145760,285340,345421,345421
New Caledonia,2046,NC,NCL,WPR,10207,20668,30875,21118,23214,23024,20331,20111,32607,140405,9642,19529,29171,20057,22252,22618,20565,21120,40059,146671,287076,347128,347128
New Caledonia,2047,NC,NCL,WPR,10180,20665,30845,21066,23037,23217,20474,20145,33269,141208,9617,19527,29144,20003,22084,22698,20701,21176,40908,147570,288778,348766,348766
New Caledonia,2048,NC,NCL,WPR,10145,20661,30806,21031,22841,23405,20683,20143,33876,141979,9583,19521,29104,19966,21893,22783,20854,21188,41750,148434,290413,350320,350320
New Caledonia,2049,NC,NCL,WPR,10097,20647,30744,21009,22646,23536,21006,20076,34457,142730,9539,19507,29046,19943,21705,22890,21042,21131,42560,149271,292001,351790,351790
New Caledonia,2050,NC,NCL,WPR,10049,20619,30668,21002,22477,23650,21360,19907,35066,143462,9491,19481,28972,19934,21534,22968,21320,20989,43344,150089,293551,353191,353191
Niger,1970,NE,NER,AFR,481841,669801,1151642,437502,283508,177600,116598,67276,28919,1111403,468008,649630,1117638,462421,335443,212923,144608,88878,44748,1289021,2400424,4669708,4669708
Niger,1971,NE,NER,AFR,492021,687122,1179143,455153,292962,182892,119412,69289,30648,1150356,477674,666465,1144139,471038,346890,219327,147870,91775,46530,1323430,2473786,4797068,4797068
Niger,1972,NE,NER,AFR,502449,704329,1206778,474494,301297,188565,122212,71317,32340,1190225,487506,683154,1170660,480809,357532,226188,151136,94610,48378,1358653,2548878,4926318,4926318
Niger,1973,NE,NER,AFR,513685,721264,1234949,496747,307377,194694,125077,73394,34026,1231315,498133,699652,1197785,493517,365878,233561,154541,97456,50379,1395332,2626647,5059382,5059382
Niger,1974,NE,NER,AFR,525900,737869,1263769,522770,310172,201321,128059,75509,35722,1273553,509603,715980,1225583,509113,372043,241412,158218,100340,52544,1433670,2707223,5196579,5196579
Niger,1975,NE,NER,AFR,539266,754398,1293664,544760,317644,208438,131234,77682,37472,1317230,522015,732493,1254508,525228,378580,249792,162264,103313,54921,1474098,2791328,5339497,5339497
Niger,1976,NE,NER,AFR,553948,771119,1325067,560884,331756,215973,134644,79943,39280,1362480,535550,749292,1284842,541124,386016,258678,166669,106326,57458,1516271,2878751,5488658,5488658
Niger,1977,NE,NER,AFR,570168,788339,1358507,577307,346253,224012,138331,82317,41179,1409399,550587,766348,1316935,557238,393670,268067,171436,109355,60100,1559866,2969265,5644703,5644703
Niger,1978,NE,NER,AFR,588648,806419,1395067,594107,361101,232666,142348,84812,43192,1458226,567946,783916,1351862,573671,401507,278088,176592,112433,62904,1605195,3063421,5810351,5810351
Niger,1979,NE,NER,AFR,609582,825824,1435406,611370,376417,241860,146720,87405,45328,1509100,587910,802400,1390310,590480,409516,288773,182099,115582,65884,1652334,3161434,5987151,5987151
Niger,1980,NE,NER,AFR,632310,846995,1479305,628754,392335,251216,151446,90062,47552,1561365,609774,822237,1432011,607274,417682,299843,187927,118782,68986,1700494,3261859,6173177,6173177
Niger,1981,NE,NER,AFR,656088,870153,1526241,646072,409102,260233,156538,92776,49868,1614589,632753,843614,1476367,623853,426122,310804,194110,122006,72165,1749060,3363649,6366262,6366262
Niger,1982,NE,NER,AFR,679649,895392,1575041,663314,427423,268252,162010,95526,52261,1668786,655757,866693,1522450,640275,435469,321025,200720,125253,75419,1798161,3466947,6564445,6564445
Niger,1983,NE,NER,AFR,701691,923303,1624994,680333,448476,274215,167897,98343,54720,1723984,677494,892143,1569637,656470,447361,329077,207759,128584,78734,1847985,3571969,6766606,6766606
Niger,1984,NE,NER,AFR,722481,954069,1676550,697188,473171,277220,174272,101278,57245,1780374,698091,920208,1618299,672484,461809,335026,215178,132084,82042,1898623,3678997,6973849,6973849
Niger,1985,NE,NER,AFR,742223,987281,1729504,714291,494523,284634,181146,104392,59837,1838823,717669,950551,1668220,688810,476814,341256,223020,135832,85337,1951069,3789892,7187618,7187618
Niger,1986,NE,NER,AFR,760358,1022453,1782811,732149,511084,298440,188516,107750,62558,1900497,735652,982828,1718480,705951,492133,348485,231391,139906,88716,2006582,3907079,7408364,7408364
Niger,1987,NE,NER,AFR,778341,1058606,1836947,750786,528291,312798,196411,111368,65392,1965046,753334,1016396,1769730,723774,508100,356105,240319,144350,92224,2064872,4029918,7636591,7636591
Niger,1988,NE,NER,AFR,797096,1094977,1892073,770293,545991,327560,204876,115242,68332,2032294,771492,1050728,1822220,742210,524607,363971,249859,149157,95868,2125672,4157966,7872252,7872252
Niger,1989,NE,NER,AFR,816308,1131748,1948056,791111,564316,342845,213828,119393,71333,2102826,789749,1085947,1875696,761654,541791,372096,260037,154284,99632,2189494,4292320,8116075,8116075
Niger,1990,NE,NER,AFR,837465,1168756,2006221,813506,582944,358857,222974,123841,74386,2176508,809685,1121814,1931499,782440,559378,380630,270689,159742,103545,2256424,4432932,8370648,8370648
Niger,1991,NE,NER,AFR,861293,1205236,2066529,837396,601517,375810,231854,128570,77436,2252583,832440,1157444,1989884,804459,577009,389693,281373,165559,107550,2325643,4578226,8634640,8634640
Niger,1992,NE,NER,AFR,887089,1241640,2128729,862906,619940,394313,239841,133594,80460,2331054,857537,1193220,2050757,827829,594604,399813,291486,171774,111603,2397109,4728163,8907644,8907644
Niger,1993,NE,NER,AFR,915530,1278004,2193534,890848,638126,415468,245998,138987,83548,2412975,885512,1229140,2114652,853405,612090,412495,299704,178427,115797,2471918,4884893,9193078,9193078
Niger,1994,NE,NER,AFR,947259,1314283,2261542,921582,656172,440121,249498,144832,86805,2499010,916812,1265074,2181886,881690,629599,427775,306113,185488,120217,2550882,5049892,9493324,9493324
Niger,1995,NE,NER,AFR,982811,1352019,2334830,955142,674701,461802,257161,151148,90286,2590240,951647,1302421,2254068,912692,647677,443713,312855,192963,124874,2634774,5225014,9813918,9813918
Niger,1996,NE,NER,AFR,1022278,1392074,2414352,990005,692913,478389,270424,157760,93899,2683390,990050,1341926,2331976,944848,665388,459272,320236,200783,129687,2720214,5403604,10149937,10149937
Niger,1997,NE,NER,AFR,1064445,1435181,2499626,1024443,710084,494590,283754,164623,97585,2775079,1030991,1384243,2415234,976756,681905,474474,327565,208912,134642,2804254,5579333,10494201,10494201
Niger,1998,NE,NER,AFR,1108424,1482668,2591092,1059196,727864,511054,297359,171912,101450,2868835,1073682,1430731,2504413,1009490,698744,489973,335017,217524,139824,2890572,5759407,10854920,10854920
Niger,1999,NE,NER,AFR,1153336,1534513,2687849,1094478,746692,527839,311308,179536,105450,2965303,1117281,1481422,2598703,1043226,716252,505809,342571,226600,145165,2979623,5944926,11231469,11231469
Niger,2000,NE,NER,AFR,1198298,1591654,2789952,1129963,766772,544672,325793,187249,109597,3064046,1160896,1537088,2697984,1077445,734634,521684,350325,235966,150614,3070668,6134714,11622665,11622665
Niger,2001,NE,NER,AFR,1243155,1655369,2898524,1165303,788655,561642,341202,194735,113953,3165490,1204360,1598875,2803235,1111769,754500,537721,358616,245317,156260,3164183,6329673,12031430,12031430
Niger,2002,NE,NER,AFR,1288748,1724503,3013251,1200620,812150,578524,358010,201430,118481,3269215,1248516,1665722,2914238,1146237,775677,553750,367885,254117,162146,3259812,6529027,12456517,12456517
Niger,2003,NE,NER,AFR,1335962,1798648,3134610,1236057,838038,595203,377184,206523,123333,3376338,1294309,1737293,3031602,1180842,798901,569577,379440,261149,168336,3358245,6734583,12900790,12900790
Niger,2004,NE,NER,AFR,1385298,1877685,3262983,1271579,866669,611706,399431,209305,128608,3487298,1342240,1813814,3156054,1215627,824698,585308,393326,266578,175011,3460548,6947846,13366885,13366885
Niger,2005,NE,NER,AFR,1436529,1960868,3397397,1308470,897602,628121,418780,215723,134306,3603002,1392130,1894623,3286753,1251891,852776,601111,407650,272344,182297,3568069,7171071,13855221,13855221
Niger,2006,NE,NER,AFR,1489077,2048094,3537171,1347758,930339,644650,433810,227231,140381,3724169,1443442,1979344,3422786,1290450,882662,617073,421868,278863,190128,3681044,7405213,14365168,14365168
Niger,2007,NE,NER,AFR,1543179,2139442,3682621,1390301,964061,661523,449143,239098,146900,3851026,1496313,2068035,3564348,1332115,913850,633275,436383,285677,198575,3799875,7650901,14897873,14897873
Niger,2008,NE,NER,AFR,1599185,2234730,3833915,1437236,998171,679040,464802,251293,153930,3984472,1550869,2160514,3711383,1377972,945919,649854,451245,292731,207680,3925401,7909873,15455175,15455175
Niger,2009,NE,NER,AFR,1657126,2333690,3990816,1488672,1032949,697616,480840,263869,161395,4125341,1606782,2256653,3863435,1428184,979097,667142,466488,299997,217411,4058319,8183660,16037915,16037915
Niger,2010,NE,NER,AFR,1717104,2435518,4152622,1545632,1068376,717699,497133,277037,169147,4275024,1664191,2355784,4019975,1483672,1013271,685629,481992,307650,227703,4199917,8474941,16647543,16647543
Niger,2011,NE,NER,AFR,1778797,2539375,4318172,1609291,1103789,739478,513586,291010,176887,4434041,1723143,2457116,4180259,1545484,1047719,705550,497722,315882,238286,4350643,8784684,17283112,17283112
Niger,2012,NE,NER,AFR,1841165,2646363,4487528,1680380,1141611,764078,530581,306413,184350,4607413,1782847,2561508,4344355,1614504,1084742,727923,513967,325210,248771,4515117,9122530,17954407,17954407
Niger,2013,NE,NER,AFR,1904536,2756998,4661534,1756559,1180129,791307,547548,323798,190722,4790063,1843746,2669189,4512935,1688484,1122585,752659,530241,336610,258086,4688665,9478728,18653199,18653199
Niger,2014,NE,NER,AFR,1969489,2871247,4840736,1836158,1217632,820660,564124,343525,195357,4977456,1906497,2779898,4686395,1765920,1159567,779441,546268,349956,266288,4867440,9844896,19372014,19372014
Niger,2015,NE,NER,AFR,2036720,2989221,5025941,1920928,1257969,853035,580972,361028,203238,5177170,1971672,2893971,4865643,1848853,1199637,809232,562693,363830,275128,5059373,10236543,20128124,20128124
Niger,2016,NE,NER,AFR,2108740,3109830,5218570,2010097,1301555,887736,598172,375153,215377,5388090,2041435,3010744,5052179,1936216,1243010,841409,579541,377757,284968,5262901,10650991,20921743,20921743
Niger,2017,NE,NER,AFR,2186575,3231621,5418196,2101420,1346646,922759,615456,389457,227862,5603600,2116679,3128843,5245522,2025255,1287616,874198,596378,391873,295282,5470602,11074202,21737922,21737922
Niger,2018,NE,NER,AFR,2268254,3355595,5623849,2195196,1394475,957561,633119,403976,240752,5825079,2195647,3248834,5444481,2116307,1334646,907228,613315,406169,305981,5683646,11508725,22577058,22577058
Niger,2019,NE,NER,AFR,2352590,3482657,5835247,2291928,1445621,992595,651612,418738,254019,6054513,2277302,3371517,5648819,2210256,1384883,940980,630787,420758,317149,5904813,11959326,23443393,23443393
Niger,2020,NE,NER,AFR,2439254,3613136,6052390,2391534,1501599,1027760,670854,432535,265705,6289987,2361317,3497231,5858548,2307125,1439647,975302,648892,434784,326963,6132713,12422700,24333639,24333639
Niger,2021,NE,NER,AFR,2526430,3749207,6275637,2494056,1564426,1062864,691150,445368,275628,6533492,2445746,3628367,6074113,2407136,1500886,1009914,668023,448188,335325,6369472,12902964,25252722,25252722
Niger,2022,NE,NER,AFR,2613999,3891149,6505148,2599798,1632696,1098459,713185,458360,285738,6788236,2530748,3765551,6296299,2510669,1567480,1045301,688794,461801,344246,6618291,13406527,26207977,26207977
Niger,2023,NE,NER,AFR,2701722,4037716,6739438,2709613,1706076,1134732,737989,471993,297449,7057852,2616513,3907478,6523991,2618102,1639125,1081468,712036,475945,354888,6881564,13939416,27202843,27202843
Niger,2024,NE,NER,AFR,2790174,4188406,6978580,2823367,1784087,1171507,766055,486813,311995,7343824,2703062,4053719,6756781,2728857,1715455,1118104,738182,490963,368221,7159782,14503606,28238972,28238972
Niger,2025,NE,NER,AFR,2881377,4343010,7224387,2940793,1866090,1209903,796731,502312,328282,7644111,2792136,4203984,6996120,2842793,1795770,1156321,766735,506525,383207,7451351,15095462,29315971,29315971
Niger,2026,NE,NER,AFR,2974604,4501771,7476375,3060787,1951910,1250606,829178,517974,344997,7955452,2883240,4358453,7241693,2959272,1879799,1196799,797109,522276,398775,7754030,15709482,30427550,30427550
Niger,2027,NE,NER,AFR,3069211,4665923,7735134,3182204,2041685,1294340,862624,533980,362086,8276919,2975419,4518445,7493864,3077298,1967617,1240176,828778,538267,414908,8067044,16343963,31572965,31572965
Niger,2028,NE,NER,AFR,3165510,4834359,7999869,3305872,2135279,1342079,896476,550570,379530,8609806,3069044,4683008,7752052,3197466,2059118,1287407,861325,554609,431645,8391570,17001376,32753299,32753299
Niger,2029,NE,NER,AFR,3262985,5006818,8269803,3432615,2232480,1393806,930923,568056,397314,8955194,3163950,4851676,8015626,3320364,2154244,1338548,894906,571583,448955,8728600,17683794,33969221,33969221
Niger,2030,NE,NER,AFR,3359049,5184022,8543071,3562652,2332511,1450398,965868,586780,415332,9313541,3257582,5025098,8282680,3446255,2252350,1394388,929334,589587,466736,9078650,18392191,35217942,35217942
Niger,1950,NE,NER,AFR,236661,343862,580523,228913,157399,105162,57517,22551,9485,581027,284356,407257,691613,271580,188309,127091,79571,35223,14254,716028,1297055,2569191,2569191
Niger,1951,NE,NER,AFR,252227,355166,607393,236926,162330,108855,61244,24295,9592,603242,286617,420852,707469,280960,193634,131718,82021,39150,14112,741595,1344837,2659698,2659698
Niger,1952,NE,NER,AFR,268616,365092,633708,244966,166936,112431,64997,26021,9686,625037,290403,433434,723837,290445,198663,136125,84471,43294,13992,766990,1392027,2749567,2749567
Niger,1953,NE,NER,AFR,287324,372282,659606,253121,171272,115895,68681,27770,9833,646572,297398,443144,740542,300044,203492,140315,87015,47399,13992,792257,1438829,2838983,2838983
Niger,1954,NE,NER,AFR,309647,375591,685238,261522,175453,119245,72144,29638,10121,668123,307365,450136,757501,309741,208301,144322,89775,51038,14389,817566,1485689,2928430,2928430
Niger,1955,NE,NER,AFR,326609,384296,710905,270179,179575,122488,75339,31665,10577,689823,317389,457351,774740,319601,213200,148173,92777,54081,15247,843079,1532902,3018555,3018555
Niger,1956,NE,NER,AFR,336180,400644,736824,279078,183730,125682,78293,33848,11201,711832,326702,465452,792154,329715,218255,151878,96020,56600,16512,868980,1580812,3109788,3109788
Niger,1957,NE,NER,AFR,345725,417242,762967,288375,188012,128867,81012,36173,12008,734447,335989,473707,809696,340216,223567,155478,99531,58587,18157,895536,1629983,3202649,3202649
Niger,1958,NE,NER,AFR,355424,433997,789421,298243,192517,132054,83571,38629,12938,757952,345418,481982,827400,351312,229203,159013,103234,60193,20111,923066,1681018,3297840,3297840
Niger,1959,NE,NER,AFR,365413,451006,816419,308636,197355,135239,86113,41168,13882,782393,355097,490264,845361,363103,235196,162534,106940,61767,22234,951774,1734167,3395947,3395947
Niger,1960,NE,NER,AFR,375692,468631,844323,319266,202641,138447,88702,43756,14835,807647,365023,498780,863803,375452,241626,166104,110563,63484,24429,981658,1789305,3497431,3497431
Niger,1961,NE,NER,AFR,386208,487363,873571,329640,208467,141710,91338,46394,15799,833348,375219,507916,883135,387908,248636,169749,114143,65306,26734,1012476,1845824,3602530,3602530
Niger,1962,NE,NER,AFR,396926,508006,904932,338939,214837,145018,94025,49097,16749,858665,385592,518383,903975,399675,256293,173466,117681,67223,29150,1043488,1902153,3711068,3711068
Niger,1963,NE,NER,AFR,407778,531852,939630,345785,221746,148394,96758,51786,17753,882222,396072,531973,928045,408926,264521,177315,121173,69291,31575,1072801,1955023,3822697,3822697
Niger,1964,NE,NER,AFR,418641,559866,978507,349033,229217,151897,99516,54355,18922,902940,406585,548601,955186,415689,273213,181405,124619,71579,33866,1100371,2003311,3937008,3937008
Niger,1965,NE,NER,AFR,429335,583419,1012754,357325,237198,155582,102290,56775,20278,929448,416948,565527,982475,422633,282336,185807,128018,74082,35970,1128846,2058294,4053524,4053524
Niger,1966,NE,NER,AFR,439990,600406,1040396,372799,245574,159465,105104,59052,21807,963801,427325,582044,1009369,430402,291909,190538,131381,76798,37910,1158938,2122739,4172501,4172501
Niger,1967,NE,NER,AFR,450835,617538,1068373,388575,254421,163589,107967,61186,23511,999249,437899,598704,1036603,438321,301977,195638,134713,79730,39677,1190056,2189305,4294283,4294283
Niger,1968,NE,NER,AFR,461449,634831,1096280,404539,263809,167970,110860,63226,25325,1035729,448237,615548,1063785,446286,312618,201096,138025,82816,41324,1222165,2257894,4417954,4417954
Niger,1969,NE,NER,AFR,471652,652311,1123963,420744,273609,172625,113738,65241,27136,1073093,458166,632597,1090763,454255,323845,206855,141314,85891,42999,1255159,2328252,4542993,4542993
Niger,2031,NE,NER,AFR,3454099,5363261,8817360,3698045,2434642,1512989,1000721,606906,433513,9686816,3350273,5200686,8550959,3577384,2352738,1455898,963947,608836,484966,9443769,19130585,36498899,36498899
Niger,2032,NE,NER,AFR,3550458,5543561,9094019,3839179,2539620,1580585,1035891,628563,451851,10075689,3444257,5377338,8821595,3714221,2456071,1522191,999094,629470,503605,9824652,19900341,37815958,37815958
Niger,2033,NE,NER,AFR,3646608,5725954,9372562,3984863,2648196,1652712,1071353,652241,470224,10479589,3538019,5556159,9094178,3855710,2562797,1592973,1034687,652048,522528,10220743,20700332,39167073,39167073
Niger,2034,NE,NER,AFR,3742011,5910981,9652992,4134666,2760570,1729215,1106969,678158,488633,10898211,3631112,5737698,9368810,4001581,2672797,1668265,1070550,676863,541747,10631803,21530014,40551808,40551808
Niger,2035,NE,NER,AFR,3838610,6097349,9935959,4288299,2876441,1809491,1143961,706053,507225,11331470,3725417,5920651,9646068,4151455,2785895,1747399,1107842,703694,561392,11057677,22389147,41971174,41971174
Niger,2036,NE,NER,AFR,3936003,6284808,10220811,4446060,2994851,1893496,1183199,735519,526130,11779255,3820473,6104823,9925296,4305522,2901538,1830198,1147351,732219,581559,11498387,23277642,43423749,43423749
Niger,2037,NE,NER,AFR,4032393,6475012,10507405,4609154,3114676,1981364,1225345,765855,545479,12241873,3914537,6291473,10206010,4465086,3018748,1916737,1189679,761936,602261,11954447,24196320,44909740,44909740
Niger,2038,NE,NER,AFR,4129799,6666775,10796574,4776486,3236731,2072969,1271312,796523,565449,12719470,4009601,6479490,10489091,4629213,3138110,2006919,1235737,792450,623587,12426016,25145486,46431153,46431153
Niger,2039,NE,NER,AFR,4227033,6859090,11086123,4947811,3361820,2168098,1321097,827716,586298,13212840,4104535,6668252,10772787,4797449,3260205,2100682,1285597,823927,645767,12913627,26126467,47985369,47985369
Niger,2040,NE,NER,AFR,4320750,7051324,11372074,5123850,3490160,2266010,1375543,859359,608213,13723135,4196049,6857079,11053128,4970424,3385283,2197407,1340008,856189,669040,13418351,27141486,49566690,49566690
Niger,2041,NE,NER,AFR,4414689,7243449,11658138,5301935,3623773,2366005,1435706,890924,631299,14249642,4287755,7045855,11333610,5145598,3515554,2296414,1399909,888629,693553,13939657,28189299,51181048,51181048
Niger,2042,NE,NER,AFR,4509417,7435908,11945325,5481105,3763040,2468799,1500644,922797,655657,14792042,4380232,7235040,11615272,5321896,3651496,2398341,1464442,921581,719411,14477167,29269209,52829810,52829810
Niger,2043,NE,NER,AFR,4601200,7629245,12230445,5662371,3906794,2575113,1569897,954992,681612,15350779,4469794,7425087,11894881,5500383,3792060,2503631,1533315,954995,747009,15031393,30382172,54507499,54507499
Niger,2044,NE,NER,AFR,4690253,7821823,12512076,5846271,4054617,2685155,1643313,987420,709355,15926131,4556750,7614447,12171197,5681611,3936986,2612179,1606571,988736,776613,15602696,31528827,56212092,56212092
Niger,2045,NE,NER,AFR,4780818,8012212,12793030,6031515,4206228,2798647,1720355,1021209,738754,16516708,4645254,7801722,12446976,5864291,4085915,2723824,1683579,1023914,808155,16189678,32706386,57946395,57946395
Niger,2046,NE,NER,AFR,4869765,8203640,13073405,6217859,4361923,2914644,1800988,1057126,769559,17122099,4732209,7989968,12722177,6048213,4239036,2838030,1764182,1061250,841412,16792123,33914222,59709808,59709808
Niger,2047,NE,NER,AFR,4956289,8394836,13351125,6406931,4522868,3032050,1885331,1095737,801273,17744190,4816895,8178007,12994902,6234636,4397632,2953834,1848447,1101288,875945,17411782,35155972,61501999,61501999
Niger,2048,NE,NER,AFR,5043665,8584129,13627794,6597560,4688007,3151675,1973276,1137834,833599,18381951,4902368,8364149,13266517,6422450,4560770,3071805,1936285,1144850,911477,18047637,36429588,63323897,63323897
Niger,2049,NE,NER,AFR,5130914,8770661,13901575,6788752,4857097,3274301,2064631,1183446,866879,19035106,4987645,8547620,13535265,6611033,4728019,3192518,2027652,1192034,948338,18699594,37734700,65171542,65171542
Niger,2050,NE,NER,AFR,5215848,8955323,14171171,6979894,5030853,3400140,2158706,1233330,901179,19704102,5070602,8729344,13799946,6799729,4900015,3316240,2121955,1243541,986595,19368075,39072177,67043296,67043296
Nigeria,1970,NG,NGA,AFR,4864830,6889653,11754483,5083047,3994319,2867397,1994716,1217549,824904,15981932,4787092,6876019,11663111,5044599,3923531,2843066,2030612,1329000,998928,16169736,32151668,55569264,55569264
Nigeria,1971,NG,NGA,AFR,4996538,7075474,12072012,5163932,4081878,2930268,2041398,1249465,843015,16309956,4910552,7052643,11963195,5139044,4004675,2902742,2073108,1357556,1015331,16492456,32802412,56837614,56837614
Nigeria,1972,NG,NGA,AFR,5146567,7266741,12413308,5255540,4163235,2996929,2087906,1283570,863093,16650273,5050943,7234517,12285460,5242042,4080042,2965488,2115627,1388055,1033545,16824799,33475072,58173834,58173834
Nigeria,1973,NG,NGA,AFR,5313996,7466240,12780236,5373909,4231309,3068662,2135474,1320021,885119,17014494,5207745,7423658,12631403,5365581,4147936,3032603,2159293,1420492,1053404,17179309,34193803,59605446,59605446
Nigeria,1974,NG,NGA,AFR,5503750,7676985,13180735,5524855,4284892,3144611,2185146,1358851,908813,17407168,5386538,7622472,13009010,5519614,4203300,3103328,2205113,1454885,1074779,17561019,34968187,61157931,61157931
Nigeria,1975,NG,NGA,AFR,5716172,7901286,13617458,5687871,4348694,3225000,2237801,1399968,934251,17833585,5588989,7833655,13422644,5682302,4273042,3178238,2254147,1491463,1098434,17977626,35811211,62851312,62851312
Nigeria,1976,NG,NGA,AFR,5939410,8143039,14082449,5851014,4428377,3309158,2293164,1443281,961886,18286880,5803653,8061905,13865558,5838568,4365977,3256945,2306199,1530463,1125267,18423419,36710299,64658315,64658315
Nigeria,1977,NG,NGA,AFR,6170350,8403992,14574342,6025942,4516336,3398937,2351873,1488637,991339,18773064,6026031,8310193,14336224,6007329,4467895,3341575,2361916,1572040,1155272,18906027,37679091,66589655,66589655
Nigeria,1978,NG,NGA,AFR,6411395,8684080,15095475,6209341,4610413,3493921,2413308,1534910,1021871,19283764,6258736,8578257,14836993,6185177,4576681,3431823,2420792,1615177,1187464,19417114,38700878,68633344,68633344
Nigeria,1979,NG,NGA,AFR,6649999,8989055,15639054,6396087,4707967,3592691,2476668,1581060,1053485,19807958,6490207,8870326,15360533,6366485,4689285,3525827,2481852,1658497,1220811,19942757,39750715,70750307,70750307
Nigeria,1980,NG,NGA,AFR,6876157,9322480,16198637,6590447,4814276,3696933,2542930,1627039,1086199,20357824,6709890,9189611,15899501,6555952,4811346,3625218,2545933,1701935,1255086,20495470,40853294,72951439,72951439
Nigeria,1981,NG,NGA,AFR,7092089,9678275,16770364,6783079,4922304,3799593,2611089,1672250,1119988,20908303,6918433,9529907,16448340,6742970,4935117,3723337,2611981,1744933,1290040,21048378,41956681,75175387,75175387
Nigeria,1982,NG,NGA,AFR,7296490,10053610,17350100,6970409,5030769,3893361,2680815,1716193,1154690,21446237,7114330,9889255,17003585,6923544,5058156,3813906,2679752,1787154,1325643,21588155,43034392,77388067,77388067
Nigeria,1983,NG,NGA,AFR,7463887,10417005,17880892,7134226,5135555,3955958,2743066,1753256,1185646,21907707,7273129,10237863,17510992,7079880,5172086,3879643,2740389,1822952,1357048,22051998,43959705,79351586,79351586
Nigeria,1984,NG,NGA,AFR,7614664,10793090,18407754,7308708,5265251,4001241,2806746,1790656,1217227,22389829,7415202,10599546,18014748,7242208,5305029,3928065,2801616,1859372,1388941,22525231,44915060,81337553,81337553
Nigeria,1985,NG,NGA,AFR,7770327,11202833,18973160,7518566,5416139,4062713,2879528,1834326,1252862,22964134,7562603,10995871,18558474,7438313,5454464,3995601,2871922,1903089,1426093,23089482,46053616,83585251,83585251
Nigeria,1986,NG,NGA,AFR,7908996,11606119,19515115,7737200,5556150,4131846,2951541,1877890,1287761,23542388,7694826,11385855,19080681,7645660,5589427,4078748,2942322,1947264,1462585,23666006,47208394,85804185,85804185
Nigeria,1987,NG,NGA,AFR,8035636,12001008,20036644,7974359,5703110,4203885,3025608,1922590,1322743,24152295,7815540,11767640,19583180,7870932,5730185,4164195,3014652,1992676,1499437,24272077,48424372,88044187,88044187
Nigeria,1988,NG,NGA,AFR,8157853,12389565,20547418,8235540,5861082,4281142,3103731,1969098,1358372,24808965,7930400,12145408,20075808,8117977,5878907,4253477,3090591,2040233,1538089,24919274,49728239,90351467,90351467
Nigeria,1989,NG,NGA,AFR,8295508,12760117,21055625,8524876,6026844,4363243,3185912,2017471,1394895,25513241,8058408,12507435,20565843,8391352,6033218,4346489,3170036,2089840,1578412,25609347,51122588,92744064,92744064
Nigeria,1990,NG,NGA,AFR,8458293,13100775,21559068,8843253,6199566,4449907,3271026,2067262,1431571,26262585,8209784,12841991,21051775,8692353,6192593,4443173,3252045,2141112,1619560,26340836,52603421,95214257,95214257
Nigeria,1991,NG,NGA,AFR,8639552,13412467,22052019,9173815,6366569,4536491,3353286,2117644,1466944,27014749,8380279,13149416,21529695,9009666,6350392,4541896,3332873,2193871,1660199,27088897,54103646,97685360,97685360
Nigeria,1992,NG,NGA,AFR,8842980,13699304,22542284,9518094,6531331,4627908,3429215,2169543,1501032,27777123,8573327,13431755,22005082,9343826,6508993,4646011,3409448,2248866,1700408,27857552,55634675,100182045,100182045
Nigeria,1993,NG,NGA,AFR,9069448,13969054,23038502,9887340,6706883,4739664,3492657,2223784,1535096,28585424,8788277,13695240,22483517,9701986,6676097,4764230,3477982,2306320,1741403,28668018,57253442,102775465,102775465
Nigeria,1994,NG,NGA,AFR,9310030,14237903,23547933,10271497,6894436,4874221,3540615,2278724,1568970,29428463,9018202,13954259,22972461,10074573,6852626,4902142,3531785,2364182,1781953,29507261,58935724,105456121,105456121
Nigeria,1995,NG,NGA,AFR,9559245,14513087,24072332,10654449,7089848,5010453,3590515,2333141,1602061,30280467,9259977,14217230,23477207,10448107,7037247,5038326,3590809,2421523,1821595,30357607,60638074,108187610,108187610
Nigeria,1996,NG,NGA,AFR,9815154,14792715,24607869,11027385,7293537,5140429,3649306,2387746,1635121,31133524,9510147,14486103,23996250,10814723,7233247,5163666,3665284,2479611,1862005,31218536,62352060,110956183,110956183
Nigeria,1997,NG,NGA,AFR,10069245,15085894,25155139,11394875,7514471,5276730,3711088,2444253,1669422,32010839,9759476,14767017,24526493,11174969,7445792,5293969,3741707,2539186,1903088,32098711,64109550,113791181,113791181
Nigeria,1998,NG,NGA,AFR,10316524,15399810,25716334,11756889,7752776,5418386,3775990,2503956,1706275,32914272,10004581,15061876,25066457,11528818,7674066,5427307,3819162,2600234,1943875,32993462,65907734,116690527,116690527
Nigeria,1999,NG,NGA,AFR,10576836,15744975,26321811,12099166,8010877,5562283,3843770,2567123,1746456,33829675,10263439,15382980,25646419,11864553,7922669,5562380,3898297,2663586,1986169,33897654,67727329,119695565,119695565
Nigeria,2000,NG,NGA,AFR,10870833,16128332,26999165,12411654,8290857,5708442,3914752,2633322,1790178,34749205,10552227,15741383,26293610,12173269,8194740,5700292,3980262,2729605,2031836,34810004,69559209,122851984,122851984
Nigeria,2001,NG,NGA,AFR,11197160,16545056,27742216,12700980,8591150,5857982,3990894,2700368,1837147,35678521,10869386,16133498,27002884,12458527,8486777,5841160,4066404,2796017,2080174,35729059,71407580,126152678,126152678
Nigeria,2002,NG,NGA,AFR,11554664,16986746,28541410,12970605,8910367,6011406,4074628,2764084,1886286,36617376,11217650,16551979,27769629,12721847,8797551,5985752,4158895,2859628,2130943,36654616,73271992,129583026,129583026
Nigeria,2003,NG,NGA,AFR,11938134,17447083,29385217,13221327,9244622,6168407,4173243,2816619,1937428,37561646,11592376,16991423,28583799,12964992,9126274,6135128,4262577,2916000,2184171,37589142,75150788,133119801,133119801
Nigeria,2004,NG,NGA,AFR,12321311,17935847,30257158,13471159,9588045,6332274,4289954,2856225,1990281,38527938,11967626,17460253,29427879,13204333,9466310,6291654,4383215,2959774,2238582,38543868,77071806,136756848,136756848
Nigeria,2005,NG,NGA,AFR,12691839,18467910,31159749,13726330,9928598,6503364,4408983,2898894,2044762,39510931,12332277,17971119,30303396,13447804,9806586,6456204,4503170,3008948,2293931,39516643,79027574,140490722,140490722
Nigeria,2006,NG,NGA,AFR,13057178,19042997,32100175,13986491,10261174,6685145,4525127,2951176,2101910,40511023,12693388,18521989,31215377,13694809,10138921,6631829,4614294,3072230,2351107,40503190,81014213,144329764,144329764
Nigeria,2007,NG,NGA,AFR,13418758,19651666,33070424,14265057,10589392,6881577,4646638,3006213,2161604,41550481,13051336,19106124,32157460,13954594,10463542,6821144,4729395,3137090,2409901,41515666,83066147,148294028,148294028
Nigeria,2008,NG,NGA,AFR,13786886,20283203,34070089,14565054,10911951,7092309,4772044,3063522,2224031,42628911,13414490,19713524,33128014,14230242,10781709,7024127,4847096,3202794,2469518,42555486,85184397,152382506,152382506
Nigeria,2009,NG,NGA,AFR,14164658,20929540,35094198,14895831,11218770,7323019,4900309,3123798,2290094,43751821,13785187,20334625,34119812,14532002,11083589,7246189,4966586,3270234,2531324,43629924,87381745,156595758,156595758
Nigeria,2010,NG,NGA,AFR,14537394,21596432,36133826,15268463,11506273,7578658,5032648,3187420,2359174,44932636,14152317,20974503,35126820,14874385,11366416,7492618,5089581,3340513,2596056,44759569,89692205,160952853,160952853
Nigeria,2011,NG,NGA,AFR,14900962,22290880,37191842,15680132,11780571,7856555,5169596,3255894,2430048,46172796,14513670,21638906,36152576,15256387,11635291,7760684,5216589,3414987,2662592,45946530,92119326,165463745,165463745
Nigeria,2012,NG,NGA,AFR,15248851,23012119,38260970,16118529,12039803,8152639,5310605,3331126,2500127,47452829,14860975,22329805,37190780,15665802,11886841,8046996,5347547,3495265,2728904,47171355,94624184,170075932,170075932
Nigeria,2013,NG,NGA,AFR,15559266,23762880,39322146,16572907,12283881,8464939,5455949,3418562,2562544,48758782,15174327,23050646,38224973,16091778,12119983,8350316,5482953,3584679,2790519,48420228,97179010,174726123,174726123
Nigeria,2014,NG,NGA,AFR,15834053,24520852,40354905,17046828,12522403,8784114,5606653,3519625,2615053,50094676,15453422,23778476,39231898,16537285,12344382,8661870,5623921,3687311,2842772,49697541,99792217,179379016,179379016
Nigeria,2015,NG,NGA,AFR,16085729,25257065,41342794,17550314,12757456,9098696,5762876,3622018,2669284,51460644,15704719,24487875,40192594,17009645,12562484,8969807,5770526,3788677,2898618,50999757,102460401,183995785,183995785
Nigeria,2016,NG,NGA,AFR,16323946,25976539,42300485,18096613,13000630,9410016,5930529,3722695,2731015,52891498,15935959,25184007,41119966,17520182,12786200,9272929,5928024,3882939,2964720,52354994,105246492,188666931,188666931
Nigeria,2017,NG,NGA,AFR,16564624,26677407,43242031,18689210,13271738,9721972,6113391,3828605,2796009,54420925,16164214,25864037,42028251,18077325,13035256,9575630,6100830,3981872,3033793,53804706,108225631,193495907,193495907
Nigeria,2018,NG,NGA,AFR,16816469,27346375,44162844,19302517,13560350,10027949,6308851,3938169,2864437,56002273,16400317,26515690,42916007,18657336,13298193,9873108,6286892,4084349,3106624,55306502,111308775,198387623,198387623
Nigeria,2019,NG,NGA,AFR,17079981,27989527,45069508,19921379,13868007,10315274,6520439,4049487,2936743,57611329,16648140,27142313,43790453,19242992,13576733,10152650,6489316,4188500,3183007,56833198,114444527,203304492,203304492
Nigeria,2020,NG,NGA,AFR,17357211,28610013,45967224,20567566,14217249,10582606,6751082,4158001,2999445,59275949,16911828,27747296,44659124,19855325,13895864,10413615,6712017,4292633,3255652,58425106,117701055,208327405,208327405
Nigeria,2021,NG,NGA,AFR,17643718,29210592,46854310,21241909,14599190,10830108,6994268,4261302,3045922,60972699,17187080,28331581,45518661,20493420,14247891,10655030,6948735,4393686,3316892,60055654,121028353,213401323,213401323
Nigeria,2022,NG,NGA,AFR,17920334,29795165,47715499,21935528,14999094,11059527,7254327,4373603,3110555,62732634,17457353,28897356,46354709,21151055,14618621,10875934,7201591,4501239,3389925,61738365,124470999,218541212,218541212
Nigeria,2023,NG,NGA,AFR,18186588,30355805,48542393,22658941,15418354,11279370,7535053,4498782,3199995,64590495,17720903,29441075,47161978,21839882,15009761,11083773,7474478,4619686,3482184,63509764,128100259,223804632,223804632
Nigeria,2024,NG,NGA,AFR,18456672,30896602,49353274,23390975,15864431,11501332,7825331,4630047,3292777,66504893,17988460,29968923,47957383,22537611,15428054,11290594,7758082,4744452,3577886,65336679,131841572,229152217,229152217
Nigeria,2025,NG,NGA,AFR,18724685,31428489,50153174,24105958,16351000,11732767,8117724,4769021,3389374,68465844,18254310,30488859,48743169,23222468,15885516,11504528,8044682,4876983,3677238,67211415,135677259,234573603,234573603
Nigeria,2026,NG,NGA,AFR,18983159,31953405,50936564,24806086,16877352,11972066,8407526,4918125,3490558,70471713,18510458,31001604,49512062,23898384,16380378,11725736,8328674,5020114,3780865,69134151,139605864,240054483,240054483
Nigeria,2027,NG,NGA,AFR,19242198,32471687,51713885,25487222,17435203,12225051,8692130,5077965,3596559,72514130,18765875,31508138,50274013,24559170,16907328,11959015,8607624,5174915,3889080,71097132,143611262,245599161,245599161
Nigeria,2028,NG,NGA,AFR,19500336,32994655,52494991,26139102,18015648,12496542,8972420,5249147,3706842,74579701,19019758,32017998,51037756,25195484,17459479,12207510,8883070,5341817,4001406,73088766,147668467,251201204,251201204
Nigeria,2029,NG,NGA,AFR,19749564,33531732,53281296,26767923,18610303,12794615,9240151,5435803,3820676,76669471,19265058,32542760,51807818,25811476,18027344,12479879,9146758,5524793,4117221,75107471,151776942,256866062,256866062
Nigeria,2030,NG,NGA,AFR,19987913,34075536,54063449,27373342,19223772,13124256,9487593,5639598,3937946,78786507,19499826,33077860,52577686,26404167,18613222,12782867,9390800,5725368,4236365,77152789,155939296,262580426,262580426
Nigeria,1950,NG,NGA,AFR,3138343,4721858,7860201,3549013,2634885,1849888,1328933,857142,469043,10688904,3030688,4570761,7601449,3462203,2618782,1892666,1423431,994243,647485,11038810,21727714,37189369,37189369
Nigeria,1951,NG,NGA,AFR,3155369,4823130,7978499,3625428,2694815,1893735,1343862,880780,486747,10925367,3075576,4664314,7739890,3534947,2674229,1931628,1437324,1015360,665930,11259418,22184785,37903171,37903171
Nigeria,1952,NG,NGA,AFR,3181542,4917186,8098728,3704665,2752581,1939152,1359362,904478,504556,11164794,3126176,4752543,7878719,3609741,2728156,1972062,1451621,1036399,684207,11482186,22646980,38624425,38624425
Nigeria,1953,NG,NGA,AFR,3231581,4990672,8222253,3784545,2807030,1985269,1375952,927149,522676,11402621,3192012,4828146,8020158,3684293,2779372,2013111,1466786,1056539,702593,11702694,23105315,39347719,39347719
Nigeria,1954,NG,NGA,AFR,3311746,5040322,8352068,3864465,2860313,2032465,1394711,947177,541215,11640346,3284090,4883288,8167378,3758249,2829907,2055045,1483844,1074508,721130,11922683,23563029,40082479,40082479
Nigeria,1955,NG,NGA,AFR,3395444,5093620,8489064,3945354,2914768,2081151,1416405,964216,560215,11882109,3374366,4947347,8321713,3832722,2881966,2098260,1503415,1090097,739877,12146337,24028446,40839223,40839223
Nigeria,1956,NG,NGA,AFR,3471499,5160762,8632261,4027601,2970160,2130989,1441155,978268,579494,12127667,3448566,5034085,8482651,3908182,2935214,2142646,1525737,1103313,758907,12373999,24501666,41616571,41616571
Nigeria,1957,NG,NGA,AFR,3550328,5229997,8780325,4111997,3026559,2181934,1468685,989692,598965,12377832,3525312,5123544,8648856,3985480,2989470,2188227,1550636,1114333,778198,12606344,24984176,42413359,42413359
Nigeria,1958,NG,NGA,AFR,3630878,5300598,8931476,4197311,3081854,2232229,1498144,999547,618777,12627862,3603642,5214554,8818196,4063019,3042267,2233259,1577169,1123925,797574,12837213,25465075,43214753,43214753
Nigeria,1959,NG,NGA,AFR,3713133,5373597,9086730,4287721,3140071,2282650,1530057,1009389,638858,12888746,3683701,5307999,8991700,4145161,3097583,2278500,1605704,1133327,816790,13077065,25965811,44044231,44044231
Nigeria,1960,NG,NGA,AFR,3799796,5450037,9249833,4385619,3204981,2334531,1564821,1020293,658712,13168957,3768032,5405284,9173316,4234985,3159429,2325538,1636784,1143709,835794,13336239,26505196,44928342,44928342
Nigeria,1961,NG,NGA,AFR,3891848,5532564,9424412,4484616,3274994,2386630,1601934,1032080,678577,13458831,3857252,5508737,9365989,4326631,3226128,2373397,1670125,1154975,855023,13606279,27065110,45855507,45855507
Nigeria,1962,NG,NGA,AFR,3989776,5626481,9616257,4577838,3350274,2438469,1641206,1044906,698790,13751483,3952025,5621840,9573865,4414322,3297503,2421483,1705442,1167042,874444,13880236,27631719,46821845,46821845
Nigeria,1963,NG,NGA,AFR,4093631,5745069,9838700,4652029,3429175,2490033,1682333,1059257,718638,14031465,4052199,5752121,9804320,4490319,3371884,2469764,1742406,1180341,893369,14148083,28179548,47822569,47822569
Nigeria,1964,NG,NGA,AFR,4202217,5893363,10095580,4703534,3509510,2542020,1725069,1075633,736997,14292763,4156713,5909280,10065993,4547173,3447517,2519147,1780976,1195697,911479,14401989,28694752,48856332,48856332
Nigeria,1965,NG,NGA,AFR,4313117,6048721,10361838,4758099,3591387,2595569,1769408,1094515,753948,14562926,4263211,6068558,10331769,4611967,3524258,2570355,1820928,1213282,928468,14669258,29232184,49925799,49925799
Nigeria,1966,NG,NGA,AFR,4424908,6202598,10627506,4823737,3673686,2650093,1815025,1116093,769947,14848581,4369474,6217342,10586816,4695534,3600948,2622457,1861758,1232917,943791,14957405,29805986,51020296,51020296
Nigeria,1967,NG,NGA,AFR,4531968,6364105,10896073,4885351,3751755,2702506,1859656,1138357,783103,15120728,4471106,6372729,10843835,4779631,3677937,2674978,1903029,1253903,956566,15246044,30366772,52106681,52106681
Nigeria,1968,NG,NGA,AFR,4637236,6533026,11170262,4945814,3828390,2754428,1903843,1161933,795124,15389532,4571664,6535170,11106834,4865499,3757506,2729107,1945208,1276873,969301,15543494,30933026,53210119,53210119
Nigeria,1969,NG,NGA,AFR,4747724,6708512,11456236,5010298,3908043,2808716,1948728,1188376,809003,15673164,4676756,6703322,11380078,4953212,3839281,2785021,1987867,1302152,983736,15851269,31524433,54360750,54360750
Nigeria,2031,NG,NGA,AFR,20216425,34614629,54831054,27958009,19862108,13481962,9717744,5857272,4058594,80935689,19724788,33612096,53336884,26976252,19222126,13114512,9617419,5940347,4358923,79229579,160165268,268333202,268333202
Nigeria,2032,NG,NGA,AFR,20430248,35146921,55577169,28529882,20525422,13862238,9933322,6087413,4182752,83121029,19935311,34142972,54078283,27534518,19856709,13469674,9827962,6168733,4485336,81342932,164463961,274119414,274119414
Nigeria,2033,NG,NGA,AFR,20625576,35672436,56298012,29081405,21217427,14260251,10138595,6330550,4311447,85339675,20127064,34668495,54795559,28073884,20521068,13843486,10025538,6411341,4616499,83491816,168831491,279925063,279925063
Nigeria,2034,NG,NGA,AFR,20802718,36193029,56995747,29614876,21918903,14684089,10346567,6581700,4446056,87592191,20300930,35189712,55490642,28599126,21195331,14243552,10222784,6663114,4753529,85677436,173269627,285756014,285756014
Nigeria,2035,NG,NGA,AFR,20957897,36701149,57659046,30140614,22605631,15146578,10563757,6834445,4587962,89878987,20453872,35699242,56153114,29117809,21859044,14681268,10427097,6917348,4897887,87900453,177779440,291591598,291591598
Nigeria,2036,NG,NGA,AFR,21089824,37190949,58280773,30660411,23279575,15646989,10788646,7084957,4739526,92200104,20583541,36190492,56774033,29630532,22515825,15154943,10638636,7169393,5052422,90161751,182361855,297416662,297416662
Nigeria,2037,NG,NGA,AFR,21208500,37667560,58876060,31174461,23936701,16177657,11026583,7331154,4901484,94548040,20699919,36667711,57367630,30138200,23159618,15659668,10861827,7417283,5218273,92454869,187002909,303246595,303246595
Nigeria,2038,NG,NGA,AFR,21328514,38126183,59454697,31693493,24567217,16730387,11282107,7573932,5073882,96921018,20818042,37125991,57944033,30649813,23781426,16189091,11099650,7662421,5395273,94777674,191698692,309097424,309097424
Nigeria,2039,NG,NGA,AFR,21438547,38558725,59997272,32226470,25176927,17297372,11562432,7806363,5259040,99328604,20925999,37558872,58484871,31176239,24385054,16734388,11359965,7897712,5585808,97139166,196467770,314949915,314949915
Nigeria,2040,NG,NGA,AFR,21536582,38959779,60496361,32766200,25765480,17882881,11871815,8021825,5457753,101765954,21021401,37961459,58982860,31713056,24967636,17297757,11648876,8116327,5790827,99534479,201300433,320779660,320779660
Nigeria,2041,NG,NGA,AFR,21635429,39329188,60964617,33301736,26335264,18492425,12206944,8222883,5667443,104226695,21118103,38332460,59450563,32249582,25531610,17883729,11964516,8320170,6007850,101957457,206184152,326599329,326599329
Nigeria,2042,NG,NGA,AFR,21719953,39672104,61392057,33831119,26893671,19125936,12562757,8412079,5887297,106712859,21200873,38677311,59878184,32783388,26083208,18494524,12302037,8510514,6236295,104409966,211122825,332393067,332393067
Nigeria,2043,NG,NGA,AFR,21779599,39998993,61778592,34354222,27433400,19786841,12934922,8593422,6118382,109221189,21258898,39006384,60265282,33312436,26617537,19133985,12657053,8690474,6477605,106889090,216110279,338154157,338154157
Nigeria,2044,NG,NGA,AFR,21833830,40298798,62132628,34872667,27956435,20457169,13331144,8778065,6357390,111752870,21311966,39308503,60620469,33837539,27138971,19783560,13036766,8871164,6728388,109396388,221149258,343902355,343902355
Nigeria,2045,NG,NGA,AFR,21877347,40566666,62444013,35379295,28472572,21114418,13763369,8971378,6600138,114301170,21354963,39578763,60933726,34351594,27654623,20424136,13451741,9058782,6983919,111924795,226225965,349603702,349603702
Nigeria,2046,NG,NGA,AFR,21898434,40813259,62711693,35868480,28983530,21760428,14230819,9172008,6845709,116860974,21375421,39828233,61203654,34848326,28165146,21059129,13900445,9253425,7242800,114469271,231330245,355245595,355245595
Nigeria,2047,NG,NGA,AFR,21916953,41033044,62949997,36345043,29489370,22391321,14726571,9384678,7093295,119430278,21393947,40051267,61445214,35331787,28671335,21682833,14378483,9459121,7504464,117028023,236458301,360853520,360853520
Nigeria,2048,NG,NGA,AFR,21936958,41229703,63166661,36804440,30000320,22997888,15243266,9613493,7343463,122002870,21414201,40251542,61665743,35797190,29181651,22286665,14880091,9678700,7769987,119594284,241597154,366429556,366429556
Nigeria,2049,NG,NGA,AFR,21942540,41411451,63353991,37238828,30524918,23585467,15773716,9864367,7592556,124579852,21419597,40436915,61856512,36238183,29706468,22874056,15397101,9918804,8035273,122169885,246749737,371960240,371960240
Nigeria,2050,NG,NGA,AFR,21956794,41571829,63528623,37642853,31056239,24153676,16321762,10140450,7836131,127151111,21433489,40600750,62034239,36650066,30241586,23442358,15931640,10184457,8295804,124745911,251897022,377459883,377459883
Nicaragua,1970,NI,NIC,AMR,234261,354740,589001,243996,151994,102907,67173,39675,25804,631549,229285,350190,579475,238806,144302,107106,75367,46273,32877,644731,1276280,2444767,2444767
Nicaragua,1971,NI,NIC,AMR,242401,365122,607523,254295,156176,105890,69295,40944,26618,653218,237195,360592,597787,249772,148176,108910,78111,47769,34220,666958,1320176,2525481,2525481
Nicaragua,1972,NI,NIC,AMR,250183,375364,625547,264338,160368,108744,71276,42085,27316,674127,244829,370642,615471,260239,152168,110444,80693,49100,35393,688037,1362164,2603182,2603182
Nicaragua,1973,NI,NIC,AMR,258040,386115,644155,273993,165209,111627,73269,43253,28038,695389,252584,381149,633733,270169,157024,111988,83213,50464,36598,709456,1404845,2682747,2682747
Nicaragua,1974,NI,NIC,AMR,266512,397943,664455,283482,171025,114716,75433,44604,28933,718193,260950,392847,653797,279815,163227,113869,85707,52115,38038,732771,1450964,2769211,2769211
Nicaragua,1975,NI,NIC,AMR,274803,410403,685206,292296,177827,117814,77606,46012,29848,741403,269175,405140,674315,288618,170668,115882,87933,53925,39505,756531,1497934,2857461,2857461
Nicaragua,1976,NI,NIC,AMR,282789,423559,706348,300743,185374,120862,79799,47484,30796,765058,277130,418108,695238,297091,178920,117991,89904,55886,41015,780807,1545865,2947454,2947454
Nicaragua,1977,NI,NIC,AMR,290406,437342,727748,309324,192933,123852,81993,49002,31783,788887,284760,431712,716472,305811,187340,120239,91608,57995,42582,805575,1594462,3038680,3038680
Nicaragua,1978,NI,NIC,AMR,297354,451672,749026,317530,199988,126577,84043,50456,32710,811304,291769,445884,737653,314697,195862,122591,93066,60192,44148,830556,1641860,3128544,3128544
Nicaragua,1979,NI,NIC,AMR,303678,466422,770100,324630,205811,128637,85750,51717,33484,830029,298175,460532,758707,323612,204402,125002,94362,62408,45700,855486,1685515,3214311,3214311
Nicaragua,1980,NI,NIC,AMR,309854,481580,791434,332664,212239,130878,87617,53080,34377,850855,304403,475637,780040,332664,213068,127574,95659,64667,47357,880989,1731844,3303309,3303309
Nicaragua,1981,NI,NIC,AMR,315904,496978,812882,342404,220065,133655,89840,54665,35472,876101,310462,491055,801517,341926,221899,130289,96961,66981,49100,907156,1783257,3397659,3397659
Nicaragua,1982,NI,NIC,AMR,321859,512229,834088,352399,227743,136512,92047,56240,36570,901511,316341,506424,822765,351405,230495,133295,98186,69313,50848,933542,1835053,3491906,3491906
Nicaragua,1983,NI,NIC,AMR,327640,527150,854790,362320,234434,139653,94120,57733,37641,925901,321950,521548,843498,361304,238449,137053,99392,71570,52654,960422,1886323,3584610,3584610
Nicaragua,1984,NI,NIC,AMR,332992,541766,874758,371944,239741,143012,95980,59102,38661,948440,327050,536404,863454,371661,245566,141754,100665,73627,54575,987848,1936288,3674501,3674501
Nicaragua,1985,NI,NIC,AMR,337895,556008,893903,381928,243952,146957,97697,60419,39702,970655,331650,550851,882501,382598,251715,147546,102019,75438,56652,1015968,1986623,3763034,3763034
Nicaragua,1986,NI,NIC,AMR,342327,569752,912079,392922,247889,151490,99357,61763,40832,994253,335750,564752,900502,394270,257496,154060,103454,77020,58875,1045175,2039428,3852017,3852017
Nicaragua,1987,NI,NIC,AMR,346201,583140,929341,404784,252056,155990,100968,63125,42035,1018958,339286,578222,917508,406716,263566,160721,105004,78373,61275,1075655,2094613,3941463,3941463
Nicaragua,1988,NI,NIC,AMR,349778,596008,945786,417941,256941,160681,102675,64563,43340,1046141,342552,591070,933622,420034,270043,167584,106714,79560,63806,1107741,2153882,4033291,4033291
Nicaragua,1989,NI,NIC,AMR,353165,608229,961394,432829,263229,165974,104608,66163,44788,1077591,345705,603145,948850,434193,276971,174712,108622,80692,66423,1141613,2219204,4129447,4129447
Nicaragua,1990,NI,NIC,AMR,356192,619891,976083,448561,270499,171711,106644,67864,46296,1111575,348606,614543,963149,448979,284330,182098,110717,81829,69062,1177015,2288590,4227820,4227820
Nicaragua,1991,NI,NIC,AMR,358871,630975,989846,464563,278605,177779,108719,69618,47823,1147107,351308,625240,976548,464179,292188,189779,112970,82957,71715,1213788,2360895,4327289,4327289
Nicaragua,1992,NI,NIC,AMR,361074,641537,1002611,480466,287686,184011,111003,71416,49338,1183920,353625,635303,988928,479463,300685,197510,115619,84066,74369,1251712,2435632,4427172,4427172
Nicaragua,1993,NI,NIC,AMR,362577,651687,1014264,495939,297740,190036,113850,73239,50860,1221664,355263,644885,1000148,494574,309923,204840,119100,85204,76974,1290615,2512279,4526689,4526689
Nicaragua,1994,NI,NIC,AMR,363295,661273,1024568,510949,308699,195788,117331,75090,52411,1260268,356075,653881,1009956,509434,319885,211572,123595,86463,79522,1330471,2590739,4625260,4625260
Nicaragua,1995,NI,NIC,AMR,363243,670067,1033310,525344,320505,201092,121618,76951,54024,1299534,355979,662114,1018093,523802,330569,217559,129237,87831,81987,1370985,2670519,4721929,4721929
Nicaragua,1996,NI,NIC,AMR,362516,676877,1039393,536407,332664,206639,126837,79338,56136,1338021,355078,668788,1023866,536094,341514,223471,135784,89602,84654,1411119,2749140,4812391,4812391
Nicaragua,1997,NI,NIC,AMR,361011,681710,1042721,544046,344838,212974,132437,82271,58819,1375385,353377,673807,1027184,546294,352476,229919,142614,91812,87556,1450671,2826056,4895962,4895962
Nicaragua,1998,NI,NIC,AMR,358463,685716,1044179,550477,357160,219685,138048,85178,61695,1412243,350622,677814,1028436,555428,363648,236634,149464,94088,90431,1489693,2901936,4974552,4974552
Nicaragua,1999,NI,NIC,AMR,355508,689066,1044574,555740,369391,226762,143796,88059,64738,1448486,347494,681015,1028509,563447,374992,243614,156399,96496,93360,1528308,2976794,5049878,5049878
Nicaragua,2000,NI,NIC,AMR,352599,691757,1044356,560109,381215,234230,149742,90917,67906,1484119,344501,683467,1027968,570547,386381,250875,163499,99092,96391,1566785,3050904,5123222,5123222
Nicaragua,2001,NI,NIC,AMR,349515,693535,1043050,563668,392346,242133,155887,93728,71095,1518857,341381,685001,1026382,576659,397562,258340,170765,101789,99364,1604479,3123336,5192764,5192764
Nicaragua,2002,NI,NIC,AMR,346649,694080,1040729,566825,402527,250578,162100,96638,74232,1552900,338467,685359,1023826,582085,408338,266110,177998,104807,102210,1641548,3194448,5259006,5259006
Nicaragua,2003,NI,NIC,AMR,344252,693168,1037420,570118,411660,259617,168101,99965,77327,1586788,336006,684288,1020294,587286,418637,274272,184828,108545,104987,1678555,3265343,5323062,5323062
Nicaragua,2004,NI,NIC,AMR,342196,691231,1033427,573678,419898,269189,173881,103762,80466,1620874,333867,682164,1016031,592374,428594,282825,191124,113163,107798,1715878,3336752,5386223,5386223
Nicaragua,2005,NI,NIC,AMR,340418,690059,1030477,580667,427839,278792,178930,107515,83281,1657024,331964,680248,1012212,599045,438775,291613,196620,118386,110528,1754967,3411991,5454678,5454678
Nicaragua,2006,NI,NIC,AMR,339175,689331,1028506,591295,435699,288426,183573,111122,85872,1695987,330547,678343,1008890,607445,449278,300678,201854,123863,113300,1796418,3492405,5529811,5529811
Nicaragua,2007,NI,NIC,AMR,338711,687450,1026161,602187,443408,298513,188740,114898,88828,1736574,329901,675460,1005361,615643,459843,310218,207646,129478,116523,1839351,3575925,5607453,5607453
Nicaragua,2008,NI,NIC,AMR,339032,684738,1023770,613090,450996,308979,194412,118867,92185,1778529,330035,671885,1001920,623502,470314,320261,213978,135235,120238,1883528,3662057,5687744,5687744
Nicaragua,2009,NI,NIC,AMR,340168,681530,1021698,623707,458532,319673,200548,123127,95854,1821441,330981,667944,998925,630883,480530,330793,220760,141175,124433,1928574,3750015,5770639,5770639
Nicaragua,2010,NI,NIC,AMR,342081,678070,1020151,633632,466370,330387,207125,127718,99701,1864933,332698,663878,996576,637529,490590,341743,227908,147324,128984,1974078,3839011,5855734,5855734
Nicaragua,2011,NI,NIC,AMR,344428,674819,1019247,642578,474685,340993,214162,132662,103560,1908640,334841,660063,994904,643354,500468,353068,235401,153766,133706,2019763,3928403,5942553,5942553
Nicaragua,2012,NI,NIC,AMR,346858,672491,1019349,649918,483788,351272,221719,137839,107432,1951968,337063,657177,994240,647893,510295,364601,243273,160329,138666,2065057,4017025,6030607,6030607
Nicaragua,2013,NI,NIC,AMR,349207,671269,1020476,655270,493965,361102,229813,142990,111492,1994632,339222,655415,994637,650761,520315,376212,251547,166675,144123,2109633,4104265,6119379,6119379
Nicaragua,2014,NI,NIC,AMR,351329,671015,1022344,658906,505093,370562,238391,148067,115826,2036845,341178,654634,995812,652231,530453,387932,260164,172662,150228,2153670,4190515,6208676,6208676
Nicaragua,2015,NI,NIC,AMR,353125,671716,1024841,661032,516973,379682,247514,152945,120628,2078774,342828,654827,997655,652510,540616,399671,269218,178210,157104,2197329,4276103,6298598,6298598
Nicaragua,2016,NI,NIC,AMR,354520,673343,1027863,661675,529550,388459,257228,157822,125856,2120590,344089,655946,1000035,651605,550867,411324,278763,183724,164469,2240752,4361342,6389235,6389235
Nicaragua,2017,NI,NIC,AMR,355431,675773,1031204,661125,542412,397169,267443,163074,131240,2162463,344890,657892,1002782,649771,560921,423017,288778,189672,171928,2284087,4446550,6480532,6480532
Nicaragua,2018,NI,NIC,AMR,355822,678868,1034690,659677,555273,405838,278094,168683,136811,2204376,345186,660551,1005737,647281,570647,434611,299282,196041,179574,2327436,4531812,6572233,6572233
Nicaragua,2019,NI,NIC,AMR,355689,682529,1038218,657634,567827,414510,288972,174644,142532,2246119,344979,663808,1008787,644419,579907,445951,310240,202787,187502,2370806,4616925,6663924,6663924
Nicaragua,2020,NI,NIC,AMR,355162,686741,1041903,655883,580310,423756,299820,180609,147064,2287442,344392,667641,1012033,642074,589112,457396,321590,209671,194675,2414518,4701960,6755895,6755895
Nicaragua,2021,NI,NIC,AMR,354306,691085,1045391,654798,592474,433836,310696,186977,151458,2330239,343499,671610,1015109,640493,598173,468978,333391,216849,201914,2459798,4790037,6850540,6850540
Nicaragua,2022,NI,NIC,AMR,352975,694999,1047974,654483,603165,444857,321547,194362,157399,2375813,342198,675175,1017373,639721,606109,480671,345567,224712,210449,2507229,4883042,6948392,6948392
Nicaragua,2023,NI,NIC,AMR,351177,698315,1049492,655077,611955,457027,332077,202468,163892,2422496,340478,678189,1018667,639923,612525,492671,357905,233133,219495,2555652,4978148,7046310,7046310
Nicaragua,2024,NI,NIC,AMR,349059,700906,1049965,656323,618928,470100,342258,211071,170667,2469347,338450,680526,1018976,640781,617463,504805,370364,241931,228903,2604247,5073594,7142529,7142529
Nicaragua,2025,NI,NIC,AMR,346845,702672,1049517,658242,624237,483852,352098,220181,177760,2516370,336327,682077,1018404,642299,621063,516934,382841,251166,238724,2653027,5169397,7237313,7237313
Nicaragua,2026,NI,NIC,AMR,344636,703578,1048214,660846,627870,498213,361580,229798,185228,2563535,334199,682819,1017018,644480,623278,529095,395212,260870,249013,2701948,5265483,7330715,7330715
Nicaragua,2027,NI,NIC,AMR,342470,703482,1045952,664052,630092,512783,370970,239826,193068,2610791,332089,682655,1014744,647256,624321,541005,407600,271003,259779,2750964,5361755,7422450,7422450
Nicaragua,2028,NI,NIC,AMR,340480,702376,1042856,667754,631166,527307,380312,250212,201302,2658053,330121,681532,1011653,650553,624434,552537,419871,281582,271020,2799997,5458050,7512564,7512564
Nicaragua,2029,NI,NIC,AMR,338717,700448,1039165,671887,631381,541497,389690,260826,209958,2705239,328376,679620,1007996,654296,623891,563573,431891,292592,282717,2848960,5554199,7601360,7601360
Nicaragua,2030,NI,NIC,AMR,336980,697930,1034910,676354,630992,554934,399399,271492,219064,2752235,326666,677133,1003799,658397,622905,573849,443765,303976,294850,2897742,5649977,7688686,7688686
Nicaragua,1950,NI,NIC,AMR,125978,176997,302975,128331,88710,59683,40002,24559,16185,357470,121865,168738,290603,132066,95433,63166,41179,27707,19844,379395,736865,1330442,1330442
Nicaragua,1951,NI,NIC,AMR,132767,181644,314411,131578,90974,61088,40711,24893,16534,365778,129298,172877,302175,133762,98257,64664,42391,27889,20377,387340,753118,1369713,1369713
Nicaragua,1952,NI,NIC,AMR,139308,186680,325988,134972,93299,62528,41395,25310,16911,374415,136357,177598,313955,135498,101156,66171,43691,28026,20942,395484,769899,1409845,1409845
Nicaragua,1953,NI,NIC,AMR,145279,192610,337889,138536,95706,64036,42118,25809,17297,383502,142676,183448,326124,137393,104033,67768,45061,28199,21527,403981,787483,1451493,1451493
Nicaragua,1954,NI,NIC,AMR,150626,199504,350130,142262,98187,65649,42930,26356,17655,393039,148092,190597,338689,139553,106704,69548,46446,28499,22071,412821,805860,1494674,1494674
Nicaragua,1955,NI,NIC,AMR,155201,207598,362799,146111,100745,67375,43856,26942,17984,403013,152529,199211,351740,141981,109113,71551,47821,28961,22570,421997,825010,1539551,1539551
Nicaragua,1956,NI,NIC,AMR,159346,216625,375971,150027,103390,69214,44897,27566,18271,413365,156534,208808,365342,144648,111276,73761,49188,29571,23049,431493,844858,1586169,1586169
Nicaragua,1957,NI,NIC,AMR,163695,225888,389583,154051,106124,71158,46057,28230,18531,424151,160742,218700,379442,147602,113179,76172,50551,30330,23495,441329,865480,1634509,1634509
Nicaragua,1958,NI,NIC,AMR,168228,235380,403608,158232,108959,73199,47308,28916,18788,435402,165136,228884,394020,150845,114905,78748,51914,31217,23933,451562,886964,1684589,1684589
Nicaragua,1959,NI,NIC,AMR,172887,245209,418096,162549,111898,75308,48604,29598,19108,447065,169652,239347,408999,154384,116582,81416,53297,32191,24365,462235,909300,1736396,1736396
Nicaragua,1960,NI,NIC,AMR,177546,255426,432972,166993,114949,77466,49925,30272,19491,459096,174170,250091,424261,158217,118298,84107,54719,33224,24791,473356,932452,1789684,1789684
Nicaragua,1961,NI,NIC,AMR,182242,266028,448270,171581,118118,79668,51287,30944,19952,471550,178730,261157,439887,162318,120036,86839,56169,34327,25228,484917,956467,1844630,1844630
Nicaragua,1962,NI,NIC,AMR,187031,276803,463834,176547,121413,81932,52680,31617,20497,484686,183398,272273,455671,166983,121801,89639,57640,35511,25686,497260,981946,1901451,1901451
Nicaragua,1963,NI,NIC,AMR,191899,287265,479164,182345,124842,84251,54131,32315,21097,498981,188150,282928,471078,172709,123688,92415,59181,36753,26183,510929,1009910,1960155,1960155
Nicaragua,1964,NI,NIC,AMR,196869,297286,494155,189082,128412,86642,55681,33094,21710,514621,193006,292912,485918,179709,125821,95012,60906,38026,26769,526243,1040864,2020941,2020941
Nicaragua,1965,NI,NIC,AMR,202009,306669,508678,197002,132095,89117,57344,33973,22330,531861,198020,302117,500137,188163,128224,97397,62859,39312,27472,543427,1075288,2084097,2084097
Nicaragua,1966,NI,NIC,AMR,207425,315730,523155,205846,135849,91684,59117,34949,22971,550416,203288,311081,514369,197630,130879,99592,65026,40629,28307,562063,1112479,2150003,2150003
Nicaragua,1967,NI,NIC,AMR,213286,325096,538382,214959,139707,94347,61012,36036,23622,569683,208975,320419,529394,207458,133822,101590,67409,41981,29282,581542,1151225,2219001,2219001
Nicaragua,1968,NI,NIC,AMR,219706,334752,554458,224314,143720,97117,63007,37208,24303,589669,215196,330098,545294,217626,137066,103447,69978,43367,30392,601876,1191545,2291300,2291300
Nicaragua,1969,NI,NIC,AMR,226679,344642,571321,233991,147832,99978,65073,38430,25034,610338,221942,340038,561980,228091,140579,105271,72660,44797,31596,622994,1233332,2366635,2366635
Nicaragua,2031,NI,NIC,AMR,335202,694970,1030172,680777,630440,567345,409589,282091,228678,2798920,324908,674231,999139,662455,621833,583286,455474,315700,307447,2946195,5745115,7774417,7774417
Nicaragua,2032,NI,NIC,AMR,333612,691556,1025168,684750,630440,578129,420519,292434,238862,2845134,323327,670900,994227,666077,621327,591407,467167,327625,320570,2994173,5839307,7858704,7858704
Nicaragua,2033,NI,NIC,AMR,332233,687830,1020063,688115,631190,586910,432467,302419,249680,2890781,321952,667262,989214,669131,621594,597841,479077,339651,334289,3041583,5932364,7941633,7941633
Nicaragua,2034,NI,NIC,AMR,330950,684008,1014958,690757,632585,593929,445296,312109,261116,2935792,320676,663536,984212,671504,622509,602807,491124,351805,348563,3088312,6024104,8023271,8023271
Nicaragua,2035,NI,NIC,AMR,329721,680109,1009830,692583,634646,599334,458791,321514,273199,2980067,319457,659745,979202,673096,624083,606454,503173,363985,363486,3134277,6114344,8103378,8103378
Nicaragua,2036,NI,NIC,AMR,328487,676178,1004665,693548,637383,603117,472878,330619,285960,3023505,318234,655904,974138,673882,626313,608727,515262,376076,379138,3179398,6202903,8181700,8181700
Nicaragua,2037,NI,NIC,AMR,327289,672480,999769,693519,640709,605529,487176,339669,299296,3065898,317044,652252,969296,673759,629134,609840,527105,388204,395467,3223509,6289407,8258476,8258476
Nicaragua,2038,NI,NIC,AMR,326097,669158,995255,692484,644528,606823,501444,348707,313202,3107188,315858,648954,964812,672682,632473,610036,538580,400230,412505,3266506,6373694,8333755,8333755
Nicaragua,2039,NI,NIC,AMR,324683,666161,990844,690631,648767,607284,515392,357804,327575,3147453,314454,645967,960421,670820,636260,609578,549567,412029,430220,3308474,6455927,8407196,8407196
Nicaragua,2040,NI,NIC,AMR,323214,663245,986459,688197,653340,607157,528628,367235,342295,3186852,312987,643072,956059,668381,640394,608681,559807,423698,448567,3349528,6536380,8478904,8478904
Nicaragua,2041,NI,NIC,AMR,321843,660280,982123,685322,657871,606876,540886,377140,357308,3225403,311617,640125,951742,665525,644490,607699,569219,435219,467532,3389684,6615087,8548953,8548953
Nicaragua,2042,NI,NIC,AMR,320416,657537,977953,681996,661958,607139,551586,387758,372518,3262955,310196,637386,947582,662249,648150,607280,577340,446736,487059,3428814,6691769,8617299,8617299
Nicaragua,2043,NI,NIC,AMR,318807,655004,973811,678359,665451,608138,560369,399345,387871,3299533,308601,634853,943454,658663,651248,607628,583801,458478,507101,3466919,6766452,8683724,8683724
Nicaragua,2044,NI,NIC,AMR,317164,652353,969517,674626,668232,609774,567469,411773,403427,3335301,306979,632201,939180,654986,653671,608619,588825,470358,527696,3504155,6839456,8748153,8748153
Nicaragua,2045,NI,NIC,AMR,315549,649698,965247,670816,670206,612059,573028,424836,419224,3370169,305391,629542,934933,651243,655312,610265,592552,482253,548826,3540451,6910620,8810803,8810803
Nicaragua,2046,NI,NIC,AMR,313884,647128,961012,666973,671336,615011,577038,438472,435275,3404105,303762,626971,930733,647451,656155,612564,594936,494198,570453,3575757,6979862,8871604,8871604
Nicaragua,2047,NI,NIC,AMR,312184,644542,956726,663357,671483,618546,579733,452326,451741,3437186,302104,624384,926488,643848,656092,615451,596179,505917,592659,3610146,7047332,8930546,8930546
Nicaragua,2048,NI,NIC,AMR,310473,641774,952247,660122,670634,622559,581366,466166,468623,3469470,300436,621627,922063,640586,655081,618847,596526,517291,615330,3643661,7113131,8987448,8987448
Nicaragua,2049,NI,NIC,AMR,308734,638754,947488,657207,668977,626989,582204,479727,485888,3500992,298731,618625,917356,637647,653283,622685,596230,528190,638302,3676337,7177329,9042168,9042168
Nicaragua,2050,NI,NIC,AMR,306819,635705,942524,654362,666739,631742,582479,492626,503682,3531630,296855,615592,912447,634793,650914,626873,595501,538367,661590,3708038,7239668,9094641,9094641
Niue,1970,NU,NIU,WPR,483,870,1353,432,240,195,151,113,100,1231,439,784,1223,402,296,218,165,128,164,1373,2604,5185,5185
Niue,1971,NU,NIU,WPR,465,848,1313,446,235,191,145,108,99,1224,420,777,1197,399,286,214,153,125,166,1343,2567,5077,5077
Niue,1972,NU,NIU,WPR,438,819,1257,450,229,187,139,103,99,1207,396,757,1153,395,276,208,153,124,163,1319,2526,4922,4922
Niue,1973,NU,NIU,WPR,406,785,1191,439,215,182,129,102,101,1168,361,720,1081,390,258,208,140,121,161,1278,2446,4719,4719
Niue,1974,NU,NIU,WPR,373,747,1120,424,203,181,121,100,101,1130,329,684,1013,381,238,213,131,114,161,1238,2368,4499,4499
Niue,1975,NU,NIU,WPR,346,712,1058,406,186,175,117,97,104,1085,302,642,944,366,221,206,118,107,163,1181,2266,4270,4270
Niue,1976,NU,NIU,WPR,322,674,996,389,172,165,109,92,106,1033,285,597,882,352,207,200,114,104,167,1144,2177,4053,4053
Niue,1977,NU,NIU,WPR,306,648,954,386,162,158,109,90,105,1010,273,559,832,348,196,191,107,103,164,1109,2119,3914,3914
Niue,1978,NU,NIU,WPR,288,631,919,395,162,155,113,90,103,1018,265,527,792,345,200,186,110,104,156,1101,2119,3828,3828
Niue,1979,NU,NIU,WPR,274,608,882,393,163,153,117,92,103,1021,255,501,756,336,194,177,110,108,147,1072,2093,3733,3733
Niue,1980,NU,NIU,WPR,261,586,847,390,164,151,120,91,101,1017,247,480,727,321,194,174,112,109,138,1048,2065,3637,3637
Niue,1981,NU,NIU,WPR,254,557,811,388,163,148,124,90,96,1009,239,458,697,308,183,166,109,109,133,1008,2017,3533,3533
Niue,1982,NU,NIU,WPR,243,517,760,376,162,143,128,89,95,993,228,428,656,294,183,162,107,107,127,980,1973,3396,3396
Niue,1983,NU,NIU,WPR,226,471,697,358,167,136,129,85,101,976,218,392,610,275,177,149,109,101,127,938,1914,3224,3224
Niue,1984,NU,NIU,WPR,206,427,633,327,166,132,133,83,100,941,209,357,566,255,172,136,117,90,128,898,1839,3038,3038
Niue,1985,NU,NIU,WPR,189,392,581,289,169,121,133,81,101,894,203,330,533,227,165,117,124,79,124,836,1730,2848,2848
Niue,1986,NU,NIU,WPR,175,364,539,255,167,116,127,82,97,844,195,308,503,197,159,109,124,79,124,792,1636,2680,2680
Niue,1987,NU,NIU,WPR,163,340,503,249,169,117,121,86,95,837,182,302,484,187,153,104,125,81,121,771,1608,2602,2602
Niue,1988,NU,NIU,WPR,157,323,480,254,170,118,121,88,94,845,167,310,477,187,151,110,125,83,120,776,1621,2583,2583
Niue,1989,NU,NIU,WPR,147,311,458,257,170,122,119,93,96,857,149,310,459,193,148,118,125,82,120,786,1643,2560,2560
Niue,1990,NU,NIU,WPR,142,302,444,256,169,129,113,96,98,861,134,311,445,190,146,124,124,82,121,787,1648,2533,2533
Niue,1991,NU,NIU,WPR,134,295,429,250,170,133,109,100,100,862,120,300,420,195,144,128,123,81,118,789,1651,2497,2497
Niue,1992,NU,NIU,WPR,129,289,418,237,171,136,111,103,95,853,113,290,403,197,140,135,122,77,117,788,1641,2458,2458
Niue,1993,NU,NIU,WPR,127,276,403,225,173,141,112,102,89,842,105,275,380,197,138,141,118,82,117,793,1635,2416,2416
Niue,1994,NU,NIU,WPR,125,267,392,215,168,147,112,103,86,831,101,259,360,195,134,144,110,97,113,793,1624,2375,2375
Niue,1995,NU,NIU,WPR,122,253,375,212,161,154,110,107,87,831,103,236,339,196,133,146,103,107,113,798,1629,2339,2339
Niue,1996,NU,NIU,WPR,118,245,363,207,153,161,108,106,89,824,105,222,327,193,129,145,99,111,113,790,1614,2300,2300
Niue,1997,NU,NIU,WPR,115,234,349,201,147,165,111,104,89,817,107,211,318,187,131,137,100,115,111,781,1598,2257,2257
Niue,1998,NU,NIU,WPR,106,226,332,192,143,163,113,102,90,803,105,201,306,182,129,132,105,115,105,768,1571,2207,2207
Niue,1999,NU,NIU,WPR,96,216,312,179,141,155,115,97,94,781,101,187,288,177,124,127,113,114,97,752,1533,2142,2142
Niue,2000,NU,NIU,WPR,90,207,297,171,137,148,119,94,95,764,99,171,270,170,124,123,118,113,93,741,1505,2074,2074
Niue,2001,NU,NIU,WPR,81,197,278,159,135,144,122,89,98,747,98,164,262,156,128,119,124,112,84,723,1470,2011,2011
Niue,2002,NU,NIU,WPR,80,189,269,150,133,143,121,88,101,736,95,159,254,138,136,108,131,112,81,706,1442,1965,1965
Niue,2003,NU,NIU,WPR,74,187,261,141,132,138,125,89,100,725,92,154,246,130,142,99,135,108,89,703,1428,1928,1928
Niue,2004,NU,NIU,WPR,74,181,255,133,135,123,131,85,97,704,90,150,240,115,145,95,137,101,97,690,1394,1891,1891
Niue,2005,NU,NIU,WPR,71,170,241,127,140,112,135,78,95,687,93,145,238,104,148,93,141,94,107,687,1374,1856,1856
Niue,2006,NU,NIU,WPR,73,162,235,125,137,103,142,74,99,680,94,139,233,95,144,96,138,91,118,682,1362,1833,1833
Niue,2007,NU,NIU,WPR,78,153,231,129,132,102,144,78,100,685,97,138,235,94,135,102,129,93,118,671,1356,1822,1822
Niue,2008,NU,NIU,WPR,83,144,227,132,126,103,142,84,101,688,96,143,239,92,129,107,122,98,116,664,1352,1821,1821
Niue,2009,NU,NIU,WPR,87,140,227,137,117,106,137,87,104,688,93,152,245,83,130,109,116,104,117,659,1347,1815,1815
Niue,2010,NU,NIU,WPR,89,138,227,135,112,109,130,93,103,682,91,161,252,68,130,112,111,108,121,650,1332,1812,1812
Niue,2011,NU,NIU,WPR,89,138,227,136,108,113,123,98,100,678,86,168,254,65,122,118,109,112,119,645,1323,1811,1811
Niue,2012,NU,NIU,WPR,88,139,227,134,102,118,123,100,99,676,82,174,256,71,111,126,103,117,121,649,1325,1813,1813
Niue,2013,NU,NIU,WPR,87,142,229,133,97,122,122,105,101,680,81,178,259,80,101,133,97,121,122,654,1334,1825,1825
Niue,2014,NU,NIU,WPR,85,148,233,126,95,127,117,113,99,677,82,181,263,85,95,138,92,123,124,657,1334,1833,1833
Niue,2015,NU,NIU,WPR,83,154,237,114,98,134,109,120,97,672,80,183,263,98,85,142,90,126,131,672,1344,1847,1847
Niue,2016,NU,NIU,WPR,80,160,240,109,97,135,107,127,95,670,76,187,263,105,84,138,94,126,137,684,1354,1861,1861
Niue,2017,NU,NIU,WPR,78,166,244,99,101,130,114,126,98,668,71,191,262,110,92,129,100,119,145,695,1363,1869,1869
Niue,2018,NU,NIU,WPR,74,171,245,91,106,126,119,125,102,669,71,192,263,113,98,127,104,114,153,709,1378,1887,1887
Niue,2019,NU,NIU,WPR,76,178,254,78,106,122,129,119,110,664,72,190,262,121,104,134,108,109,166,742,1406,1921,1921
Niue,2020,NU,NIU,WPR,75,179,254,73,104,125,133,116,119,670,73,189,262,124,106,139,116,104,174,763,1433,1942,1942
Niue,2021,NU,NIU,WPR,72,180,252,71,98,126,131,115,118,659,74,187,261,130,105,134,124,102,168,763,1422,1937,1937
Niue,2022,NU,NIU,WPR,69,179,248,82,93,121,132,113,118,659,71,186,257,135,106,127,132,97,172,769,1428,1934,1934
Niue,2023,NU,NIU,WPR,69,176,245,96,85,116,131,114,123,665,68,183,251,143,106,122,138,91,174,774,1439,1935,1935
Niue,2024,NU,NIU,WPR,70,170,240,113,73,114,133,110,129,672,67,180,247,148,108,116,143,87,173,775,1447,1935,1935
Niue,2025,NU,NIU,WPR,70,164,234,129,63,113,137,107,127,676,66,176,242,154,113,106,148,86,176,783,1459,1935,1935
Niue,2026,NU,NIU,WPR,70,158,228,145,56,114,134,106,126,681,65,170,235,162,115,104,143,90,170,784,1465,1937,1937
Niue,2027,NU,NIU,WPR,70,152,222,159,52,115,127,107,131,691,65,161,226,174,113,110,135,97,167,796,1487,1942,1942
Niue,2028,NU,NIU,WPR,70,148,218,170,51,113,121,112,135,702,66,154,220,182,113,112,132,102,162,803,1505,1945,1945
Niue,2029,NU,NIU,WPR,70,146,216,175,55,108,118,117,136,709,67,150,217,184,115,111,134,104,158,806,1515,1948,1948
Niue,2030,NU,NIU,WPR,71,144,215,178,59,101,120,118,131,707,67,145,212,186,118,108,134,106,154,806,1513,1948,1948
Niue,1950,NU,NIU,WPR,335,537,872,477,268,203,176,123,90,1337,343,533,876,432,290,206,218,139,121,1406,2743,4485,4485
Niue,1951,NU,NIU,WPR,368,518,886,479,274,207,177,125,94,1356,367,522,889,444,298,205,223,139,126,1435,2791,4559,4559
Niue,1952,NU,NIU,WPR,403,511,914,471,280,209,169,126,87,1342,391,517,908,452,304,210,221,138,127,1452,2794,4617,4617
Niue,1953,NU,NIU,WPR,430,515,945,447,279,201,162,132,88,1309,407,521,928,444,306,208,217,139,133,1447,2756,4636,4636
Niue,1954,NU,NIU,WPR,443,529,972,431,274,192,161,131,87,1276,409,533,942,439,306,207,218,143,137,1450,2726,4647,4647
Niue,1955,NU,NIU,WPR,447,552,999,418,262,187,160,131,93,1251,403,552,955,432,309,214,220,147,140,1462,2713,4673,4673
Niue,1956,NU,NIU,WPR,458,576,1034,411,255,184,160,132,97,1239,404,571,975,427,307,215,219,145,141,1454,2693,4706,4706
Niue,1957,NU,NIU,WPR,476,596,1072,404,251,184,161,129,98,1227,418,580,998,421,303,223,213,151,139,1450,2677,4752,4752
Niue,1958,NU,NIU,WPR,496,612,1108,399,249,190,161,125,101,1225,436,591,1027,418,302,225,198,159,143,1445,2670,4803,4803
Niue,1959,NU,NIU,WPR,506,641,1147,385,244,199,156,125,100,1209,449,605,1054,411,298,228,183,163,146,1429,2638,4845,4845
Niue,1960,NU,NIU,WPR,513,675,1188,375,240,207,155,126,95,1198,460,619,1079,406,297,230,167,168,148,1416,2614,4876,4876
Niue,1961,NU,NIU,WPR,510,715,1225,363,233,211,156,126,97,1186,469,640,1109,400,298,221,157,172,146,1394,2580,4912,4912
Niue,1962,NU,NIU,WPR,516,752,1268,360,237,211,158,123,96,1185,480,663,1143,400,299,219,156,171,151,1396,2581,4987,4987
Niue,1963,NU,NIU,WPR,526,779,1305,358,248,207,165,122,95,1195,491,685,1176,401,308,222,155,170,153,1409,2604,5090,5090
Niue,1964,NU,NIU,WPR,533,813,1346,355,257,208,167,121,99,1207,500,711,1211,402,321,226,157,170,153,1429,2636,5202,5202
Niue,1965,NU,NIU,WPR,538,845,1383,356,266,210,167,123,104,1226,507,738,1245,404,331,232,160,173,158,1458,2684,5316,5316
Niue,1966,NU,NIU,WPR,540,880,1420,359,267,213,167,126,105,1237,507,768,1275,411,336,234,168,169,158,1476,2713,5412,5412
Niue,1967,NU,NIU,WPR,528,893,1421,374,267,211,163,129,104,1248,497,785,1282,411,334,234,175,158,158,1470,2718,5422,5422
Niue,1968,NU,NIU,WPR,511,892,1403,392,258,207,157,128,100,1242,481,786,1267,409,323,226,171,150,164,1443,2685,5359,5359
Niue,1969,NU,NIU,WPR,496,884,1380,413,250,200,153,121,102,1239,461,787,1248,410,310,220,171,134,166,1411,2650,5279,5279
Niue,2031,NU,NIU,WPR,72,141,213,179,66,95,121,119,128,708,68,140,208,186,125,106,130,114,152,813,1521,1949,1949
Niue,2032,NU,NIU,WPR,74,139,213,179,77,90,118,119,132,715,69,136,205,185,134,105,124,121,157,826,1541,1956,1956
Niue,2033,NU,NIU,WPR,75,139,214,176,92,83,113,120,139,723,71,133,204,183,143,104,118,126,153,827,1550,1963,1963
Niue,2034,NU,NIU,WPR,77,140,217,170,109,72,109,123,136,719,72,133,205,180,148,106,114,130,150,828,1547,1970,1970
Niue,2035,NU,NIU,WPR,78,141,219,164,125,61,108,122,131,711,73,133,206,176,154,110,104,135,150,829,1540,1972,1972
Niue,2036,NU,NIU,WPR,79,142,221,158,141,54,107,120,134,714,75,133,208,170,162,112,102,134,152,832,1546,1976,1976
Niue,2037,NU,NIU,WPR,81,143,224,152,155,50,108,113,139,717,77,134,211,161,174,110,108,129,155,837,1554,1988,1988
Niue,2038,NU,NIU,WPR,82,145,227,148,166,49,106,111,138,718,78,136,214,153,182,109,111,126,155,836,1554,1996,1996
Niue,2039,NU,NIU,WPR,83,147,230,146,173,52,102,106,139,718,79,137,216,148,184,112,110,126,154,834,1552,1999,1999
Niue,2040,NU,NIU,WPR,84,149,233,144,177,57,97,106,143,724,80,139,219,144,185,116,107,126,159,837,1561,2010,2010
Niue,2041,NU,NIU,WPR,85,151,236,141,178,66,91,107,144,727,80,142,222,140,184,123,106,120,164,837,1564,2022,2022
Niue,2042,NU,NIU,WPR,85,154,239,139,178,77,86,105,145,730,80,145,225,136,182,132,104,113,167,834,1564,2029,2029
Niue,2043,NU,NIU,WPR,85,157,242,138,175,92,80,101,147,733,80,148,228,133,179,141,101,110,172,836,1569,2037,2037
Niue,2044,NU,NIU,WPR,85,159,244,138,170,108,70,100,147,733,80,150,230,133,176,147,101,106,179,842,1575,2046,2046
Niue,2045,NU,NIU,WPR,85,162,247,138,163,124,60,101,145,731,80,152,232,133,172,153,106,97,182,843,1574,2055,2055
Niue,2046,NU,NIU,WPR,85,164,249,139,156,140,54,101,143,733,80,154,234,133,166,162,107,96,182,846,1579,2066,2066
Niue,2047,NU,NIU,WPR,84,166,250,141,149,154,50,102,141,737,80,156,236,134,158,173,105,101,178,849,1586,2076,2076
Niue,2048,NU,NIU,WPR,83,167,250,144,144,165,49,100,143,745,79,158,237,135,152,180,106,104,177,854,1599,2084,2084
Niue,2049,NU,NIU,WPR,82,168,250,146,141,172,52,95,142,748,78,159,237,137,148,181,109,104,180,859,1607,2089,2089
Niue,2050,NU,NIU,WPR,81,169,250,148,138,176,57,88,140,747,76,160,236,139,144,182,113,103,184,865,1612,2096,2096
Netherlands,1970,NL,NLD,EUR,608744,1212194,1820938,1176589,896118,773863,686644,566808,583384,4683406,580604,1156891,1737495,1119752,829366,755926,717944,629664,743191,4795843,9479249,13037686,13037686
Netherlands,1971,NL,NLD,EUR,605822,1221378,1827200,1178449,934582,780637,694727,569740,591747,4749882,578193,1165601,1743794,1123275,864443,756243,725960,632559,763357,4865837,9615719,13186712,13186712
Netherlands,1972,NL,NLD,EUR,598054,1228241,1826295,1166181,988349,787957,702651,572137,599700,4816975,571077,1172334,1743411,1112932,915311,757829,733070,635083,783268,4937493,9754468,13324176,13324176
Netherlands,1973,NL,NLD,EUR,582584,1233685,1816269,1162351,1033124,796524,712781,572603,608048,4885431,556487,1177770,1734257,1110767,958310,760863,742044,635439,804184,5011607,9897038,13447570,13447570
Netherlands,1974,NL,NLD,EUR,557671,1239662,1797333,1167041,1069039,806875,724163,572495,617793,4957406,532668,1183632,1716300,1117093,992892,766178,751957,634805,826578,5089503,10046909,13560532,13560532
Netherlands,1975,NL,NLD,EUR,527479,1245630,1773109,1176943,1098962,817309,731042,578665,626383,5029304,503808,1189285,1693093,1127909,1022695,772574,756088,641110,848085,5168461,10197765,13663969,13663969
Netherlands,1976,NL,NLD,EUR,499575,1245391,1744966,1190219,1126640,827283,734007,590344,632402,5100895,476961,1188833,1665794,1141685,1051568,778556,755157,653783,867711,5248460,10349355,13760112,13760112
Netherlands,1977,NL,NLD,EUR,477000,1236820,1713820,1204420,1154342,838187,738024,599736,640479,5175188,454968,1180481,1635449,1156282,1081125,785503,755086,663784,889332,5331112,10506300,13855566,13855566
Netherlands,1978,NL,NLD,EUR,462183,1218829,1681012,1218920,1177018,854907,740960,608082,650348,5250235,440416,1163655,1604071,1170481,1106097,798960,753466,672294,912785,5414083,10664318,13949408,13949408
Netherlands,1979,NL,NLD,EUR,454349,1191623,1645972,1235384,1193481,877820,743496,615665,660121,5325967,432861,1138223,1571084,1185790,1125023,819425,750611,680471,935941,5497261,10823228,14040287,14040287
Netherlands,1980,NL,NLD,EUR,451803,1160270,1612073,1250248,1210807,899131,748320,622829,668876,5400211,430577,1108707,1539284,1198925,1145056,839211,749868,688383,957370,5578813,10979024,14130387,14130387
Netherlands,1981,NL,NLD,EUR,452155,1128781,1580936,1260716,1212858,935714,754211,630762,675880,5470141,431338,1078701,1510039,1207904,1150713,874008,750569,696414,976591,5656199,11126340,14217318,14217318
Netherlands,1982,NL,NLD,EUR,451387,1097366,1548753,1267917,1200224,987582,760747,638370,682600,5537440,431102,1048601,1479703,1214081,1141715,924024,752334,703442,995035,5730631,11268071,14296533,14296533
Netherlands,1983,NL,NLD,EUR,449085,1065711,1514796,1273179,1195424,1030620,768555,647790,687978,5603546,429172,1018304,1447476,1218510,1140105,965995,755484,712054,1011685,5803833,11407379,14369647,14369647
Netherlands,1984,NL,NLD,EUR,447328,1031366,1478694,1278699,1199097,1064587,778082,658220,692997,5671682,427593,985489,1413082,1223360,1146498,999332,760712,721426,1027141,5878469,11550151,14441927,14441927
Netherlands,1985,NL,NLD,EUR,446628,997071,1443699,1283733,1208213,1092456,787752,664668,703017,5739839,427092,952879,1379971,1227876,1157191,1027722,766891,725220,1047300,5952200,11692039,14515704,14515704
Netherlands,1986,NL,NLD,EUR,447849,968201,1416050,1282379,1220910,1118162,796942,667767,716262,5802422,428707,925478,1354185,1226436,1170873,1055036,772432,724157,1070941,6019875,11822297,14592531,14592531
Netherlands,1987,NL,NLD,EUR,453430,943942,1397372,1272690,1234981,1144104,807138,671676,728830,5859419,434266,902183,1336449,1217459,1185510,1083183,778773,723857,1093284,6082066,11941485,14675301,14675301
Netherlands,1988,NL,NLD,EUR,461727,926466,1388193,1253539,1250029,1165520,823241,674767,742356,5909452,442225,885146,1327371,1200295,1200186,1107304,791419,722342,1115754,6137300,12046752,14762318,14762318
Netherlands,1989,NL,NLD,EUR,469944,917092,1387036,1225469,1267777,1181349,845453,677548,754725,5952321,450439,876071,1326510,1175011,1216634,1125874,810824,719739,1136272,6184354,12136675,14850225,14850225
Netherlands,1990,NL,NLD,EUR,478829,914788,1393617,1193665,1284870,1198656,866274,682480,765344,5991289,458970,874020,1332990,1146292,1231716,1146025,829775,719055,1153774,6226637,12217926,14944548,14944548
Netherlands,1991,NL,NLD,EUR,487781,917986,1405767,1162230,1298241,1201703,902407,688485,776057,6029123,466954,877772,1344726,1117728,1243375,1152695,863783,719769,1169617,6266967,12296090,15046584,15046584
Netherlands,1992,NL,NLD,EUR,494499,924805,1419304,1131483,1308597,1190996,953808,695132,786997,6067013,472933,884740,1357673,1089637,1252803,1145485,912879,721582,1184319,6306705,12373718,15150685,15150685
Netherlands,1993,NL,NLD,EUR,499587,932909,1432496,1100808,1317275,1188460,996696,703119,797317,6103675,477573,892417,1369990,1061567,1260970,1145955,954203,724737,1197494,6344926,12448601,15251086,15251086
Netherlands,1994,NL,NLD,EUR,503561,941416,1444977,1067476,1326384,1194546,1030940,712881,808297,6140524,480893,900655,1381548,1030784,1269932,1154632,987223,729856,1210003,6382430,12522954,15349478,15349478
Netherlands,1995,NL,NLD,EUR,503781,951236,1455017,1034349,1334710,1206258,1059474,723161,821566,6179518,480737,910020,1390757,999908,1278522,1167870,1015501,736147,1223434,6421382,12600900,15446668,15446668
Netherlands,1996,NL,NLD,EUR,500566,962289,1462855,1006828,1336116,1221538,1085799,733102,834641,6218024,477430,920411,1397841,973927,1281040,1184131,1042766,741914,1236121,6459899,12677923,15538616,15538616
Netherlands,1997,NL,NLD,EUR,498100,974611,1472711,984061,1328354,1237904,1112304,743965,847861,6254449,475032,932132,1407164,951742,1275593,1201130,1070881,748218,1248013,6495577,12750026,15629905,15629905
Netherlands,1998,NL,NLD,EUR,498446,987210,1485656,967991,1309961,1254912,1134315,760267,861168,6288614,475515,944192,1419707,935575,1261003,1217797,1095061,760328,1258849,6528613,12817227,15722594,15722594
Netherlands,1999,NL,NLD,EUR,501015,997956,1498971,959722,1281433,1273827,1150472,782141,873602,6321197,477825,954448,1432273,927207,1237236,1235525,1113632,778803,1267639,6560042,12881239,15812487,15812487
Netherlands,2000,NL,NLD,EUR,505978,1004923,1510901,957825,1247976,1290903,1167543,802508,886835,6353590,482565,960737,1443302,925527,1209059,1250915,1133342,796752,1275739,6591334,12944924,15899135,15899135
Netherlands,2001,NL,NLD,EUR,511907,1007863,1519770,960646,1213959,1303039,1170355,837481,901240,6386720,488504,962622,1451126,929145,1180383,1261773,1139647,829122,1283947,6624017,13010737,15981636,15981636
Netherlands,2002,NL,NLD,EUR,515863,1008838,1524701,966398,1180354,1310990,1159623,886779,916133,6420277,492160,963082,1455242,935280,1151999,1269475,1132185,875923,1291950,6656812,13077089,16057040,16057040
Netherlands,2003,NL,NLD,EUR,516910,1010839,1527749,972868,1146844,1316427,1156457,927549,932843,6452988,492698,965061,1457759,941495,1123720,1275358,1131938,915056,1301520,6689087,13142075,16127579,16127579
Netherlands,2004,NL,NLD,EUR,513925,1014171,1528096,979423,1111021,1321840,1161144,959988,953336,6486752,489857,967837,1457694,947996,1092948,1281854,1139498,946155,1315041,6723492,13210244,16196035,16196035
Netherlands,2005,NL,NLD,EUR,506529,1016663,1523192,987052,1076186,1326126,1171164,986990,976603,6524121,482808,970214,1453022,955252,1062532,1287986,1151568,972570,1331581,6761489,13285610,16261831,16261831
Netherlands,2006,NL,NLD,EUR,497229,1017402,1514631,995795,1047843,1323635,1184685,1011919,1000519,6564396,473709,971289,1444998,963220,1037566,1288429,1166739,997862,1347845,6801661,13366057,16325677,16325677
Netherlands,2007,NL,NLD,EUR,488037,1017511,1505548,1005964,1025255,1312687,1199274,1036968,1025749,6605897,465183,971508,1436691,972674,1016858,1281669,1182698,1024044,1365154,6843097,13448994,16391232,16391232
Netherlands,2008,NL,NLD,EUR,479941,1018129,1498070,1017058,1010388,1292192,1214610,1058042,1055927,6648217,457768,972034,1429802,983166,1002523,1266582,1198536,1046625,1387246,6884678,13532895,16460770,16460770
Netherlands,2009,NL,NLD,EUR,474936,1017629,1492565,1027400,1004434,1263092,1232158,1073956,1090937,6691977,452976,971579,1424555,993054,996337,1243329,1215802,1064156,1414428,6927106,13619083,16536208,16536208
Netherlands,2010,NL,NLD,EUR,472662,1015918,1488580,1035487,1005960,1230842,1248647,1090811,1125238,6736985,450984,970067,1421051,1000471,997247,1216750,1231329,1083056,1441655,6970508,13707493,16617117,16617117
Netherlands,2011,NL,NLD,EUR,471175,1014059,1485234,1041309,1013039,1199674,1261120,1094995,1173937,6784074,449772,968309,1418081,1005080,1003815,1190546,1242854,1089487,1482305,7014087,13798161,16701472,16701472
Netherlands,2012,NL,NLD,EUR,469152,1010827,1479979,1046585,1023599,1170262,1270351,1087227,1235517,6833541,447564,965152,1412716,1009598,1013121,1165374,1251702,1083365,1535913,7059073,13892614,16785299,16785299
Netherlands,2013,NL,NLD,EUR,465008,1006106,1471114,1053890,1035434,1141866,1277963,1086640,1290064,6885857,443281,960217,1403498,1016478,1022778,1140816,1259422,1084500,1582895,7106889,13992746,16867352,16867352
Netherlands,2014,NL,NLD,EUR,459804,1000488,1460292,1063227,1047870,1111894,1286170,1093560,1339977,6942698,438263,954431,1392694,1024736,1033122,1113905,1268322,1093301,1625007,7158393,14101091,16954081,16954081
Netherlands,2015,NL,NLD,EUR,454877,992999,1447876,1072026,1061746,1083332,1293766,1105421,1385439,7001730,433258,947010,1380268,1032943,1044506,1087277,1277149,1106433,1662913,7211221,14212951,17041107,17041107
Netherlands,2016,NL,NLD,EUR,450621,984491,1435112,1078564,1077157,1061070,1295182,1120439,1427191,7059603,428762,938467,1367229,1039395,1056792,1065846,1280456,1122571,1697497,7262557,14322160,17124505,17124505
Netherlands,2017,NL,NLD,EUR,447841,975820,1423661,1083377,1094156,1044176,1288483,1136605,1469213,7116010,425923,929784,1355707,1043956,1070756,1048328,1276653,1139661,1732470,7311824,14427834,17207198,17207198
Netherlands,2018,NL,NLD,EUR,445705,965940,1411645,1087880,1111741,1034392,1272454,1153647,1510847,7170961,424039,920057,1344096,1048022,1085628,1036780,1264616,1156747,1767556,7359349,14530310,17286042,17286042
Netherlands,2019,NL,NLD,EUR,443287,957611,1400898,1090602,1127840,1032740,1247757,1172924,1551502,7223365,421878,911762,1333640,1050411,1099370,1032955,1244350,1175356,1802920,7405362,14628727,17363262,17363262
Netherlands,2020,NL,NLD,EUR,441799,951785,1393584,1091206,1140566,1037838,1219200,1191213,1588319,7268342,420467,905785,1326252,1050802,1109925,1035813,1220350,1192434,1837057,7446381,14714723,17434557,17434557
Netherlands,2021,NL,NLD,EUR,443456,946883,1390339,1090732,1149808,1047727,1190872,1205240,1621778,7306157,422236,900654,1322890,1049995,1116789,1043914,1196040,1205511,1870058,7482307,14788464,17501696,17501696
Netherlands,2022,NL,NLD,EUR,447321,941108,1388429,1084473,1155493,1060356,1164005,1216166,1660819,7341312,426134,894672,1320806,1043167,1121292,1053909,1172076,1215761,1907264,7513469,14854781,17564014,17564014
Netherlands,2023,NL,NLD,EUR,452875,932192,1385067,1072624,1160185,1073560,1137993,1225767,1704873,7375002,431373,886217,1317590,1030212,1126014,1063478,1148069,1224799,1948060,7540632,14915634,17618299,17618299
Netherlands,2024,NL,NLD,EUR,459566,921824,1381390,1059683,1165899,1086688,1110061,1235761,1749891,7407983,437482,876784,1314266,1016121,1131404,1073421,1121384,1234789,1990365,7567484,14975467,17671125,17671125
Netherlands,2025,NL,NLD,EUR,465811,912821,1378632,1044854,1170072,1100729,1083179,1244983,1795149,7438966,443182,868291,1311473,1000503,1135706,1084181,1094774,1244472,2033627,7593263,15032229,17722333,17722333
Netherlands,2026,NL,NLD,EUR,469753,907893,1377646,1029362,1170742,1115952,1062128,1247996,1840824,7467004,446698,863722,1310420,984397,1136881,1095751,1073102,1248620,2077782,7616533,15083537,17771604,17771604
Netherlands,2027,NL,NLD,EUR,471894,907232,1379126,1014565,1168508,1132253,1046007,1243082,1886971,7491386,448521,863417,1311938,969305,1134769,1108697,1055224,1245578,2122815,7636388,15127774,17818839,17818839
Netherlands,2028,NL,NLD,EUR,473613,909326,1382939,999698,1165122,1148503,1036559,1229077,1933113,7512072,449954,865696,1315650,954753,1130889,1122127,1043123,1234185,2168013,7653090,15165162,17863750,17863750
Netherlands,2029,NL,NLD,EUR,474630,912271,1386901,987430,1159411,1162668,1034989,1206596,1979794,7530888,450742,868524,1319266,942943,1124528,1134134,1038587,1214579,2213622,7668393,15199281,17905449,17905449
Netherlands,2030,NL,NLD,EUR,474988,915832,1390820,978313,1151521,1172879,1040150,1180429,2024710,7548002,450929,871779,1322708,934165,1116026,1142632,1040749,1191223,2257482,7682277,15230279,17943803,17943803
Netherlands,1950,NL,NLD,EUR,619078,896204,1515282,815597,733462,651545,540227,400898,374090,3515819,585952,855932,1441884,790425,747097,678321,572013,423986,408727,3620569,7136388,10093554,10093554
Netherlands,1951,NL,NLD,EUR,614663,930227,1544890,812168,738637,654984,550062,410104,385538,3551493,581546,888145,1469691,786729,753452,680519,583101,435100,421321,3660222,7211715,10226295,10226295
Netherlands,1952,NL,NLD,EUR,594786,980615,1575401,809922,743666,657547,559910,419569,397192,3587806,562274,935663,1497937,784568,758946,682194,593689,446760,434506,3700663,7288469,10361805,10361805
Netherlands,1953,NL,NLD,EUR,582114,1022102,1604216,809495,751107,657623,570656,428282,408770,3625933,550184,974351,1524535,784079,766445,681516,604736,458153,447676,3742605,7368538,10497290,10497290
Netherlands,1954,NL,NLD,EUR,575401,1054617,1630018,811654,759805,656638,581660,436863,419563,3666183,544382,1003699,1548081,786122,774937,679742,616005,469573,460730,3787109,7453292,10631383,10631383
Netherlands,1955,NL,NLD,EUR,573662,1081341,1655003,814824,763667,662711,591900,445663,429534,3708299,543253,1027513,1570766,789548,777366,685421,626275,481342,473891,3833843,7542142,10767906,10767906
Netherlands,1956,NL,NLD,EUR,574695,1105977,1680672,818624,763502,675201,599255,454619,439262,3750463,544825,1050093,1594918,792726,774487,697870,633796,493185,487223,3879287,7629750,10905345,10905345
Netherlands,1957,NL,NLD,EUR,576379,1130212,1706591,824903,764812,684742,605733,465117,449370,3794677,546946,1073060,1620006,796922,772673,707308,640809,506142,500996,3924850,7719527,11046130,11046130
Netherlands,1958,NL,NLD,EUR,579520,1148694,1728214,838620,765191,692773,613361,475425,460603,3845973,550515,1090727,1641242,807927,769232,715126,648917,518582,516542,3976326,7822299,11191752,11191752
Netherlands,1959,NL,NLD,EUR,585342,1160879,1746221,859526,765372,700094,621003,484890,472333,3903218,556848,1102109,1658957,826078,764296,722677,656683,530098,533534,4033366,7936584,11341765,11341765
Netherlands,1960,NL,NLD,EUR,591478,1174556,1766034,879263,768548,707216,626524,494732,483442,3959725,563238,1115032,1678270,843287,761390,730188,661641,542032,550548,4089086,8048811,11493117,11493117
Netherlands,1961,NL,NLD,EUR,598192,1172516,1770708,915406,773473,715381,630469,503328,495253,4033310,570069,1113515,1683584,875751,760011,737926,664461,552978,568638,4159765,8193075,11647367,11647367
Netherlands,1962,NL,NLD,EUR,605324,1155910,1761234,967319,779431,723572,633550,511667,506383,4121922,577448,1097796,1675244,923355,759694,744662,666812,563449,587076,4245048,8366970,11803458,11803458
Netherlands,1963,NL,NLD,EUR,611579,1148184,1759763,1010113,787087,734218,634245,520635,515669,4201967,583621,1090764,1674385,962273,760742,753270,666819,574445,604751,4322300,8524267,11958415,11958415
Netherlands,1964,NL,NLD,EUR,617220,1148964,1766184,1044072,797057,746154,634000,529975,525316,4276574,588716,1092599,1681315,992349,764091,762758,665604,585626,623332,4393760,8670334,12117829,12117829
Netherlands,1965,NL,NLD,EUR,621057,1154813,1775870,1072169,807563,753415,640559,538626,534860,4347192,591923,1099136,1691059,1017377,768581,766150,671620,595641,642298,4461667,8808859,12275791,12275791
Netherlands,1966,NL,NLD,EUR,620630,1164106,1784736,1098152,818092,756715,653294,544591,544080,4414924,591123,1109021,1700144,1041567,772733,764258,684251,602915,661259,4526983,8941907,12426787,12426787
Netherlands,1967,NL,NLD,EUR,617338,1174640,1791978,1124070,830083,761351,663276,549875,554770,4483425,587607,1120234,1707841,1066689,777999,763414,693981,609684,681948,4593715,9077140,12576967,12576967
Netherlands,1968,NL,NLD,EUR,613200,1185910,1799110,1144878,848351,764974,671796,556307,565014,4551320,583767,1131697,1715464,1087386,790271,761044,702181,617539,702881,4661302,9212622,12727200,12727200
Netherlands,1969,NL,NLD,EUR,610009,1199575,1809584,1159885,873067,768188,679442,562594,574307,4617483,581253,1144978,1726231,1102569,810001,757352,710120,624956,722952,4727950,9345433,12881249,12881249
Netherlands,2031,NL,NLD,EUR,474739,920436,1395175,970414,1142928,1179115,1050123,1154477,2065737,7562794,450560,876189,1326749,926528,1106663,1147140,1048189,1167570,2297801,7693891,15256685,17978614,17978614
Netherlands,2032,NL,NLD,EUR,473711,925999,1399710,963218,1132790,1183214,1062855,1129523,2103800,7575400,449471,881503,1330974,919353,1095699,1150415,1057876,1144469,2335569,7703381,15278781,18009471,18009471
Netherlands,2033,NL,NLD,EUR,471836,933284,1405120,954345,1121050,1188001,1076160,1105055,2140333,7584944,447596,888187,1335783,910923,1082795,1155180,1067517,1121517,2372235,7710167,15295111,18036007,18036007
Netherlands,2034,NL,NLD,EUR,469470,941007,1410477,944021,1108228,1193800,1089395,1078862,2178091,7592397,445274,895093,1340367,901508,1068759,1160609,1077529,1096064,2410475,7714944,15307341,18058190,18058190
Netherlands,2035,NL,NLD,EUR,466461,947623,1414084,935062,1093516,1198065,1103542,1053804,2215298,7599287,442350,900984,1343334,893039,1053194,1164960,1088363,1070782,2448598,7718936,15318223,18075642,18075642
Netherlands,2036,NL,NLD,EUR,462706,951326,1414032,930170,1078144,1198855,1118865,1034380,2247022,7607436,438729,904141,1342870,888491,1037143,1166199,1100011,1050325,2481750,7723919,15331355,18088257,18088257
Netherlands,2037,NL,NLD,EUR,458514,952456,1410970,929541,1063457,1196743,1135235,1019649,2271808,7616433,434713,904882,1339595,888201,1022107,1164151,1113003,1033520,2508432,7729414,15345847,18096419,18096419
Netherlands,2038,NL,NLD,EUR,454102,952311,1406413,931662,1048697,1193480,1151528,1011249,2288145,7624761,430498,904454,1334952,890492,1007603,1160343,1126456,1022252,2526831,7733977,15358738,18100104,18100104
Netherlands,2039,NL,NLD,EUR,449726,950973,1400699,934631,1036526,1187895,1165737,1010382,2297265,7632436,426328,902931,1329259,893332,995839,1154056,1138486,1018289,2537663,7737665,15370101,18100067,18100067
Netherlands,2040,NL,NLD,EUR,445443,948337,1393780,938212,1027489,1180132,1176034,1015996,2301712,7639575,422254,900202,1322456,896596,987098,1145629,1147041,1020838,2543372,7740574,15380149,18096392,18096392
Netherlands,2041,NL,NLD,EUR,441143,944344,1385487,942836,1019666,1171664,1182398,1026259,2303412,7646235,418173,896223,1314396,901018,979497,1136342,1151644,1028524,2545693,7742718,15388953,18088839,18088839
Netherlands,2042,NL,NLD,EUR,437002,939137,1376139,948422,1012543,1161655,1186654,1039189,2303989,7652452,414248,891127,1305375,906345,972354,1125455,1155029,1038399,2546617,7744199,15396651,18078167,18078167
Netherlands,2043,NL,NLD,EUR,432949,932858,1365807,955721,1003738,1150050,1191587,1052668,2304327,7658091,410408,885051,1295459,913035,963958,1112641,1159897,1048226,2547222,7744979,15403070,18064333,18064333
Netherlands,2044,NL,NLD,EUR,428504,926131,1354635,963450,993493,1137365,1197526,1066065,2304937,7662836,406195,878568,1284763,919945,954582,1098696,1165428,1058417,2547674,7744742,15407578,18046977,18046977
Netherlands,2045,NL,NLD,EUR,424244,918848,1343092,970073,984604,1122808,1201962,1080380,2306814,7666641,402145,871580,1273725,925844,946150,1083242,1169904,1069440,2549010,7743590,15410231,18027049,18027049
Netherlands,2046,NL,NLD,EUR,420644,910806,1331450,973792,979771,1107580,1202957,1095857,2309465,7669422,398723,863889,1262612,929011,941631,1067297,1171293,1081273,2550937,7741442,15410864,18004933,18004933
Netherlands,2047,NL,NLD,EUR,417236,902488,1319724,974937,979192,1093036,1201063,1112300,2310593,7671121,395478,855955,1251433,929763,941368,1052358,1169413,1094383,2550906,7738191,15409312,17980469,17980469
Netherlands,2048,NL,NLD,EUR,414253,894029,1308282,974806,981352,1078415,1198017,1128602,2310406,7671598,392633,847912,1240545,929345,943678,1037948,1165770,1107893,2549053,7733687,15405285,17954107,17954107
Netherlands,2049,NL,NLD,EUR,412226,885217,1297443,973487,984362,1066364,1192652,1142847,2311016,7670728,390701,839537,1230238,927831,946536,1026262,1159654,1119996,2547593,7727872,15398600,17926277,17926277
Netherlands,2050,NL,NLD,EUR,410687,876681,1287368,970867,987973,1057431,1185107,1153270,2313711,7668359,389242,831422,1220664,925117,949825,1017593,1151402,1128699,2548001,7720637,15388996,17897025,17897025
Norway,1970,NO,NOR,EUR,169446,317418,486864,316849,233650,213071,249548,210772,217033,1440923,160214,301925,462139,299329,222935,207390,250748,223848,281362,1485612,2926535,3875546,3875546
Norway,1971,NO,NOR,EUR,168839,319435,488274,315701,247098,208368,248535,212955,220067,1452724,160099,303369,463468,298341,234592,202990,249189,225897,287435,1498444,2951168,3902910,3902910
Norway,1972,NO,NOR,EUR,168131,321850,489981,313858,261366,205311,246352,215449,223402,1465738,159718,305368,465086,296981,247059,199893,246528,228253,293532,1512246,2977984,3933047,3933047
Norway,1973,NO,NOR,EUR,166211,324735,490946,312655,273638,203786,242960,217920,226915,1477874,157920,308006,465926,296538,257856,198313,242735,230826,299701,1525969,3003843,3960709,3960709
Norway,1974,NO,NOR,EUR,162589,327823,490412,312575,284346,203288,239872,218916,231025,1490022,154837,310896,465733,296916,266905,197823,239334,231943,306294,1539215,3029237,3985380,3985380
Norway,1975,NO,NOR,EUR,158286,330584,488870,313006,293644,203601,235141,221050,235302,1501744,151282,313433,464715,297677,274977,198128,234096,234160,313099,1552137,3053881,4007466,4007466
Norway,1976,NO,NOR,EUR,153151,332913,486064,313688,302444,204346,229080,223982,239458,1512998,146577,315656,462233,298838,282838,198517,227398,237642,319784,1565017,3078015,4026314,4026314
Norway,1977,NO,NOR,EUR,146961,334912,481873,314521,310357,206726,223736,225386,243975,1524701,140621,317800,458421,300025,290013,200362,221705,239406,326854,1578365,3103066,4043361,4043361
Norway,1978,NO,NOR,EUR,141258,335714,476972,315140,316038,212299,217839,226485,248412,1536213,135286,318369,453655,300960,295758,205347,215558,240463,333881,1591967,3128180,4058807,4058807
Norway,1979,NO,NOR,EUR,136845,334185,471030,316858,318665,221444,211691,226982,252498,1548138,130862,317190,448052,302311,299178,213388,209418,240810,340329,1605434,3153572,4072653,4072653
Norway,1980,NO,NOR,EUR,133729,330376,464105,319309,319275,233045,206367,226490,256206,1560692,127321,314401,441722,304142,300505,223455,204473,240074,346607,1619256,3179948,4085776,4085776
Norway,1981,NO,NOR,EUR,131889,324805,456694,321884,318352,246660,202010,225601,259429,1573936,125481,309678,435159,306217,300309,235662,200310,238673,352901,1634072,3208008,4099855,4099855
Norway,1982,NO,NOR,EUR,131400,317884,449284,324715,316657,260715,199115,223575,263012,1587789,125059,303372,428431,308588,299399,248370,197384,235971,359711,1649423,3237212,4114931,4114931
Norway,1983,NO,NOR,EUR,131202,310311,441513,327692,315852,273047,197690,220418,266866,1601565,124648,296236,420884,311334,299398,259042,195898,232177,366761,1664610,3266175,4128572,4128572
Norway,1984,NO,NOR,EUR,130534,302369,432903,330680,315833,283759,197338,217558,269805,1614973,123887,288816,412703,314382,300304,268059,195500,228834,372570,1679649,3294622,4140235,4140235
Norway,1985,NO,NOR,EUR,130296,295035,425331,333431,316592,293204,197823,213293,273635,1627978,123742,281771,405513,317213,301615,276176,195816,223865,379136,1693821,3321799,4152637,4152637
Norway,1986,NO,NOR,EUR,130908,288162,419070,336090,318212,302264,198621,207871,278082,1641140,124103,275184,399287,320043,303564,284028,196115,217582,386623,1707955,3349095,4167459,4167459
Norway,1987,NO,NOR,EUR,132147,281576,413723,339345,321148,310554,201002,203042,281305,1656396,125356,268856,394212,322960,305868,291193,197860,212137,392695,1722713,3379109,4187036,4187036
Norway,1988,NO,NOR,EUR,134738,276029,410767,341514,324442,316927,206592,197789,284180,1671444,128345,263373,391718,324142,308011,296993,202776,206269,397524,1735715,3407159,4209653,4209653
Norway,1989,NO,NOR,EUR,138917,271355,410272,339280,327007,319695,215426,192410,286704,1680522,132303,258566,390869,322458,310041,300476,210764,200345,401326,1745410,3425932,4227074,4227074
Norway,1990,NO,NOR,EUR,143608,268125,411733,334237,328919,320021,226523,187758,288056,1685514,136562,255090,391652,318842,311890,301993,220688,195605,403718,1752736,3438250,4241636,4241636
Norway,1991,NO,NOR,EUR,148129,267093,415222,328749,331527,319084,239746,184072,288878,1692056,140892,253771,394663,314200,313932,301992,232695,191758,405365,1759942,3451998,4261886,4261886
Norway,1992,NO,NOR,EUR,152198,268155,420353,322336,335010,317567,253499,181811,289422,1699645,144312,254725,399037,308408,316778,301325,245290,189085,406636,1767522,3467167,4286557,4286557
Norway,1993,NO,NOR,EUR,154968,271033,426001,315263,338514,317257,265665,180980,288965,1706644,146522,257681,404203,302087,320486,302076,256077,187861,406705,1775292,3481936,4312136,4312136
Norway,1994,NO,NOR,EUR,156022,275113,431135,307633,341725,318074,276273,181203,288505,1713413,147516,261522,409038,295476,324410,303821,265252,187787,406407,1783153,3496566,4336739,4336739
Norway,1995,NO,NOR,EUR,156103,279726,435829,300414,344101,319359,285406,182174,288325,1719779,147530,265955,413485,288962,327632,305570,273403,188414,406252,1790233,3510012,4359333,4359333
Norway,1996,NO,NOR,EUR,155904,284882,440786,293688,345927,320880,293988,183411,287888,1725782,147291,270721,418012,282802,330417,307660,281155,188969,405929,1796932,3522714,4381510,4381510
Norway,1997,NO,NOR,EUR,155711,290134,445845,287288,347859,322561,301755,186078,287358,1732899,147239,275253,422492,276856,333325,309818,288109,190859,405137,1804104,3537003,4405333,4405333
Norway,1998,NO,NOR,EUR,155326,295229,450555,282295,349365,324444,307713,191671,286409,1741897,147084,280086,427170,272099,335162,311842,293840,195809,403310,1812062,3553959,4431676,4431676
Norway,1999,NO,NOR,EUR,155194,300924,456118,278765,349072,327912,311148,200699,284758,1752354,147015,285502,432517,268478,335789,314716,297794,203774,400605,1821156,3573510,4462142,4462142
Norway,2000,NO,NOR,EUR,154858,306458,461316,276752,346673,331893,312694,212043,282977,1763032,146846,290481,437327,265817,334547,317873,299984,213490,397816,1829527,3592559,4491202,4491202
Norway,2001,NO,NOR,EUR,153185,311013,464198,276284,341821,335256,312363,224997,281834,1772555,145509,294734,440243,264824,330861,320614,300381,224959,395387,1837026,3609581,4514017,4514017
Norway,2002,NO,NOR,EUR,150810,315286,466096,277760,335617,338927,311213,238162,281381,1783060,143703,298592,442295,266388,326395,324029,300013,236941,393217,1846983,3630043,4538438,4538438
Norway,2003,NO,NOR,EUR,149249,317848,467097,280917,329030,342870,311206,249634,281985,1795642,142531,300892,443423,269624,321371,328242,300815,247039,391910,1859001,3654643,4565167,4565167
Norway,2004,NO,NOR,EUR,148287,318407,466694,285082,322063,346837,312331,259702,284033,1810048,141770,301556,443326,273434,315795,332702,302559,255739,391976,1872205,3682253,4592277,4592277
Norway,2005,NO,NOR,EUR,147237,318330,465567,290229,316602,350855,314319,268573,287068,1827646,141070,301530,442600,278366,311161,337061,304618,263654,393022,1887882,3715528,4623689,4623689
Norway,2006,NO,NOR,EUR,147346,317188,464534,296512,312919,355452,317248,277130,290278,1849539,141282,300660,441942,283988,307434,341383,307318,271189,393767,1905079,3754618,4661087,4661087
Norway,2007,NO,NOR,EUR,149125,315332,464457,303728,312340,361594,321408,285051,294361,1878482,142714,299595,442309,289749,305167,345932,310208,278159,395114,1924329,3802811,4709577,4709577
Norway,2008,NO,NOR,EUR,151560,314413,465973,310917,314886,367903,326129,291297,300472,1911604,144615,299322,443937,296155,305409,349665,313125,284152,398637,1947143,3858747,4768654,4768654
Norway,2009,NO,NOR,EUR,154386,314405,468791,317864,317100,371355,331378,295266,309368,1942331,146851,299445,446296,302905,306809,352246,316921,288434,404466,1971781,3914112,4829199,4829199
Norway,2010,NO,NOR,EUR,157186,314025,471211,325380,320171,372007,337096,297812,320352,1972818,149229,299394,448623,309740,309308,353528,321187,291100,412224,1997087,3969905,4889741,4889741
Norway,2011,NO,NOR,EUR,159075,313555,472630,332793,326895,372148,343314,299111,333190,2007451,150757,299369,450126,316350,313961,353222,325469,292294,422051,2023347,4030798,4953561,4953561
Norway,2012,NO,NOR,EUR,160277,313776,474053,338871,336197,372105,349822,299682,346890,2043567,151747,299794,451541,321518,321062,351811,330241,292712,432553,2049897,4093464,5019056,5019056
Norway,2013,NO,NOR,EUR,160450,315382,475832,342502,345427,371229,356096,301105,359721,2076080,152141,301254,453395,324216,329503,349759,335687,294170,442025,2075360,4151440,5080668,5080668
Norway,2014,NO,NOR,EUR,159167,317919,477086,344264,353960,370001,362305,303593,372170,2106293,151116,303527,454643,325192,337596,347556,341503,296638,451421,2099906,4206199,5137923,5137923
Norway,2015,NO,NOR,EUR,157515,320414,477929,345136,361387,368927,367972,306671,384176,2134269,149505,305841,455346,325039,344791,345819,347133,299362,460666,2122810,4257079,5190356,5190356
Norway,2016,NO,NOR,EUR,156299,323306,479605,345376,367141,366732,372814,309918,395762,2157743,148167,308156,456323,323673,350614,344201,352490,302626,469314,2142918,4300661,5236590,5236590
Norway,2017,NO,NOR,EUR,154897,326384,481281,344364,371489,363783,377220,313310,407519,2177685,146660,310474,457134,322020,354920,342565,357599,305969,478215,2161288,4338973,5277392,5277392
Norway,2018,NO,NOR,EUR,152895,327998,480893,342356,374559,361902,380700,316828,419700,2196045,144348,311794,456142,320738,358517,341675,361240,309039,488032,2179241,4375286,5312320,5312320
Norway,2019,NO,NOR,EUR,150642,328180,478822,340878,378319,361675,382868,321472,431997,2217209,141843,311956,453799,319782,362344,341618,363513,312778,498409,2198444,4415653,5348279,5348279
Norway,2020,NO,NOR,EUR,147519,327935,475454,338733,381596,362657,383054,327022,444604,2237666,139017,311465,450482,318377,364855,342357,364416,317000,509240,2216245,4453911,5379839,5379839
Norway,2021,NO,NOR,EUR,143966,326820,470786,336409,382311,364689,381248,332707,457408,2254772,135938,309970,445908,316981,365190,344404,363337,321194,520449,2231555,4486327,5403021,5403021
Norway,2022,NO,NOR,EUR,141672,324699,466371,336360,383118,368682,378755,338629,470182,2275726,133909,307649,441558,317866,365509,348640,361067,325920,531661,2250663,4526389,5434319,5434319
Norway,2023,NO,NOR,EUR,140875,321257,462132,338714,383813,374006,376244,344879,483154,2300810,133231,304288,437519,321073,365526,354499,358391,331414,542998,2273901,4574711,5474360,5474360
Norway,2024,NO,NOR,EUR,140897,316505,457402,341489,383681,379673,373791,351267,496432,2326333,133312,299744,433056,324757,364635,360842,355622,337286,554543,2297685,4624018,5514477,5514477
Norway,2025,NO,NOR,EUR,141880,311118,452998,343521,383632,385322,372057,357271,509586,2351389,134035,294704,428739,327953,363591,367370,353499,343003,565930,2321346,4672735,5554468,5554468
Norway,2026,NO,NOR,EUR,143204,306251,449455,345382,382786,391157,370549,362988,522461,2375323,135091,290162,425253,330499,362388,373678,351817,348419,577296,2344097,4719420,5594125,5594125
Norway,2027,NO,NOR,EUR,144209,302415,446624,347567,381225,396498,369067,368526,535390,2398273,136069,286440,422509,332746,361498,379047,350283,353645,588801,2366020,4764293,5633425,5633425
Norway,2028,NO,NOR,EUR,145139,299546,444685,348806,380371,400600,368718,373039,548495,2420029,136975,283347,420322,334177,361502,383690,349636,357507,600742,2387254,4807283,5672292,5672292
Norway,2029,NO,NOR,EUR,145970,297433,443403,348769,380696,404212,369120,375727,562228,2440752,137781,281007,418788,334485,362378,387752,349731,359931,613423,2407700,4848452,5710637,5710637
Norway,2030,NO,NOR,EUR,146751,295464,442215,348547,381156,407522,370765,376387,576639,2461016,138541,279112,417653,334169,363793,390981,350994,361058,626523,2427518,4888534,5748397,5748397
Norway,1950,NO,NOR,EUR,161027,252912,413939,224091,265516,240835,200430,142276,139208,1212356,151950,241824,393774,214995,262015,241247,212585,157309,173210,1261361,2473717,3281416,3281416
Norway,1951,NO,NOR,EUR,162434,253458,415892,219038,264530,243239,202780,147173,142151,1218911,152918,242206,395124,210337,259895,242776,214920,161730,176757,1266415,2485326,3296340,3296340
Norway,1952,NO,NOR,EUR,158631,266873,425504,215380,262111,246255,205467,151848,145840,1226901,149127,254512,403639,206677,256330,245081,217146,166268,180776,1272278,2499179,3328325,3328325
Norway,1953,NO,NOR,EUR,156592,278381,434973,213316,258599,249096,208305,156670,149387,1235373,147547,264740,412287,204470,251752,247615,219063,171018,184954,1278872,2514245,3361500,3361500
Norway,1954,NO,NOR,EUR,155729,287991,443720,212385,255483,250453,211731,161775,152547,1244374,147350,273205,420555,203503,247826,248658,221208,175981,189068,1286244,2530618,3394890,3394890
Norway,1955,NO,NOR,EUR,156032,295726,451758,212685,251344,253211,215238,166222,155600,1254300,147856,280078,427934,203673,242779,250843,223661,180812,193327,1295095,2549395,3429090,3429090
Norway,1956,NO,NOR,EUR,157109,303533,460642,212531,244528,256624,218567,170496,159593,1262339,149303,287137,436440,203608,235369,254294,225759,185297,197865,1302192,2564531,3461602,3461602
Norway,1957,NO,NOR,EUR,157871,310942,468813,213511,237679,257861,222207,174754,164135,1270147,150709,293858,444567,204845,228351,255846,228138,189505,202288,1308973,2579120,3492505,3492505
Norway,1958,NO,NOR,EUR,157990,315925,473915,218630,230966,258880,225671,178301,168459,1280907,150959,298605,449564,209816,221569,256692,230518,193500,206993,1319088,2599995,3523479,3523479
Norway,1959,NO,NOR,EUR,158304,318054,476358,227277,223602,259382,229141,181307,172972,1293681,150890,301202,452092,217834,214761,256750,232639,197084,212062,1331130,2624811,3553260,3553260
Norway,1960,NO,NOR,EUR,158105,318168,476273,238455,216931,258737,232370,183759,177738,1307990,150574,301660,452234,227906,209146,255651,234660,200195,217459,1345017,2653007,3581520,3581520
Norway,1961,NO,NOR,EUR,157468,316554,474022,251775,211690,257664,234971,185813,182518,1324431,149806,300351,450157,240206,204495,253992,236630,202797,223274,1361394,2685825,3609995,3609995
Norway,1962,NO,NOR,EUR,157216,314147,471363,265095,208451,255361,237804,188013,186808,1341532,149264,298219,447483,252772,201427,251085,239053,205202,229215,1378754,2720286,3639133,3639133
Norway,1963,NO,NOR,EUR,157220,312747,469967,276557,206630,251783,240478,190378,190757,1356583,149307,297204,446511,263186,199693,247104,241610,207255,234892,1393740,2750323,3666800,3666800
Norway,1964,NO,NOR,EUR,158084,312368,470452,286198,205693,248450,241543,193373,194736,1369993,150026,297271,447297,271562,198902,243508,242798,209562,240594,1406926,2776919,3694673,3694673
Norway,1965,NO,NOR,EUR,160244,312326,472570,294019,205463,243355,243829,196601,198887,1382154,151573,297450,449023,278420,198924,238095,245151,212120,247046,1419756,2801910,3723510,3723510
Norway,1966,NO,NOR,EUR,162541,312867,475408,301662,205638,236972,247010,199312,202776,1393370,153429,298185,451614,284862,198789,231155,248683,214522,254673,1432684,2826054,3753077,3753077
Norway,1967,NO,NOR,EUR,164668,313693,478361,308977,207688,231493,248408,202187,206679,1405432,155464,299100,454564,290837,200135,225151,250406,217149,262306,1445984,2851416,3784342,3784342
Norway,1968,NO,NOR,EUR,167211,313963,481174,314351,213203,225324,249469,205170,210785,1418302,157616,299583,457199,295845,205030,218771,251463,219571,268940,1459620,2877922,3816298,3816298
Norway,1969,NO,NOR,EUR,169162,315311,484473,316656,222326,218765,250064,208065,214179,1430055,159499,300533,460032,298739,213087,212475,251732,221737,275194,1472964,2903019,3847521,3847521
Norway,2031,NO,NOR,EUR,147527,293609,441136,347853,381859,410220,374256,375380,591215,2480783,139292,277504,416796,333156,365624,393629,354204,360453,639729,2446795,4927578,5785507,5785507
Norway,2032,NO,NOR,EUR,148278,292549,440827,345994,383216,412355,378903,373387,605493,2499348,140019,276677,416696,331107,368005,395287,359047,358541,653032,2465019,4964367,5821885,5821885
Norway,2033,NO,NOR,EUR,149049,292688,441737,342561,385591,413086,384256,371138,619672,2516304,140755,276907,417662,327754,371211,395320,364913,356030,666652,2481880,4998184,5857592,5857592
Norway,2034,NO,NOR,EUR,149878,293543,443421,337832,388385,413002,389949,368965,634026,2532159,141546,277796,419342,323221,374905,394453,371263,353446,680479,2497767,5029926,5892684,5892684
Norway,2035,NO,NOR,EUR,150781,295308,446089,332460,390440,412996,395620,367494,647698,2546708,142406,279280,421686,318187,378103,393435,377798,351505,693675,2512703,5059411,5927178,5927178
Norway,2036,NO,NOR,EUR,151755,297410,449165,327607,392320,412198,401475,366245,660717,2560562,143330,281088,424418,313655,380654,392254,384116,349993,706266,2526938,5087500,5961087,5961087
Norway,2037,NO,NOR,EUR,152811,299172,451983,323786,394522,410689,406837,365025,673537,2574396,144330,282796,427126,309941,382909,391390,389493,348634,718592,2540959,5115355,5994456,5994456
Norway,2038,NO,NOR,EUR,153958,300874,454832,320929,395778,409875,410967,364912,685515,2587976,145416,284442,429858,306857,384348,391410,394147,348149,729827,2554738,5142714,6027403,6027403
Norway,2039,NO,NOR,EUR,155050,302534,457584,318831,395768,410238,414611,365514,696414,2601376,146454,286039,432493,304522,384660,392303,398222,348384,740212,2568303,5169679,6059761,6059761
Norway,2040,NO,NOR,EUR,155959,304222,460181,316876,395570,410734,417953,367315,706126,2614574,147312,287660,434972,302633,384355,393736,401471,349761,749726,2581682,5196256,6091402,6091402
Norway,2041,NO,NOR,EUR,156663,305975,462638,315035,394900,411471,420691,370899,714561,2627557,147977,289339,437316,301034,383355,395581,404141,353045,757687,2594843,5222400,6122351,6122351
Norway,2042,NO,NOR,EUR,157178,307784,464962,313987,393072,412861,422867,375598,721966,2640351,148464,291067,439531,300209,381317,397976,405828,357927,764564,2607821,5248172,6152665,6152665
Norway,2043,NO,NOR,EUR,157444,309703,467147,314133,389677,415254,423658,380986,729221,2652929,148717,292892,441609,300442,377980,401195,405901,363814,771301,2620633,5273562,6182325,6182325
Norway,2044,NO,NOR,EUR,157472,311627,469099,314998,384987,418069,423638,386711,736943,2665346,148747,294718,443465,301338,373462,404896,405083,370187,778346,2633312,5298658,6211225,6211225
Norway,2045,NO,NOR,EUR,157289,313438,470727,316766,379658,420151,423699,392426,744928,2677628,148583,296437,445020,302828,368443,408104,404120,376744,785666,2645905,5323533,6239281,6239281
Norway,2046,NO,NOR,EUR,156926,315121,472047,318871,374847,422055,422978,398307,752690,2689748,148248,298031,446279,304639,363931,410672,403002,383081,793074,2658399,5348147,6266468,6266468
Norway,2047,NO,NOR,EUR,156490,316693,473183,320636,371059,424280,421544,403697,760473,2701689,147842,299518,447360,306347,360228,412936,402189,388485,800554,2670739,5372428,6292968,6292968
Norway,2048,NO,NOR,EUR,155962,318105,474067,322345,368233,425559,420798,407878,768668,2713481,147349,300860,448209,307994,357159,414391,402256,393171,808030,2683001,5396482,6318755,6318755
Norway,2049,NO,NOR,EUR,155320,319229,474549,324007,366164,425576,421218,411573,776646,2725184,146746,301930,448676,309598,354838,414719,403189,397285,815581,2695210,5420394,6343614,6343614
Norway,2050,NO,NOR,EUR,154653,319955,474608,325699,364235,425409,421771,414972,784734,2736820,146121,302622,448743,311221,352959,414429,404658,400579,823541,2707387,5444207,6367559,6367559
Nepal,1970,NP,NPL,SEA,1027903,1569140,2597043,1239990,905890,641375,457617,291091,182257,3718220,987266,1490461,2477727,1170984,858990,643170,488207,325026,221914,3708291,7426511,12501285,12501285
Nepal,1971,NP,NPL,SEA,1050391,1605206,2655597,1265929,929018,654548,466388,297600,187732,3801215,1009234,1524736,2533970,1195398,878135,652348,496329,333213,228656,3784079,7585294,12774870,12774870
Nepal,1972,NP,NPL,SEA,1072436,1643503,2715939,1289766,954035,667849,475244,304199,193336,3884429,1030528,1561288,2591816,1217584,899636,661512,504378,341435,235493,3860038,7744467,13052220,13052220
Nepal,1973,NP,NPL,SEA,1092689,1684431,2777120,1311174,983116,681625,484394,310898,198999,3970206,1049865,1600466,2650331,1237567,925309,671021,512483,349560,242371,3938311,7908517,13335963,13335963
Nepal,1974,NP,NPL,SEA,1113591,1727280,2840871,1332848,1012397,695493,493729,317670,204692,4056829,1069603,1641546,2711149,1257903,951616,680603,520558,357455,249312,4017447,8074276,13626301,13626301
Nepal,1975,NP,NPL,SEA,1136912,1770894,2907806,1356628,1037491,712188,503289,324556,210487,4144639,1091572,1683325,2774897,1280312,974906,692800,528633,365118,256435,4098204,8242843,13925541,13925541
Nepal,1976,NP,NPL,SEA,1161710,1814759,2976469,1380944,1058768,732371,512982,331517,216409,4232991,1115045,1725283,2840328,1303653,995754,708427,536698,372596,263822,4180950,8413941,14230738,14230738
Nepal,1977,NP,NPL,SEA,1188466,1858594,3047060,1408093,1080422,754706,523297,338639,222433,4327590,1140387,1767116,2907503,1329219,1016891,725905,544927,379937,271399,4268278,8595868,14550430,14550430
Nepal,1978,NP,NPL,SEA,1218206,1901808,3120014,1438648,1104001,778659,534496,346016,228634,4430454,1168544,1808346,2976890,1357373,1039284,744704,553468,387290,279283,4361402,8791856,14888770,14888770
Nepal,1979,NP,NPL,SEA,1249576,1945750,3195326,1471070,1128354,802264,546242,353558,235042,4536530,1198393,1850287,3048680,1387494,1062477,763554,562204,394714,287587,4458030,8994560,15238564,15238564
Nepal,1980,NP,NPL,SEA,1280037,1992087,3272124,1506269,1154752,825244,558724,361351,241696,4648036,1227577,1894293,3121870,1420001,1086988,781960,571134,402166,296167,4558416,9206452,15600442,15600442
Nepal,1981,NP,NPL,SEA,1309878,2040665,3350543,1542926,1181219,848009,571586,369315,248517,4761572,1256334,1940257,3196591,1454185,1111418,800692,580186,409654,304950,4661085,9422657,15969792,15969792
Nepal,1982,NP,NPL,SEA,1340800,2090899,3431699,1580819,1205221,872506,584589,377424,255431,4875990,1286329,1987557,3273886,1490056,1133606,821687,589290,417128,313774,4765541,9641531,16347124,16347124
Nepal,1983,NP,NPL,SEA,1373318,2142613,3515931,1621919,1227415,900844,598076,385810,262473,4996537,1318097,2035960,3354057,1528687,1153613,846236,598562,424560,322474,4874132,9870669,16740664,16740664
Nepal,1984,NP,NPL,SEA,1407007,2196452,3603459,1663500,1248671,928992,611566,394378,269570,5116677,1351260,2086279,3437539,1568423,1173365,871204,607883,431985,331074,4983934,10100611,17141610,17141610
Nepal,1985,NP,NPL,SEA,1441653,2251563,3693216,1702963,1269046,952290,627237,403029,276700,5231265,1385641,2137907,3523548,1607375,1193671,892999,619448,439423,339630,5092546,10323811,17540571,17540571
Nepal,1986,NP,NPL,SEA,1476207,2307726,3783933,1740534,1287687,971672,645946,411783,283878,5341500,1420067,2190811,3610878,1645397,1213732,912388,634083,446848,348164,5200612,10542112,17936926,17936926
Nepal,1987,NP,NPL,SEA,1509964,2366682,3876646,1774754,1303141,988130,665236,420542,291042,5442845,1453678,2246867,3700545,1681596,1232946,930571,649873,454311,356876,5306173,10749018,18326204,18326204
Nepal,1988,NP,NPL,SEA,1542927,2429882,3972809,1807991,1318004,1003496,684709,429507,298236,5541943,1486341,2307458,3793799,1717024,1252611,948520,666296,461893,365858,5412202,10954145,18720745,18720745
Nepal,1989,NP,NPL,SEA,1574888,2496513,4071401,1846937,1338235,1021071,704596,439247,305954,5656040,1517725,2371866,3889591,1755947,1275981,967919,683071,469810,375317,5528045,11184085,19145077,19145077
Nepal,1990,NP,NPL,SEA,1607827,2564484,4172311,1895770,1367742,1043075,725031,450131,314548,5796297,1549693,2438247,3987940,1801248,1305161,989887,700038,478246,385399,5659979,11456276,19616530,19616530
Nepal,1991,NP,NPL,SEA,1642485,2632880,4275365,1952316,1405313,1068194,746619,462022,324026,5958490,1583072,2505761,4088833,1852443,1340287,1013745,718164,487261,396179,5808079,11766569,20130779,20130779
Nepal,1992,NP,NPL,SEA,1678318,2703116,4381434,2016370,1452695,1095428,771826,475047,334571,6145937,1617472,2575699,4193171,1911752,1385223,1039500,740090,497167,407859,5981591,12127528,20702133,20702133
Nepal,1993,NP,NPL,SEA,1716329,2773715,4490044,2075664,1498435,1118068,799302,487943,344879,6324291,1653643,2646630,4300273,1968175,1430464,1062138,764982,507267,419716,6152742,12477033,21267359,21267359
Nepal,1994,NP,NPL,SEA,1754342,2843291,4597633,2127463,1537520,1136731,825272,500199,354618,6481803,1689436,2717138,4406574,2018078,1470467,1082116,789438,517188,431457,6308744,12790547,21794751,21794751
Nepal,1995,NP,NPL,SEA,1787766,2914607,4702373,2175912,1572728,1155052,847200,514526,364449,6629867,1720795,2789353,4510148,2066939,1509111,1103150,811370,529284,443319,6463173,13093040,22305571,22305571
Nepal,1996,NP,NPL,SEA,1813059,2987088,4800147,2219704,1601498,1170935,865438,531456,374226,6763257,1744392,2862376,4606768,2114193,1544826,1123941,831310,544223,455307,6613800,13377057,22783969,22783969
Nepal,1997,NP,NPL,SEA,1828128,3059085,4887213,2266745,1628855,1187157,882682,549537,384304,6899280,1758145,2934562,4692707,2164999,1579939,1145865,851106,560579,467724,6770212,13669492,23249417,23249417
Nepal,1998,NP,NPL,SEA,1831490,3132789,4964279,2318137,1653653,1203441,899347,567965,394709,7037252,1760639,3008252,4768891,2220659,1613659,1168866,871150,577779,480798,6932911,13970163,23703328,23703328
Nepal,1999,NP,NPL,SEA,1825666,3206219,5031885,2372050,1676365,1219684,915733,585789,405461,7175082,1754387,3081422,4835809,2279735,1646719,1193025,891636,594970,494293,7100378,14275460,24143157,24143157
Nepal,2000,NP,NPL,SEA,1814808,3275604,5090412,2425012,1696716,1235170,931730,602196,416408,7307232,1743408,3150008,4893416,2339344,1679337,1217927,912437,611459,507928,7268432,14575664,24559500,24559500
Nepal,2001,NP,NPL,SEA,1800491,3338709,5139200,2478017,1716010,1250324,946854,618050,427538,7436793,1729192,3211958,4941150,2399753,1712210,1243806,932993,628207,521951,7438920,14875713,24956071,24956071
Nepal,2002,NP,NPL,SEA,1784462,3391154,5175616,2517223,1737548,1268855,961857,636837,440281,7562601,1714105,3263624,4977729,2462284,1747456,1270650,951381,647635,536828,7616234,15178835,25332178,25332178
Nepal,2003,NP,NPL,SEA,1767937,3433261,5201198,2539462,1758826,1290720,975723,659761,454668,7679160,1699034,3305630,5004664,2525679,1784321,1298329,966447,670616,552496,7797888,15477048,25682908,25682908
Nepal,2004,NP,NPL,SEA,1749931,3466465,5216396,2556460,1775985,1312314,988853,683020,469433,7786065,1682140,3339455,5021595,2588016,1821599,1326614,980671,694393,568619,7979912,15765977,26003965,26003965
Nepal,2005,NP,NPL,SEA,1726965,3489957,5216922,2569749,1787145,1332190,1002649,703747,486310,7881790,1660240,3364513,5024753,2650206,1858645,1354263,995369,716331,586832,8161646,16043436,26285110,26285110
Nepal,2006,NP,NPL,SEA,1698165,3502118,5200283,2579514,1791319,1349695,1016155,722738,505827,7965248,1632662,3379311,5011973,2711368,1895303,1380615,1009711,736928,607538,8341463,16306711,26518971,26518971
Nepal,2007,NP,NPL,SEA,1666643,3501883,5168526,2587523,1790879,1364561,1029475,741120,526483,8040041,1602361,3382449,4984810,2770303,1933983,1405530,1023970,757110,629378,8520274,16560315,26713655,26713655
Nepal,2008,NP,NPL,SEA,1632398,3489044,5121442,2600868,1788095,1376358,1042589,759145,547605,8114660,1569457,3373137,4942594,2830493,1976651,1428770,1038322,776934,651688,8702858,16817518,26881544,26881544
Nepal,2009,NP,NPL,SEA,1596000,3465594,5061594,2619569,1781810,1386264,1055859,777097,568473,8189072,1534587,3353192,4887779,2890653,2022397,1451668,1053322,796553,673893,8888486,17077558,27026941,27026941
Nepal,2010,NP,NPL,SEA,1562345,3432684,4995029,2644520,1771351,1395935,1069616,795072,588559,8265053,1502249,3323892,4826141,2948441,2069859,1475963,1069508,815968,695611,9075350,17340403,27161567,27161567
Nepal,2011,NP,NPL,SEA,1535695,3390437,4926132,2664197,1751859,1403454,1083410,812445,608561,8323926,1476483,3285739,4762222,2999345,2116009,1500321,1086382,834450,717618,9254125,17578051,27266399,27266399
Nepal,2012,NP,NPL,SEA,1517154,3342926,4860080,2668991,1721191,1406856,1097175,827827,629937,8351977,1458492,3242778,4701270,3038184,2159765,1523485,1103879,850608,741450,9417371,17769348,27330694,27330694
Nepal,2013,NP,NPL,SEA,1505446,3291804,4797250,2668604,1686581,1407047,1111505,840423,653486,8367646,1446911,3196181,4643092,3068409,2203870,1546816,1122824,863860,767794,9573573,17941219,27381555,27381555
Nepal,2014,NP,NPL,SEA,1500043,3237955,4737998,2679209,1658339,1407355,1126619,852302,677159,8400983,1440916,3146138,4587054,3095858,2251788,1573749,1143799,876325,794544,9736063,18137046,27462106,27462106
Nepal,2015,NP,NPL,SEA,1499857,3183390,4683247,2715602,1648051,1409742,1142115,864426,699662,8479598,1439236,3094040,4533276,3123807,2308250,1606183,1166824,888902,820235,9914201,18393799,27610325,27610325
Nepal,2016,NP,NPL,SEA,1502319,3133094,4635413,2785133,1664286,1416558,1158791,876548,722741,8624057,1439459,3044431,4483890,3153821,2376083,1646571,1193063,901517,846773,10117828,18741885,27861186,27861186
Nepal,2017,NP,NPL,SEA,1504047,3091083,4595130,2868774,1702668,1427718,1176139,888953,746415,8810667,1439010,3001570,4440580,3179950,2451079,1695253,1221950,914597,874218,10337047,19147714,28183426,28183426
Nepal,2018,NP,NPL,SEA,1503132,3053767,4556899,2937487,1756776,1439929,1192143,901152,769783,8997270,1436770,2962631,4399401,3193115,2529943,1749574,1251172,927840,901487,10553131,19550401,28506712,28506712
Nepal,2019,NP,NPL,SEA,1501063,3020596,4521659,2990137,1825767,1451798,1208051,913802,792997,9182552,1434139,2927214,4361353,3194570,2610913,1808439,1281917,942145,928948,10766932,19949484,28832496,28832496
Nepal,2020,NP,NPL,SEA,1502555,2998971,4501526,3071579,1948085,1480586,1232714,929587,816371,9478922,1435476,2901598,4337074,3205892,2710983,1879817,1319276,958917,956232,11031117,20510039,29348627,29348627
Nepal,2021,NP,NPL,SEA,1509349,2989419,4498768,3173787,2121869,1526372,1265653,947750,836768,9872199,1442380,2886685,4329065,3224269,2827707,1962654,1362797,977567,979968,11334962,21207161,30034989,30034989
Nepal,2022,NP,NPL,SEA,1516498,2982165,4498663,3215576,2266162,1553857,1291500,964555,855938,10147588,1449773,2875005,4324778,3211918,2918517,2039517,1405406,997633,1003565,11576556,21724144,30547580,30547580
Nepal,2023,NP,NPL,SEA,1522070,2976046,4498116,3201625,2379150,1565971,1309750,980941,876809,10314246,1455675,2865211,4320886,3171813,2983463,2110859,1447060,1020202,1029937,11763334,22077580,30896590,30896590
Nepal,2024,NP,NPL,SEA,1525446,2975747,4501193,3171291,2496184,1583495,1327880,998309,897408,10474567,1459534,2861023,4320557,3124775,3042093,2184523,1491345,1045169,1056095,11944000,22418567,31240315,31240315
Nepal,2025,NP,NPL,SEA,1525195,2980417,4505612,3128178,2613106,1609804,1344945,1015953,918147,10630133,1459913,2861904,4321817,3072846,3093157,2261622,1537805,1071847,1082526,12119803,22749936,31577361,31577361
Nepal,2026,NP,NPL,SEA,1520798,2987888,4508686,3079619,2723331,1646610,1360552,1033709,939445,10783266,1456377,2866081,4322458,3020628,3134094,2341551,1586604,1100052,1109738,12292667,23075933,31907071,31907071
Nepal,2027,NP,NPL,SEA,1511165,2996486,4507651,3034254,2819670,1693993,1376150,1051135,961078,10936280,1447796,2872103,4319899,2973625,3161996,2422455,1639551,1129444,1137625,12464696,23400976,32228530,32228530
Nepal,2028,NP,NPL,SEA,1497356,3003827,4501183,2993134,2897446,1756109,1392657,1067558,982961,11089865,1435065,2877764,4312829,2931273,3175060,2506747,1697822,1159451,1166257,12636610,23726475,32540486,32540486
Nepal,2029,NP,NPL,SEA,1480924,3007776,4488700,2956166,2956939,1832714,1408894,1084097,1005356,11244166,1419745,2880972,4300717,2893241,3174854,2592753,1760412,1191174,1196018,12808452,24052618,32842036,32842036
Nepal,2030,NP,NPL,SEA,1462726,3008008,4470734,2926617,2997898,1921473,1422890,1101737,1028194,11398809,1402689,2881385,4284074,2862468,3162449,2676964,1825321,1225606,1226973,12979781,24378590,33133395,33133395
Nepal,1950,NP,NPL,SEA,698669,1043853,1742522,797428,608257,446990,301386,176308,106112,2436481,672912,1006649,1679561,805530,633732,464107,318286,194716,124005,2540376,4976857,8398945,8398945
Nepal,1951,NP,NPL,SEA,715645,1067174,1782819,813341,620359,456693,309494,181873,108092,2489852,689279,1025546,1714825,817006,644985,475555,326957,200595,127227,2592325,5082177,8579831,8579831
Nepal,1952,NP,NPL,SEA,731230,1092943,1824173,828520,631880,466129,317543,187395,110219,2541686,704129,1047369,1751498,827496,655507,486796,335562,206506,130660,2642527,5184213,8759894,8759894
Nepal,1953,NP,NPL,SEA,743536,1122695,1866231,842642,642517,475139,325381,192807,112590,2591076,715945,1073345,1789290,836741,664932,497465,343965,212415,134371,2689889,5280965,8936482,8936482
Nepal,1954,NP,NPL,SEA,755784,1153038,1908822,856083,652638,483874,333001,197965,115399,2638960,727736,1100283,1828019,845142,673543,507492,352138,218203,138456,2734974,5373934,9110777,9110777
Nepal,1955,NP,NPL,SEA,768990,1179432,1948422,872623,662716,492530,340466,202897,118694,2689926,740285,1124243,1864528,856228,681791,516990,360166,223917,142922,2782014,5471940,9284895,9284895
Nepal,1956,NP,NPL,SEA,781020,1202928,1983948,893404,672753,501081,347773,207861,122202,2745074,751597,1146140,1897737,871112,689631,525949,368133,229793,147512,2832130,5577204,9458896,9458896
Nepal,1957,NP,NPL,SEA,792350,1225877,2018227,915791,682840,509542,354983,213008,125787,2801951,762133,1167910,1930043,887467,697048,534408,376131,235889,152074,2883017,5684968,9633243,9633243
Nepal,1958,NP,NPL,SEA,803182,1248952,2052134,938242,692509,517606,361989,218304,129425,2858075,772143,1190010,1962153,903961,703568,542200,384179,242135,156612,2932655,5790730,9805019,9805019
Nepal,1959,NP,NPL,SEA,814105,1273133,2087238,960565,702785,525735,369043,223810,133101,2915039,782303,1213155,1995458,920691,710175,549840,392547,248531,161163,2982947,5897986,9980681,9980681
Nepal,1960,NP,NPL,SEA,826722,1299009,2125731,982784,714547,534382,376354,229552,136816,2974435,794182,1237761,2031943,937931,717839,557797,401423,255081,165760,3035831,6010266,10167941,10167941
Nepal,1961,NP,NPL,SEA,841903,1325449,2167352,1005369,727099,543280,383794,235447,140587,3035576,808655,1262653,2071308,956187,726022,565880,410612,261741,170473,3090915,6126491,10365144,10365144
Nepal,1962,NP,NPL,SEA,859179,1350141,2209320,1030741,740220,552454,391395,241476,144497,3100783,825175,1285578,2110753,977655,734540,574013,419888,268442,175319,3149857,6250640,10570716,10570716
Nepal,1963,NP,NPL,SEA,878008,1371768,2249776,1060197,753722,561875,399114,247555,148570,3171033,843111,1305594,2148705,1003282,743279,582120,429053,275119,180340,3213193,6384226,10782717,10782717
Nepal,1964,NP,NPL,SEA,898555,1393934,2292489,1090450,767660,571646,406976,253649,152817,3243198,862651,1326218,2188869,1030099,752387,590326,438031,281810,185609,3278262,6521460,11002819,11002819
Nepal,1965,NP,NPL,SEA,919867,1418893,2338760,1117382,785442,581994,415080,259778,157258,3316934,882932,1349437,2232369,1054572,764980,598805,446817,288547,191164,3344885,6661819,11232951,11232951
Nepal,1966,NP,NPL,SEA,940689,1445356,2386045,1141645,807806,592813,423344,265920,161895,3393423,902802,1374088,2276890,1077144,781718,607380,455330,295335,196930,3413837,6807260,11470199,11470199
Nepal,1967,NP,NPL,SEA,961707,1473487,2435194,1165336,832110,604111,431738,272101,166733,3472129,922943,1400379,2323322,1099609,800365,616079,463659,302303,202920,3484935,6957064,11715579,11715579
Nepal,1968,NP,NPL,SEA,983700,1503226,2486926,1189224,857321,615962,440244,278331,171726,3552808,944174,1428300,2372474,1122542,820132,624974,471898,309548,209099,3558193,7111001,11970411,11970411
Nepal,1969,NP,NPL,SEA,1005872,1535028,2540900,1213865,882080,628343,448851,284648,176912,3634699,965722,1458223,2423945,1146118,839760,633933,480024,317092,215396,3632323,7267022,12231874,12231874
Nepal,2031,NP,NPL,SEA,1443135,3005459,4448594,2906816,3019203,2020499,1434390,1120192,1051371,11552471,1384189,2879805,4263994,2840414,3138414,2757168,1891706,1262596,1259228,13149526,24701997,33414586,33414586
Nepal,2032,NP,NPL,SEA,1422879,3000649,4423528,2895684,3023323,2126394,1444810,1138823,1075258,11704292,1365011,2876289,4241300,2825915,3106609,2829687,1959995,1301690,1293371,13317267,25021559,33686387,33686387
Nepal,2033,NP,NPL,SEA,1402728,2993051,4395779,2890336,3010676,2238169,1457589,1157092,1100232,11854094,1345922,2870076,4215998,2816742,3067854,2894961,2030819,1342662,1329970,13483008,25337102,33948886,33948886
Nepal,2034,NP,NPL,SEA,1383503,2980609,4364112,2890681,2981777,2353906,1475628,1175339,1126042,12003373,1327639,2859199,4186838,2813078,3022101,2953940,2103929,1386233,1368869,13648150,25651523,34202471,34202471
Nepal,2035,NP,NPL,SEA,1365893,2962761,4328654,2895892,2940172,2469528,1502179,1192633,1152480,12152884,1310859,2843063,4153922,2814409,2971384,3005391,2180387,1431937,1409836,13813344,25966228,34448817,34448817
Nepal,2036,NP,NPL,SEA,1349544,2939361,4288905,2903838,2893103,2578559,1538889,1208648,1179813,12302850,1295215,2821534,4116749,2818967,2920284,3046766,2259608,1479934,1453170,13978729,26281579,34687232,34687232
Nepal,2037,NP,NPL,SEA,1334376,2910045,4244421,2912862,2849086,2673901,1585851,1224673,1207500,12453873,1280585,2794234,4074819,2825323,2874264,3075176,2339792,1531921,1498462,14144938,26598811,34918056,34918056
Nepal,2038,NP,NPL,SEA,1320522,2876640,4197162,2920612,2809193,2751002,1647110,1241469,1234712,12604098,1267137,2762843,4029980,2831288,2832791,3088885,2423310,1588955,1545044,14310273,26914371,35141522,35141522
Nepal,2039,NP,NPL,SEA,1307747,2841521,4149268,2924975,2773354,2810151,1722406,1258027,1262512,12751425,1254743,2729643,3984386,2834787,2795557,3089465,2508558,1650141,1594146,14472654,27224079,35357736,35357736
Nepal,2040,NP,NPL,SEA,1296264,2806230,4102494,2925624,2744795,2851069,1809415,1272584,1291716,12895203,1243619,2696184,3939803,2835482,2765485,3077941,2592053,1713605,1646724,14631290,27526493,35568802,35568802
Nepal,2041,NP,NPL,SEA,1286872,2770795,4057667,2923493,2725817,2872633,1906254,1284894,1322060,13035151,1234520,2662392,3896912,2834167,2744025,3054860,2671603,1778527,1702706,14785888,27821039,35775609,35775609
Nepal,2042,NP,NPL,SEA,1279211,2735853,4015064,2919088,2715376,2877266,2009616,1296271,1353193,13170810,1227109,2628913,3856022,2830898,2730024,3024040,2743604,1845302,1762048,14935916,28106726,35977813,35977813
Nepal,2043,NP,NPL,SEA,1273511,2702304,3975815,2911895,2710637,2865419,2118626,1309925,1384895,13301397,1221571,2596682,3818253,2824935,2721295,2986322,2808514,1914557,1824926,15080549,28381946,36176020,36176020
Nepal,2044,NP,NPL,SEA,1269403,2670735,3940138,2899873,2711520,2837613,2231500,1328619,1417277,13426402,1217525,2566288,3783813,2814298,2718023,2941669,2867289,1986078,1891836,15219193,28645595,36369545,36369545
Nepal,2045,NP,NPL,SEA,1265128,2642042,3907170,2882467,2717210,2797350,2344307,1355320,1449347,13546001,1213282,2538642,3751924,2798416,2719699,2892108,2918722,2060861,1962204,15352010,28898011,36557101,36557101
Nepal,2046,NP,NPL,SEA,1260120,2616680,3876800,2859535,2725597,2751737,2450758,1391541,1481001,13660169,1208342,2514140,3722482,2777144,2724573,2842153,2960310,2138360,2036426,15478966,29139135,36738417,36738417
Nepal,2047,NP,NPL,SEA,1254960,2594206,3849166,2830720,2735054,2709137,2543950,1437410,1512932,13769203,1203271,2492319,3695590,2750113,2731235,2797205,2989207,2216880,2115650,15600290,29369493,36914245,36914245
Nepal,2048,NP,NPL,SEA,1249286,2574990,3824276,2797832,2743246,2670610,2619556,1496728,1545134,13873106,1197698,2473537,3671235,2718996,2737497,2756750,3003745,2298736,2200120,15715844,29588950,37084465,37084465
Nepal,2049,NP,NPL,SEA,1242459,2558426,3800885,2763236,2748083,2636086,2677880,1569203,1577623,13972111,1190994,2457284,3648278,2686070,2741297,2720480,3005458,2382366,2290056,15825727,29797838,37247004,37247004
Nepal,2050,NP,NPL,SEA,1234938,2542964,3777902,2728461,2749238,2608726,2718570,1652507,1609549,14067051,1183617,2442090,3625707,2652872,2742297,2691276,2995300,2464363,2384599,15930707,29997758,37401365,37401365
Nauru,1970,NR,NRU,WPR,451,891,1342,514,788,711,412,140,68,2633,417,839,1256,442,370,335,159,66,59,1431,4064,6663,6663
Nauru,1971,NR,NRU,WPR,432,920,1352,530,758,727,437,151,70,2673,401,861,1262,479,356,350,171,74,57,1487,4160,6778,6778
Nauru,1972,NR,NRU,WPR,420,935,1355,558,721,739,466,164,72,2720,393,871,1264,517,345,359,190,74,60,1545,4265,6883,6883
Nauru,1973,NR,NRU,WPR,413,942,1355,595,676,746,494,182,73,2766,386,874,1260,561,333,369,208,77,62,1610,4376,6990,6990
Nauru,1974,NR,NRU,WPR,409,940,1349,640,627,755,519,204,75,2820,384,870,1254,604,323,376,225,85,61,1674,4494,7096,7096
Nauru,1975,NR,NRU,WPR,407,937,1344,682,582,758,546,227,77,2872,379,864,1243,643,325,380,237,98,58,1741,4613,7199,7199
Nauru,1976,NR,NRU,WPR,404,929,1333,724,542,761,565,255,79,2926,379,854,1233,683,333,381,252,108,60,1817,4743,7306,7306
Nauru,1977,NR,NRU,WPR,409,922,1331,767,518,765,584,276,81,2991,385,843,1228,722,351,375,270,117,58,1893,4884,7441,7441
Nauru,1978,NR,NRU,WPR,415,905,1320,800,493,765,597,293,86,3034,387,825,1212,754,372,367,286,128,58,1965,4999,7541,7541
Nauru,1979,NR,NRU,WPR,416,875,1291,824,474,757,621,315,98,3089,388,802,1190,784,384,360,297,136,64,2025,5114,7586,7586
Nauru,1980,NR,NRU,WPR,421,834,1255,850,461,734,644,335,110,3134,393,775,1168,813,399,349,308,140,70,2079,5213,7635,7635
Nauru,1981,NR,NRU,WPR,432,803,1235,872,461,702,662,359,119,3175,403,752,1155,834,420,330,323,149,71,2127,5302,7691,7691
Nauru,1982,NR,NRU,WPR,432,775,1207,866,455,662,680,391,129,3183,404,728,1132,842,424,309,332,169,71,2147,5330,7672,7672
Nauru,1983,NR,NRU,WPR,463,765,1228,892,489,613,679,418,139,3230,429,721,1150,852,467,296,344,187,74,2220,5450,7832,7832
Nauru,1984,NR,NRU,WPR,518,784,1302,926,564,557,650,417,150,3264,487,739,1226,861,554,298,340,192,83,2328,5592,8125,8125
Nauru,1985,NR,NRU,WPR,566,818,1384,919,620,512,612,409,161,3233,536,772,1308,858,619,311,327,190,86,2391,5624,8313,8313
Nauru,1986,NR,NRU,WPR,614,861,1475,910,673,484,573,395,166,3201,586,818,1404,852,678,334,309,185,87,2445,5646,8527,8527
Nauru,1987,NR,NRU,WPR,657,923,1580,896,717,479,535,370,163,3160,637,881,1518,842,730,372,285,179,87,2495,5655,8759,8759
Nauru,1988,NR,NRU,WPR,705,992,1697,877,753,496,503,337,157,3123,686,954,1640,835,770,424,268,171,89,2557,5680,9022,9022
Nauru,1989,NR,NRU,WPR,752,1072,1824,863,782,531,460,309,149,3094,730,1038,1768,828,802,482,259,162,82,2615,5709,9306,9306
Nauru,1990,NR,NRU,WPR,794,1166,1960,852,806,578,422,274,129,3061,757,1134,1891,830,823,548,257,149,78,2685,5746,9598,9598
Nauru,1991,NR,NRU,WPR,830,1270,2100,851,818,628,384,237,108,3026,769,1237,2006,843,839,608,265,141,74,2770,5796,9902,9902
Nauru,1992,NR,NRU,WPR,843,1349,2192,858,825,665,365,213,93,3019,763,1319,2082,860,842,652,276,138,71,2839,5858,10129,10129
Nauru,1993,NR,NRU,WPR,834,1389,2223,869,829,676,363,208,94,3039,742,1357,2099,863,834,668,291,138,70,2864,5903,10226,10226
Nauru,1994,NR,NRU,WPR,813,1402,2215,893,829,673,362,210,99,3066,725,1366,2091,877,827,672,314,137,72,2899,5965,10274,10274
Nauru,1995,NR,NRU,WPR,796,1407,2203,926,833,667,369,209,105,3109,715,1360,2075,894,816,676,335,132,74,2927,6036,10316,10316
Nauru,1996,NR,NRU,WPR,782,1404,2186,960,832,658,378,207,108,3143,707,1346,2053,918,798,681,354,127,75,2953,6096,10345,10345
Nauru,1997,NR,NRU,WPR,770,1394,2164,991,832,658,385,208,105,3179,701,1327,2028,943,784,690,373,122,82,2994,6173,10363,10363
Nauru,1998,NR,NRU,WPR,761,1389,2150,1018,828,656,392,205,95,3194,697,1304,2001,965,770,697,393,121,82,3028,6222,10377,10377
Nauru,1999,NR,NRU,WPR,754,1383,2137,1043,821,662,400,200,93,3219,692,1281,1973,988,752,701,412,125,78,3056,6275,10383,10383
Nauru,2000,NR,NRU,WPR,745,1379,2124,1062,811,671,403,195,86,3228,691,1261,1952,1002,741,700,423,129,73,3068,6296,10377,10377
Nauru,2001,NR,NRU,WPR,739,1380,2119,1067,806,682,405,189,78,3227,682,1251,1933,1006,735,702,430,138,70,3081,6308,10363,10363
Nauru,2002,NR,NRU,WPR,732,1385,2117,1060,806,693,409,181,73,3222,679,1246,1925,1004,729,703,435,149,68,3088,6310,10351,10351
Nauru,2003,NR,NRU,WPR,719,1378,2097,1064,806,692,417,174,74,3227,674,1237,1911,1019,730,688,441,163,65,3106,6333,10344,10344
Nauru,2004,NR,NRU,WPR,705,1354,2059,1077,814,689,427,167,80,3254,666,1218,1884,1034,737,667,452,176,65,3131,6385,10335,10335
Nauru,2005,NR,NRU,WPR,695,1320,2015,1088,826,683,432,168,88,3285,665,1197,1862,1048,750,645,461,186,66,3156,6441,10318,10318
Nauru,2006,NR,NRU,WPR,690,1281,1971,1098,841,667,436,172,87,3301,666,1172,1838,1060,766,622,468,199,68,3183,6484,10294,10294
Nauru,2007,NR,NRU,WPR,694,1240,1934,1104,856,651,439,177,85,3312,672,1142,1814,1067,790,600,473,208,71,3209,6521,10267,10267
Nauru,2008,NR,NRU,WPR,711,1202,1913,1104,872,635,439,181,83,3314,680,1122,1802,1065,806,580,472,224,70,3217,6531,10243,10243
Nauru,2009,NR,NRU,WPR,739,1167,1906,1095,890,617,443,190,78,3313,696,1103,1799,1052,830,562,471,234,69,3218,6531,10233,10233
Nauru,2010,NR,NRU,WPR,786,1139,1925,1065,920,599,442,198,68,3292,717,1093,1810,1024,857,553,467,239,71,3211,6503,10241,10241
Nauru,2011,NR,NRU,WPR,851,1126,1977,1032,943,587,440,205,59,3266,743,1094,1837,994,884,548,462,240,76,3204,6470,10283,10283
Nauru,2012,NR,NRU,WPR,898,1147,2045,1028,958,593,439,217,55,3290,770,1115,1885,976,911,549,460,244,85,3225,6515,10444,10444
Nauru,2013,NR,NRU,WPR,917,1189,2106,1043,968,611,437,230,56,3345,798,1157,1955,972,945,562,457,253,94,3283,6628,10694,10694
Nauru,2014,NR,NRU,WPR,921,1245,2166,1056,982,632,438,240,62,3410,821,1197,2018,973,968,583,453,264,101,3342,6752,10940,10940
Nauru,2015,NR,NRU,WPR,917,1315,2232,1073,991,650,444,244,72,3474,840,1235,2075,986,979,604,453,272,107,3401,6875,11185,11185
Nauru,2016,NR,NRU,WPR,909,1386,2295,1086,1004,669,450,243,80,3532,853,1279,2132,1004,987,637,445,289,115,3477,7009,11437,11437
Nauru,2017,NR,NRU,WPR,908,1457,2365,1093,1023,690,459,240,86,3591,857,1326,2183,1023,985,673,440,302,123,3546,7137,11682,11682
Nauru,2018,NR,NRU,WPR,908,1514,2422,1100,1050,702,470,239,95,3656,855,1380,2235,1047,982,706,439,311,127,3612,7268,11924,11924
Nauru,2019,NR,NRU,WPR,902,1562,2464,1097,1069,720,478,249,105,3718,846,1424,2270,1062,972,744,444,325,135,3682,7400,12132,12132
Nauru,2020,NR,NRU,WPR,893,1605,2498,1089,1072,752,482,261,112,3768,834,1466,2300,1065,958,779,455,339,150,3746,7514,12315,12315
Nauru,2021,NR,NRU,WPR,883,1641,2524,1098,1066,792,486,279,118,3839,826,1510,2336,1066,952,816,462,353,167,3816,7655,12511,12511
Nauru,2022,NR,NRU,WPR,877,1674,2551,1108,1058,812,493,291,124,3886,819,1542,2361,1062,941,849,468,360,187,3867,7753,12668,12668
Nauru,2023,NR,NRU,WPR,865,1699,2564,1122,1032,826,501,304,133,3918,812,1574,2386,1067,921,869,480,365,209,3911,7829,12780,12780
Nauru,2024,NR,NRU,WPR,854,1716,2570,1156,1004,844,512,312,141,3969,798,1600,2398,1080,901,874,495,369,224,3943,7912,12884,12884
Nauru,2025,NR,NRU,WPR,838,1731,2569,1197,971,855,525,327,146,4021,785,1617,2402,1104,887,868,525,371,238,3993,8014,12979,12979
Nauru,2026,NR,NRU,WPR,821,1733,2554,1249,937,859,537,330,155,4067,768,1621,2389,1131,870,865,550,373,258,4047,8114,13063,13063
Nauru,2027,NR,NRU,WPR,805,1727,2532,1305,901,864,553,339,163,4125,752,1618,2370,1176,849,850,589,367,276,4107,8232,13141,13141
Nauru,2028,NR,NRU,WPR,786,1719,2505,1360,871,870,569,353,168,4191,735,1605,2340,1223,832,831,618,375,290,4169,8360,13213,13213
Nauru,2029,NR,NRU,WPR,776,1705,2481,1412,846,873,584,355,177,4247,726,1592,2318,1272,818,815,650,375,306,4236,8483,13286,13286
Nauru,2030,NR,NRU,WPR,767,1687,2454,1462,826,866,612,355,187,4308,716,1573,2289,1319,807,793,678,380,325,4302,8610,13358,13358
Nauru,1950,NR,NRU,WPR,283,449,732,242,218,145,107,79,159,950,260,429,689,276,220,156,111,79,143,985,1935,3354,3354
Nauru,1951,NR,NRU,WPR,269,472,741,272,230,160,113,81,142,998,245,434,679,283,218,158,114,81,133,987,1985,3408,3408
Nauru,1952,NR,NRU,WPR,258,492,750,333,263,186,114,79,133,1108,236,427,663,292,221,160,112,80,125,990,2098,3512,3512
Nauru,1953,NR,NRU,WPR,254,502,756,385,297,213,118,79,126,1218,232,418,650,297,224,160,110,77,119,987,2205,3607,3607
Nauru,1954,NR,NRU,WPR,259,499,758,432,335,237,124,81,116,1325,239,405,644,295,223,153,106,78,115,970,2295,3700,3700
Nauru,1955,NR,NRU,WPR,272,492,764,470,381,272,135,82,111,1451,252,392,644,289,225,153,101,81,108,957,2408,3818,3818
Nauru,1956,NR,NRU,WPR,283,486,769,501,431,312,151,84,106,1585,267,387,654,283,230,158,100,80,105,956,2541,3963,3963
Nauru,1957,NR,NRU,WPR,299,477,776,530,487,349,168,83,96,1713,282,389,671,273,237,161,99,74,101,945,2658,4112,4112
Nauru,1958,NR,NRU,WPR,310,473,783,551,538,385,192,84,95,1845,299,399,698,263,241,168,95,68,98,933,2778,4258,4258
Nauru,1959,NR,NRU,WPR,323,479,802,551,590,423,220,87,93,1964,313,416,729,252,242,174,91,59,98,916,2880,4414,4414
Nauru,1960,NR,NRU,WPR,337,491,828,549,644,470,251,92,85,2091,331,442,773,241,240,176,96,50,90,893,2984,4582,4582
Nauru,1961,NR,NRU,WPR,348,513,861,543,678,509,272,100,79,2181,346,471,817,238,245,182,96,42,88,891,3072,4753,4753
Nauru,1962,NR,NRU,WPR,361,544,905,549,699,540,281,109,76,2254,356,509,865,253,258,195,91,42,82,921,3175,4950,4950
Nauru,1963,NR,NRU,WPR,385,581,966,560,716,563,286,108,76,2309,376,553,929,275,287,215,92,44,78,991,3300,5198,5198
Nauru,1964,NR,NRU,WPR,424,629,1053,554,744,587,298,108,78,2369,405,598,1003,290,320,233,98,44,76,1061,3430,5484,5484
Nauru,1965,NR,NRU,WPR,470,681,1151,542,774,610,316,100,75,2417,441,648,1089,305,356,252,109,46,75,1143,3560,5804,5804
Nauru,1966,NR,NRU,WPR,492,732,1224,516,787,635,342,100,74,2454,454,693,1147,319,366,273,124,47,73,1202,3656,6021,6021
Nauru,1967,NR,NRU,WPR,482,769,1251,482,784,655,364,108,73,2466,440,730,1170,335,354,287,135,50,66,1227,3693,6114,6114
Nauru,1968,NR,NRU,WPR,478,809,1287,481,796,670,379,117,70,2513,434,768,1202,367,357,301,143,52,60,1280,3793,6288,6288
Nauru,1969,NR,NRU,WPR,475,852,1327,502,802,691,394,129,66,2584,431,804,1235,407,373,318,151,57,59,1365,3949,6508,6508
Nauru,2031,NR,NRU,WPR,763,1660,2423,1507,819,854,637,357,202,4376,713,1549,2262,1364,794,775,710,388,345,4376,8752,13428,13428
Nauru,2032,NR,NRU,WPR,763,1633,2396,1543,825,839,652,360,215,4434,715,1525,2240,1402,786,755,731,390,364,4428,8862,13498,13498
Nauru,2033,NR,NRU,WPR,764,1611,2375,1568,842,816,666,369,221,4482,715,1504,2219,1436,791,733,755,403,374,4492,8974,13570,13570
Nauru,2034,NR,NRU,WPR,771,1589,2360,1587,876,788,684,376,234,4545,721,1482,2203,1458,804,717,759,419,384,4541,9086,13643,13643
Nauru,2035,NR,NRU,WPR,777,1565,2342,1595,916,760,692,386,242,4591,728,1460,2188,1477,826,704,755,441,396,4599,9190,13719,13719
Nauru,2036,NR,NRU,WPR,785,1542,2327,1599,968,726,698,401,251,4643,735,1439,2174,1482,855,687,751,469,408,4652,9295,13794,13794
Nauru,2037,NR,NRU,WPR,793,1523,2316,1595,1021,694,703,413,256,4682,741,1421,2162,1483,897,668,740,501,414,4703,9385,13868,13868
Nauru,2038,NR,NRU,WPR,801,1512,2313,1588,1075,667,707,422,262,4721,749,1411,2160,1470,947,654,722,528,426,4747,9468,13944,13944
Nauru,2039,NR,NRU,WPR,809,1504,2313,1573,1126,643,712,439,272,4765,756,1405,2161,1455,993,641,706,556,437,4788,9553,14022,14022
Nauru,2040,NR,NRU,WPR,813,1502,2315,1555,1172,625,705,465,276,4798,760,1403,2163,1435,1040,628,687,584,443,4817,9615,14097,14097
Nauru,2041,NR,NRU,WPR,818,1507,2325,1530,1217,620,692,485,283,4827,765,1409,2174,1412,1088,615,667,610,457,4849,9676,14172,14172
Nauru,2042,NR,NRU,WPR,822,1516,2338,1506,1251,628,683,494,291,4853,769,1415,2184,1391,1123,609,651,632,473,4879,9732,14245,14245
Nauru,2043,NR,NRU,WPR,823,1526,2349,1482,1280,644,663,505,299,4873,769,1423,2192,1370,1156,611,633,651,483,4904,9777,14318,14318
Nauru,2044,NR,NRU,WPR,822,1537,2359,1457,1298,673,635,518,309,4890,767,1435,2202,1347,1180,627,617,655,499,4925,9815,14386,14386
Nauru,2045,NR,NRU,WPR,819,1547,2366,1434,1308,718,613,526,318,4917,767,1447,2214,1326,1196,649,607,650,529,4957,9874,14451,14451
Nauru,2046,NR,NRU,WPR,814,1563,2377,1417,1313,765,583,531,328,4937,761,1461,2222,1306,1205,680,588,650,550,4979,9916,14513,14513
Nauru,2047,NR,NRU,WPR,807,1574,2381,1398,1307,817,555,538,343,4958,756,1470,2226,1291,1203,722,571,637,573,4997,9955,14563,14563
Nauru,2048,NR,NRU,WPR,799,1583,2382,1386,1303,869,532,543,355,4988,748,1479,2227,1279,1193,769,558,623,606,5028,10016,14614,14614
Nauru,2049,NR,NRU,WPR,790,1588,2378,1376,1287,918,510,545,362,4998,740,1482,2222,1274,1177,815,545,610,631,5052,10050,14656,14656
Nauru,2050,NR,NRU,WPR,780,1591,2371,1379,1270,966,496,542,383,5036,730,1488,2218,1276,1157,860,534,592,659,5078,10114,14695,14695
New Zealand,1970,NZ,NZL,WPR,152059,308130,460189,248048,173719,159966,146820,119116,102436,950105,145675,295168,440843,238061,171383,152536,148356,123436,139143,972915,1923020,2824061,2824061
New Zealand,1971,NZ,NZL,WPR,153034,310380,463414,254186,181506,159157,149419,120406,104673,969347,146802,297493,444295,243847,178495,152148,149408,125728,142201,991827,1961174,2868885,2868885
New Zealand,1972,NZ,NZL,WPR,154358,312965,467323,259659,191724,159021,152318,121246,107252,991220,148133,300229,448362,249388,187926,152638,150739,127734,145540,1013965,2005185,2920878,2920878
New Zealand,1973,NZ,NZL,WPR,155678,315401,471079,266701,203134,159986,155489,121845,110034,1017189,149414,302809,452223,255917,198853,154080,152579,129526,149187,1040142,2057331,2980638,2980638
New Zealand,1974,NZ,NZL,WPR,155790,318033,473823,274664,214076,162214,158465,122806,112940,1045165,149610,305366,454976,263512,209660,156674,154457,131431,153116,1068850,2114015,3042812,3042812
New Zealand,1975,NZ,NZL,WPR,153798,320974,474772,281441,222297,165321,160498,124554,115961,1070072,147794,307781,455575,270757,218072,160067,155343,133572,157201,1095012,2165084,3095428,3095428
New Zealand,1976,NZ,NZL,WPR,149753,322371,472124,286579,226983,168573,161006,126311,118830,1088282,143926,308732,452658,276228,223308,163670,155013,135330,161199,1114748,2203030,3127812,3127812
New Zealand,1977,NZ,NZL,WPR,144375,320491,464866,290824,229624,171300,160315,127469,121684,1101216,138767,306924,445691,279824,227160,166972,154092,136299,165054,1129401,2230617,3141174,3141174
New Zealand,1978,NZ,NZL,WPR,138678,316169,454847,293827,231350,173306,159276,128413,124784,1110956,133522,303062,436584,282043,230996,169766,152652,136427,169028,1140912,2251868,3143300,3143300
New Zealand,1979,NZ,NZL,WPR,133881,310695,444576,295716,232920,175432,158011,129544,127674,1119297,129309,298422,427731,283326,234758,172928,150660,136282,172984,1150938,2270235,3142539,3142539
New Zealand,1980,NZ,NZL,WPR,130568,305573,436141,296638,235707,179019,156270,131192,130016,1128842,126109,293754,419863,283988,238189,177272,148703,137340,176832,1162324,2291166,3147168,3147168
New Zealand,1981,NZ,NZL,WPR,128443,301862,430305,296433,239314,184558,154471,133325,132257,1140358,123513,289492,413005,284546,241413,183182,147279,139594,180946,1176960,2317318,3160622,3160622
New Zealand,1982,NZ,NZL,WPR,127608,298177,425785,297825,242809,192146,153419,135560,134467,1156226,122142,285392,407534,286400,245470,191125,146839,141432,184919,1196185,2352411,3185721,3185721
New Zealand,1983,NZ,NZL,WPR,128074,293418,421492,301360,246873,200878,153254,137763,136349,1176477,122078,281377,403455,289376,250415,199983,147628,142611,188397,1218410,2394887,3219827,3219827
New Zealand,1984,NZ,NZL,WPR,128848,287758,416606,303809,251021,208496,153898,139818,138212,1195254,122417,277132,399549,291360,254937,207629,149229,143748,192029,1238932,2434186,3250340,3250340
New Zealand,1985,NZ,NZL,WPR,129063,281908,410971,302262,254543,213939,155567,141577,140546,1208434,122612,271882,394494,290519,258776,213422,151721,144268,195747,1254453,2462887,3268356,3268356
New Zealand,1986,NZ,NZL,WPR,129536,276144,405680,297986,258316,218354,158311,142695,143339,1219001,123288,265610,388898,287974,263289,218344,155187,143736,199558,1268088,2487089,3281671,3281671
New Zealand,1987,NZ,NZL,WPR,131339,269917,401256,294695,262814,222414,161768,142718,146090,1230499,125371,258813,384184,286428,269005,222617,158681,142986,203805,1283522,2514021,3299450,3299450
New Zealand,1988,NZ,NZL,WPR,133753,264222,397975,291048,266427,225459,165392,142046,149122,1239494,128120,252621,380741,285235,273603,226895,161871,142421,207769,1297794,2537288,3316002,3316002
New Zealand,1989,NZ,NZL,WPR,136409,260414,396823,286527,268012,229161,168749,141472,152795,1246716,130761,249063,379824,282536,276754,232514,165532,141721,211333,1310390,2557106,3333755,3333755
New Zealand,1990,NZ,NZL,WPR,141492,262134,403626,285641,271536,237801,173808,142390,158101,1269277,135269,251378,386647,282851,281833,241487,172196,142103,217363,1337833,2607110,3397389,3397389
New Zealand,1991,NZ,NZL,WPR,146900,265763,412663,286756,277004,246735,181491,144314,164520,1300820,140002,254396,394398,286195,287308,250356,181383,143823,224649,1373714,2674534,3481599,3481599
New Zealand,1992,NZ,NZL,WPR,149883,267669,417552,285854,279779,251197,190093,144891,169572,1321386,142507,255152,397659,285702,290066,255239,190387,144858,229710,1395962,2717348,3532563,3532563
New Zealand,1993,NZ,NZL,WPR,151630,271399,423029,283663,280940,255221,198823,144742,173608,1336997,143785,258015,401800,282279,291850,259853,198988,145294,233658,1411922,2748919,3573742,3573742
New Zealand,1994,NZ,NZL,WPR,152563,276531,429094,281318,282461,260854,207190,145497,177538,1354858,144098,262571,406669,278985,294041,266336,207027,146422,237457,1430268,2785126,3620890,3620890
New Zealand,1995,NZ,NZL,WPR,152786,282743,435529,279583,284394,268033,214835,147420,181209,1375474,143625,268373,411998,275846,296801,274400,214262,148662,240921,1450892,2826366,3673893,3673893
New Zealand,1996,NZ,NZL,WPR,151991,289655,441646,277883,286083,275981,221671,150477,184672,1396767,142615,274809,417424,272573,299518,283617,220857,152212,243847,1472624,2869391,3728457,3728457
New Zealand,1997,NZ,NZL,WPR,150531,295848,446379,275033,285580,283269,228396,154100,187887,1414265,141657,280708,422365,269013,300265,292672,227895,156422,246574,1492841,2907106,3775852,3775852
New Zealand,1998,NZ,NZL,WPR,148888,300373,449261,271260,281846,288743,235162,157855,190960,1425826,140536,285097,425633,265451,298139,300025,235628,160611,249469,1509323,2935149,3810044,3810044
New Zealand,1999,NZ,NZL,WPR,147171,303356,450527,268206,276142,292111,241128,162269,193746,1433602,139051,287871,426922,262746,294403,305106,242987,165418,251779,1522439,2956041,3833494,3833494
New Zealand,2000,NZ,NZL,WPR,145571,305266,450837,267601,270161,293519,246219,167496,196783,1441779,137836,289365,427201,262149,289975,308153,249619,171085,254473,1535454,2977233,3855266,3855266
New Zealand,2001,NZ,NZL,WPR,144375,306872,451247,271300,265694,294566,250810,174130,200247,1456747,137278,290706,427984,265352,285985,310964,255486,177964,257851,1553602,3010349,3889579,3889579
New Zealand,2002,NZ,NZL,WPR,143989,309148,453137,279769,264545,297344,255239,182627,203942,1483466,137312,293187,430499,272981,284562,315581,260793,186600,260962,1581479,3064945,3948584,3948584
New Zealand,2003,NZ,NZL,WPR,144451,311342,455793,289317,265282,300949,260275,191536,208362,1515721,137948,295457,433405,281950,285106,320991,266793,195647,264539,1615026,3130747,4019941,4019941
New Zealand,2004,NZ,NZL,WPR,145131,311864,456995,296024,265335,303284,266069,199573,213558,1543843,138761,295853,434614,288864,285396,325063,273814,203909,268910,1645956,3189799,4081409,4081409
New Zealand,2005,NZ,NZL,WPR,145606,310709,456315,300648,264436,304357,272343,206332,220144,1568260,139234,294910,434144,294247,284688,327737,281420,211261,274719,1674072,3242332,4132781,4132781
New Zealand,2006,NZ,NZL,WPR,147014,308656,455670,303977,263160,304657,278930,212058,227788,1590570,140374,293506,433880,298438,283157,329475,289653,217642,281493,1699858,3290428,4179978,4179978
New Zealand,2007,NZ,NZL,WPR,150255,306426,456681,305019,261962,303598,285319,218002,234899,1608799,143107,291856,434963,300362,281275,329635,297993,224074,287715,1721054,3329853,4221494,4221494
New Zealand,2008,NZ,NZL,WPR,154170,304893,459063,305415,261398,301096,291037,224644,241285,1624875,146470,290390,436860,301192,279907,328164,305549,231421,293207,1739440,3364315,4260239,4260239
New Zealand,2009,NZ,NZL,WPR,157836,304383,462219,307519,261703,298020,295737,231224,248247,1642450,149658,289679,439337,302854,279732,326236,311736,238999,299323,1758880,3401330,4302886,4302886
New Zealand,2010,NZ,NZL,WPR,160910,304205,465115,311102,262171,294534,298876,237540,256308,1660531,152473,289511,441984,305149,280314,323915,316316,246324,306704,1778722,3439253,4346338,4346338
New Zealand,2011,NZ,NZL,WPR,162386,304065,466451,314288,262207,290380,300310,242970,265695,1675850,153885,289550,443435,306695,280745,320393,319408,252845,315443,1795529,3471379,4381269,4381269
New Zealand,2012,NZ,NZL,WPR,161844,304595,466439,316639,262779,285979,300914,246853,276769,1689933,153377,290010,443387,307405,281578,315921,321687,258041,325890,1810522,3500455,4410284,4410284
New Zealand,2013,NZ,NZL,WPR,160203,306183,466386,320670,267179,282028,301743,250592,288734,1710946,151947,291385,443332,308731,285123,311565,323806,263217,337527,1829969,3540915,4450644,4450644
New Zealand,2014,NZ,NZL,WPR,158311,309224,467535,326501,278622,280591,303244,255068,299544,1743570,150686,294819,445505,311915,293654,308880,325769,268681,348680,1857579,3601149,4514195,4514195
New Zealand,2015,NZ,NZL,WPR,156860,313110,469970,330855,294665,281877,305202,260063,308890,1781552,149882,299651,449533,315048,306170,307696,327607,274200,358817,1889538,3671090,4590590,4590590
New Zealand,2016,NZ,NZL,WPR,156181,317125,473306,332242,311635,284327,307249,265695,317982,1819130,149585,304431,454016,316140,320085,307061,329348,280391,368601,1921626,3740756,4668081,4668081
New Zealand,2017,NZ,NZL,WPR,155796,321638,477434,331187,328653,288222,309294,271686,327067,1856109,149640,309652,459292,315766,333939,307786,330661,286961,378308,1953421,3809530,4746252,4746252
New Zealand,2018,NZ,NZL,WPR,155730,326980,482710,330939,345768,294989,311990,279163,338024,1900873,149440,314856,464296,315704,347401,310719,332001,295256,389568,1990649,3891522,4838526,4838526
New Zealand,2019,NZ,NZL,WPR,156513,333049,489562,334460,363846,305646,316273,288907,353036,1962168,149278,318599,467877,317200,361196,316388,334055,306380,404206,2039425,4001593,4959034,4959034
New Zealand,2020,NZ,NZL,WPR,157665,336923,494588,337501,377526,315046,318605,296136,368446,2013260,149967,320510,470477,319424,370948,322996,334925,314516,419997,2082806,4096066,5061133,5061133
New Zealand,2021,NZ,NZL,WPR,158925,337700,496625,338666,385374,322095,318058,299506,382034,2045733,151307,321105,472412,322164,375889,329742,333992,318124,435042,2114953,4160686,5129727,5129727
New Zealand,2022,NZ,NZL,WPR,160421,336647,497068,339348,389432,329840,316980,302192,395464,2073256,152630,320173,472803,323949,377536,337047,332296,321162,450177,2142167,4215423,5185288,5185288
New Zealand,2023,NZ,NZL,WPR,162087,333958,496045,339547,389650,337908,315223,304632,408919,2095879,154126,317779,471905,324675,375402,344684,329960,323898,465650,2164269,4260148,5228100,5228100
New Zealand,2024,NZ,NZL,WPR,163839,330722,494561,340523,388220,346667,313509,306836,422732,2118487,155799,314960,470759,325818,371966,352848,327688,326315,481495,2186130,4304617,5269939,5269939
New Zealand,2025,NZ,NZL,WPR,164612,328294,492906,341516,385452,356002,312213,308766,436792,2140741,156487,312793,469280,326938,367863,361378,325519,328393,497674,2207765,4348506,5310695,5310695
New Zealand,2026,NZ,NZL,WPR,164454,326964,491418,342507,381445,365636,311251,310407,451089,2162335,156266,311427,467693,328052,363269,369893,323327,330099,514323,2228963,4391298,5350410,5350410
New Zealand,2027,NZ,NZL,WPR,163986,326099,490085,343886,376477,374744,311000,311417,465616,2183140,155779,310350,466129,329513,358476,377255,321975,330918,531309,2249446,4432586,5388806,5388806
New Zealand,2028,NZ,NZL,WPR,163173,325723,488896,345280,371627,382538,312152,311507,479977,2203081,154977,309771,464748,330996,354206,382818,322236,330682,548100,2269038,4472119,5425762,5425762
New Zealand,2029,NZ,NZL,WPR,162192,325775,487967,346352,367496,388934,314812,310902,493620,2222116,154020,309853,463873,331823,350945,386582,324124,329983,563963,2287420,4509536,5461373,5461373
New Zealand,2030,NZ,NZL,WPR,161139,326057,487196,347153,363770,394390,318784,309993,506251,2240341,152995,310299,463294,332151,348435,388960,327727,329016,578555,2304844,4545185,5495670,5495670
New Zealand,1950,NZ,NZL,WPR,117799,164811,282610,139939,138768,133206,103196,78469,82875,676453,112844,159599,272443,133624,140820,129640,101880,83247,90887,680098,1356551,1911608,1911608
New Zealand,1951,NZ,NZL,WPR,120560,173643,294203,139597,141823,134863,106638,78039,84980,685940,115386,167629,283015,133460,141833,132116,103907,83747,93904,688967,1374907,1952124,1952124
New Zealand,1952,NZ,NZL,WPR,122331,184157,306488,140207,146193,136345,110225,78049,86868,697887,116913,177142,294055,134497,143737,134587,106470,84409,96817,700517,1398404,1998948,1998948
New Zealand,1953,NZ,NZL,WPR,124389,194601,318990,141731,150758,137771,113732,78539,88392,710923,118654,186830,305484,136223,145997,137007,109359,85298,99679,713563,1424486,2048965,2048965
New Zealand,1954,NZ,NZL,WPR,127040,203782,330822,143817,154362,138952,116950,79484,89545,723110,120973,195464,316437,138362,147609,139086,112222,86325,102355,725959,1449069,2096332,2096332
New Zealand,1955,NZ,NZL,WPR,129881,211614,341495,146946,156650,140110,119938,80899,90480,735023,123705,202812,326517,141416,148264,140861,115002,87462,104925,737930,1472953,2140976,2140976
New Zealand,1956,NZ,NZL,WPR,132419,219115,351534,151246,157807,141698,122850,82860,91202,747663,126590,209756,336346,145634,148371,142675,117809,88809,107503,750801,1498464,2186348,2186348
New Zealand,1957,NZ,NZL,WPR,135253,227261,362514,156238,158544,143768,125837,85275,91556,761218,129760,217358,347118,150300,148395,144666,120832,90379,109895,764467,1525685,2235321,2235321
New Zealand,1958,NZ,NZL,WPR,139136,235703,374839,161436,158993,145965,128757,87894,91730,774775,133473,225573,359046,154865,148299,146562,124045,92062,112072,777905,1552680,2286559,2286559
New Zealand,1959,NZ,NZL,WPR,143562,243626,387188,166483,158457,147960,131226,90587,91824,786537,137463,233474,370937,159535,147727,147981,127128,93791,114187,790349,1576886,2335010,2335010
New Zealand,1960,NZ,NZL,WPR,147582,250933,398515,172176,157166,150072,133244,93331,92008,797997,141474,240543,382017,165005,146915,148967,129892,95654,116241,802674,1600671,2381189,2381189
New Zealand,1961,NZ,NZL,WPR,150845,257967,408812,180041,156346,152988,135104,96180,92403,813062,145317,246956,392273,172288,146628,150134,132426,97733,118260,817469,1630531,2431617,2431617
New Zealand,1962,NZ,NZL,WPR,153793,264449,418242,189709,156230,156479,136522,99235,92720,830895,148397,252885,401282,181400,147209,151932,134782,100074,120501,835898,1666793,2486311,2486311
New Zealand,1963,NZ,NZL,WPR,156524,270257,426781,199497,156554,159739,137227,102379,92980,848376,150527,258496,409023,191010,148525,153976,136775,102773,122790,855849,1704225,2540026,2540026
New Zealand,1964,NZ,NZL,WPR,158176,276305,434481,208471,157526,162446,137894,105353,93521,865211,151654,264321,415975,199810,150463,155700,138540,105687,124784,874984,1740195,2590648,2590648
New Zealand,1965,NZ,NZL,WPR,158020,283224,441244,216324,159421,164434,139169,108111,94555,882014,151153,270850,422003,207328,153074,156787,140556,108496,126818,893059,1775073,2638316,2638316
New Zealand,1966,NZ,NZL,WPR,156394,290772,447166,223310,162314,165540,140909,110755,96008,898836,149277,278098,427375,214068,156525,157109,142847,111326,129092,910967,1809803,2684356,2684356
New Zealand,1967,NZ,NZL,WPR,154168,297804,451972,229387,164991,165347,142412,113224,97682,913043,147083,285075,432158,220368,160152,156639,144877,114405,131576,928017,1841060,2725198,2725198
New Zealand,1968,NZ,NZL,WPR,152241,302993,455234,234636,166622,163640,143417,115420,99205,922940,145391,290234,435625,226077,163217,155404,146296,117609,134031,942634,1865574,2756419,2756419
New Zealand,1969,NZ,NZL,WPR,151544,306094,457638,240789,168914,161476,144704,117394,100611,933888,144951,293221,438172,231866,166534,153792,147349,120699,136419,956659,1890547,2786352,2786352
New Zealand,2031,NZ,NZL,WPR,160041,326573,486614,347179,360879,398569,324126,308998,518021,2257772,151930,310838,462768,331937,346788,390219,332845,327600,592203,2321592,4579364,5528743,5528743
New Zealand,2032,NZ,NZL,WPR,158976,327287,486263,345787,359622,400763,330956,307816,529368,2274312,150903,311363,462266,330644,346448,389975,339276,325749,605559,2337651,4611963,5560491,5560491
New Zealand,2033,NZ,NZL,WPR,157993,328142,486135,343117,359851,401015,338978,306294,540695,2289950,149950,312063,462013,328262,347188,387869,346879,323572,618997,2352767,4642717,5590867,5590867
New Zealand,2034,NZ,NZL,WPR,157054,328919,485973,339907,360856,399634,347683,304825,552060,2304965,149047,312786,461833,325452,348339,384471,355003,321473,632391,2367129,4672094,5619900,5619900
New Zealand,2035,NZ,NZL,WPR,156140,328650,484790,337503,361875,396932,356960,303772,563332,2320374,148171,312448,460619,323296,349470,380409,363494,319483,645701,2381853,4702227,5647638,5647638
New Zealand,2036,NZ,NZL,WPR,155305,327396,482701,336199,362892,393003,366533,303052,574480,2336159,147369,311165,458534,321943,350592,375857,371971,317484,659025,2396872,4733031,5674271,5674271
New Zealand,2037,NZ,NZL,WPR,154601,325872,480473,335352,364290,388114,375581,303030,585207,2351574,146691,309655,456346,320875,352062,371116,379301,316315,671765,2411434,4763008,5699822,5699822
New Zealand,2038,NZ,NZL,WPR,154041,324080,478121,334996,365705,383349,383328,304348,594871,2366597,146149,307907,454056,320306,353554,366886,384842,316713,683249,2425550,4792147,5724319,5724319
New Zealand,2039,NZ,NZL,WPR,153696,322166,475862,335062,366796,379287,389695,307112,603157,2381109,145812,306049,451861,320396,354389,363663,388604,318694,693348,2439094,4820203,5747927,5747927
New Zealand,2040,NZ,NZL,WPR,153585,320205,473790,335356,367617,375627,395123,311125,610202,2395050,145702,304149,449851,320848,354726,361189,390989,322343,701919,2452014,4847064,5770708,5770708
New Zealand,2041,NZ,NZL,WPR,153557,318277,471834,335883,367669,372795,399294,316454,616398,2408493,145675,302287,447962,321394,354524,359568,392267,327459,709141,2464353,4872846,5792644,5792644
New Zealand,2042,NZ,NZL,WPR,153576,316510,470086,336606,366315,371592,401511,323227,622083,2421334,145693,300585,446278,321927,353250,359252,392058,333855,715670,2476012,4897346,5813704,5813704
New Zealand,2043,NZ,NZL,WPR,153648,314976,468624,337471,363685,371858,401816,331154,627489,2433473,145764,299097,444861,322627,350885,360007,390011,341402,721960,2486892,4920365,5833850,5833850
New Zealand,2044,NZ,NZL,WPR,153643,313698,467341,338252,360515,372892,400517,339746,633062,2444984,145757,297861,443618,323351,348093,361176,386690,349464,728335,2497109,4942093,5853055,5853055
New Zealand,2045,NZ,NZL,WPR,153479,312681,466160,337989,358149,373940,397923,348905,639043,2455949,145608,296878,442486,323023,345954,362325,382721,357886,734798,2506707,4962656,5871298,5871298
New Zealand,2046,NZ,NZL,WPR,153212,311818,465030,336750,356878,374989,394118,358346,645334,2466415,145353,296049,441402,321747,344620,363464,378267,366288,741326,2515712,4982127,5888568,5888568
New Zealand,2047,NZ,NZL,WPR,152883,311135,464018,335239,356060,376412,389377,367279,652011,2476378,145035,295392,440427,320245,343569,364951,373628,373566,748168,2524127,5000505,5904945,5904945
New Zealand,2048,NZ,NZL,WPR,152430,310651,463081,333458,355730,377847,384749,374941,659090,2485815,144605,294926,439531,318503,343013,366451,369494,379088,755408,2531957,5017772,5920383,5920383
New Zealand,2049,NZ,NZL,WPR,151933,310305,462238,331562,355819,378963,380811,381243,666368,2494766,144135,294587,438722,316655,343111,367301,366349,382863,762983,2539262,5034028,5934989,5934989
New Zealand,2050,NZ,NZL,WPR,151536,310037,461573,329618,356135,379807,377272,386629,673812,2503273,143757,294328,438085,314766,343575,367655,363945,385284,770850,2546075,5049348,5949002,5949002
Oman,1970,OM,OMN,EMR,64789,89798,154587,58826,43793,29853,21918,15140,11099,180629,62257,87097,149354,58630,44375,30884,22990,16555,12693,186127,366756,670693,670693
Oman,1971,OM,OMN,EMR,66804,93468,160272,59846,44857,30375,22225,15343,11325,183971,64188,90541,154729,59574,45484,31493,23342,16868,13066,189827,373798,688803,688803
Oman,1972,OM,OMN,EMR,69037,97260,166297,61130,45792,30965,22539,15536,11559,187521,66332,94115,160447,60778,46503,32166,23711,17176,13446,193780,381301,708045,708045
Oman,1973,OM,OMN,EMR,71550,101166,172716,63047,46280,31617,22841,15727,11782,191294,68756,97799,166555,62608,47095,32892,24102,17488,13842,198027,389321,728597,728597
Oman,1974,OM,OMN,EMR,74535,105262,179797,66212,47030,32636,23284,15994,12051,197207,71635,101681,173316,65707,47953,33948,24626,17851,14270,204355,401562,754676,754676
Oman,1975,OM,OMN,EMR,78220,109531,187751,70253,48861,34136,23942,16370,12369,205931,75192,105735,180927,69413,49583,35314,25283,18261,14733,212587,418518,787194,787194
Oman,1976,OM,OMN,EMR,82668,113955,196623,74701,51577,36022,24763,16832,12728,216623,79485,109936,189421,73099,51601,36798,26003,18693,15221,221415,438038,824081,824081
Oman,1977,OM,OMN,EMR,87858,118661,206519,79648,55029,38338,25774,17383,13144,229316,84502,114416,198918,77100,54023,38519,26832,19151,15744,231369,460685,866124,866124
Oman,1978,OM,OMN,EMR,93761,123731,217492,84873,59049,41041,26959,18005,13597,243524,90206,119271,209477,81311,56754,40484,27766,19649,16296,242260,485784,912750,912750
Oman,1979,OM,OMN,EMR,100346,129261,229607,90171,63444,44074,28303,18683,14077,258752,96561,124586,221147,85620,59703,42677,28794,20183,16867,253844,512596,963351,963351
Oman,1980,OM,OMN,EMR,107434,135492,242926,95387,68064,47369,29787,19408,14580,274595,103401,130595,233996,89953,62793,45071,29906,20758,17462,265943,540538,1017462,1017462
Oman,1981,OM,OMN,EMR,114851,142639,257490,100619,73046,50937,31454,20195,15112,291363,110557,137497,248054,94361,66115,47643,31138,21374,18086,278717,570080,1075624,1075624
Oman,1982,OM,OMN,EMR,122517,150763,273280,105970,78578,54743,33359,21061,15688,309399,117954,145341,263295,98891,69821,50308,32520,22040,18747,292327,601726,1138301,1138301
Oman,1983,OM,OMN,EMR,130239,159898,290137,111304,84811,58418,35478,21992,16309,328312,125409,154166,279575,103469,74178,52720,34032,22757,19444,306600,634912,1204626,1204626
Oman,1984,OM,OMN,EMR,137733,170068,307801,116448,91524,61915,37754,22972,16973,347586,132644,163995,296639,107995,79063,54882,35646,23522,20175,321283,668869,1273306,1273306
Oman,1985,OM,OMN,EMR,144119,183576,327695,126168,102465,67697,40467,23984,17661,378442,138592,174990,313582,112051,83075,56649,36896,24063,20831,333565,712007,1353289,1353289
Oman,1986,OM,OMN,EMR,148676,199442,348118,140426,117872,76483,43840,25065,18371,422057,142693,186829,329522,115993,86102,58149,37757,24366,21375,343742,765799,1443446,1443446
Oman,1987,OM,OMN,EMR,151715,214273,365988,154305,133750,86777,47831,26304,19143,468110,145516,198918,344434,120583,89111,59913,38659,24680,21869,354815,822925,1533351,1533351
Oman,1988,OM,OMN,EMR,153823,227799,381622,167749,149860,98603,52568,27758,19971,516509,147529,210864,358393,125920,92121,61916,39611,25018,22322,366908,883417,1623433,1623433
Oman,1989,OM,OMN,EMR,155479,239926,395405,180524,165940,111952,58171,29464,20863,566914,149162,222311,371473,131982,95175,64149,40625,25395,22725,380051,946965,1713838,1713838
Oman,1990,OM,OMN,EMR,156796,250895,407691,192351,181746,126783,64751,31487,21818,618936,150526,233133,383659,138723,98325,66608,41687,25816,23090,394249,1013185,1804524,1804524
Oman,1991,OM,OMN,EMR,157777,260890,418667,202988,197078,143018,72418,33884,22839,672225,151598,243234,394832,146044,101638,69299,42793,26287,23397,409458,1081683,1895187,1895187
Oman,1992,OM,OMN,EMR,158278,270034,428312,212228,211784,160519,81301,36708,23961,726501,152190,252588,404778,153784,105204,72218,43959,26809,23656,425630,1152131,1985227,1985227
Oman,1993,OM,OMN,EMR,157774,278483,436257,220118,225071,178341,91244,39942,25185,779901,151786,261225,413011,161903,109052,75263,45241,27353,23899,442711,1222612,2071868,2071868
Oman,1994,OM,OMN,EMR,156968,285691,442659,227675,230046,187383,97935,42436,26272,811747,150854,268640,419494,170808,112618,77601,46587,27863,24303,459780,1271527,2133675,2133675
Oman,1995,OM,OMN,EMR,156196,291199,447395,235983,228426,187746,100734,43979,27150,824018,149795,274447,424242,180638,115998,79262,47913,28343,24861,477015,1301033,2172672,2172672
Oman,1996,OM,OMN,EMR,154872,295162,450034,244904,228320,187822,103014,45440,27997,837497,148392,278719,427111,190993,119870,81038,49211,28831,25380,495323,1332820,2209958,2209958
Oman,1997,OM,OMN,EMR,153219,297632,450851,253843,230031,187771,104712,46753,28766,851876,146876,281454,428330,201576,124334,82978,50459,29350,25829,514526,1366402,2245588,2245588
Oman,1998,OM,OMN,EMR,151457,298802,450259,262290,233552,187759,105921,47858,29462,866842,145367,282820,428187,212066,129461,85100,51678,29910,26235,534450,1401292,2279727,2279727
Oman,1999,OM,OMN,EMR,149336,299441,448777,269910,238532,187978,106802,48697,30068,881987,143526,283490,427016,222160,135260,87402,52901,30510,26589,554822,1436809,2312600,2312600
Oman,2000,OM,OMN,EMR,147072,299515,446587,276390,244938,188772,107368,49166,30544,897178,141469,283583,425052,231505,141819,89945,54149,31129,26888,575435,1472613,2344253,2344253
Oman,2001,OM,OMN,EMR,145118,298568,443686,281467,252768,190512,107664,49162,30852,912425,139589,282834,422423,239756,149263,92804,55457,31726,27117,596123,1508548,2374653,2374653
Oman,2002,OM,OMN,EMR,143257,296968,440225,284744,261880,193504,107799,48637,30905,927469,137715,281554,419269,246536,157719,96015,56873,32302,27243,616688,1544157,2403659,2403659
Oman,2003,OM,OMN,EMR,141171,295060,436231,286918,271738,197643,108103,47670,30737,942809,135611,279932,415543,251714,167141,99536,58419,32865,27334,637009,1579818,2431600,2431600
Oman,2004,OM,OMN,EMR,138969,291371,430340,299096,280812,201308,110429,47812,31359,970816,133399,276430,409829,256618,176535,102771,60323,33644,27979,657870,1628686,2468855,2468855
Oman,2005,OM,OMN,EMR,137344,284605,421949,319936,290830,204474,114420,49142,32810,1011612,131838,270447,402285,261470,185817,105676,62591,34630,29159,679343,1690955,2515192,2515192
Oman,2006,OM,OMN,EMR,136811,275829,412640,336494,305006,208756,118119,50279,34145,1052799,131470,263246,394716,265007,195663,108922,65001,35579,30315,700487,1753286,2560649,2560649
Oman,2007,OM,OMN,EMR,137593,266505,404098,346289,324194,214536,121489,51255,35204,1092967,132373,255403,387776,266846,205889,112773,67480,36523,31349,720860,1813827,2605700,2605700
Oman,2008,OM,OMN,EMR,139799,257771,397570,348141,348674,221796,124504,52167,35937,1131219,134540,247529,382069,266835,216304,117384,69921,37504,32227,740175,1871394,2651028,2651028
Oman,2009,OM,OMN,EMR,143227,250689,393916,342105,377855,230571,127217,53087,36355,1167190,137738,240588,378326,264827,226644,122884,72249,38545,32961,758110,1925300,2697537,2697537
Oman,2010,OM,OMN,EMR,149292,246746,396038,365859,450741,260607,140059,57397,38202,1312865,143477,236139,379616,269071,241924,130787,75728,41201,34689,793400,2106265,2881914,2881914
Oman,2011,OM,OMN,EMR,158631,245759,404390,407665,574052,314678,164514,66257,42011,1569177,152541,234694,387235,277037,263867,141668,80358,45435,37706,846071,2415248,3206870,3206870
Oman,2012,OM,OMN,EMR,168379,247254,415633,416558,714915,376928,192036,77711,46379,1824527,162052,236225,398277,277363,289197,154826,84963,49651,41138,897138,2721665,3535579,3535579
Oman,2013,OM,OMN,EMR,177290,254073,431363,397355,839948,434915,216392,89361,50228,2028199,170703,243262,413965,271654,314335,169792,89450,53416,44501,943148,2971347,3816680,3816680
Oman,2014,OM,OMN,EMR,186630,266203,452833,372663,909845,474536,230999,97529,52971,2138543,179637,255609,435246,264927,334328,185765,93419,56706,47506,982651,3121194,4009267,4009267
Oman,2015,OM,OMN,EMR,196396,279395,475791,365743,958290,512328,243607,102890,55753,2238611,188729,268865,457594,259985,349302,202175,97688,60195,50429,1019774,3258385,4191776,4191776
Oman,2016,OM,OMN,EMR,205168,291573,496741,375107,1010870,558534,259326,107731,58027,2369595,196872,280868,477740,257457,359587,217438,102934,63140,53441,1053997,3423592,4398070,4398070
Oman,2017,OM,OMN,EMR,213551,303691,517242,375692,1028197,595898,272515,112690,58683,2443675,205028,292657,497685,256852,364934,231891,108110,65267,56204,1083258,3526933,4541854,4541854
Oman,2018,OM,OMN,EMR,220916,318494,539410,359259,998428,617995,280416,116758,59103,2431959,212409,306896,519305,256308,367401,247310,113358,67561,58547,1110485,3542444,4601157,4601157
Oman,2019,OM,OMN,EMR,226095,338810,564905,335986,937397,625849,282134,118257,60168,2359791,217537,326348,543885,254082,366776,262545,119624,70094,61065,1134186,3493977,4602768,4602768
Oman,2020,OM,OMN,EMR,227630,365980,593610,313721,844868,615053,276612,115649,61271,2227174,219225,352251,571476,251400,359687,276343,127254,72494,63959,1151137,3378311,4543399,4543399
Oman,2021,OM,OMN,EMR,225707,390935,616642,308246,773558,613861,275744,112629,61081,2145119,217313,376154,593467,250872,349014,290023,136146,74100,65081,1165236,3310355,4520471,4520471
Oman,2022,OM,OMN,EMR,220878,409521,630399,308131,750877,633506,287257,114665,60662,2155098,212439,393993,606432,253834,340864,302528,146151,75413,65581,1184371,3339469,4576298,4576298
Oman,2023,OM,OMN,EMR,213956,425208,639164,304044,732677,657105,303490,120315,62189,2179820,205620,409334,614954,260609,334113,313049,157093,77472,68106,1210442,3390262,4644384,4644384
Oman,2024,OM,OMN,EMR,207292,436954,644246,307482,710665,679587,319984,126423,65007,2209148,199046,420807,619853,270903,327127,322111,168724,79901,71535,1240301,3449449,4713553,4713553
Oman,2025,OM,OMN,EMR,201272,445459,646731,316116,688838,693805,338700,134258,68318,2240035,193177,428684,621861,283631,320102,329702,180604,82864,75178,1272081,3512116,4780706,4780706
Oman,2026,OM,OMN,EMR,197648,449768,647416,329117,667737,702160,357866,142704,72194,2271778,189635,432550,622185,297578,313655,335630,192539,86195,79036,1304633,3576411,4846014,4846014
Oman,2027,OM,OMN,EMR,194735,450656,645391,345866,645987,706736,378722,151470,76630,2305411,186880,433241,620121,313239,307515,339628,205711,89802,82926,1338821,3644232,4909747,4909747
Oman,2028,OM,OMN,EMR,191023,448860,639883,364642,622062,710086,402561,161168,81284,2341803,183276,431421,614697,330880,301739,342428,219705,94294,86661,1375707,3717510,4972087,4972087
Oman,2029,OM,OMN,EMR,187679,443709,631388,384105,601053,713071,425519,170446,86384,2380578,180026,426359,606385,349588,297977,344073,232837,99904,90525,1414904,3795482,5033246,5033246
Oman,2030,OM,OMN,EMR,184887,435706,620593,403978,584241,708605,450328,181649,92306,2421107,177306,418931,596237,368530,296497,343353,245434,106811,94814,1455439,3876546,5093376,5093376
Oman,1950,OM,OMN,EMR,39243,58608,97851,44122,32537,23885,16756,10250,6921,134471,37982,56823,94805,42686,31215,22943,16191,10134,7033,130202,264673,457317,457317
Oman,1951,OM,OMN,EMR,39055,59740,98795,44731,32872,24140,17068,10494,7131,136436,37853,58034,95887,43417,31620,23309,16566,10408,7277,132597,269033,463719,463719
Oman,1952,OM,OMN,EMR,39080,60727,99807,45422,33220,24378,17362,10759,7334,138475,37904,59116,97020,44218,32053,23673,16929,10705,7521,135099,273574,470396,470396
Oman,1953,OM,OMN,EMR,39732,61195,100927,46195,33554,24616,17641,11032,7532,140570,38533,59698,98231,45081,32504,24029,17279,11015,7762,137670,278240,477401,477401
Oman,1954,OM,OMN,EMR,40960,61209,102169,47014,33887,24863,17908,11314,7719,142705,39702,59856,99558,45976,32974,24391,17630,11345,7996,140312,283017,484741,484741
Oman,1955,OM,OMN,EMR,42119,61417,103536,47861,34229,25132,18173,11593,7910,144898,40798,60182,100980,46892,33467,24750,17987,11679,8232,143007,287905,492416,492416
Oman,1956,OM,OMN,EMR,43121,61909,105030,48739,34585,25419,18438,11873,8086,147140,41732,60768,102500,47837,33990,25109,18347,12021,8462,145766,292906,500443,500443
Oman,1957,OM,OMN,EMR,44169,62478,106647,49667,34957,25716,18699,12154,8259,149452,42720,61408,104128,48828,34555,25469,18715,12374,8687,148628,298080,508853,508853
Oman,1958,OM,OMN,EMR,45277,63105,108382,50657,35377,26019,18965,12436,8436,151890,43767,62077,105844,49882,35157,25831,19080,12729,8914,151593,303483,517707,517707
Oman,1959,OM,OMN,EMR,46447,63795,110242,51724,35850,26334,19221,12705,8621,154455,44878,62773,107651,51012,35792,26204,19440,13078,9156,154682,309137,527029,527029
Oman,1960,OM,OMN,EMR,47755,64561,112316,52775,36299,26619,19447,12961,8818,156919,46119,63521,109640,52131,36386,26557,19777,13409,9415,157675,314594,536553,536553
Oman,1961,OM,OMN,EMR,49245,65478,114723,53762,36744,26877,19651,13196,9023,159253,47527,64379,111906,53195,36952,26895,20097,13729,9688,160556,319809,546443,546443
Oman,1962,OM,OMN,EMR,50862,66695,117557,54649,37278,27156,19851,13423,9245,161602,49048,65510,114558,54156,37588,27245,20417,14037,9987,163430,325032,557139,557139
Oman,1963,OM,OMN,EMR,52555,68599,121154,55086,37899,27429,20053,13639,9474,163580,50642,67288,117930,54677,38278,27613,20732,14342,10298,165940,329520,568603,568603
Oman,1964,OM,OMN,EMR,54279,71199,125478,55130,38574,27703,20271,13852,9701,165231,52269,69727,121996,54810,38998,27997,21047,14646,10616,168114,333345,580824,580824
Oman,1965,OM,OMN,EMR,55989,73948,129937,55367,39283,27992,20511,14070,9937,167160,53878,72296,126174,55127,39749,28399,21363,14956,10941,170535,337695,593808,593808
Oman,1966,OM,OMN,EMR,57683,76745,134428,55887,40039,28291,20771,14283,10164,169435,55478,74897,130375,55705,40533,28830,21679,15273,11276,173296,342731,607538,607538
Oman,1967,OM,OMN,EMR,59386,79738,139124,56501,40860,28616,21048,14502,10395,171922,57092,77687,134779,56358,41371,29293,21994,15593,11617,176226,348148,622042,622042
Oman,1968,OM,OMN,EMR,61121,82915,144036,57192,41761,28984,21331,14721,10625,174614,58744,80653,139397,57063,42283,29793,22311,15920,11967,179337,353951,637379,637379
Oman,1969,OM,OMN,EMR,62914,86271,149185,57959,42744,29396,21621,14938,10858,177516,60458,83794,144252,57813,43286,30322,22643,16239,12330,182633,360149,653593,653593
Oman,2031,OM,OMN,EMR,182722,425747,608469,424000,571226,700460,474151,194498,98239,2462574,175194,409407,584601,387835,297454,339837,257842,115254,98923,1497145,3959719,5152792,5152792
Oman,2032,OM,OMN,EMR,181124,414935,596059,442774,561450,691626,495098,208791,104292,2504031,173633,398815,572448,406048,301186,334531,269317,125254,102773,1539109,4043140,5211645,5211645
Oman,2033,OM,OMN,EMR,180106,404343,584449,458460,557470,673731,518744,224845,111218,2544468,172634,388418,561052,421384,307972,327860,279833,136065,107060,1580174,4124642,5270150,5270150
Oman,2034,OM,OMN,EMR,179707,394368,574075,470198,560934,651909,541060,240891,118612,2583604,172231,378621,550852,432857,318264,320917,288849,147470,111682,1620039,4203643,5328579,5328579
Oman,2035,OM,OMN,EMR,179952,385592,565544,478704,569572,630259,555212,259172,128017,2620936,172445,370056,542501,440733,330975,313940,296404,159123,116980,1658155,4279091,5387135,5387135
Oman,2036,OM,OMN,EMR,180869,379831,560700,483020,582567,609317,563553,277899,138434,2654790,173305,364421,537726,444602,344912,307534,302309,170830,122778,1692965,4347755,5446192,5446192
Oman,2037,OM,OMN,EMR,182466,375347,557813,483926,599302,587723,568162,298275,149616,2687004,174817,360117,534934,445297,360562,301434,306305,183744,128830,1726172,4413176,5505926,5505926
Oman,2038,OM,OMN,EMR,184617,370642,555259,482152,618053,563974,571605,321578,161807,2719169,176860,355531,532391,443488,378178,295703,309127,197467,135527,1759490,4478659,5566306,5566306
Oman,2039,OM,OMN,EMR,187254,366917,554171,477031,637499,543131,574666,343958,173935,2750220,179377,351890,531267,438431,396868,291977,310797,210351,143375,1791799,4542019,5627456,5627456
Oman,2040,OM,OMN,EMR,190301,364389,554690,469067,657350,526459,570383,368218,188559,2780036,182284,349398,531682,431022,415792,290526,310125,222728,152842,1823035,4603071,5689446,5689446
Oman,2041,OM,OMN,EMR,193557,363163,556720,459152,677354,513573,562451,391525,204654,2808709,185390,348157,533547,421507,435079,291504,306686,234941,163554,1853271,4661980,5752240,5752240
Oman,2042,OM,OMN,EMR,196896,363176,560072,448384,696113,503909,553819,412017,222108,2836350,188577,348112,536689,410933,453272,295252,301471,246248,175465,1882641,4718991,5815752,5815752
Oman,2043,OM,OMN,EMR,200223,364324,564547,437833,711795,500020,536256,435217,241964,2863085,191748,349167,540915,400551,468595,302039,294904,256626,188511,1911226,4774311,5879774,5879774
Oman,2044,OM,OMN,EMR,203441,366571,570012,427905,723546,503536,514791,457078,262126,2888982,194812,351283,546095,390768,480056,312322,288066,265530,202407,1939149,4828131,5944240,5944240
Oman,2045,OM,OMN,EMR,206384,369873,576257,419160,732070,512207,493469,471031,286168,2914105,197614,354411,552025,382215,487929,325017,281192,273004,217122,1966479,4880584,6008877,6008877
Oman,2046,OM,OMN,EMR,209043,374052,583095,413428,736417,525207,472810,479302,311448,2938612,200152,358380,558532,376592,491799,338931,274883,278855,232318,1993378,4931990,6073623,6073623
Oman,2047,OM,OMN,EMR,211405,378997,590402,408972,737359,541933,451503,483963,338838,2962568,202402,363084,565486,372296,492500,354550,268879,282841,248856,2019922,4982490,6138380,6138380
Oman,2048,OM,OMN,EMR,213349,384482,597831,404292,735631,560673,428092,487605,369772,2986065,204256,368301,572557,367715,490699,372140,263245,285695,266728,2046222,5032287,6202674,6202674
Oman,2049,OM,OMN,EMR,214814,390346,605160,400594,730564,580104,407577,490824,399550,3009213,205650,373879,579529,364087,485662,390797,259611,287420,284809,2072386,5081599,6266279,6266279
Oman,2050,OM,OMN,EMR,215822,396344,612166,398086,722657,599941,391196,486949,433268,3032097,206602,379593,586195,361604,478263,409684,258231,286854,303890,2098526,5130623,6328978,6328978
Pakistan,1970,PK,PAK,EMR,5266903,8028396,13295299,5422200,4393197,3305453,2444286,1587975,1146019,18299130,4991286,7595196,12586482,5042335,3724312,2593765,1793763,1138108,817687,15109970,33409100,59290872,59290872
Pakistan,1971,PK,PAK,EMR,5386934,8305935,13692869,5550191,4468790,3366593,2496667,1633794,1173348,18689383,5100967,7858322,12959289,5190676,3819906,2663402,1843703,1176278,843271,15537236,34226619,60878781,60878781
Pakistan,1972,PK,PAK,EMR,5513560,8579502,14093062,5702482,4537639,3427955,2548710,1680427,1201757,19098970,5216779,8117186,13333965,5356538,3913195,2734328,1894314,1215174,870011,15983560,35082530,62509565,62509565
Pakistan,1973,PK,PAK,EMR,5660778,8851446,14512224,5901082,4603024,3498741,2606526,1732348,1237309,19579030,5351693,8373735,13725428,5547101,4006543,2809492,1947903,1256522,901384,16468945,36047975,64285624,64285624
Pakistan,1974,PK,PAK,EMR,5821470,9115802,14937272,6141542,4654540,3575427,2665456,1784343,1275259,20096567,5499441,8622031,14121472,5768664,4097141,2890197,2003999,1298775,935082,16993858,37090425,66149169,66149169
Pakistan,1975,PK,PAK,EMR,5994338,9376364,15370702,6418312,4704208,3660632,2726643,1836655,1316265,20662715,5659000,8865622,14524622,6028148,4184756,2978675,2063572,1342267,971550,17568968,38231683,68126999,68126999
Pakistan,1976,PK,PAK,EMR,6177341,9638238,15815579,6717012,4767908,3754604,2790796,1889480,1360368,21280168,5827670,9110378,14938048,6314024,4282338,3075199,2127196,1387354,1011022,18197133,39477301,70230923,70230923
Pakistan,1977,PK,PAK,EMR,6372172,9905925,16278097,7021282,4854007,3856529,2857463,1942180,1406916,21938377,6004624,9360931,15365555,6606502,4401466,3179348,2194679,1433850,1053228,18869073,40807450,72451105,72451105
Pakistan,1978,PK,PAK,EMR,6580307,10183204,16763511,7327197,4960713,3967205,2926671,1995201,1455834,22632821,6193629,9620817,15814446,6901052,4539750,3292072,2265845,1481894,1097946,19578559,42211380,74789330,74789330
Pakistan,1979,PK,PAK,EMR,6806629,10473512,17280141,7655844,5117030,4094489,3003857,2051614,1508932,23431766,6407221,9894015,16301236,7220659,4722130,3425721,2345342,1533798,1146543,20394193,43825959,77407341,77407341
Pakistan,1980,PK,PAK,EMR,7068893,10786288,17855181,8046912,5376581,4258004,3100268,2116400,1569998,24468163,6661300,10189570,16850870,7609164,5002888,3599262,2442960,1593583,1201985,21449842,45918005,80624057,80624057
Pakistan,1981,PK,PAK,EMR,7380361,11119984,18500345,8461623,5708060,4445789,3210482,2186907,1636021,25648882,6963542,10504971,17468513,8024801,5354980,3797332,2554126,1659171,1262045,22652455,48301337,84270202,84270202
Pakistan,1982,PK,PAK,EMR,7729241,11467819,19197060,8816727,6028109,4616825,3316889,2255212,1699305,26733067,7304234,10830796,18135030,8377542,5691373,3984845,2663710,1724367,1321204,23763041,50496108,87828198,87828198
Pakistan,1983,PK,PAK,EMR,8094795,11831554,19926349,9086093,6311055,4744497,3413248,2318430,1757772,27631095,7661518,11170219,18831737,8638411,5978275,4143811,2765714,1786940,1378038,24691189,52322284,91080372,91080372
Pakistan,1984,PK,PAK,EMR,8461476,12213716,20675192,9277380,6555305,4823071,3500358,2376480,1812099,28344693,8012881,11533354,19546235,8814777,6215190,4267073,2860364,1847040,1433318,25437762,53782455,94003867,94003867
Pakistan,1985,PK,PAK,EMR,8825684,12633300,21458984,9483422,6835991,4901413,3596933,2437741,1870590,29126090,8357814,11936610,20294424,9004114,6487733,4387188,2962293,1909898,1490834,26242060,55368150,97121552,97121552
Pakistan,1986,PK,PAK,EMR,9183804,13107389,22291193,9734823,7166047,5007771,3708761,2505251,1935365,30058018,8697987,12389722,21087709,9238883,6810795,4527877,3075828,1977178,1551034,27181595,57239613,100618523,100618523
Pakistan,1987,PK,PAK,EMR,9530651,13632729,23163380,9996541,7492291,5132703,3826893,2574203,2000240,31022871,9026668,12889272,21915940,9482618,7128608,4685190,3194669,2046404,1611417,28148906,59171777,104251093,104251093
Pakistan,1988,PK,PAK,EMR,9872736,14197091,24069827,10265598,7803949,5271258,3950339,2643415,2063750,31998309,9343037,13426285,22769322,9733326,7431607,4855459,3319632,2117799,1672566,29130389,61128698,107967838,107967838
Pakistan,1989,PK,PAK,EMR,10217141,14786304,25003445,10527966,8084195,5419839,4072015,2712142,2125856,32942013,9650178,13989036,23639214,9976710,7703097,5031496,3449072,2190808,1734539,30085722,63027735,111670386,111670386
Pakistan,1990,PK,PAK,EMR,10563383,15392420,25955803,10797931,8343142,5587584,4189519,2782100,2188132,33888408,9951033,14571219,24522252,10227284,7953356,5221369,3580619,2266607,1798375,31047610,64936018,115414069,115414069
Pakistan,1991,PK,PAK,EMR,10892357,16022509,26914866,11083137,8584546,5774355,4305183,2854285,2251519,34853025,10233744,15177522,25411266,10491478,8184878,5427895,3711374,2345269,1863509,32024403,66877428,119203569,119203569
Pakistan,1992,PK,PAK,EMR,11168341,16663693,27832034,11297253,8707439,5929643,4396276,2919067,2307429,35557107,10471394,15790742,26262136,10670884,8292730,5598870,3823036,2417420,1920963,32723903,68281010,122375179,122375179
Pakistan,1993,PK,PAK,EMR,11391596,17327764,28719360,11552509,8814363,6109464,4473921,2985966,2364044,36300267,10664301,16415557,27079858,10887638,8379992,5779874,3931495,2490574,1977557,33447130,69747397,125546615,125546615
Pakistan,1994,PK,PAK,EMR,11584838,18023443,29608281,11924986,8988451,6354572,4551866,3063899,2427822,37311596,10831751,17054245,27885996,11233102,8532475,6012079,4048036,2572943,2040633,34439268,71750864,129245139,129245139
Pakistan,1995,PK,PAK,EMR,11755048,18720547,30475595,12356277,9179929,6628289,4625534,3147738,2492912,38430679,10983631,17684120,28667751,11643453,8701086,6272699,4158820,2660884,2106504,35543446,73974125,133117476,133117476
Pakistan,1996,PK,PAK,EMR,11912359,19392515,31304874,12865935,9408666,6922286,4711650,3238683,2560857,39708077,11125388,18291580,29416968,12132708,8906923,6555660,4277465,2755479,2176653,36804888,76512965,137234810,137234810
Pakistan,1997,PK,PAK,EMR,12058760,20017609,32076369,13413148,9639422,7202589,4811176,3333412,2628551,41028298,11252594,18861280,30113874,12656613,9115491,6825702,4409360,2854807,2249759,38111732,79140030,141330267,141330267
Pakistan,1998,PK,PAK,EMR,12212546,20590312,32802858,13997145,9888807,7471881,4925510,3433880,2697187,42414410,11390382,19380475,30770857,13216842,9343621,7084839,4555259,2960897,2326524,39487982,81902392,145476106,145476106
Pakistan,1999,PK,PAK,EMR,12378786,21128434,33507220,14605208,10158349,7730635,5059183,3537173,2768433,43858981,11545910,19859065,31404975,13801545,9592705,7332539,4714864,3074544,2407086,40923283,84782264,149694462,149694462
Pakistan,2000,PK,PAK,EMR,12557633,21656995,34214628,15284078,10513714,8010294,5229658,3645135,2848540,45531419,11713753,20326868,32040621,14462682,9928279,7597952,4902851,3196199,2495284,42583247,88114666,154369924,154369924
Pakistan,2001,PK,PAK,EMR,12752315,22156227,34908542,15989568,10912817,8289881,5425341,3754238,2932280,47304125,11895439,20767639,32663078,15151037,10308161,7861971,5113110,3319710,2587989,44341978,91646103,159217727,159217727
Pakistan,2002,PK,PAK,EMR,12939569,22593558,35533127,16580686,11203622,8493568,5612429,3848955,3006004,48745264,12069962,21150508,33220470,15712098,10575755,8053183,5313467,3434988,2674458,45763949,94509213,163262807,163262807
Pakistan,2003,PK,PAK,EMR,13104361,22980823,36085184,17128661,11449776,8650225,5810075,3926230,3077110,50042077,12226246,21495338,33721584,16214873,10795761,8198095,5514800,3544414,2759885,47027828,97069905,166876680,166876680
Pakistan,2004,PK,PAK,EMR,13245669,23342754,36588423,17728199,11744543,8805333,6037757,3991087,3154189,51461108,12364597,21827510,34192107,16755243,11070483,8340249,5736690,3651220,2853102,48406987,99868095,170648620,170648620
Pakistan,2005,PK,PAK,EMR,13365688,23673890,37039578,18331753,12061722,8949679,6279170,4046781,3233327,52902432,12482530,22136012,34618542,17291470,11372158,8471774,5974746,3749163,2952238,49811549,102713981,174372098,174372098
Pakistan,2006,PK,PAK,EMR,13460572,23993488,37454060,18911551,12410852,9089906,6521080,4106888,3315800,54356077,12583677,22434905,35018582,17809173,11704792,8600619,6218307,3849505,3058869,51241265,105597342,178069984,178069984
Pakistan,2007,PK,PAK,EMR,13566452,24319457,37885909,19467586,12810003,9240299,6754376,4182177,3403657,55858098,12700024,22739337,35439361,18316365,12087011,8741617,6455127,3965701,3175336,52741157,108599255,181924521,181924521
Pakistan,2008,PK,PAK,EMR,13716004,24641244,38357248,19990637,13249764,9405909,6975483,4270685,3495900,57388378,12855603,23047867,35903470,18795831,12510691,8899412,6680996,4095321,3300610,54282861,111671239,185931955,185931955
Pakistan,2009,PK,PAK,EMR,13903550,24947376,38850926,20505035,13730385,9593183,7186544,4376538,3590589,58982274,13054191,23351444,36405635,19262695,12975591,9078854,6895966,4237671,3433602,55884379,114866653,190123222,190123222
Pakistan,2010,PK,PAK,EMR,14131100,25236601,39367701,21012638,14234743,9800286,7385963,4502014,3684145,60619789,13302142,23636893,36939035,19722207,13465201,9277416,7098265,4394631,3570258,57527978,118147767,194454498,194454498
Pakistan,2011,PK,PAK,EMR,14387831,25504768,39892599,21452230,14719949,10004861,7563216,4640539,3773632,62154427,13579295,23905898,37485193,20112938,13934924,9474196,7278851,4564028,3705589,59070526,121224953,198602738,198602738
Pakistan,2012,PK,PAK,EMR,14619572,25776269,40395841,21769666,15136809,10183108,7706675,4786029,3853858,63436145,13832728,24181848,38014576,20379200,14333053,9644534,7427233,4738348,3836934,60359302,123795447,202205861,202205861
Pakistan,2013,PK,PAK,EMR,14801798,26066530,40868328,21987623,15495331,10342507,7819057,4944927,3920866,64510311,14041358,24475478,38516836,20552828,14662119,9796686,7545689,4919100,3965655,61442077,125952388,205337562,205337562
Pakistan,2014,PK,PAK,EMR,14933183,26358631,41291814,22169030,15841955,10503761,7910020,5121018,3977404,65523188,14196379,24780007,38976386,20699337,14960473,9956242,7641955,5110745,4091487,62460239,127983427,208251628,208251628
Pakistan,2015,PK,PAK,EMR,14998248,26670597,41668845,22272346,16104260,10640350,7971980,5300892,4025031,66314859,14281544,25117262,39398806,20883861,15283490,10152282,7732526,5318977,4215646,63586782,129901641,210969298,210969298
Pakistan,2016,PK,PAK,EMR,15012947,26995220,42008167,22320489,16251855,10758882,8009470,5472164,4073491,66886351,14311802,25476279,39788081,21117025,15624912,10393141,7826063,5533892,4347223,64842256,131728607,213524840,213524840
Pakistan,2017,PK,PAK,EMR,15003900,27323286,42327186,22472727,16425213,10936201,8060860,5638334,4142563,67675898,14314026,25838451,40152477,21398698,15976711,10681509,7929371,5741329,4496471,66224089,133899987,216379655,216379655
Pakistan,2018,PK,PAK,EMR,14991293,27667515,42658808,22751748,16665943,11184913,8140694,5801289,4234926,68779513,14308439,26213217,40521656,21746733,16349401,11019540,8051583,5940038,4664204,67771499,136551012,219731479,219731479
Pakistan,2019,PK,PAK,EMR,15000406,28005799,43006205,23072200,16934787,11465974,8236659,5954843,4344376,70008839,14320094,26582170,40902264,22110321,16723357,11384101,8187182,6125618,4845391,69375970,139384809,223293280,223293280
Pakistan,2020,PK,PAK,EMR,15057164,28318399,43375563,23457923,17288619,11790074,8355607,6094197,4453659,71440079,14375838,26930230,41306068,22491105,17139915,11778318,8340191,6295562,5029939,71075030,142515109,227196741,227196741
Pakistan,2021,PK,PAK,EMR,15144168,28615941,43760109,23895674,17719890,12166795,8499013,6218283,4556093,73055748,14460310,27259753,41720063,22889586,17592773,12210350,8512600,6448538,5212352,72866199,145921947,231402117,231402117
Pakistan,2022,PK,PAK,EMR,15242808,28879727,44122535,24374532,18193343,12591475,8669468,6336181,4673342,74838341,14555379,27552727,42108106,23313575,18061084,12679934,8705966,6590219,5405098,74755876,149594217,235824862,235824862
Pakistan,2023,PK,PAK,EMR,15352710,29101587,44454297,24886228,18698848,13060815,8872131,6456216,4828082,76802320,14663190,27803900,42467090,23759796,18545052,13178100,8926178,6727703,5625121,76761950,153564270,240485658,240485658
Pakistan,2024,PK,PAK,EMR,15462781,29301017,44763798,25371036,19213034,13560562,9098011,6572566,5009906,78825115,14774413,28025748,42800161,24195908,19034398,13691078,9175458,6857635,5866258,78820735,157645850,245209815,245209815
Pakistan,2025,PK,PAK,EMR,15571853,29474398,45046251,25843242,19737128,14076425,9346461,6681796,5196971,80882023,14885215,28215232,43100447,24636491,19524668,14212110,9453431,6979624,6113837,80920161,161802184,249948885,249948885
Pakistan,2026,PK,PAK,EMR,15693152,29616909,45310061,26296038,20281571,14586069,9628965,6790026,5387990,82970659,15007618,28369160,43376778,25073985,20020460,14729507,9765838,7100770,6366421,83056981,166027640,254714473,254714473
Pakistan,2027,PK,PAK,EMR,15830751,29739397,45570148,26717144,20851100,15079457,9949573,6903090,5580371,85080735,15145914,28499159,43645073,25494533,20524102,15237152,10116108,7227554,6620761,85220210,170300945,259516159,259516159
Pakistan,2028,PK,PAK,EMR,15973139,29861137,45834276,27121898,21429599,15552640,10298761,7024999,5771545,87199442,15288128,28625885,43914013,25907773,21031807,15722579,10496075,7364472,6873975,87396681,174596123,264344407,264344407
Pakistan,2029,PK,PAK,EMR,16114868,30003841,46118709,27501451,21994119,16024440,10666105,7155644,5960120,89301879,15428487,28771917,44200404,26304659,21526942,16196101,10896666,7512076,7124428,89560872,178862751,269181864,269181864
Pakistan,2030,PK,PAK,EMR,16256037,30186831,46442868,27837577,22534516,16511442,11044213,7296388,6145263,91369399,15568163,28955755,44523918,26669336,21991784,16677787,11311712,7671737,7371296,91693652,183063051,274029836,274029836
Pakistan,1950,PK,PAK,EMR,3005104,4937131,7942235,3825272,2945554,2156581,1488264,1051343,1097654,12564668,2883597,4435968,7319565,3212370,2292767,1583586,1059367,754224,967484,9869798,22434466,37696264,37696264
Pakistan,1951,PK,PAK,EMR,2987489,5032241,8019730,3902868,3004525,2210263,1521119,1051412,1078544,12768731,2882245,4538264,7420509,3291343,2345138,1623198,1082321,749042,915774,10006816,22775547,38215785,38215785
Pakistan,1952,PK,PAK,EMR,3000705,5121265,8121970,3983372,3064811,2266025,1556229,1053607,1062334,12986378,2906231,4638128,7544359,3373785,2399490,1664517,1107246,746287,872746,10164071,23150449,38816777,38816777
Pakistan,1953,PK,PAK,EMR,3050629,5193055,8243684,4067461,3126497,2323178,1593446,1058541,1048245,13217368,2953799,4732846,7686645,3459760,2456094,1707356,1134056,746370,836900,10340536,23557904,39488228,39488228
Pakistan,1954,PK,PAK,EMR,3138516,5243186,8381702,4156421,3189585,2380520,1632841,1067423,1035734,13462524,3027667,4816353,7844020,3549867,2515209,1751273,1162734,750079,806677,10535839,23998363,40224090,40224090
Pakistan,1955,PK,PAK,EMR,3255032,5280260,8535292,4250573,3254294,2437709,1674496,1080555,1024773,13722400,3131147,4884404,8015551,3644262,2577092,1796249,1193297,757573,781412,10749885,24472285,41023128,41023128
Pakistan,1956,PK,PAK,EMR,3385291,5320025,8705316,4349189,3321129,2494848,1718265,1097785,1015660,13996876,3251886,4950151,8202037,3741992,2641887,1842339,1225525,768604,760410,10980757,24977633,41884995,41884995
Pakistan,1957,PK,PAK,EMR,3518193,5373857,8892050,4452315,3390440,2551850,1764000,1119280,1008346,14286231,3374674,5028445,8403119,3842933,2709666,1889440,1259178,783046,742864,11227127,25513358,42808511,42808511
Pakistan,1958,PK,PAK,EMR,3653964,5441366,9095330,4560598,3462169,2609110,1811712,1144362,1002966,14590917,3500140,5118664,8618804,3948238,2780452,1937803,1294285,800415,728744,11489937,26080854,43794993,43794993
Pakistan,1959,PK,PAK,EMR,3792642,5527836,9320478,4668606,3536026,2667260,1861321,1171691,999811,14904715,3628320,5221305,8849625,4058141,2854076,1987786,1330888,819847,718079,11768817,26673532,44843639,44843639
Pakistan,1960,PK,PAK,EMR,3934227,5638992,9573219,4770406,3612431,2726675,1912622,1200763,999060,15221957,3759283,5341570,9100853,4167155,2930812,2039586,1368912,840901,710828,12058194,27280151,45954226,45954226
Pakistan,1961,PK,PAK,EMR,4076849,5772546,9849395,4857470,3681074,2782099,1963400,1230664,999617,15514324,3891263,5481527,9372790,4260983,3000156,2088217,1406365,862757,705925,12324403,27838727,47060915,47060915
Pakistan,1962,PK,PAK,EMR,4217903,5930324,10148227,4930207,3741776,2833408,2013762,1261309,1001503,15781965,4022090,5639608,9661698,4343305,3061621,2133404,1443210,885270,703143,12569953,28351918,48161841,48161841
Pakistan,1963,PK,PAK,EMR,4357020,6124242,10481262,4988864,3805712,2885680,2065343,1293690,1005971,16045260,4151545,5820670,9972215,4424089,3126464,2180534,1481568,909611,704052,12826318,28871578,49325050,49325050
Pakistan,1964,PK,PAK,EMR,4494221,6356760,10850981,5029450,3874595,2939193,2117402,1328236,1013849,16302725,4278624,6029310,10307934,4498215,3196022,2230275,1521367,936103,708973,13090955,29393680,50552592,50552592
Pakistan,1965,PK,PAK,EMR,4628051,6618686,11246737,5060197,3949100,2994241,2169742,1365192,1025566,16564038,4401977,6269160,10671137,4561431,3270584,2282759,1562496,964711,717728,13359709,29923747,51841626,51841626
Pakistan,1966,PK,PAK,EMR,4758724,6896610,11655334,5096523,4029033,3051516,2222710,1404719,1041565,16846066,4522337,6529536,11051873,4626333,3349897,2338439,1605277,995532,730665,13646143,30492209,53199414,53199414
Pakistan,1967,PK,PAK,EMR,4888606,7178357,12066963,5149519,4114951,3111515,2276419,1446974,1062309,17161687,4642099,6794149,11436248,4707106,3434492,2397570,1649729,1028416,747589,13964902,31126589,54629793,54629793
Pakistan,1968,PK,PAK,EMR,5016994,7461316,12478310,5218295,4207696,3173968,2330998,1491767,1087171,17509895,4760887,7060298,11821185,4802672,3525678,2459931,1695828,1063194,768044,14315347,31825242,56124743,56124743
Pakistan,1969,PK,PAK,EMR,5141794,7744933,12886727,5307584,4302374,3238562,2386909,1538863,1115177,17889469,4876357,7327296,12203653,4912913,3623899,2525213,1743751,1099744,791425,14696945,32586414,57676805,57676805
Pakistan,2031,PK,PAK,EMR,16393761,30404314,46798075,28145863,23044902,17005211,11441759,7449395,6326825,93413955,15704908,29172735,44877643,27006463,22429960,17160407,11748640,7845600,7614255,93805325,187219280,278894997,278894997
Pakistan,2032,PK,PAK,EMR,16522824,30644196,47167020,28413868,23549513,17499831,11865826,7618256,6504635,95451929,15832881,29411946,45244827,27302622,22868695,17638352,12213265,8035485,7852966,95911385,191363314,283775146,283775146
Pakistan,2033,PK,PAK,EMR,16643184,30898373,47541557,28636156,24055070,17995551,12316421,7805321,6677989,97486508,15952026,29666007,45618033,27554468,23312852,18116936,12698377,8245279,8086884,98014796,195501304,288660900,288660900
Pakistan,2034,PK,PAK,EMR,16759888,31153705,47913593,28836222,24535234,18500735,12795032,8009606,6845790,99522619,16067783,29922305,45990088,27777408,23747884,18601680,13197809,8480475,8314925,100120181,199642800,293546480,293546480
Pakistan,2035,PK,PAK,EMR,16873077,31407568,48280645,29010700,25003178,19015880,13288952,8233981,7010935,101563626,16179826,30177551,46357377,27968265,24187519,19087558,13705187,8742509,8540095,102231133,203794759,298432780,298432780
Pakistan,2036,PK,PAK,EMR,16981366,31669935,48651301,29154818,25452221,19551174,13777230,8489395,7177546,103602384,16286921,30441309,46728230,28123861,24624264,19579120,14209364,9037037,8767263,104340909,207943293,303322829,303322829
Pakistan,2037,PK,PAK,EMR,17071550,31939679,49011229,29279285,25870268,20111186,14250433,8779569,7347824,105638565,16376608,30711974,47088582,28255741,25044382,20078667,14704570,9367420,8999498,106450278,212088843,308188654,308188654
Pakistan,2038,PK,PAK,EMR,17144019,32205637,49349656,29403165,26272339,20679957,14704524,9095651,7523228,107678864,16449118,30977721,47426839,28384463,25457375,20582306,15178481,9725874,9238218,108566717,216245581,313022074,313022074
Pakistan,2039,PK,PAK,EMR,17205732,32467595,49673327,29547830,26649680,21235052,15157344,9427770,7702986,109720662,16511283,31238386,47749669,28532443,25854205,21073614,15640991,10103599,9482635,110687487,220408149,317831136,317831136
Pakistan,2040,PK,PAK,EMR,17246267,32725587,49971854,29732300,26984323,21766611,15624616,9768944,7887467,111764261,16553062,31494733,48047795,28718017,26219091,21535174,16111567,10494637,9733370,112811856,224576117,322595767,322595767
Pakistan,2041,PK,PAK,EMR,17256918,32975226,50232144,29950899,27291630,22268854,16098550,10127194,8078169,113815296,16565910,31743176,48309086,28936573,26556685,21970601,16583371,10906081,9992190,114945501,228760797,327302028,327302028
Pakistan,2042,PK,PAK,EMR,17263226,33198410,50461636,30191724,27559452,22765669,16573846,10509266,8278010,115877967,16574736,31965684,48540420,29177302,26853819,22406851,17051156,11343517,10260893,117093538,232971505,331973561,331973561
Pakistan,2043,PK,PAK,EMR,17280236,33395478,50675714,30446746,27782451,23263691,17050863,10915140,8488408,117947299,16593835,32162310,48756145,29432821,27107153,22848717,17520033,11800148,10542703,119251575,237198874,336630727,336630727
Pakistan,2044,PK,PAK,EMR,17292537,33578307,50870844,30702941,27983703,23737168,17537740,11345798,8707770,120015120,16607991,32345074,48953065,29690545,27331897,23281823,17995348,12270231,10841638,121411482,241426602,341250506,341250506
Pakistan,2045,PK,PAK,EMR,17302714,33736731,51039445,30957722,28159882,24198983,18034704,11789822,8940870,122081983,16620008,32503833,49123841,29947238,27524950,23719713,18472159,12747910,11161708,123573678,245655661,345818945,345818945
Pakistan,2046,PK,PAK,EMR,17321790,33860601,51182391,31220935,28306271,24642671,18551419,12229237,9200230,124150763,16640340,32628814,49269154,30212422,27683165,24155064,18954969,13223260,11512535,125741415,249892178,350343720,350343720
Pakistan,2047,PK,PAK,EMR,17330884,33962164,51293048,31491441,28433376,25056391,19092164,12656091,9490908,126220371,16650842,32732398,49383240,30484493,27817959,24574304,19446053,13691234,11899776,127913819,254134190,354810480,354810480
Pakistan,2048,PK,PAK,EMR,17314302,34056651,51370953,31758194,28559951,25454593,19640894,13066011,9806054,128285697,16636382,32828932,49465314,30751663,27949667,24986607,19941077,14139724,12317422,130086160,258371857,359208126,359208126
Pakistan,2049,PK,PAK,EMR,17283237,34135769,51419006,32020994,28707033,25828505,20176070,13474635,10136178,130343415,16607791,32910129,49517920,31013745,28100462,25382866,20423885,14577657,12756540,132255155,262598570,363535502,363535502
Pakistan,2050,PK,PAK,EMR,17253281,34191951,51445232,32279888,28893342,26160452,20688491,13895874,10475294,132393341,16580328,32968957,49549285,31271527,28288519,25747446,20877763,15023340,13212006,134420601,266813942,367808468,367808468
Panama,1970,PA,PAN,AMR,130577,209887,340464,146738,100279,68878,50184,34257,27939,428275,126798,204637,331435,142969,97104,66027,47571,33053,29288,416012,844287,1516188,1516188
Panama,1971,PA,PAN,AMR,132491,216368,348859,151685,103490,70896,51305,35132,28966,441474,128538,210919,339457,147857,100324,68034,48711,33957,30388,429271,870745,1559072,1559072
Panama,1972,PA,PAN,AMR,134233,222774,357007,156826,106825,73081,52453,36040,30035,455260,130128,217125,347253,152940,103660,70200,49890,34889,31545,443124,898384,1602646,1602646
Panama,1973,PA,PAN,AMR,135734,229009,364743,162212,110243,75416,53637,36972,31136,469616,131495,223143,354638,158277,107075,72515,51111,35852,32750,457580,927196,1646580,1646580
Panama,1974,PA,PAN,AMR,136971,235004,371975,167770,113829,77870,54882,37915,32274,484540,132620,228908,361528,163759,110689,74955,52402,36842,33986,472633,957173,1690676,1690676
Panama,1975,PA,PAN,AMR,138013,240661,378674,173489,117626,80423,56195,38869,33424,500026,133536,234340,367876,169378,114533,77504,53768,37847,35269,488299,988325,1734876,1734876
Panama,1976,PA,PAN,AMR,138821,245955,384776,179446,121556,83064,57579,39843,34586,516074,134198,239410,373608,175241,118501,80167,55221,38873,36576,504579,1020653,1779037,1779037
Panama,1977,PA,PAN,AMR,139426,250842,390268,185605,125652,85793,59049,40841,35740,532680,134653,244064,378717,181308,122639,82941,56767,39920,37906,521481,1054161,1823146,1823146
Panama,1978,PA,PAN,AMR,140023,255186,395209,191948,129942,88606,60610,41866,36877,549849,135098,248157,383255,187547,126975,85828,58426,40982,39254,539012,1088861,1867313,1867313
Panama,1979,PA,PAN,AMR,140784,259022,399806,198400,134400,91500,62283,42921,37991,567495,135704,251721,387425,193893,131487,88829,60195,42071,40611,557086,1124581,1911814,1911814
Panama,1980,PA,PAN,AMR,141837,262465,404302,204859,139034,94499,64074,44008,39089,585563,136592,254874,391466,200252,136176,91957,62081,43185,42002,575653,1161216,1956987,1956987
Panama,1981,PA,PAN,AMR,143316,265491,408807,211314,143865,97606,66006,45125,40168,604084,137885,257589,395474,206604,141055,95200,64109,44330,43429,594727,1198811,2003092,2003092
Panama,1982,PA,PAN,AMR,145242,268135,413377,217726,148892,100835,68096,46267,41238,623054,139609,259926,399535,212888,146134,98559,66298,45515,44890,614284,1237338,2050247,2050247
Panama,1983,PA,PAN,AMR,147599,270523,418122,223990,154173,104148,70335,47439,42298,642383,141747,262024,403771,218989,151471,101985,68633,46745,46401,634224,1276607,2098499,2098499
Panama,1984,PA,PAN,AMR,150149,272800,422949,230031,159651,107639,72703,48657,43341,662022,144079,264027,408106,224837,156964,105609,71093,48041,47953,654497,1316519,2147577,2147577
Panama,1985,PA,PAN,AMR,152534,275153,427687,235762,165311,111364,75186,49928,44371,681922,146272,266091,412363,230369,162621,109473,73664,49422,49549,675098,1357020,2197065,2197065
Panama,1986,PA,PAN,AMR,154662,277677,432339,241144,171238,115246,77780,51266,45388,702062,148239,268289,416528,235551,168560,113490,76354,50891,51189,696035,1398097,2246960,2246960
Panama,1987,PA,PAN,AMR,156493,280427,436920,246129,177402,119323,80476,52680,46413,722423,149944,270696,420640,240330,174743,117696,79158,52454,52864,717245,1439668,2297231,2297231
Panama,1988,PA,PAN,AMR,157957,283570,441527,250580,183753,123617,83268,54188,47472,742878,151326,273496,424822,244571,181131,122119,82071,54125,54589,738606,1481484,2347821,2347821
Panama,1989,PA,PAN,AMR,159221,287043,446264,254443,190136,128043,86119,55769,48547,763057,152563,276625,429188,248301,187671,126731,85091,55897,56338,760029,1523086,2398535,2398535
Panama,1990,PA,PAN,AMR,160505,290632,451137,257954,196556,132661,89068,57465,49716,783420,153868,279874,433742,251661,194289,131551,88228,57784,58156,781669,1565089,2449968,2449968
Panama,1991,PA,PAN,AMR,161506,294387,455893,261191,203119,137540,92149,59327,51022,804348,154946,283290,438236,254632,200985,136598,91494,59809,60045,803563,1607911,2502044,2502044
Panama,1992,PA,PAN,AMR,162216,298287,460503,264090,209699,142634,95336,61336,52463,825558,155755,286858,442613,257268,207692,141870,94875,61987,62017,825709,1651267,2554382,2554382
Panama,1993,PA,PAN,AMR,162948,302254,465202,266756,216200,147991,98604,63500,54060,847111,156564,290512,447076,259677,214290,147439,98337,64311,64056,848110,1695221,2607499,2607499
Panama,1994,PA,PAN,AMR,163671,306246,469917,269326,222547,153548,102040,65796,55814,869071,157311,294228,451539,261996,220693,153192,102015,66759,66212,870867,1739938,2661385,2661385
Panama,1995,PA,PAN,AMR,164458,310090,474548,271974,228646,159289,105707,68200,57732,891548,158039,297867,455906,264369,226813,159133,105948,69326,68477,894066,1785614,2716067,2716067
Panama,1996,PA,PAN,AMR,165659,313372,479031,274796,234465,165296,109544,70721,59816,914638,159090,301032,460122,266873,232617,165377,110042,72004,70895,917808,1832446,2771606,2771606
Panama,1997,PA,PAN,AMR,167267,316066,483333,277848,239949,171556,113597,73344,62070,938364,160483,303671,464154,269586,238045,171891,114347,74796,73476,942141,1880505,2827992,2827992
Panama,1998,PA,PAN,AMR,168996,318395,487391,281296,244960,178043,117897,76057,64479,962732,161977,305978,467955,272688,242947,178635,118881,77700,76243,967094,1929826,2885177,2885177
Panama,1999,PA,PAN,AMR,170786,320529,491315,285075,249527,184693,122413,78860,67063,987631,163532,308090,471622,276116,247337,185552,123621,80710,79208,992544,1980175,2943120,2943120
Panama,2000,PA,PAN,AMR,172533,322729,495262,288957,253752,191414,127148,81748,69831,1012850,165066,310247,475313,279655,251330,192529,128560,83832,82390,1018296,2031146,3001731,3001731
Panama,2001,PA,PAN,AMR,174181,325036,499217,292985,257606,198206,132108,84721,72791,1038417,166535,312475,479010,283341,254900,199560,133715,87063,85804,1044383,2082800,3061024,3061024
Panama,2002,PA,PAN,AMR,175724,327462,503186,297143,261121,205033,137280,87788,75949,1064314,167926,314774,482700,287168,258097,206578,139082,90396,89461,1070782,2135096,3120990,3120990
Panama,2003,PA,PAN,AMR,177177,330024,507201,301352,264409,211795,142714,90934,79304,1090508,169255,317160,486415,291066,261056,213462,144735,93805,93366,1097490,2187998,3181608,3181608
Panama,2004,PA,PAN,AMR,178809,332640,511449,305555,267587,218432,148340,94249,82828,1116991,170773,319543,490316,295013,263914,220143,150571,97419,97487,1124547,2241538,3243311,3243311
Panama,2005,PA,PAN,AMR,180596,335287,515883,309597,270820,224840,154135,97793,86518,1143703,172452,321883,494335,298880,266812,226539,156591,101296,101830,1151948,2295651,3305868,3305868
Panama,2006,PA,PAN,AMR,182225,338253,520478,313042,274181,230972,160174,101513,90385,1170267,174001,324485,498486,302269,269821,232621,162904,105345,106375,1179335,2349602,3368573,3368573
Panama,2007,PA,PAN,AMR,183838,341524,525362,315870,277704,236767,166438,105460,94414,1196653,175565,327353,502918,305127,273017,238326,169470,109618,111129,1206687,2403340,3431614,3431614
Panama,2008,PA,PAN,AMR,185612,344820,530432,318298,281541,242082,172888,109654,98602,1223065,177310,330265,507575,307653,276575,243512,176255,114123,116090,1234208,2457273,3495276,3495276
Panama,2009,PA,PAN,AMR,187239,348357,535596,320496,285617,246931,179475,114056,102944,1249519,178915,333427,512342,309981,280427,248193,183200,118830,121252,1261883,2511402,3559343,3559343
Panama,2010,PA,PAN,AMR,188704,351998,540702,322751,289721,251419,186114,118667,107446,1276118,180353,336732,517085,312338,284370,252463,190200,123724,126623,1289718,2565836,3623617,3623617
Panama,2011,PA,PAN,AMR,190598,355382,545980,325119,293907,255519,192809,123477,112108,1302939,182176,339850,522026,314757,288438,256298,197236,128793,132206,1317728,2620667,3688674,3688674
Panama,2012,PA,PAN,AMR,192933,358637,551570,327646,298193,259266,199531,128467,116935,1330038,184375,342896,527271,317246,292646,259760,204261,134046,138013,1345972,2676010,3754862,3754862
Panama,2013,PA,PAN,AMR,195149,361966,557115,330373,302544,262783,206217,133679,121918,1357514,186378,346064,532442,319845,296947,262976,211164,139536,144016,1374484,2731998,3821556,3821556
Panama,2014,PA,PAN,AMR,197116,365331,562447,333281,307016,266224,212814,139061,127127,1385523,188077,349290,537367,322532,301403,266124,217885,145188,150324,1403456,2788979,3888793,3888793
Panama,2015,PA,PAN,AMR,198951,368716,567667,336397,311536,269804,219246,144605,132621,1414209,189588,352537,542125,325348,305971,269393,224371,151029,156985,1433097,2847306,3957099,3957099
Panama,2016,PA,PAN,AMR,200261,372397,572658,339997,315744,273624,225487,150390,138378,1443620,190523,356074,546597,328596,310291,272874,230592,157184,163929,1463466,2907086,4026336,4026336
Panama,2017,PA,PAN,AMR,200812,376527,577339,343974,319568,277695,231456,156402,144475,1473570,190712,360026,550738,332207,314267,276628,236480,163625,171210,1494417,2967987,4096063,4096063
Panama,2018,PA,PAN,AMR,200802,380709,581511,347924,323099,282121,236997,162606,150956,1503703,190439,363981,554420,335829,317986,280788,241873,170298,178850,1525624,3029327,4165255,4165255
Panama,2019,PA,PAN,AMR,200140,384467,584607,351915,326328,286756,242083,168932,157883,1533897,189664,367475,557139,339554,321445,285230,246740,177113,186815,1556897,3090794,4232532,4232532
Panama,2020,PA,PAN,AMR,198903,387823,586726,355513,329141,291197,246682,175130,164481,1562144,188454,370515,558969,342879,324466,289553,251094,183874,194691,1586557,3148701,4294396,4294396
Panama,2021,PA,PAN,AMR,197552,390994,588546,358470,331622,295523,250743,181194,170432,1587984,187274,373271,560545,345566,327077,293818,254907,190557,202272,1614197,3202181,4351267,4351267
Panama,2022,PA,PAN,AMR,196272,393858,590130,361499,334335,300025,254488,187329,176605,1614281,186253,375667,561920,348401,329861,298288,258385,197240,210077,1642252,3256533,4408581,4408581
Panama,2023,PA,PAN,AMR,195195,396052,591247,364781,337308,304662,258116,193663,183796,1642326,185440,377399,562839,351515,332795,302917,261713,203957,218780,1671677,3314003,4468087,4468087
Panama,2024,PA,PAN,AMR,194655,397333,591988,368023,340210,309280,261657,200049,191839,1671058,185115,378297,563412,354577,335535,307559,264963,210579,228302,1701515,3372573,4527961,4527961
Panama,2025,PA,PAN,AMR,194520,397939,592459,371178,342962,313676,265198,206227,200212,1699453,185146,378605,563751,357549,338020,312057,268215,216922,238238,1731001,3430454,4586672,4586672
Panama,2026,PA,PAN,AMR,194440,397925,592365,374549,345849,317459,268829,212180,208961,1727827,185206,378372,563578,360716,340551,316013,271555,222964,248641,1760440,3488267,4644204,4644204
Panama,2027,PA,PAN,AMR,194431,397124,591555,378311,348869,320607,272592,217853,218121,1756353,185315,377455,562770,364238,343146,319364,275051,228642,259519,1789960,3546313,4700639,4700639
Panama,2028,PA,PAN,AMR,194505,395893,590398,382120,351791,323355,276651,223117,227689,1784723,185483,376215,561698,367751,345624,322310,278878,233830,270866,1819259,3603982,4756063,4756063
Panama,2029,PA,PAN,AMR,194532,394552,589084,385546,354855,325845,280942,227979,237591,1812758,185583,374959,560542,370827,348227,324970,282984,238531,282598,1848137,3660895,4810535,4810535
Panama,2030,PA,PAN,AMR,194504,393124,587628,388675,357951,328334,285263,232529,247763,1840515,185617,373712,559329,373552,350877,327575,287163,242846,294641,1876654,3717169,4864126,4864126
Panama,1950,PA,PAN,AMR,73357,111785,185142,81771,61072,44629,31620,21085,15848,256025,71119,108640,179759,79049,57835,41218,28306,18825,14925,240158,496183,861079,861079
Panama,1951,PA,PAN,AMR,75617,115014,190631,83586,62014,45576,32231,21495,16379,261281,73367,111760,185127,80811,58780,42200,29040,19265,15576,245672,506953,882710,882710
Panama,1952,PA,PAN,AMR,77981,118394,196375,85604,63001,46580,32876,21948,16852,266861,75721,115034,190755,82805,59788,43217,29822,19722,16236,251590,518451,905583,905583
Panama,1953,PA,PAN,AMR,80514,121858,202372,87799,64043,47610,33564,22415,17272,272703,78244,118395,196639,84986,60866,44251,30635,20197,16871,257806,530509,929509,929509
Panama,1954,PA,PAN,AMR,83100,125479,208579,90151,65155,48633,34294,22890,17635,278758,80784,121944,202728,87316,62011,45284,31476,20692,17460,264239,542997,954303,954303
Panama,1955,PA,PAN,AMR,85700,129313,215013,92637,66357,49649,35072,23370,17973,285058,83307,125724,209031,89773,63252,46315,32342,21210,18015,270907,555965,980004,980004
Panama,1956,PA,PAN,AMR,88398,133283,221681,95265,67669,50662,35901,23868,18307,291672,85935,129642,215577,92359,64594,47347,33228,21757,18546,277831,569503,1006764,1006764
Panama,1957,PA,PAN,AMR,91169,137450,228619,98032,69103,51683,36771,24404,18667,298660,88641,133744,222385,95069,66054,48392,34131,22345,19086,285077,583737,1034739,1034739
Panama,1958,PA,PAN,AMR,94004,141841,235845,100932,70666,52720,37683,24984,19057,306042,91415,138060,229475,97909,67644,49443,35057,22968,19647,292668,598710,1064034,1064034
Panama,1959,PA,PAN,AMR,96958,146419,243377,103953,72370,53782,38627,25614,19517,313863,94307,142556,236863,100875,69365,50521,36000,23631,20236,300628,614491,1094741,1094741
Panama,1960,PA,PAN,AMR,100081,151186,251267,107101,74227,54870,39601,26288,20026,322113,97378,147239,244617,103971,71224,51623,36970,24340,20867,308995,631108,1126989,1126989
Panama,1961,PA,PAN,AMR,103376,156146,259522,110367,76243,55982,40604,27002,20606,330804,100638,152109,252747,107187,73240,52758,37965,25094,21523,317767,648571,1160832,1160832
Panama,1962,PA,PAN,AMR,106845,161300,268145,113758,78427,57119,41641,27735,21238,339918,104068,157183,261251,110511,75417,53928,38994,25894,22225,326969,666887,1196289,1196289
Panama,1963,PA,PAN,AMR,110444,166717,277161,117232,80773,58292,42705,28490,21922,349414,107616,162524,270140,113913,77750,55145,40050,26738,22958,336554,685968,1233267,1233267
Panama,1964,PA,PAN,AMR,114028,172324,286352,120885,83249,59520,43770,29268,22660,359352,111145,168021,279166,117505,80204,56424,41108,27621,23727,346589,705941,1271461,1271461
Panama,1965,PA,PAN,AMR,117435,178109,295544,124758,85834,60821,44835,30068,23436,369752,114479,173674,288153,121331,82763,57780,42169,28531,24542,357116,726868,1310556,1310556
Panama,1966,PA,PAN,AMR,120631,184146,304777,128772,88521,62204,45895,30884,24257,380533,117564,179586,297150,125283,85424,59225,43234,29450,25389,368005,748538,1350462,1350462
Panama,1967,PA,PAN,AMR,123554,190408,313962,132976,91307,63690,46956,31709,25117,391755,120346,185701,306047,129418,88178,60760,44299,30362,26291,379308,771063,1391072,1391072
Panama,1968,PA,PAN,AMR,126147,196841,322988,137387,94192,65286,48019,32546,26024,403454,122764,191969,314733,133754,91038,62404,45373,31269,27247,391085,794539,1432255,1432255
Panama,1969,PA,PAN,AMR,128468,203372,331840,141975,97180,67015,49091,33395,26965,415621,124886,198315,323201,138275,94009,64156,46458,32163,28241,403302,818923,1473965,1473965
Panama,2031,PA,PAN,AMR,194512,391716,586228,391688,360748,330847,289656,236719,258191,1867849,185674,372587,558261,376081,353265,330139,291454,246751,306971,1904661,3772510,4917001,4917001
Panama,2032,PA,PAN,AMR,194570,390410,584980,394368,363386,333387,294123,240573,268859,1894696,185768,371638,557406,378221,355545,332643,295844,250294,319538,1932085,3826781,4969177,4969177
Panama,2033,PA,PAN,AMR,194657,389357,584014,396368,366076,335964,298581,244181,279707,1920877,185878,370927,556805,379700,357921,335103,300277,253600,332265,1958866,3879743,5020569,5020569
Panama,2034,PA,PAN,AMR,194771,388804,583575,397484,368788,338491,303007,247660,290697,1946127,186013,370646,556659,380388,360343,337420,304728,256789,345095,1984763,3930890,5071120,5071120
Panama,2035,PA,PAN,AMR,194860,388606,583466,397960,371510,340944,307249,251164,301777,1970604,186117,370664,556781,380511,362768,339549,309060,260005,357996,2009889,3980493,5120748,5120748
Panama,2036,PA,PAN,AMR,194820,388509,583329,397840,374529,343594,310928,254775,312963,1994629,186090,370744,556834,380124,365486,341796,312890,263317,370978,2034591,4029220,5169383,5169383
Panama,2037,PA,PAN,AMR,194607,388544,583151,396956,378001,346430,314023,258535,324227,2018172,185894,370919,556813,379071,368625,344160,316148,266799,384002,2058805,4076977,5216940,5216940
Panama,2038,PA,PAN,AMR,194275,388697,582972,395660,381560,349207,316742,262588,335458,2041215,185578,371174,556752,377706,371799,346440,319026,270610,396932,2082513,4123728,5263458,5263458
Panama,2039,PA,PAN,AMR,193824,388829,582653,394267,384771,352145,319228,266876,346597,2063884,185143,371389,556532,376346,374580,348873,321634,274697,409697,2105827,4169711,5308889,5308889
Panama,2040,PA,PAN,AMR,193294,388883,582177,392793,387708,355129,321720,271193,357632,2086175,184631,371509,556140,374987,377024,351357,324196,278854,422299,2128717,4214892,5353222,5353222
Panama,2041,PA,PAN,AMR,192688,388848,581536,391346,390542,357830,324242,275583,368552,2108095,184047,371527,555574,373767,379283,353593,326720,283119,434705,2151187,4259282,5396390,5396390
Panama,2042,PA,PAN,AMR,192051,388692,580743,390001,393061,360380,326792,280041,379345,2129620,183432,371405,554837,372724,381172,355732,329191,287482,446920,2173221,4302841,5438418,5438418
Panama,2043,PA,PAN,AMR,191475,388447,579922,388919,394926,362989,329386,284495,390039,2150754,182874,371190,554064,371925,382422,357975,331619,291885,458970,2194796,4345550,5479534,5479534
Panama,2044,PA,PAN,AMR,190899,388109,579008,388339,395934,365634,331942,288920,400704,2171473,182317,370878,553195,371569,382896,360274,333911,296303,470934,2215887,4387360,5519569,5519569
Panama,2045,PA,PAN,AMR,190274,387672,577946,388115,396321,368297,334425,293178,411449,2191785,181711,370463,552174,371520,382834,362590,336026,300617,482927,2236514,4428299,5558419,5558419
Panama,2046,PA,PAN,AMR,189658,387029,576687,388002,396140,371262,337103,296901,422350,2211758,181114,369847,550961,371538,382278,365199,338255,304441,495020,2256731,4468489,5596146,5596146
Panama,2047,PA,PAN,AMR,189113,386188,575301,388025,395225,374688,339968,300066,433443,2231415,180590,369028,549618,371661,381079,368244,340613,307716,507246,2276559,4507974,5632900,5632900
Panama,2048,PA,PAN,AMR,188491,385291,573782,388173,393922,378210,342779,302884,444742,2250710,179994,368159,548153,371875,379596,371343,342889,310623,519644,2295970,4546680,5668608,5668608
Panama,2049,PA,PAN,AMR,187747,384271,572018,388312,392540,381404,345754,305485,456136,2269631,179285,367168,546453,372060,378134,374052,345315,313276,532087,2314924,4584555,5703036,5703036
Panama,2050,PA,PAN,AMR,186902,383134,570036,388384,391101,384340,348780,308095,467438,2288138,178477,366059,544536,372169,376705,376450,347805,315883,544406,2333418,4621556,5736121,5736121
Peru,1970,PE,PER,AMR,1196199,1827804,3024003,1281116,865485,644071,440176,311863,254955,3797666,1163377,1791468,2954845,1274957,860678,628143,427688,312928,281472,3785866,7583532,13562371,13562371
Peru,1971,PE,PER,AMR,1219042,1878374,3097416,1324408,887977,660800,451119,316483,260593,3901380,1185129,1839577,3024706,1317333,884435,644364,437804,317159,287372,3888467,7789847,13911968,13911968
Peru,1972,PE,PER,AMR,1245390,1929055,3174445,1368564,912369,678238,462820,321599,271606,4015196,1209977,1887693,3097670,1362926,910607,660983,448415,321995,300194,4005120,8020316,14292437,14292437
Peru,1973,PE,PER,AMR,1271175,1978890,3250065,1410853,938654,695476,474829,326052,283017,4128881,1234386,1936882,3171268,1407846,940252,678372,459621,325852,312631,4124574,8253455,14674785,14674785
Peru,1974,PE,PER,AMR,1296012,2028416,3324428,1451309,967278,711681,487157,330529,293073,4241027,1258067,1988027,3246094,1452351,973758,696069,471617,329378,322457,4245630,8486657,15057175,15057175
Peru,1975,PE,PER,AMR,1319254,2077863,3397117,1492074,998204,726631,499669,335687,302811,4355076,1280249,2038838,3319087,1497879,1009684,712987,483985,333594,332094,4370223,8725299,15441497,15441497
Peru,1976,PE,PER,AMR,1340198,2127650,3467848,1533658,1030614,740689,512368,341494,311995,4470818,1300383,2089666,3390049,1544810,1047278,729501,496705,338511,341289,4498094,8968912,15826813,15826813
Peru,1977,PE,PER,AMR,1359402,2179689,3539091,1577502,1065807,754865,526024,348033,320759,4592990,1318896,2141810,3460706,1592691,1087488,746538,510614,344321,350175,4631827,9224817,16224613,16224613
Peru,1978,PE,PER,AMR,1377909,2233543,3611452,1623876,1104138,769934,540877,355328,329032,4723185,1336715,2194950,3531665,1641041,1130560,764769,525968,351148,358688,4772174,9495359,16638480,16638480
Peru,1979,PE,PER,AMR,1396012,2286906,3682918,1671448,1144054,786044,556208,363259,336547,4857560,1354283,2247460,3601743,1689892,1175276,784326,542025,358853,366594,4916966,9774526,17059185,17059185
Peru,1980,PE,PER,AMR,1414378,2342021,3756399,1722045,1186663,805032,572804,371767,339413,4997724,1372018,2300703,3672721,1738802,1222138,806932,559747,367810,370137,5065566,10063290,17492406,17492406
Peru,1981,PE,PER,AMR,1432723,2398091,3830814,1774518,1230602,826665,590730,380760,338273,5141548,1389685,2354239,3743924,1786809,1269605,832410,579255,377918,370068,5216065,10357613,17932344,17932344
Peru,1982,PE,PER,AMR,1450900,2451827,3902727,1827392,1273837,850137,609301,390197,337366,5288230,1407328,2405648,3812976,1835126,1315963,860155,599807,388752,370639,5370442,10658672,18374372,18374372
Peru,1983,PE,PER,AMR,1469826,2503442,3973268,1881566,1317713,876261,628167,400140,336778,5440625,1425656,2454872,3880528,1885340,1362489,891145,621129,400414,371964,5532481,10973106,18826906,18826906
Peru,1984,PE,PER,AMR,1489345,2553121,4042466,1935982,1361539,905059,646140,410587,337003,5596310,1444619,2502203,3946822,1936509,1408788,925240,642116,412866,374532,5700051,11296361,19285646,19285646
Peru,1985,PE,PER,AMR,1509269,2600541,4109810,1990531,1404967,936298,662862,421693,338528,5754879,1463914,2547368,4011282,1987758,1454068,961750,662249,426128,378682,5870635,11625514,19746610,19746610
Peru,1986,PE,PER,AMR,1529602,2644909,4174511,2045675,1448267,969289,678632,433670,341693,5917226,1483200,2589670,4072870,2039210,1498086,999878,681691,440323,384638,6043826,11961052,20208437,20208437
Peru,1987,PE,PER,AMR,1549289,2686789,4236078,2101440,1491168,1003864,693680,446625,346731,6083508,1501598,2629718,4131316,2091222,1540749,1039602,700672,455550,392673,6220468,12303976,20671360,20671360
Peru,1988,PE,PER,AMR,1567696,2728238,4295934,2158117,1534831,1040452,708795,460621,353631,6256447,1518779,2669156,4187935,2144396,1583220,1081343,719871,471836,402812,6403478,12659925,21143799,21143799
Peru,1989,PE,PER,AMR,1584146,2769893,4354039,2214890,1579404,1078641,724663,475484,362122,6435204,1534053,2708627,4242680,2198008,1625805,1124724,739934,489029,414880,6592380,13027584,21624311,21624311
Peru,1990,PE,PER,AMR,1597686,2812130,4409816,2271011,1624845,1117629,742173,490979,372028,6618665,1546450,2748463,4294913,2251000,1668507,1168801,761771,506877,428754,6785710,13404375,22109099,22109099
Peru,1991,PE,PER,AMR,1607421,2854675,4462096,2324260,1669178,1155846,761155,507109,383121,6800669,1555215,2788039,4343254,2300875,1709298,1211818,785334,525421,444242,6976988,13777657,22583006,22583006
Peru,1992,PE,PER,AMR,1613011,2896886,4509897,2374800,1713399,1193133,781772,524069,395195,6982368,1560267,2826842,4387109,2347815,1749579,1253399,810939,544897,461243,7167872,14150240,23047248,23047248
Peru,1993,PE,PER,AMR,1614605,2938868,4553473,2424721,1759564,1230764,804714,541470,408304,7169537,1561789,2865099,4426888,2393780,1791751,1294446,839337,564898,479776,7363988,14533525,23513882,23513882
Peru,1994,PE,PER,AMR,1613254,2976421,4589675,2472953,1807516,1269056,830374,558982,427977,7366858,1560380,2899885,4460265,2438749,1835173,1334393,870019,584346,503778,7566458,14933316,23983258,23983258
Peru,1995,PE,PER,AMR,1609579,3008408,4617987,2518342,1857172,1308016,858686,576102,453046,7571364,1556601,2930214,4486815,2482044,1879900,1373367,902610,602857,532107,7772885,15344249,24449055,24449055
Peru,1996,PE,PER,AMR,1603278,3038479,4641757,2560891,1909078,1347932,889092,592228,477072,7776293,1550471,2958282,4508753,2522877,1927107,1412658,937250,620773,559839,7980504,15756797,24907304,24907304
Peru,1997,PE,PER,AMR,1595534,3065794,4661328,2601989,1964095,1389026,921759,607600,500547,7985016,1543001,2983454,4526455,2562557,1977695,1452590,974175,638365,587200,8192582,16177598,25365386,25365386
Peru,1998,PE,PER,AMR,1587088,3088034,4675122,2642300,2020350,1430807,956461,622711,524202,8196831,1534715,3004091,4538806,2601582,2029880,1492433,1012979,655986,614599,8407459,16604290,25818226,25818226
Peru,1999,PE,PER,AMR,1578096,3102928,4681024,2679590,2074772,1472510,992473,638332,549909,8407586,1525888,3018271,4544159,2638261,2080372,1530911,1052553,674050,643327,8619474,17027060,26252239,26252239
Peru,2000,PE,PER,AMR,1569483,3107943,4677426,2711449,2124182,1513173,1028653,655528,579951,8612936,1517648,3023998,4541646,2670671,2125683,1566572,1091286,693214,675004,8822430,17435366,26654439,26654439
Peru,2001,PE,PER,AMR,1559285,3102319,4661604,2737143,2166982,1552318,1064231,674731,615582,8810987,1507982,3020911,4528893,2697952,2164329,1598738,1128085,713716,710606,9013426,17824413,27014909,27014909
Peru,2002,PE,PER,AMR,1547307,3087591,4634898,2756525,2202657,1590460,1098812,696018,656388,9000860,1496447,3010231,4506678,2719980,2195890,1628199,1162351,735760,749888,9192068,18192928,27334503,27334503
Peru,2003,PE,PER,AMR,1536578,3065683,4602261,2770622,2231738,1627661,1132573,719450,700299,9182343,1486111,2993222,4479333,2737676,2220983,1655631,1194186,759693,791232,9359401,18541744,27623341,27623341
Peru,2004,PE,PER,AMR,1529791,3039319,4569110,2780099,2255314,1664105,1165762,745196,745489,9355965,1479707,2971862,4451569,2751583,2241157,1681604,1224171,785648,833100,9517263,18873228,27893911,27893911
Peru,2005,PE,PER,AMR,1528351,3009732,4538083,2784161,2272784,1699764,1198310,773101,791387,9519507,1478419,2947534,4425953,2760979,2256050,1706101,1252381,813299,874913,9663723,19183230,28147267,28147267
Peru,2006,PE,PER,AMR,1533448,2975132,4508580,2783269,2283483,1734962,1230495,802488,837488,9672185,1483163,2918625,4401788,2766137,2265321,1729693,1279029,842066,916281,9798527,19470712,28381078,28381078
Peru,2007,PE,PER,AMR,1543114,2938338,4481452,2777654,2289332,1770017,1262280,833075,882887,9815245,1492094,2887023,4379117,2767351,2271230,1753257,1304219,871893,956617,9924567,19739812,28600387,28600387
Peru,2008,PE,PER,AMR,1551874,2899848,4451722,2753706,2291049,1805661,1294404,866041,925441,9936302,1500653,2853234,4353887,2759988,2281841,1782751,1332730,906907,1000054,10064271,20000573,28806185,28806185
Peru,2009,PE,PER,AMR,1556766,2866146,4422912,2713615,2290475,1841813,1327140,900880,964247,10038170,1505782,2823068,4328850,2744539,2298757,1818790,1364870,946660,1045778,10219394,20257564,29009326,29009326
Peru,2010,PE,PER,AMR,1555987,2848576,4404563,2675257,2292659,1877252,1360238,935324,1000183,10140913,1504922,2806357,4311279,2727318,2318508,1855872,1396227,985981,1088911,10372817,20513730,29229572,29229572
Peru,2011,PE,PER,AMR,1550119,2846838,4396957,2641991,2299871,1911943,1394336,968997,1033652,10250790,1498873,2802685,4301558,2710383,2342358,1893978,1427264,1024285,1130152,10528420,20779210,29477721,29477721
Peru,2012,PE,PER,AMR,1540224,2856489,4396713,2614847,2311379,1945047,1430137,1001851,1065464,10368725,1488871,2808275,4297146,2694545,2369549,1932080,1458938,1061265,1170627,10687004,21055729,29749589,29749589
Peru,2013,PE,PER,AMR,1527311,2872734,4400045,2594182,2326455,1976115,1467579,1034330,1096167,10494828,1475769,2819315,4295084,2680100,2399385,1969478,1491760,1097130,1211003,10848856,21343684,30038809,30038809
Peru,2014,PE,PER,AMR,1512093,2895699,4407792,2584396,2345760,2005924,1506981,1066479,1124363,10633903,1460314,2835826,4296140,2670195,2431901,2007020,1526207,1132070,1248716,11016109,21650012,30353951,30353951
Peru,2015,PE,PER,AMR,1495328,2926623,4421951,2591656,2371623,2035526,1549267,1097933,1147711,10793716,1443383,2858428,4301811,2669543,2468295,2045722,1563273,1165945,1281610,11194388,21988104,30711863,30711863
Peru,2016,PE,PER,AMR,1479124,2968053,4447177,2618031,2407372,2065538,1595437,1128698,1165832,10980908,1426896,2889442,4316338,2679205,2510597,2086071,1604207,1198701,1309565,11388346,22369254,31132779,31132779
Peru,2017,PE,PER,AMR,1467254,3005026,4472280,2652602,2449532,2097476,1645578,1160474,1188126,11193788,1414711,2918149,4332860,2696007,2558265,2129115,1649978,1231655,1341544,11606564,22800352,31605486,31605486
Peru,2018,PE,PER,AMR,1465151,3028344,4493495,2703444,2508744,2140703,1701285,1195610,1218659,11468445,1412360,2937287,4349647,2733771,2624058,2182981,1702553,1266470,1382521,11892354,23360799,32203944,32203944
Peru,2019,PE,PER,AMR,1470358,3041150,4511508,2759397,2568683,2187760,1757615,1231917,1251300,11756672,1417167,2946900,4364067,2776609,2689269,2240542,1757409,1301027,1427762,12192618,23949290,32824861,32824861
Peru,2020,PE,PER,AMR,1477592,3039795,4517387,2801039,2607074,2227936,1806604,1262697,1276695,11982045,1423825,2942791,4366616,2803746,2730523,2291897,1808804,1331943,1471788,12438701,24420746,33304756,33304756
Peru,2021,PE,PER,AMR,1485776,3029666,4515442,2841571,2636932,2267238,1849266,1288961,1295703,12179671,1431394,2930473,4361867,2829554,2761107,2342493,1857153,1358547,1509643,12658497,24838168,33715471,33715471
Peru,2022,PE,PER,AMR,1491097,3014455,4505552,2872835,2653163,2302717,1886843,1317486,1318487,12351531,1436022,2913630,4349652,2846149,2775793,2389226,1901505,1384514,1545657,12842844,25194375,34049588,34049588
Peru,2023,PE,PER,AMR,1491918,2998226,4490144,2893883,2657667,2335504,1922623,1352856,1352438,12514971,1436392,2896161,4332553,2853358,2775853,2433003,1944440,1415960,1592435,13015049,25530020,34352719,34352719
Peru,2024,PE,PER,AMR,1488409,2984388,4472797,2915111,2661852,2368925,1957982,1394197,1396107,12694174,1432939,2881367,4314306,2862520,2772560,2476914,1987584,1452724,1649869,13202171,25896345,34683444,34683444
Peru,2025,PE,PER,AMR,1481313,2972686,4453999,2936429,2667228,2401518,1990841,1437726,1441960,12875702,1426131,2868924,4295055,2873375,2767739,2519340,2029442,1491849,1709320,13391065,26266767,35015825,35015825
Peru,2026,PE,PER,AMR,1473247,2962211,4435458,2958800,2671625,2433535,2021164,1483752,1489964,13058840,1418440,2857836,4276276,2886993,2759795,2560086,2069814,1534004,1770517,13581209,26640049,35351784,35351784
Peru,2027,PE,PER,AMR,1464981,2954082,4419063,2979972,2675935,2463519,2049863,1531833,1540025,13241147,1410660,2848998,4259658,2901355,2749692,2597770,2109386,1579127,1833097,13770427,27011574,35690300,35690300
Peru,2028,PE,PER,AMR,1457121,2949108,4406229,2994768,2683791,2490003,2078934,1580535,1592169,13420200,1403181,2843438,4246619,2911182,2741428,2630953,2149562,1626258,1896805,13956188,27376388,36029236,36029236
Peru,2029,PE,PER,AMR,1450334,2945926,4396260,3001204,2697277,2512902,2109281,1628773,1646526,13595963,1396576,2839971,4236547,2913885,2738229,2658835,2191093,1674620,1961709,14138371,27734334,36367136,36367136
Peru,2030,PE,PER,AMR,1444402,2943838,4388240,2998223,2717891,2532056,2141570,1675632,1703173,13768545,1390827,2837625,4228452,2908036,2742496,2680758,2234560,1723346,2027970,14317166,28085711,36702393,36702393
Peru,1950,PE,PER,AMR,680836,951012,1631848,721928,513092,395658,286096,188818,120207,2225799,663425,929336,1592761,704765,502457,388736,289331,200141,143131,2228561,4454360,7678967,7678967
Peru,1951,PE,PER,AMR,706086,975845,1681931,742290,527495,403319,292537,195336,124915,2285892,688683,954340,1643023,725267,516604,395894,294908,206367,147594,2286634,4572526,7897482,7897482
Peru,1952,PE,PER,AMR,730158,1003717,1733875,763031,542700,410066,299258,201713,130042,2346810,712502,982505,1695007,746162,531626,402256,300703,212502,152512,2345761,4692571,8121459,8121459
Peru,1953,PE,PER,AMR,753508,1034759,1788267,783327,558237,416188,306252,207855,135491,2407350,735188,1014069,1749257,766591,547032,408068,306737,218408,157757,2404593,4811943,8349466,8349466
Peru,1954,PE,PER,AMR,776614,1069286,1845900,802455,574180,422717,313586,213673,141093,2467704,757483,1049093,1806576,785865,562861,414278,313151,223954,163114,2463223,4930927,8583399,8583399
Peru,1955,PE,PER,AMR,800053,1107156,1907209,820512,590751,430259,321241,219189,146775,2528727,780177,1087221,1867398,804118,579350,421466,319953,229125,168545,2522557,5051284,8825897,8825897
Peru,1956,PE,PER,AMR,824463,1147531,1971994,837844,607863,438696,329276,224401,152566,2590646,803824,1127710,1931534,821719,596396,429528,327196,233955,174078,2582872,5173518,9077048,9077048
Peru,1957,PE,PER,AMR,849670,1190207,2039877,854808,625437,448029,337825,229259,158453,2653811,828262,1170388,1998650,839010,613939,438481,335013,238417,179717,2644577,5298388,9336910,9336910
Peru,1958,PE,PER,AMR,875465,1234894,2110359,871605,642824,458019,346417,233907,164456,2717228,853274,1214986,2068260,856115,631311,448122,342974,242631,185513,2706666,5423894,9602507,9602507
Peru,1959,PE,PER,AMR,901899,1281380,2183279,890035,660692,469055,354557,238766,170625,2783730,878922,1261311,2140233,874839,649220,458821,350540,246997,191551,2771968,5555698,9879206,9879206
Peru,1960,PE,PER,AMR,929006,1329062,2258068,912020,679663,481501,362267,244083,176933,2856467,905298,1308731,2214029,897157,668295,470929,357701,251750,197811,2843643,5700110,10172207,10172207
Peru,1961,PE,PER,AMR,956665,1377324,2333989,937302,699443,495122,369474,249791,183391,2934523,932318,1356558,2288876,922803,688200,484221,364392,256811,204285,2920712,5855235,10478096,10478096
Peru,1962,PE,PER,AMR,984392,1424550,2408942,965352,719346,509447,375548,255881,191945,3017519,959487,1402688,2362175,951949,708108,497995,369847,262129,213425,3003453,6020972,10792094,10792094
Peru,1963,PE,PER,AMR,1011909,1470980,2482889,996212,738637,524340,380832,262412,202324,3104757,986455,1447187,2433642,984840,727371,512101,374356,267816,224904,3091388,6196145,11112665,11112665
Peru,1964,PE,PER,AMR,1039480,1518304,2557784,1030482,757121,540043,386616,269335,212070,3195667,1013392,1492388,2505780,1021151,746020,527055,379297,273915,235631,3183069,6378736,11442301,11442301
Peru,1965,PE,PER,AMR,1066920,1567154,2634074,1067944,774778,556486,393436,276466,220941,3290051,1040065,1539340,2579405,1060154,764149,542877,385255,280307,245313,3278055,6568106,11781581,11781581
Peru,1966,PE,PER,AMR,1093863,1617589,2711452,1107619,791808,573485,401087,283858,229150,3387007,1066045,1587986,2654031,1101099,781909,559276,392000,287012,254201,3375497,6762504,12127990,12127990
Peru,1967,PE,PER,AMR,1120609,1669098,2789707,1149218,808510,590921,409558,291612,236942,3486761,1091608,1637781,2729389,1143760,799600,576101,399523,294136,262647,3475767,6962528,12481626,12481626
Peru,1968,PE,PER,AMR,1147172,1721507,2868679,1192528,825682,608728,418959,299401,244473,3589771,1116828,1688563,2805391,1187833,818033,593356,407981,301377,270822,3579402,7169173,12843249,12843249
Peru,1969,PE,PER,AMR,1173514,1775394,2948908,1237324,844610,626877,429480,306599,251067,3695957,1141767,1741024,2882791,1232788,838497,611175,417669,308115,277846,3686090,7382047,13213739,13213739
Peru,2031,PE,PER,AMR,1438012,2942087,4380099,2988032,2744507,2547644,2176073,1720392,1762264,13938912,1384654,2835639,4220293,2895794,2753328,2696854,2279940,1771787,2095845,14493548,28432460,37032851,37032851
Peru,2032,PE,PER,AMR,1430921,2938756,4369677,2974792,2774370,2560833,2211949,1762290,1824273,14108507,1377769,2832130,4209899,2881167,2768292,2708026,2326473,1818953,2166053,14668964,28777471,37357050,37357050
Peru,2033,PE,PER,AMR,1423666,2933029,4356695,2962043,2804509,2572384,2248664,1801095,1889241,14277936,1370701,2826329,4197030,2867320,2784984,2714700,2373590,1864252,2238981,14843827,29121763,37675482,37675482
Peru,2034,PE,PER,AMR,1416023,2924059,4340082,2951243,2834255,2583326,2285038,1837153,1957082,14448097,1363237,2817515,4180752,2855536,2802890,2717733,2419990,1908019,2314686,15018854,29466951,37987772,37987772
Peru,2035,PE,PER,AMR,1408051,2912195,4320246,2942019,2862706,2594551,2320213,1870769,2027821,14618079,1355388,2806034,4161422,2845491,2821012,2718378,2464572,1950456,2393328,15193237,29811316,38292986,38292986
Peru,2036,PE,PER,AMR,1400943,2898700,4299643,2933531,2890649,2603691,2354318,1901880,2101740,14785809,1348351,2793042,4141393,2836261,2840229,2714820,2507032,1991335,2475329,15365006,30150815,38591846,38591846
Peru,2037,PE,PER,AMR,1395082,2884096,4279178,2926967,2916043,2611695,2385974,1931364,2178442,14950485,1342535,2779040,4121575,2828836,2858734,2708057,2546027,2031314,2560342,15533310,30483795,38884546,38884546
Peru,2038,PE,PER,AMR,1389027,2869608,4258635,2923265,2934188,2622456,2413901,1961159,2256709,15111678,1336532,2765028,4101560,2824390,2871701,2702386,2580282,2071805,2647303,15697867,30809545,39169734,39169734
Peru,2039,PE,PER,AMR,1382847,2855728,4238575,2921183,2943496,2638311,2438148,1992154,2335728,15269020,1330411,2751419,4081830,2821873,2876952,2701285,2609135,2113568,2735631,15858444,31127464,39447878,39447878
Peru,2040,PE,PER,AMR,1377304,2842310,4219614,2920123,2943085,2660839,2458611,2024984,2414869,15422511,1324954,2738231,4063185,2820420,2873251,2707248,2631980,2157173,2824778,16014850,31437361,39720162,39720162
Peru,2041,PE,PER,AMR,1371256,2829265,4200521,2919372,2935251,2689009,2475492,2059902,2493723,15572749,1319033,2725388,4044421,2819302,2862860,2719446,2648966,2202606,2914423,16167603,31740352,39985297,39985297
Peru,2042,PE,PER,AMR,1364172,2816730,4180902,2917014,2924209,2720186,2489966,2096113,2572095,15719583,1312103,2713020,4025123,2816643,2849878,2735533,2661015,2249115,3004420,16316604,32036187,40242211,40242211
Peru,2043,PE,PER,AMR,1357469,2803820,4161289,2912205,2913511,2751522,2502805,2133116,2649916,15863075,1305530,2700265,4005795,2811618,2837525,2753213,2668583,2296165,3094691,16461795,32324870,40491961,40491961
Peru,2044,PE,PER,AMR,1350962,2790379,4141341,2904087,2904638,2782418,2515032,2169790,2727519,16003484,1299172,2686975,3986147,2803490,2827130,2772032,2672547,2342519,3185731,16603449,32606933,40734414,40734414
Peru,2045,PE,PER,AMR,1343823,2777210,4121033,2893002,2897238,2812002,2527538,2205332,2805308,16140420,1292227,2673934,3966161,2792609,2818378,2791024,2674148,2387107,3278017,16741283,32881703,40968891,40968891
Peru,2046,PE,PER,AMR,1337373,2764373,4101746,2880208,2890463,2841048,2538000,2239872,2883468,16273059,1285957,2661216,3947173,2780128,2810353,2811068,2671581,2429634,3371698,16874462,33147521,41196444,41196444
Peru,2047,PE,PER,AMR,1331658,2751719,4083377,2866248,2885501,2867534,2547329,2272077,2962397,16401086,1280419,2648681,3929100,2766571,2804045,2830357,2665841,2468792,3467127,17002733,33403819,41416289,41416289
Peru,2048,PE,PER,AMR,1325220,2739238,4064458,2852330,2883244,2886824,2559341,2300750,3042780,16525269,1274206,2636308,3910514,2752940,2800592,2844105,2661168,2503346,3564695,17126846,33652115,41627090,41627090
Peru,2049,PE,PER,AMR,1318252,2726817,4045069,2838967,2882453,2897314,2576326,2325945,3124775,16645780,1267471,2624012,3891483,2739653,2798914,2850113,2660983,2532653,3664564,17246880,33892660,41829207,41829207
Peru,2050,PE,PER,AMR,1311078,2714372,4025450,2826009,2882475,2898097,2599805,2347544,3208341,16762271,1260541,2611775,3872316,2726730,2798101,2847098,2667724,2556107,3766759,17362519,34124790,42022554,42022554
Philippines,1970,PH,PHL,WPR,3449488,5513468,8962956,3547161,2260805,1641869,1106197,706129,501270,9763431,3241889,5328422,8570311,3713392,2379490,1687899,1143508,700469,514133,10138891,19902322,37435586,37435586
Philippines,1971,PH,PHL,WPR,3493158,5646510,9139668,3697004,2335536,1698170,1142278,736031,518576,10127595,3284932,5443641,8728573,3833849,2437930,1729861,1168467,726237,529556,10425900,20553495,38421746,38421746
Philippines,1972,PH,PHL,WPR,3536344,5767255,9303599,3854728,2418675,1759540,1181440,767633,538792,10520808,3327063,5549691,8876754,3954364,2495856,1773673,1191296,750683,545441,10711313,21232121,39412479,39412479
Philippines,1973,PH,PHL,WPR,3575454,5882334,9457788,4011856,2503962,1823399,1222585,797937,562846,10922585,3363911,5647519,9011430,4086584,2554478,1820871,1215860,773079,563570,11014442,21937027,40406234,40406234
Philippines,1974,PH,PHL,WPR,3604086,5984905,9588991,4174390,2592550,1889676,1266238,826662,590290,11339806,3391018,5730370,9121388,4236099,2613907,1869937,1242116,792693,583392,11338144,22677950,41388324,41388324
Philippines,1975,PH,PHL,WPR,3637752,6060647,9698399,4333133,2695387,1950792,1308420,854134,618169,11760035,3422512,5799482,9221994,4397073,2691276,1921024,1278136,818971,607525,11714005,23474040,42394433,42394433
Philippines,1976,PH,PHL,WPR,3709149,6112188,9821337,4457536,2824148,2003029,1345581,880243,645735,12156272,3487613,5861790,9349403,4547098,2800985,1973465,1327426,858624,639759,12147357,24303629,43474370,43474370
Philippines,1977,PH,PHL,WPR,3811905,6178875,9990780,4554023,2968624,2056573,1381709,904190,676620,12541739,3582432,5928945,9511377,4682668,2931901,2026995,1378958,901902,680199,12602623,25144362,44646518,44646518
Philippines,1978,PH,PHL,WPR,3922912,6277691,10200603,4636788,3118167,2117358,1419367,925404,712158,12929242,3686336,6009329,9695665,4809274,3074344,2082862,1428055,942759,727933,13065227,25994469,45890739,45890739
Philippines,1979,PH,PHL,WPR,4026218,6398338,10424556,4699933,3271307,2185447,1457740,944119,751769,13310315,3785734,6102909,9888643,4921687,3226795,2141454,1476213,982006,782561,13530716,26841031,47154232,47154232
Philippines,1980,PH,PHL,WPR,4109373,6547234,10656607,4779400,3413108,2255074,1500411,960886,787289,13696168,3869202,6227092,10096294,5017227,3381634,2201628,1523087,1014060,832837,13970473,27666641,48419546,48419546
Philippines,1981,PH,PHL,WPR,4175691,6716059,10891750,4898072,3537105,2320636,1549256,978067,812324,14095460,3936519,6386046,10322565,5099255,3530837,2262101,1569991,1037822,869549,14369555,28465015,49679330,49679330
Philippines,1982,PH,PHL,WPR,4237499,6882921,11120420,5033710,3654661,2386473,1601779,998468,831799,14506890,3996877,6555013,10551890,5178444,3675801,2325256,1619304,1061027,899494,14759326,29266216,50938522,50938522
Philippines,1983,PH,PHL,WPR,4300915,7044802,11345717,5176498,3770308,2457799,1656694,1022541,849343,14933183,4055985,6721048,10777033,5265789,3817377,2394470,1671557,1086846,927703,15163742,30096925,52219685,52219685
Philippines,1984,PH,PHL,WPR,4364386,7200653,11565039,5323886,3885420,2536037,1713378,1049436,865023,15373180,4112559,6880500,10993059,5363869,3953703,2471415,1725962,1114641,954092,15583682,30956862,53514959,53514959
Philippines,1985,PH,PHL,WPR,4425883,7348437,11774320,5472689,4000563,2622974,1770772,1078613,879015,15824626,4166567,7029146,11195713,5473573,4082295,2557955,1781363,1143962,978853,16018001,31842627,54812660,54812660
Philippines,1986,PH,PHL,WPR,4482881,7490008,11972889,5622493,4114320,2719209,1827626,1110027,892177,16285852,4218162,7166284,11384446,5597542,4199899,2654608,1836782,1174799,1003020,16466650,32752502,56109838,56109838
Philippines,1987,PH,PHL,WPR,4542123,7625455,12167578,5769314,4229163,2822957,1883490,1143850,905625,16754399,4273379,7292225,11565604,5732234,4308951,2759500,1891781,1207336,1027785,16927587,33681986,57415175,57415175
Philippines,1988,PH,PHL,WPR,4609996,7762139,12372135,5912581,4348483,2932056,1938416,1180780,919080,17231396,4337718,7413629,11751347,5873230,4416241,2870350,1946107,1242715,1052404,17401047,34632443,58755923,58755923
Philippines,1989,PH,PHL,WPR,4679729,7905938,12585667,6052804,4471602,3045212,1992148,1221446,931966,17715178,4405586,7537289,11942875,6016864,4523993,2985674,1999399,1282126,1075572,17883628,35598806,60127343,60127343
Philippines,1990,PH,PHL,WPR,4755547,8056962,12812509,6193842,4600128,3166293,2044793,1264488,947455,18216999,4479139,7673191,12152330,6153384,4639110,3108597,2049749,1325192,1101028,18377060,36594059,61558898,61558898
Philippines,1991,PH,PHL,WPR,4840397,8200004,13040401,6337247,4736469,3297432,2097495,1307148,968880,18744671,4557591,7818481,12376072,6279250,4761015,3240026,2096164,1369303,1132850,18878608,37623279,63039751,63039751
Philippines,1992,PH,PHL,WPR,4924880,8339059,13263939,6476714,4876381,3435114,2156172,1349861,995402,19289644,4632483,7963614,12596097,6404127,4882242,3377678,2146133,1413728,1169934,19393842,38683486,64543525,64543525
Philippines,1993,PH,PHL,WPR,5006125,8482052,13488177,6615725,5018875,3575565,2224717,1394115,1024332,19853329,4702655,8103310,12805965,6538249,5004771,3518909,2205384,1459028,1209509,19935850,39789179,66083321,66083321
Philippines,1994,PH,PHL,WPR,5083708,8622890,13706598,6761001,5163004,3718833,2302330,1439483,1053194,20437845,4768637,8233192,13001829,6685338,5128975,3662465,2273757,1504414,1249074,20504023,40941868,67650283,67650283
Philippines,1995,PH,PHL,WPR,5155885,8769177,13925062,6908171,5305629,3864224,2391025,1486310,1083317,21038676,4830429,8365078,13195507,6836256,5252340,3806520,2353860,1551093,1291154,21091223,42129899,69250468,69250468
Philippines,1996,PH,PHL,WPR,5227550,8935692,14163242,7060964,5445550,4006154,2495086,1537160,1120263,21665177,4891563,8515977,13407540,6984244,5377266,3948702,2451032,1603438,1344331,21709013,43374190,70944969,70944969
Philippines,1997,PH,PHL,WPR,5296973,9119227,14416200,7221088,5579397,4144870,2613541,1591036,1165356,22315288,4948837,8683587,13632424,7131494,5501022,4089321,2564109,1659688,1409301,22354935,44670223,72718837,72718837
Philippines,1998,PH,PHL,WPR,5354883,9304979,14659862,7380832,5707185,4284240,2740387,1645369,1215107,22973120,4996315,8856470,13852785,7278568,5617571,4227654,2686646,1715462,1480255,23006156,45979276,74491918,74491918
Philippines,1999,PH,PHL,WPR,5400031,9486200,14886231,7540841,5830637,4424721,2873558,1700624,1267877,23638258,5036005,9027342,14063347,7427735,5727078,4362727,2817109,1770974,1555604,23661227,47299485,76249064,76249064
Philippines,2000,PH,PHL,WPR,5443882,9669561,15113443,7697012,5954024,4556945,3005308,1751539,1316097,24280925,5079222,9192639,14271861,7567098,5837783,4488904,2949910,1822684,1625615,24291994,48572919,77958223,77958223
Philippines,2001,PH,PHL,WPR,5503427,9856553,15359980,7841652,6088532,4676044,3130005,1796265,1356759,24889257,5138346,9352624,14490970,7682449,5962338,4603777,3080642,1870121,1686550,24885877,49775134,79626086,79626086
Philippines,2002,PH,PHL,WPR,5563666,10033552,15597218,7985882,6232052,4792538,3252351,1843731,1397388,25503942,5197002,9505614,14702616,7791344,6095196,4714121,3211873,1920856,1748402,25481792,50985734,81285572,81285572
Philippines,2003,PH,PHL,WPR,5615081,10204395,15819476,8127624,6377504,4915961,3372997,1898448,1438301,26130835,5248483,9655896,14904379,7899302,6226698,4827347,3343327,1979012,1812459,26088145,52218980,82942837,82942837
Philippines,2004,PH,PHL,WPR,5660637,10368978,16029615,8268208,6524065,5048545,3495223,1960746,1476029,26772816,5294562,9803574,15098136,8008554,6356191,4945747,3476576,2044636,1875227,26706931,53479747,84607501,84607501
Philippines,2005,PH,PHL,WPR,5683307,10532663,16215970,8420642,6666862,5187503,3617382,2031042,1510729,27434160,5317730,9955211,15272941,8129214,6479073,5066991,3608644,2117612,1936649,27338183,54772343,86261250,86261250
Philippines,2006,PH,PHL,WPR,5705211,10675550,16380761,8592944,6799450,5333342,3733982,2106533,1544537,28110788,5338592,10091220,15429812,8269304,6590702,5192449,3733436,2195436,1999144,27980471,56091259,87901835,87901835
Philippines,2007,PH,PHL,WPR,5763010,10756122,16519132,8781854,6926698,5481801,3850452,2191342,1581726,28813873,5386932,10166247,15553179,8435957,6703174,5323329,3857659,2286247,2068830,28675196,57489069,89561377,89561377
Philippines,2008,PH,PHL,WPR,5846447,10790961,16637408,8951993,7063030,5617565,3977210,2297594,1624061,29531453,5451237,10184054,15635291,8609816,6833262,5452307,3996363,2407404,2149020,29448172,58979625,91252326,91252326
Philippines,2009,PH,PHL,WPR,5921682,10825297,16746979,9097866,7199589,5742290,4114746,2421830,1669640,30245961,5511047,10188828,15699875,8772368,6967316,5578280,4146869,2551799,2237506,30254138,60500099,92946951,92946951
Philippines,2010,PH,PHL,WPR,5968508,10894122,16862630,9255163,7336730,5866197,4246449,2546713,1718392,30969644,5552074,10230135,15782209,8929569,7094695,5697089,4281849,2693556,2325457,31022215,61991859,94636700,94636700
Philippines,2011,PH,PHL,WPR,5991605,11000166,16991771,9432404,7486003,5995239,4367285,2664698,1769262,31714891,5571803,10315070,15886873,9091875,7222524,5808528,4393832,2823169,2404460,31744388,63459279,96337913,96337913
Philippines,2012,PH,PHL,WPR,6004355,11115375,17119730,9607385,7643474,6128871,4487121,2778308,1822894,32468053,5581549,10410992,15992541,9253747,7351544,5917965,4499031,2947453,2482257,32451997,64920050,98032317,98032317
Philippines,2013,PH,PHL,WPR,6012060,11221942,17234002,9761758,7809698,6264479,4612725,2889499,1883009,33221168,5587748,10500330,16088078,9399805,7485449,6025205,4607123,3070161,2569119,33156862,66378030,99700107,99700107
Philippines,2014,PH,PHL,WPR,6008299,11309877,17318176,9905629,7977510,6406125,4743565,3000137,1948757,33981723,5585366,10575682,16161048,9533686,7622899,6134122,4716725,3191750,2665070,33864252,67845975,101325201,101325201
Philippines,2015,PH,PHL,WPR,6005882,11389525,17395407,10072564,8138261,6550122,4886947,3120692,2025319,34793905,5585579,10644512,16230091,9674597,7776674,6255009,4835923,3316894,2752871,34611968,69405873,103031365,103031365
Philippines,2016,PH,PHL,WPR,6019705,11484499,17504204,10232155,8312317,6695534,5042876,3248904,2115808,35647594,5600669,10725256,16325925,9800342,7962778,6388764,4966522,3443928,2835196,35397530,71045124,104875266,104875266
Philippines,2017,PH,PHL,WPR,6040948,11593173,17634121,10355564,8506520,6842428,5193042,3374719,2215159,36487432,5622515,10815698,16438213,9896464,8167010,6525493,5092295,3568175,2929298,36178735,72666167,106738501,106738501
Philippines,2018,PH,PHL,WPR,6063868,11695687,17759555,10467666,8702023,6986126,5332390,3500692,2323571,37312468,5646246,10899950,16546196,9981249,8372110,6661070,5209642,3690822,3035728,36950621,74263089,108568836,108568836
Philippines,2019,PH,PHL,WPR,6092029,11780706,17872735,10583097,8892448,7126425,5466291,3627635,2442496,38138392,5675385,10971634,16647019,10063241,8572765,6794034,5324167,3811839,3156607,37722653,75861045,110380804,110380804
Philippines,2020,PH,PHL,WPR,6127720,11844804,17972524,10706238,9078203,7267267,5600466,3754009,2569239,38975422,5711154,11029529,16740683,10146329,8767515,6927972,5440918,3930029,3289584,38502347,77477769,112190977,112190977
Philippines,2021,PH,PHL,WPR,6170419,11892150,18062569,10828133,9252367,7403017,5735433,3869463,2666474,39754887,5752548,11074150,16826698,10226698,8949556,7059844,5561453,4039638,3398975,39236164,78991051,113880328,113880328
Philippines,2022,PH,PHL,WPR,6213589,11933825,18147414,10948105,9419227,7537615,5872485,3987002,2767425,40531859,5794835,11113910,16908745,10307900,9119629,7193176,5685683,4149358,3515241,39970987,80502846,115559009,115559009
Philippines,2023,PH,PHL,WPR,6250159,11973231,18223390,11072162,9575383,7681905,6012878,4121393,2906746,41370467,5831509,11153324,16984833,10398538,9270243,7337632,5812651,4269430,3670186,40758680,82129147,117337368,117337368
Philippines,2024,PH,PHL,WPR,6280650,12013986,18294636,11186525,9726160,7826834,6153353,4261593,3052612,42207077,5862702,11194927,17057629,10487734,9403961,7488055,5940627,4393132,3833379,41546888,83753965,119106224,119106224
Philippines,2025,PH,PHL,WPR,6304952,12057802,18362754,11277583,9891323,7971360,6291869,4403830,3203506,43039471,5888435,11239950,17128385,10562524,9537633,7644315,6068396,4517547,4003330,42333745,85373216,120864358,120864358
Philippines,2026,PH,PHL,WPR,6324765,12110778,18435543,11363527,10033277,8132554,6428253,4545443,3356068,43859122,5910011,11293569,17203580,10634467,9646023,7818563,6195344,4640893,4176666,43111956,86971078,122610193,122610193
Philippines,2027,PH,PHL,WPR,6341465,12170940,18512405,11462009,10138009,8311652,6564397,4680447,3510069,44666583,5928033,11354212,17282245,10715332,9723538,8008687,6323690,4758598,4352421,43882266,88548849,124343503,124343503
Philippines,2028,PH,PHL,WPR,6356667,12229071,18585738,11560450,10236597,8495060,6699780,4807517,3668968,45468372,5944096,11413583,17357679,10795924,9794742,8202569,6453322,4870400,4533288,44650245,90118617,126062041,126062041
Philippines,2029,PH,PHL,WPR,6371057,12287909,18658966,11645431,10341875,8675041,6833259,4931145,3834659,46261410,5959312,11474328,17433640,10867805,9866642,8393684,6581897,4981041,4721283,45412352,91673762,127766369,127766369
Philippines,2030,PH,PHL,WPR,6383516,12347722,18731238,11709452,10457398,8852022,6967657,5055048,4003519,47045096,5972462,11536036,17508498,10925954,9942740,8580777,6711935,5093874,4913207,46168487,93213583,129453321,129453321
Philippines,1950,PH,PHL,WPR,1721395,2446278,4167673,1664983,1176509,968860,631395,330079,247859,5019685,1606526,2356807,3963333,1637815,1256942,959112,600662,455043,409614,5319188,10338873,18469878,18469878
Philippines,1951,PH,PHL,WPR,1857089,2557094,4414183,1753697,1213851,982815,652421,342833,259218,5204835,1738503,2474092,4212595,1726304,1291037,980361,610403,445162,416236,5469503,10674338,19301117,19301117
Philippines,1952,PH,PHL,WPR,1996714,2674770,4671484,1845405,1253980,997204,672906,357216,270881,5397592,1873721,2591268,4464989,1824852,1327634,1000972,624533,435536,420281,5633808,11031400,20167861,20167861
Philippines,1953,PH,PHL,WPR,2138003,2801956,4939959,1938826,1298096,1013911,693426,372574,282694,5599527,2010138,2711600,4721738,1930333,1367780,1023183,642596,427009,421612,5812513,11412040,21073747,21073747
Philippines,1954,PH,PHL,WPR,2282435,2938053,5220488,2032310,1348645,1035200,714097,388177,294545,5812974,2148361,2837489,4985850,2039563,1413457,1049264,663521,420053,420187,6006045,11819019,22025355,22025355
Philippines,1955,PH,PHL,WPR,2414815,3099976,5514791,2125996,1406066,1061217,735250,403759,306600,6038888,2273835,2986155,5259990,2151211,1466085,1079222,686633,415121,415968,6214240,12253128,23027910,23027910
Philippines,1956,PH,PHL,WPR,2530378,3292147,5822525,2219640,1469882,1091771,757291,419503,318738,6276825,2382609,3160253,5542862,2264478,1526532,1112856,711820,412754,408693,6437133,12713958,24079343,24079343
Philippines,1957,PH,PHL,WPR,2642088,3499883,6141971,2313041,1539979,1126894,780326,435838,330616,6526694,2486827,3345913,5832740,2378088,1595895,1150113,738865,413642,397941,6674544,13201238,25175946,25175946
Philippines,1958,PH,PHL,WPR,2747383,3720501,6467884,2405675,1615090,1165577,804418,453389,342059,6786208,2584384,3542183,6126567,2487661,1674388,1190414,767396,418851,383326,6922036,13708244,26302696,26302696
Philippines,1959,PH,PHL,WPR,2841680,3953061,6794741,2501934,1694453,1208233,830501,470253,354150,7059524,2673128,3750415,6423543,2595179,1763019,1234170,797143,427332,365716,7182559,14242083,27460371,27460371
Philippines,1960,PH,PHL,WPR,2913177,4154495,7067672,2586495,1765087,1245336,859666,485737,363159,7305480,2743588,3946729,6690317,2677436,1842676,1274536,830010,441122,357613,7423393,14728873,28486871,28486871
Philippines,1961,PH,PHL,WPR,2965966,4312196,7278162,2652429,1824862,1273606,889042,502462,368980,7511381,2797637,4121355,6918992,2729753,1906642,1308798,864655,461085,362946,7633879,15145260,29342411,29342411
Philippines,1962,PH,PHL,WPR,3015396,4460636,7476032,2719705,1884815,1302255,915670,521776,376754,7720975,2848215,4289586,7137801,2784468,1969706,1342907,897670,484067,372356,7851174,15572149,30185979,30185979
Philippines,1963,PH,PHL,WPR,3068232,4599767,7667999,2795428,1943434,1333881,940389,543122,386649,7942903,2901577,4446406,7347983,2851979,2031532,1378821,929516,509044,383930,8084822,16027725,31043711,31043711
Philippines,1964,PH,PHL,WPR,3127466,4728116,7855582,2881992,1997674,1369036,963689,565764,398616,8176771,2958829,4589156,7547985,2936499,2089139,1417128,960423,535480,397622,8336291,16513062,31916622,31916622
Philippines,1965,PH,PHL,WPR,3188147,4852768,8040915,2979878,2045959,1407826,985875,589338,412672,8421548,3014880,4722453,7737333,3039493,2141002,1458145,990477,563047,413575,8605739,17027287,32805538,32805538
Philippines,1966,PH,PHL,WPR,3245564,4978239,8223803,3085867,2088362,1450743,1007630,612956,428511,8674069,3065372,4849800,7915172,3158905,2187747,1502360,1020226,590886,431583,8891707,17565776,33704749,33704749
Philippines,1967,PH,PHL,WPR,3302161,5104024,8406185,3197630,2127337,1497044,1029626,636106,445815,8933558,3112438,4971102,8083540,3292442,2231890,1549027,1050304,618635,451279,9193577,18127135,34616857,34616857
Philippines,1968,PH,PHL,WPR,3357217,5234521,8591738,3311289,2165971,1544778,1052588,658855,464229,9197710,3157804,5090041,8247845,3434747,2276431,1596551,1081334,646315,472302,9507680,18705390,35544973,35544973
Philippines,1969,PH,PHL,WPR,3405820,5371852,8777672,3422022,2206350,1592167,1076869,681194,483339,9461941,3200345,5208773,8409118,3578791,2324471,1643560,1113371,673713,494533,9828439,19290380,36477170,36477170
Philippines,2031,PH,PHL,WPR,6394717,12409811,18804528,11756434,10577336,9023871,7102265,5185609,4172039,47817554,5984214,11599346,17583560,10970701,10022269,8760923,6843745,5214249,5105417,46917304,94734858,131122947,131122947
Philippines,2032,PH,PHL,WPR,6402910,12469703,18872613,11798191,10697624,9190712,7236886,5318511,4341324,48583248,5992981,11660381,17653362,11010986,10105018,8931448,6977972,5338521,5298567,47662512,96245760,132771740,132771740
Philippines,2033,PH,PHL,WPR,6405897,12521760,18927657,11837683,10820538,9344668,7377530,5449299,4517100,49346818,5996744,11713802,17710546,11050782,10195745,9081185,7120846,5461911,5497812,48408281,97755099,134393296,134393296
Philippines,2034,PH,PHL,WPR,6404256,12566985,18971241,11878545,10933863,9493379,7519145,5581074,4701492,50107498,5996089,11760891,17756980,11092741,10285001,9214238,7269733,5586714,5705111,49153538,99261036,135989261,135989261
Philippines,2035,PH,PHL,WPR,6400601,12604157,19004758,11922472,11024160,9656283,7660501,5711511,4890103,50865030,5993306,11800458,17793764,11138091,10359936,9347266,7424408,5711571,5916680,49897952,100762982,137561513,137561513
Philippines,2036,PH,PHL,WPR,6392172,12635613,19027785,11975486,11109379,9796378,7818087,5840002,5078121,51617453,5985800,11834462,17820262,11191991,10431992,9455322,7596678,5835643,6127914,50639540,102256993,139105043,139105043
Philippines,2037,PH,PHL,WPR,6381151,12660987,19042138,12035631,11206956,9899822,7992945,5967808,5260429,52363591,5975733,11861916,17837649,11252866,10512837,9532828,7784401,5960802,6334096,51377830,103741421,140621204,140621204
Philippines,2038,PH,PHL,WPR,6374030,12679711,19053741,12093777,11304510,9997229,8171795,6094618,5439101,53101030,5969266,11882401,17851667,11312460,10593393,9604108,7975697,6087054,6537658,52110370,105211400,142116809,142116809
Philippines,2039,PH,PHL,WPR,6366184,12693037,19059221,12152636,11388806,10101276,8347237,6219887,5619820,53829662,5962026,11897626,17859652,11373423,10665308,9676108,8164241,6212461,6744826,52836367,106666029,143584902,143584902
Philippines,2040,PH,PHL,WPR,6354871,12702463,19057334,12212473,11452433,10215493,8519769,6346297,5802689,54549154,5951458,11908657,17860115,11435336,10723608,9752325,8348854,6339489,6956037,53555649,108104803,145022250,145022250
Philippines,2041,PH,PHL,WPR,6342258,12705913,19048171,12274562,11499260,10334128,8687397,6473463,5990509,55259319,5939759,11913563,17853322,11498833,10768624,9831989,8526705,6468524,7173125,54267800,109527119,146428606,146428606
Philippines,2042,PH,PHL,WPR,6326481,12703805,19030286,12334471,11540964,10453135,8850138,6600955,6180637,55960300,5925134,11912919,17838053,11560069,10809228,9914856,8695142,6600083,7393651,54973029,110933329,147801667,147801667
Philippines,2043,PH,PHL,WPR,6308641,12700431,19009072,12386624,11580474,10574755,9000529,6734568,6374316,56651266,5908325,11910864,17819189,11613713,10849376,10005623,8843295,6740185,7618191,55670383,112321649,149149914,149149914
Philippines,2044,PH,PHL,WPR,6293380,12691749,18985129,12432023,11621389,10687014,9146120,6870021,6576471,57333038,5893642,11903634,17797276,11661057,10891694,10094953,8975268,6886500,7850889,56360361,113693399,150475799,150475799
Philippines,2045,PH,PHL,WPR,6279847,12677616,18957463,12469458,11665388,10776750,9305706,7005619,6781265,58004186,5880589,11890947,17771536,11700913,10937405,10170180,9107383,7038576,8087136,57041593,115045779,151774780,151774780
Philippines,2046,PH,PHL,WPR,6270142,12657479,18927621,12501250,11718410,10861494,9443395,7156544,6984030,58665123,5870959,11872413,17743372,11735222,10991607,10242541,9215196,7207587,8322239,57714392,116379515,153050505,153050505
Philippines,2047,PH,PHL,WPR,6265225,12631625,18896850,12527026,11778517,10958316,9545634,7323422,7181809,59314724,5865639,11848380,17714019,11763004,11052735,10323526,9293160,7391272,8553637,58377334,117692058,154302926,154302926
Philippines,2048,PH,PHL,WPR,6257861,12607583,18865444,12546201,11836672,11055118,9642085,7493670,7376119,59949865,5858145,11825730,17683875,11783833,11112593,10404212,9365070,7578186,8783572,59027466,118977331,155526647,155526647
Philippines,2049,PH,PHL,WPR,6247489,12585382,18832871,12560014,11895546,11138881,9745055,7660548,7571226,60571270,5847899,11804403,17652302,11799409,11173800,10476348,9437750,7762365,9016105,59665777,120237047,156722225,156722225
Philippines,2050,PH,PHL,WPR,6237244,12561451,18798695,12569955,11955403,11202365,9858114,7824771,7769785,61180393,5837699,11781374,17619073,11810801,11235949,10535037,9514683,7942808,9254185,60293463,121473856,157891622,157891622
Palau,1970,PW,PLW,WPR,904,1784,2688,1183,528,439,445,241,249,3085,929,1653,2582,1094,542,477,392,253,260,3018,6103,11366,11366
Palau,1971,PW,PLW,WPR,933,1833,2766,1260,581,450,448,253,255,3247,941,1700,2641,1117,563,469,407,258,272,3086,6333,11740,11740
Palau,1972,PW,PLW,WPR,968,1893,2861,1347,633,465,450,258,270,3423,936,1777,2713,1142,574,468,418,275,289,3166,6589,12172,12172
Palau,1973,PW,PLW,WPR,983,1951,2934,1421,689,485,441,274,280,3590,915,1848,2763,1172,584,473,424,296,305,3254,6844,12541,12541
Palau,1974,PW,PLW,WPR,962,1962,2924,1452,727,502,431,289,276,3677,875,1863,2738,1199,596,473,432,309,310,3319,6996,12662,12662
Palau,1975,PW,PLW,WPR,919,1943,2862,1448,753,511,420,307,270,3709,835,1838,2673,1218,614,472,435,319,311,3369,7078,12607,12607
Palau,1976,PW,PLW,WPR,881,1919,2800,1441,778,511,411,321,261,3723,800,1806,2606,1225,640,471,430,329,311,3406,7129,12539,12539
Palau,1977,PW,PLW,WPR,847,1891,2738,1440,794,511,405,335,259,3744,773,1777,2550,1214,665,479,427,334,315,3434,7178,12463,12463
Palau,1978,PW,PLW,WPR,815,1856,2671,1445,806,510,397,347,261,3766,748,1742,2490,1198,692,487,416,341,329,3463,7229,12387,12387
Palau,1979,PW,PLW,WPR,781,1820,2601,1459,806,509,388,350,271,3783,723,1708,2431,1182,713,496,399,344,348,3482,7265,12300,12300
Palau,1980,PW,PLW,WPR,747,1785,2532,1488,806,512,385,355,280,3826,694,1675,2369,1186,728,512,388,348,365,3527,7353,12252,12252
Palau,1981,PW,PLW,WPR,733,1765,2498,1531,850,540,390,362,282,3955,677,1637,2314,1230,754,530,381,356,368,3619,7574,12386,12386
Palau,1982,PW,PLW,WPR,738,1750,2488,1581,924,583,405,372,279,4144,675,1604,2279,1272,808,552,387,363,372,3754,7898,12666,12666
Palau,1983,PW,PLW,WPR,758,1739,2497,1618,995,634,423,374,290,4334,684,1583,2267,1300,861,578,394,370,380,3883,8217,12973,12973
Palau,1984,PW,PLW,WPR,784,1729,2513,1643,1062,691,447,378,295,4516,702,1568,2270,1305,916,610,401,377,389,3998,8514,13299,13299
Palau,1985,PW,PLW,WPR,816,1727,2543,1664,1131,751,479,382,306,4713,730,1562,2292,1294,974,649,406,386,396,4105,8818,13644,13644
Palau,1986,PW,PLW,WPR,827,1712,2539,1666,1220,823,506,382,323,4920,748,1538,2286,1298,1031,688,419,393,413,4242,9162,13985,13985
Palau,1987,PW,PLW,WPR,820,1679,2499,1648,1334,912,540,381,341,5156,750,1507,2257,1309,1080,724,445,400,433,4391,9547,14309,14309
Palau,1988,PW,PLW,WPR,812,1651,2463,1610,1440,1018,581,378,360,5387,752,1483,2235,1313,1126,770,475,401,457,4542,9929,14632,14632
Palau,1989,PW,PLW,WPR,807,1625,2432,1569,1520,1139,630,379,380,5617,757,1471,2228,1300,1156,831,500,400,484,4671,10288,14957,14957
Palau,1990,PW,PLW,WPR,811,1604,2415,1553,1582,1241,666,383,392,5817,763,1463,2226,1307,1197,891,528,398,508,4829,10646,15293,15293
Palau,1991,PW,PLW,WPR,821,1587,2408,1564,1651,1319,696,383,394,6007,772,1453,2225,1345,1250,946,553,386,524,5004,11011,15640,15640
Palau,1992,PW,PLW,WPR,836,1577,2413,1558,1723,1391,727,389,397,6185,784,1446,2230,1375,1309,1004,573,388,529,5178,11363,16004,16004
Palau,1993,PW,PLW,WPR,857,1576,2433,1531,1791,1470,764,395,399,6350,800,1452,2252,1383,1370,1065,593,396,540,5347,11697,16380,16380
Palau,1994,PW,PLW,WPR,885,1587,2472,1488,1862,1551,817,406,397,6521,821,1465,2286,1360,1443,1125,617,399,550,5494,12015,16770,16770
Palau,1995,PW,PLW,WPR,918,1603,2521,1452,1916,1641,875,422,391,6697,849,1484,2333,1330,1517,1188,650,410,562,5657,12354,17209,17209
Palau,1996,PW,PLW,WPR,948,1624,2572,1470,1974,1732,943,434,397,6950,875,1509,2384,1311,1585,1242,687,423,568,5816,12766,17732,17732
Palau,1997,PW,PLW,WPR,957,1660,2617,1505,2054,1823,1015,460,399,7256,883,1551,2434,1299,1653,1296,730,435,568,5981,13237,18297,18297
Palau,1998,PW,PLW,WPR,935,1720,2655,1517,2147,1917,1097,492,408,7578,863,1613,2476,1282,1707,1350,779,454,573,6145,13723,18852,18852
Palau,1999,PW,PLW,WPR,882,1796,2678,1502,2251,2000,1182,523,418,7876,820,1694,2514,1266,1752,1409,832,475,577,6311,14187,19380,19380
Palau,2000,PW,PLW,WPR,821,1860,2681,1488,2288,2071,1261,551,427,8086,762,1759,2521,1257,1737,1480,892,496,580,6442,14528,19726,19726
Palau,2001,PW,PLW,WPR,765,1884,2649,1487,2230,2119,1313,575,433,8157,704,1794,2498,1249,1671,1543,959,509,592,6523,14680,19828,19828
Palau,2002,PW,PLW,WPR,731,1878,2609,1479,2152,2152,1359,593,437,8172,671,1797,2468,1246,1601,1590,1034,523,607,6601,14773,19851,19851
Palau,2003,PW,PLW,WPR,712,1857,2569,1464,2089,2184,1401,614,444,8196,661,1769,2430,1257,1533,1618,1114,536,623,6681,14877,19880,19880
Palau,2004,PW,PLW,WPR,699,1819,2518,1446,2042,2211,1442,637,453,8231,669,1717,2386,1280,1472,1631,1196,558,639,6776,15007,19907,19907
Palau,2005,PW,PLW,WPR,687,1757,2444,1439,1985,2196,1483,668,455,8226,674,1639,2313,1316,1410,1625,1256,594,648,6849,15075,19831,19831
Palau,2006,PW,PLW,WPR,680,1671,2351,1441,1900,2141,1525,707,458,8172,671,1542,2213,1361,1361,1604,1277,639,642,6884,15056,19619,19619
Palau,2007,PW,PLW,WPR,680,1584,2264,1442,1813,2069,1557,752,463,8096,664,1448,2112,1392,1317,1581,1282,686,638,6896,14992,19366,19366
Palau,2008,PW,PLW,WPR,685,1504,2189,1444,1727,1987,1574,800,468,8000,658,1372,2030,1395,1281,1556,1276,735,638,6881,14881,19102,19102
Palau,2009,PW,PLW,WPR,689,1429,2118,1439,1650,1916,1569,847,474,7895,645,1316,1961,1380,1256,1526,1272,784,636,6854,14749,18826,18826
Palau,2010,PW,PLW,WPR,687,1370,2057,1426,1574,1841,1556,886,488,7771,636,1268,1904,1342,1242,1488,1273,817,638,6800,14571,18540,18540
Palau,2011,PW,PLW,WPR,675,1324,1999,1409,1508,1774,1529,926,495,7641,626,1227,1853,1292,1229,1451,1282,842,651,6747,14388,18240,18240
Palau,2012,PW,PLW,WPR,664,1289,1953,1388,1447,1715,1492,954,502,7498,615,1196,1811,1238,1219,1413,1291,856,670,6687,14185,17946,17946
Palau,2013,PW,PLW,WPR,651,1276,1927,1373,1419,1689,1481,983,517,7462,602,1190,1792,1184,1186,1368,1317,874,701,6630,14092,17805,17805
Palau,2014,PW,PLW,WPR,649,1269,1918,1360,1433,1686,1497,1012,539,7527,578,1192,1770,1135,1141,1314,1356,913,725,6584,14111,17796,17796
Palau,2015,PW,PLW,WPR,649,1264,1913,1339,1428,1664,1514,1038,560,7543,560,1192,1752,1124,1111,1271,1374,950,752,6582,14125,17794,17794
Palau,2016,PW,PLW,WPR,647,1267,1914,1323,1389,1634,1527,1061,582,7516,557,1199,1756,1143,1098,1254,1369,980,785,6629,14145,17816,17816
Palau,2017,PW,PLW,WPR,641,1275,1916,1310,1353,1603,1534,1079,611,7490,556,1200,1756,1158,1084,1237,1360,1009,820,6668,14158,17837,17837
Palau,2018,PW,PLW,WPR,640,1278,1918,1306,1319,1569,1538,1094,643,7469,568,1199,1767,1183,1074,1221,1344,1033,855,6710,14179,17864,17864
Palau,2019,PW,PLW,WPR,647,1292,1939,1293,1285,1530,1545,1110,674,7437,594,1187,1781,1201,1066,1208,1327,1054,901,6757,14194,17916,17916
Palau,2020,PW,PLW,WPR,659,1299,1958,1288,1263,1493,1540,1127,705,7416,617,1178,1795,1208,1070,1197,1306,1082,940,6803,14219,17972,17972
Palau,2021,PW,PLW,WPR,675,1300,1975,1280,1252,1461,1530,1145,741,7409,632,1174,1806,1209,1076,1182,1284,1116,975,6842,14251,18024,18024
Palau,2022,PW,PLW,WPR,692,1294,1986,1271,1247,1419,1515,1160,775,7387,645,1166,1811,1202,1088,1159,1262,1151,1008,6870,14257,18055,18055
Palau,2023,PW,PLW,WPR,697,1297,1994,1264,1241,1381,1498,1171,810,7365,651,1163,1814,1194,1098,1137,1237,1176,1045,6887,14252,18058,18058
Palau,2024,PW,PLW,WPR,689,1307,1996,1255,1244,1337,1482,1182,842,7342,643,1171,1814,1187,1115,1112,1218,1192,1081,6905,14247,18051,18051
Palau,2025,PW,PLW,WPR,682,1318,2000,1249,1246,1301,1460,1195,867,7318,635,1176,1811,1183,1131,1089,1195,1201,1122,6921,14239,18044,18044
Palau,2026,PW,PLW,WPR,673,1326,1999,1248,1237,1268,1437,1211,891,7292,626,1183,1809,1180,1139,1068,1181,1203,1161,6932,14224,18031,18031
Palau,2027,PW,PLW,WPR,664,1331,1995,1250,1237,1239,1413,1220,916,7275,619,1192,1811,1178,1146,1047,1169,1198,1197,6935,14210,18011,18011
Palau,2028,PW,PLW,WPR,657,1333,1990,1252,1232,1209,1388,1228,943,7252,612,1207,1819,1170,1153,1029,1156,1190,1232,6930,14182,17988,17988
Palau,2029,PW,PLW,WPR,649,1329,1978,1262,1223,1185,1359,1234,964,7227,605,1226,1831,1157,1156,1018,1137,1179,1270,6917,14144,17955,17955
Palau,2030,PW,PLW,WPR,643,1330,1973,1269,1215,1173,1329,1231,986,7203,599,1240,1839,1147,1152,1014,1122,1163,1310,6908,14111,17919,17919
Palau,1950,PW,PLW,WPR,703,998,1701,519,480,320,219,174,334,2046,644,938,1582,581,477,339,236,167,302,2102,4148,7430,7430
Palau,1951,PW,PLW,WPR,727,1049,1776,511,455,335,222,175,321,2019,672,976,1648,578,467,352,239,167,289,2092,4111,7529,7529
Palau,1952,PW,PLW,WPR,734,1097,1831,532,427,353,223,174,297,2006,683,1014,1697,593,458,366,239,169,271,2096,4102,7638,7638
Palau,1953,PW,PLW,WPR,735,1146,1881,585,407,374,226,166,278,2036,691,1049,1740,629,454,380,245,175,258,2141,4177,7798,7798
Palau,1954,PW,PLW,WPR,747,1178,1925,644,399,393,231,164,260,2091,703,1074,1777,674,463,396,254,180,244,2211,4302,8008,8008
Palau,1955,PW,PLW,WPR,779,1186,1965,700,406,413,240,170,252,2181,725,1084,1809,715,481,410,265,185,236,2292,4473,8252,8252
Palau,1956,PW,PLW,WPR,819,1197,2016,753,419,433,251,173,248,2277,761,1094,1855,755,501,420,272,191,229,2368,4645,8516,8516
Palau,1957,PW,PLW,WPR,857,1218,2075,801,431,458,257,177,249,2373,795,1108,1903,791,515,434,279,201,223,2443,4816,8791,8791
Palau,1958,PW,PLW,WPR,879,1267,2146,826,442,473,261,187,247,2436,821,1143,1964,815,530,446,288,204,222,2505,4941,9051,9051
Palau,1959,PW,PLW,WPR,895,1335,2230,816,456,477,268,196,240,2453,837,1208,2045,810,535,454,300,206,226,2531,4984,9264,9264
Palau,1960,PW,PLW,WPR,909,1414,2323,792,467,475,277,207,233,2451,854,1285,2139,796,534,457,312,215,221,2535,4986,9446,9446
Palau,1961,PW,PLW,WPR,926,1491,2417,773,478,464,292,214,228,2449,871,1360,2231,780,528,462,327,218,223,2538,4987,9639,9639
Palau,1962,PW,PLW,WPR,944,1568,2512,765,490,452,306,219,228,2460,892,1434,2326,772,529,466,343,218,229,2557,5017,9851,9851
Palau,1963,PW,PLW,WPR,962,1637,2599,775,491,440,327,219,236,2488,909,1501,2410,781,528,471,353,218,228,2579,5067,10076,10076
Palau,1964,PW,PLW,WPR,979,1696,2675,811,486,426,345,217,242,2527,925,1563,2488,805,526,471,365,221,231,2619,5146,10318,10318
Palau,1965,PW,PLW,WPR,1003,1747,2750,862,471,411,363,209,261,2577,939,1619,2558,848,516,468,373,229,239,2673,5250,10563,10563
Palau,1966,PW,PLW,WPR,1024,1795,2819,935,449,405,380,202,276,2647,947,1667,2614,911,499,465,383,234,243,2735,5382,10813,10813
Palau,1967,PW,PLW,WPR,1011,1812,2823,1017,440,402,394,205,279,2737,929,1696,2625,973,493,467,382,239,243,2797,5534,10992,10992
Palau,1968,PW,PLW,WPR,966,1797,2763,1082,459,409,412,214,268,2844,906,1690,2596,1025,501,472,384,249,244,2875,5719,11079,11079
Palau,1969,PW,PLW,WPR,919,1774,2693,1128,487,426,430,229,256,2956,908,1657,2565,1064,518,478,384,254,246,2944,5900,11159,11159
Palau,2031,PW,PLW,WPR,634,1337,1971,1266,1201,1160,1298,1225,1007,7157,591,1247,1838,1141,1146,1019,1104,1144,1355,6909,14066,17883,17883
Palau,2032,PW,PLW,WPR,628,1343,1971,1259,1195,1157,1264,1216,1033,7124,586,1253,1839,1132,1136,1031,1086,1121,1399,6905,14029,17843,17843
Palau,2033,PW,PLW,WPR,621,1341,1962,1266,1187,1151,1228,1206,1060,7098,579,1250,1829,1130,1131,1040,1064,1103,1437,6905,14003,17798,17798
Palau,2034,PW,PLW,WPR,613,1328,1941,1277,1180,1158,1192,1191,1075,7073,573,1237,1810,1138,1127,1056,1041,1090,1472,6924,13997,17744,17744
Palau,2035,PW,PLW,WPR,608,1312,1920,1288,1176,1158,1158,1178,1100,7058,567,1222,1789,1144,1122,1073,1019,1071,1497,6926,13984,17688,17688
Palau,2036,PW,PLW,WPR,601,1298,1899,1299,1175,1153,1133,1161,1116,7037,561,1209,1770,1153,1119,1083,1001,1054,1520,6930,13967,17629,17629
Palau,2037,PW,PLW,WPR,596,1283,1879,1301,1174,1154,1105,1142,1133,7009,556,1195,1751,1165,1118,1088,983,1046,1531,6931,13940,17570,17570
Palau,2038,PW,PLW,WPR,592,1268,1860,1299,1181,1148,1082,1125,1146,6981,551,1181,1732,1178,1110,1096,967,1034,1543,6928,13909,17506,17506
Palau,2039,PW,PLW,WPR,586,1252,1838,1300,1193,1143,1066,1103,1159,6964,547,1168,1715,1199,1097,1103,960,1022,1552,6933,13897,17441,17441
Palau,2040,PW,PLW,WPR,584,1239,1823,1300,1196,1133,1052,1077,1170,6928,544,1154,1698,1214,1089,1100,955,1008,1562,6928,13856,17375,17375
Palau,2041,PW,PLW,WPR,578,1226,1804,1306,1195,1124,1048,1055,1171,6899,541,1144,1685,1217,1085,1092,961,994,1568,6917,13816,17306,17306
Palau,2042,PW,PLW,WPR,575,1214,1789,1316,1194,1117,1040,1027,1175,6869,536,1133,1669,1226,1075,1086,972,975,1574,6908,13777,17235,17235
Palau,2043,PW,PLW,WPR,572,1203,1775,1311,1193,1110,1038,997,1178,6827,533,1120,1653,1223,1074,1079,983,960,1581,6900,13727,17161,17161
Palau,2044,PW,PLW,WPR,570,1192,1762,1300,1208,1105,1044,971,1176,6804,531,1112,1643,1209,1082,1074,998,940,1580,6883,13687,17092,17092
Palau,2045,PW,PLW,WPR,567,1182,1749,1284,1222,1102,1045,944,1178,6775,530,1103,1633,1197,1089,1073,1014,920,1578,6871,13646,17027,17027
Palau,2046,PW,PLW,WPR,566,1173,1739,1268,1226,1100,1044,924,1174,6736,529,1092,1621,1181,1098,1071,1026,904,1573,6853,13589,16955,16955
Palau,2047,PW,PLW,WPR,565,1161,1726,1253,1233,1103,1044,905,1168,6706,525,1085,1610,1168,1111,1068,1032,888,1574,6841,13547,16881,16881
Palau,2048,PW,PLW,WPR,564,1154,1718,1240,1237,1108,1041,886,1163,6675,525,1077,1602,1155,1124,1062,1041,875,1564,6821,13496,16814,16814
Palau,2049,PW,PLW,WPR,562,1148,1710,1227,1231,1118,1034,876,1153,6639,525,1070,1595,1142,1143,1052,1045,867,1555,6804,13443,16751,16751
Palau,2050,PW,PLW,WPR,563,1140,1703,1213,1235,1128,1026,866,1139,6607,525,1065,1590,1129,1159,1045,1042,865,1542,6782,13389,16689,16689
Papua New Guinea,1970,PG,PNG,WPR,241715,377595,619310,231319,183240,139293,92295,38368,14783,699298,222641,312327,534968,201389,183612,134851,81161,26965,7506,635484,1334782,2489059,2489059
Papua New Guinea,1971,PG,PNG,WPR,247270,391330,638600,237171,186371,140077,93626,39782,15128,712155,227857,322607,550464,204666,187698,136945,83296,28062,7426,648093,1360248,2549315,2549315
Papua New Guinea,1972,PG,PNG,WPR,250790,403897,654687,244037,189635,141732,95736,41982,15344,728466,231611,334283,565894,208010,190431,139300,86394,30176,7349,661660,1390126,2610700,2610700
Papua New Guinea,1973,PG,PNG,WPR,252556,414397,666953,251926,193146,144206,98608,45019,15476,748381,233937,346492,580429,211856,191699,141795,90344,33378,7305,676377,1424758,2672144,2672144
Papua New Guinea,1974,PG,PNG,WPR,254541,423169,677710,261313,196619,146624,101290,48225,15744,769815,236119,357532,593651,216570,193194,144155,93987,36860,7374,692140,1461955,2733313,2733313
Papua New Guinea,1975,PG,PNG,WPR,256692,430299,686991,272405,199850,148985,103839,51545,16155,792779,238227,367310,605537,222324,194877,146410,97347,40596,7597,709151,1501930,2794462,2794462
Papua New Guinea,1976,PG,PNG,WPR,259023,435942,694965,284624,203304,151323,106312,54916,16740,817219,240347,375776,616123,229665,196319,148557,100456,44535,7998,727530,1544749,2855837,2855837
Papua New Guinea,1977,PG,PNG,WPR,261247,440599,701846,297738,207012,153674,108744,58281,17510,842959,242341,383125,625466,238585,197553,150595,103364,48602,8598,747297,1590256,2917572,2917572
Papua New Guinea,1978,PG,PNG,WPR,263253,444596,707849,311349,211036,156117,111176,61582,18489,869749,244165,389489,633654,248875,198676,152538,106096,52733,9438,768356,1638105,2979606,2979606
Papua New Guinea,1979,PG,PNG,WPR,265265,448006,713271,325058,215389,158734,113617,64772,19673,897243,245984,394861,640845,260293,199761,154409,108689,56847,10547,790546,1687789,3041902,3041902
Papua New Guinea,1980,PG,PNG,WPR,267396,451124,718520,338418,220230,161608,116076,67803,21103,925238,247914,399458,647372,272452,201032,156206,111162,60871,11941,813664,1738902,3104788,3104788
Papua New Guinea,1981,PG,PNG,WPR,271181,456736,727917,350110,225562,164121,117738,69941,23023,950495,250607,404694,655301,284843,203681,157644,112571,63419,13197,835355,1785850,3169073,3169073
Papua New Guinea,1982,PG,PNG,WPR,276533,465308,741841,359930,231672,166180,118612,71137,25343,972874,254204,410842,665046,297026,208151,158635,113030,64427,14229,855498,1828372,3235264,3235264
Papua New Guinea,1983,PG,PNG,WPR,282133,474696,756829,368621,238737,168625,119503,72093,27672,995251,258467,416974,675441,308585,213815,159580,113606,65188,15390,876164,1871415,3303677,3303677
Papua New Guinea,1984,PG,PNG,WPR,288101,484739,772840,376368,247013,171120,120387,72854,29981,1017723,263492,423122,686614,319443,220124,161040,114290,65727,16667,897291,1915014,3374465,3374465
Papua New Guinea,1985,PG,PNG,WPR,294300,495379,789679,383310,256668,173481,121269,73492,32256,1040476,269143,429401,698544,329485,227185,162978,115081,66101,18041,918871,1959347,3447579,3447579
Papua New Guinea,1986,PG,PNG,WPR,300814,506361,807175,389661,267135,176135,122160,74069,34470,1063630,275267,435913,711180,338685,235481,164968,115949,66356,19503,940942,2004572,3522916,3522916
Papua New Guinea,1987,PG,PNG,WPR,307674,517226,824900,395953,278205,179095,123095,74616,36590,1087554,281678,442594,724272,347234,244988,167013,116853,66538,20989,963615,2051169,3600343,3600343
Papua New Guinea,1988,PG,PNG,WPR,314584,528173,842757,402478,289563,182391,124128,75165,38610,1112335,288097,449678,737775,355209,255538,169144,117773,66667,22454,986785,2099120,3679651,3679651
Papua New Guinea,1989,PG,PNG,WPR,321251,539643,860894,409515,301051,186304,125608,76014,40511,1139003,294596,458113,752709,362433,266907,171749,119092,67240,24077,1011498,2150501,3764112,3764112
Papua New Guinea,1990,PG,PNG,WPR,327169,551769,878938,418249,312779,191973,128512,78106,42414,1172033,301752,470066,771818,368790,278576,176219,122091,69867,26645,1042188,2214221,3864972,3864972
Papua New Guinea,1991,PG,PNG,WPR,333753,565986,899739,429857,325516,199988,132791,81170,44502,1213824,309491,486098,795589,377914,291729,182746,126035,73683,29736,1081843,2295667,3990995,3990995
Papua New Guinea,1992,PG,PNG,WPR,342167,582633,924800,443990,339085,209920,137597,84334,46779,1261705,317482,504406,821888,391574,306882,190683,129471,77048,32583,1128241,2389946,4136644,4136644
Papua New Guinea,1993,PG,PNG,WPR,351535,600194,951729,459477,352221,221149,142968,87586,49148,1312549,325838,523656,849494,406925,322300,199988,132803,80369,35436,1177821,2490370,4291588,4291588
Papua New Guinea,1994,PG,PNG,WPR,361457,618173,979630,475675,364754,233682,148505,90868,51588,1365072,334533,543279,877812,422926,337523,210032,136647,83694,38356,1229178,2594250,4451694,4451694
Papua New Guinea,1995,PG,PNG,WPR,371620,636630,1008250,492429,376842,247643,154057,94185,54106,1419262,343629,562970,906599,439514,352545,220892,141004,87017,41354,1282326,2701588,4616439,4616439
Papua New Guinea,1996,PG,PNG,WPR,382388,655470,1037858,509439,388671,262474,160029,97536,56724,1474873,353526,582379,935905,456631,367403,232990,145494,90301,44435,1337254,2812127,4785895,4785895
Papua New Guinea,1997,PG,PNG,WPR,394045,674692,1068737,526283,400756,277959,166458,100959,59437,1531852,364279,601542,965821,474110,382332,246282,150166,93526,47616,1394032,2925884,4960439,4960439
Papua New Guinea,1998,PG,PNG,WPR,406049,694222,1100271,543114,413309,293723,173360,104484,62224,1590214,375353,620483,995836,492001,397368,260507,155075,96681,50876,1452508,3042722,5138829,5138829
Papua New Guinea,1999,PG,PNG,WPR,418504,713995,1132499,560266,426257,309484,180727,108204,65104,1650042,386883,639219,1026102,510450,412408,275522,160308,99819,54235,1512742,3162784,5321388,5321388
Papua New Guinea,2000,PG,PNG,WPR,431579,733927,1165506,577693,439730,324968,188690,112207,68081,1711369,399044,657748,1056792,529291,427480,291117,166068,102977,57701,1574634,3286003,5508297,5508297
Papua New Guinea,2001,PG,PNG,WPR,444071,754580,1198651,596451,453545,339995,197506,116627,71345,1775469,411133,676100,1087233,548549,442336,306657,172395,106036,61165,1637138,3412607,5698489,5698489
Papua New Guinea,2002,PG,PNG,WPR,456013,775887,1231900,616847,467810,354358,207397,121361,74848,1842621,423075,694518,1117593,568408,457158,321867,179579,108869,64596,1700477,3543098,5892596,5892596
Papua New Guinea,2003,PG,PNG,WPR,468306,797151,1265457,638077,482816,367780,218219,126393,78337,1911622,435087,713187,1148274,588954,472387,336739,187892,111626,68034,1765632,3677254,6090980,6090980
Papua New Guinea,2004,PG,PNG,WPR,480474,818594,1299068,660122,498422,380464,230158,131459,81799,1982424,446692,732424,1179116,610134,487990,351305,196833,114828,71464,1832554,3814978,6293166,6293166
Papua New Guinea,2005,PG,PNG,WPR,492391,840178,1332569,682928,514595,392569,243331,136433,85267,2055123,457788,752452,1210240,631592,503974,365550,206469,118439,74863,1900887,3956010,6498818,6498818
Papua New Guinea,2006,PG,PNG,WPR,504026,862240,1366266,706293,531212,404355,257319,141741,88804,2129724,468523,773417,1241940,652910,520363,379495,217189,122100,78224,1970281,4100005,6708217,6708217
Papua New Guinea,2007,PG,PNG,WPR,514980,885106,1400086,730029,547975,416319,271935,147421,92479,2206158,478676,795233,1273909,674026,537115,393398,228951,125851,81566,2040907,4247065,6921066,6921066
Papua New Guinea,2008,PG,PNG,WPR,525401,908428,1433829,753959,565203,428692,286880,153522,96324,2284580,488369,817574,1305943,695071,554607,407486,241661,129847,84961,2113633,4398213,7137988,7137988
Papua New Guinea,2009,PG,PNG,WPR,535616,931921,1467537,777742,583322,441418,301873,160021,100366,2364742,497887,840146,1338033,715892,573173,421725,255197,134143,88444,2188574,4553316,7358890,7358890
Papua New Guinea,2010,PG,PNG,WPR,545838,955698,1501536,801016,602384,454598,316668,167032,104649,2446347,507439,862931,1370370,736158,592685,436062,269293,138843,91970,2265011,4711358,7583269,7583269
Papua New Guinea,2011,PG,PNG,WPR,555875,978841,1534716,823108,621934,468073,330863,174675,109048,2527701,516938,885320,1402258,754983,612530,450641,283792,144365,95651,2341962,4869663,7806637,7806637
Papua New Guinea,2012,PG,PNG,WPR,565469,1000710,1566179,843937,641763,481817,344169,183090,113434,2608210,526098,906835,1432933,772363,632363,465555,298473,151036,99442,2419232,5027442,8026545,8026545
Papua New Guinea,2013,PG,PNG,WPR,574556,1021959,1596515,864053,662148,496036,356527,192265,117990,2689019,534767,927842,1462609,789198,652389,480802,312959,158818,103320,2497486,5186505,8245627,8245627
Papua New Guinea,2014,PG,PNG,WPR,583188,1042491,1625679,883667,683075,510607,368159,202359,122565,2770432,542984,948187,1491171,805843,672466,496279,327261,167296,107730,2576875,5347307,8464153,8464153
Papua New Guinea,2015,PG,PNG,WPR,591075,1062463,1653538,902742,704461,525495,379204,213464,127074,2852440,550471,968030,1518501,822690,692275,512027,341426,176581,112698,2657697,5510137,8682174,8682174
Papua New Guinea,2016,PG,PNG,WPR,597965,1081945,1679910,921624,726036,540515,389818,225166,131813,2934972,557011,987512,1544523,839981,711380,528036,355460,186999,117903,2739759,5674731,8899169,8899169
Papua New Guinea,2017,PG,PNG,WPR,604153,1100423,1704576,940707,747619,555425,400485,237330,136841,3018407,562892,1006167,1569059,857679,729637,544158,369514,198456,123313,2822757,5841164,9114796,9114796
Papua New Guinea,2018,PG,PNG,WPR,609896,1117823,1727719,959713,769031,570552,411407,249700,142252,3102655,568358,1023848,1592206,875526,747070,560614,383677,210770,128998,2906655,6009310,9329227,9329227
Papua New Guinea,2019,PG,PNG,WPR,615175,1134519,1749694,978432,789884,586298,422474,261986,147993,3187067,573386,1040886,1614272,893383,763571,577728,397894,223843,135030,2991449,6178516,9542486,9542486
Papua New Guinea,2020,PG,PNG,WPR,619946,1149602,1769548,996302,809412,602455,433684,273950,154118,3269921,578025,1056702,1634727,910196,778338,595379,412297,237597,141647,3075454,6345375,9749640,9749640
Papua New Guinea,2021,PG,PNG,WPR,624255,1163062,1787317,1013435,827831,619058,445025,285061,160155,3350565,582248,1071224,1653472,926031,791607,613388,426867,251506,148684,3158083,6508648,9949437,9949437
Papua New Guinea,2022,PG,PNG,WPR,627863,1175117,1802980,1029339,845205,635977,456670,295414,166732,3429337,585880,1084638,1670518,940658,803710,631571,441784,265522,156543,3239788,6669125,10142619,10142619
Papua New Guinea,2023,PG,PNG,WPR,630347,1185804,1816151,1043966,861507,653177,468791,305241,174515,3507197,588540,1096991,1685531,954069,814759,649817,457129,279615,165665,3321054,6828251,10329931,10329931
Papua New Guinea,2024,PG,PNG,WPR,632066,1196049,1828115,1058184,877527,670997,481274,314495,182957,3585434,590399,1108820,1699219,967449,825747,668044,472622,293486,175668,3403016,6988450,10515788,10515788
Papua New Guinea,2025,PG,PNG,WPR,633574,1205736,1839310,1072170,893200,689354,494073,323302,192017,3664116,592030,1119922,1711952,980972,836996,685869,488229,307131,186573,3485770,7149886,10701144,10701144
Papua New Guinea,2026,PG,PNG,WPR,635172,1214531,1849703,1086026,908822,708013,507035,331826,201596,3743318,593713,1129974,1723687,994809,848757,702887,503971,320591,198383,3569398,7312716,10886097,10886097
Papua New Guinea,2027,PG,PNG,WPR,636732,1222480,1859212,1099260,924715,726775,519920,340458,211582,3822710,595327,1139037,1734364,1008551,861081,719024,519778,334077,211076,3653587,7476297,11069871,11069871
Papua New Guinea,2028,PG,PNG,WPR,638524,1229417,1867941,1111847,940583,745508,533045,349385,221846,3902214,597130,1146947,1744077,1022063,873736,734323,535867,347678,224554,3738221,7640435,11252452,11252452
Papua New Guinea,2029,PG,PNG,WPR,640857,1235288,1876145,1124182,956203,763876,546822,358524,232212,3981819,599426,1153655,1753081,1035635,886542,748614,552494,361301,238704,3823290,7805109,11434334,11434334
Papua New Guinea,2030,PG,PNG,WPR,643146,1240827,1883973,1136235,971752,781516,561284,367927,242568,4061282,601670,1159832,1761502,1049161,899674,761710,569597,374963,253454,3908559,7969841,11615322,11615322
Papua New Guinea,1950,PG,PNG,WPR,134503,208938,343441,189635,148423,88126,38215,17608,9329,491336,119518,184226,303744,166489,124795,67715,25912,11873,7547,404331,895667,1542854,1542854
Papua New Guinea,1951,PG,PNG,WPR,138479,210348,348827,189935,151629,91912,40338,17721,9571,501106,124769,183688,308457,167878,129104,71681,27723,11675,7655,415716,916822,1574111,1574111
Papua New Guinea,1952,PG,PNG,WPR,142873,212724,355597,189951,154617,95827,42868,17936,9814,511013,130606,184206,314812,168650,133183,75862,30003,11592,7767,427057,938070,1608470,1608470
Papua New Guinea,1953,PG,PNG,WPR,147586,216591,364177,189927,157518,99962,45830,18332,10090,521659,136961,186268,323229,169089,137153,80325,32764,11684,7916,438931,960590,1647998,1647998
Papua New Guinea,1954,PG,PNG,WPR,152513,221343,373856,189780,160179,104186,49095,18911,10379,532530,142696,190324,333020,169093,140829,84936,35892,11975,8083,450808,983338,1690220,1690220
Papua New Guinea,1955,PG,PNG,WPR,157785,226712,384497,189615,162579,108469,52604,19707,10687,543661,147752,196291,344043,168783,144184,89652,39328,12511,8266,462724,1006385,1734921,1734921
Papua New Guinea,1956,PG,PNG,WPR,162901,233110,396011,189562,164720,112779,56271,20791,11009,555132,152635,203567,356202,168289,147180,94433,42954,13383,8471,474710,1029842,1782051,1782051
Papua New Guinea,1957,PG,PNG,WPR,167888,240361,408249,189756,166599,117020,59970,22150,11349,566844,157348,211836,369184,167836,149839,99192,46631,14583,8689,486770,1053614,1831047,1831047
Papua New Guinea,1958,PG,PNG,WPR,172812,248290,421102,190365,168220,121105,63700,23687,11701,578778,161933,220791,382724,167636,152176,103848,50350,15994,8903,498907,1077685,1881514,1881514
Papua New Guinea,1959,PG,PNG,WPR,177693,256638,434331,191540,169576,124990,67458,25361,12062,590987,166417,230135,396552,167864,154176,108350,54130,17561,9115,511196,1102183,1933070,1933070
Papua New Guinea,1960,PG,PNG,WPR,182624,265263,447887,193420,170680,128614,71205,27166,12429,603514,170898,239666,410564,168699,155839,112649,57940,19273,9317,523717,1127231,1985666,1985666
Papua New Guinea,1961,PG,PNG,WPR,188143,273707,461850,195961,171534,131430,74455,28713,12746,614839,175576,247855,423431,170510,157513,116291,61191,20658,9386,535549,1150388,2035672,2035672
Papua New Guinea,1962,PG,PNG,WPR,194212,282242,476454,198926,172233,133361,77144,29932,12998,624594,180495,254694,435189,173020,159389,119206,63802,21625,9292,546334,1170928,2082562,2082562
Papua New Guinea,1963,PG,PNG,WPR,200295,291289,491584,202483,172898,134801,79604,31072,13186,634044,185498,261345,446843,175873,161423,121714,66203,22470,9075,556758,1190802,2129222,2129222
Papua New Guinea,1964,PG,PNG,WPR,206496,301142,507638,206160,173607,135739,81768,32053,13341,642668,190666,267051,457717,179595,163772,123816,68335,23110,8762,567390,1210058,2175409,2175409
Papua New Guinea,1965,PG,PNG,WPR,212629,312243,524872,209630,174430,136365,83735,32959,13472,650591,195940,272447,468387,183822,166429,125666,70355,23640,8412,578324,1228915,2222178,2222178
Papua New Guinea,1966,PG,PNG,WPR,218508,324311,542819,213355,175452,136974,85704,33947,13650,659082,201228,278868,480096,187794,169299,127504,72532,24234,8129,589492,1248574,2271490,2271490
Papua New Guinea,1967,PG,PNG,WPR,224335,337045,561380,217341,176747,137518,87543,34927,13901,667977,206540,286051,492591,191554,172442,129288,74700,24778,7938,600700,1268677,2322647,2322647
Papua New Guinea,1968,PG,PNG,WPR,230179,350189,580368,221643,178420,137992,89198,35918,14174,677345,211888,293807,505695,195122,175921,131028,76795,25315,7768,611949,1289294,2375356,2375356
Papua New Guinea,1969,PG,PNG,WPR,235977,363785,599762,226253,180564,138585,90801,37067,14463,687733,217280,302630,519910,198336,179652,132882,78970,26046,7624,623510,1311243,2430922,2430922
Papua New Guinea,2031,PG,PNG,WPR,645486,1246276,1891762,1147819,987194,798477,576418,377687,252851,4140446,603953,1165716,1769669,1062384,913114,773815,587048,388762,268734,3993857,8134303,11795728,11795728
Papua New Guinea,2032,PG,PNG,WPR,648335,1251291,1899626,1159018,1002201,814974,592187,387874,262991,4219245,606692,1171056,1777748,1075269,926557,785314,604710,402786,284412,4079048,8298293,11975671,11975671
Papua New Guinea,2033,PG,PNG,WPR,651311,1255759,1907070,1169820,1016881,831069,608594,398490,272961,4297815,609536,1175751,1785287,1087740,940074,796433,622512,417045,300419,4164223,8462038,12154395,12154395
Papua New Guinea,2034,PG,PNG,WPR,653921,1260004,1913925,1180184,1031158,846904,625593,409417,282848,4376104,612036,1180136,1792172,1099694,953561,807501,640305,431452,316749,4249262,8625366,12331461,12331461
Papua New Guinea,2035,PG,PNG,WPR,656387,1263987,1920374,1189996,1045216,862411,643090,420607,292713,4454033,614399,1184231,1798630,1110917,967187,818825,657710,445974,333430,4334043,8788076,12507085,12507085
Papua New Guinea,2036,PG,PNG,WPR,658611,1268103,1926714,1198929,1059142,877869,660865,431937,302639,4531381,616537,1188406,1804943,1121099,981123,830647,674330,460630,350486,4418315,8949696,12681353,12681353
Papua New Guinea,2037,PG,PNG,WPR,660473,1272683,1933156,1207014,1072458,893594,678721,443219,312863,4607869,618358,1192964,1811322,1130292,994958,843021,690108,475371,368093,4501843,9109712,12854191,12854191
Papua New Guinea,2038,PG,PNG,WPR,662289,1277623,1939912,1214094,1085129,909301,696555,454759,323420,4683258,620146,1197818,1817964,1138339,1008563,855714,705085,490406,386233,4584340,9267598,13025474,13025474
Papua New Guinea,2039,PG,PNG,WPR,664029,1282737,1946766,1220119,1097561,924770,714056,466892,334123,4757521,621854,1202810,1824664,1145185,1022229,868557,719107,505958,404727,4665763,9423284,13194712,13194712
Papua New Guinea,2040,PG,PNG,WPR,665654,1287661,1953315,1225811,1109713,940164,730878,479637,344946,4831149,623458,1207611,1831069,1151503,1035847,881717,731983,521969,423534,4746553,9577702,13362082,13362082
Papua New Guinea,2041,PG,PNG,WPR,667116,1292391,1959507,1231414,1121399,955456,747072,492988,355922,4904251,624898,1212226,1837124,1157527,1049161,895173,743921,538318,442669,4826769,9731020,13527645,13527645
Papua New Guinea,2042,PG,PNG,WPR,668101,1297263,1965364,1236590,1132704,970324,762848,506908,367052,4976426,625880,1216975,1842855,1163006,1062140,908637,755291,554876,462118,4906068,9882494,13690710,13690710
Papua New Guinea,2043,PG,PNG,WPR,668938,1302215,1971153,1241222,1143621,984872,778258,521383,378316,5047672,626731,1221791,1848522,1167847,1074709,922174,766308,571569,481835,4984442,10032114,13851796,13851796
Papua New Guinea,2044,PG,PNG,WPR,669340,1306734,1976074,1245632,1154111,999036,793450,536370,389718,5118317,627161,1226198,1853359,1172380,1086761,935682,777291,588254,501759,5062127,10180444,14009881,14009881
Papua New Guinea,2045,PG,PNG,WPR,669429,1310992,1980421,1249788,1164058,1012994,808354,551794,401298,5188286,627288,1230349,1857637,1176618,1098097,949330,788533,604580,521902,5139060,10327346,14165403,14165403
Papua New Guinea,2046,PG,PNG,WPR,669824,1314848,1984672,1254078,1173144,1026831,823230,567431,412995,5257709,627704,1234114,1861818,1180939,1108401,963291,800265,620177,542325,5215398,10473107,14319594,14319594
Papua New Guinea,2047,PG,PNG,WPR,670312,1317868,1988180,1258825,1181406,1040087,838377,583123,424875,5326693,628200,1237107,1865307,1185640,1117726,977163,812534,635000,563147,5291210,10617903,14471387,14471387
Papua New Guinea,2048,PG,PNG,WPR,670522,1320695,1991217,1263929,1188676,1052731,853528,598805,437205,5394874,628417,1239928,1868345,1190628,1125914,990813,825130,649112,584555,5366152,10761026,14620589,14620589
Papua New Guinea,2049,PG,PNG,WPR,670827,1323014,1993841,1269192,1194916,1065145,868470,614210,450078,5462011,628719,1242253,1870972,1195754,1132920,1004524,837871,662373,606611,5440053,10902064,14766879,14766879
Papua New Guinea,2050,PG,PNG,WPR,671044,1324900,1995944,1274273,1200833,1077292,883344,629043,463504,5528289,628935,1244160,1873095,1200688,1139396,1018195,850926,674604,629234,5513043,11041332,14910369,14910369
Poland,1970,PL,POL,EUR,1290142,3168986,4459128,3202111,2037067,2219322,1462465,1365992,1039771,11326728,1231171,3028089,4259260,3101103,2026090,2296244,1722053,1658409,1633923,12437822,23764550,32482943,32482943
Poland,1971,PL,POL,EUR,1290304,3062084,4352388,3325900,2038408,2231479,1547955,1322167,1080763,11546672,1232817,2923768,4156585,3215704,2025825,2281498,1820096,1617129,1694845,12655097,24201769,32710744,32710744
Poland,1972,PL,POL,EUR,1319216,2957930,4277146,3394257,2093017,2239726,1636480,1267960,1128048,11759488,1257922,2818909,4076831,3278103,2075906,2272624,1916918,1560845,1761546,12865942,24625430,32979398,32979398
Poland,1973,PL,POL,EUR,1357349,2859051,4216400,3436012,2175218,2229403,1738336,1212983,1177279,11969231,1292773,2721376,4014149,3314103,2152422,2253676,2018073,1502676,1829281,13070231,25039462,33270009,33270009
Poland,1974,PL,POL,EUR,1407586,2774139,4181725,3459720,2264558,2205527,1831707,1177213,1223872,12162597,1338036,2640499,3978535,3329038,2235940,2227066,2100758,1468027,1894996,13255825,25418422,33578683,33578683
Poland,1975,PL,POL,EUR,1467613,2709268,4176881,3456623,2364049,2171234,1903630,1167162,1270543,12333241,1392209,2578796,3971005,3318537,2329410,2192443,2158817,1458693,1960746,13418646,25751887,33899770,33899770
Poland,1976,PL,POL,EUR,1527692,2673504,4201196,3418373,2488880,2126584,1967495,1166591,1308607,12476530,1449901,2545031,3994932,3273915,2448175,2149154,2208900,1457904,2018998,13557046,26033576,34229706,34229706
Poland,1977,PL,POL,EUR,1574543,2666818,4241361,3360138,2633922,2076755,2014202,1174265,1341982,12601264,1496801,2540857,4037658,3208714,2586509,2101559,2236719,1469315,2078478,13681294,26282558,34561582,34561582
Poland,1978,PL,POL,EUR,1602737,2676466,4279203,3292734,2788650,2030124,2037972,1194980,1369797,12714257,1528098,2553162,4081260,3135616,2733827,2056820,2237027,1499278,2133407,13795975,26510232,34870698,34870698
Poland,1979,PL,POL,EUR,1630075,2701979,4332054,3216682,2942936,1991392,2052777,1222027,1390244,12816058,1556350,2579512,4135862,3056946,2880598,2020226,2227463,1537248,2181904,13904385,26720443,35188357,35188357
Poland,1980,PL,POL,EUR,1657640,2749807,4407447,3125925,3100501,1953892,2061715,1272050,1390138,12904221,1581205,2626354,4207559,2967815,3030326,1984074,2211978,1602550,2205465,14002208,26906429,35521429,35521429
Poland,1981,PL,POL,EUR,1672675,2814708,4487383,3027776,3221573,1954382,2069433,1342607,1370540,12986311,1593967,2690311,4284278,2871915,3145068,1982171,2198891,1694892,2200182,14093119,27079430,35851094,35851094
Poland,1982,PL,POL,EUR,1692083,2883062,4575145,2928343,3289967,2008063,2075565,1414263,1349512,13065713,1610742,2756348,4367090,2775807,3208016,2031282,2191801,1784786,2189003,14180695,27246408,36188644,36188644
Poland,1983,PL,POL,EUR,1723012,2950545,4673557,2832304,3332013,2090179,2064524,1496943,1325178,13141141,1638550,2820913,4459463,2686589,3243905,2108249,2174139,1878633,2170458,14261973,27403114,36536141,36536141
Poland,1984,PL,POL,EUR,1741581,3028210,4769791,2749753,3358519,2179585,2041977,1571952,1313360,13215146,1655559,2893940,4549499,2614400,3260956,2192363,2150387,1956078,2167942,14342126,27557272,36876560,36876560
Poland,1985,PL,POL,EUR,1742128,3108035,4850163,2689400,3361526,2277908,2009945,1627738,1319615,13286132,1655727,2969207,4624934,2562621,3256012,2285711,2119316,2010148,2184120,14417928,27704060,37179160,37179160
Poland,1986,PL,POL,EUR,1730072,3176522,4906594,2653630,3330325,2399851,1968100,1676678,1328440,13357024,1643504,3034497,4678001,2532569,3219376,2403724,2078801,2056594,2204118,14495182,27852206,37436798,37436798
Poland,1987,PL,POL,EUR,1697073,3237424,4934497,2641836,3277450,2540058,1920808,1711391,1343585,13435128,1611724,3091296,4703020,2526118,3160127,2540301,2032966,2082431,2239838,14581781,28016909,37654411,37654411
Poland,1988,PL,POL,EUR,1621655,3301737,4923392,2650075,3192717,2689293,1874462,1733926,1376879,13517352,1546657,3154547,4701204,2530880,3091252,2689655,1984530,2083336,2290474,14670127,28187479,37812076,37812076
Poland,1989,PL,POL,EUR,1537803,3353011,4890814,2676421,3097429,2834632,1836971,1747727,1409550,13602730,1472013,3207103,4679116,2551068,3014556,2837068,1945393,2074571,2343691,14766347,28369077,37939013,37939013
Poland,1990,PL,POL,EUR,1476579,3374272,4850851,2723468,3004645,2978101,1804368,1749720,1435872,13696174,1410155,3229060,4639215,2597649,2922867,2978958,1913917,2060371,2404249,14878011,28574185,38064255,38064255
Poland,1991,PL,POL,EUR,1428237,3370305,4798542,2785772,2902561,3085795,1805772,1748807,1460819,13789526,1360977,3226278,4587255,2660349,2822115,3085963,1915733,2047397,2460504,14992061,28781587,38167382,38167382
Poland,1992,PL,POL,EUR,1391655,3344639,4736294,2853373,2801472,3144549,1854725,1745607,1483305,13883031,1324607,3202586,4527193,2728815,2720546,3145408,1965096,2038984,2506909,15105758,28988789,38252276,38252276
Poland,1993,PL,POL,EUR,1359268,3302597,4661865,2920233,2706465,3179454,1929496,1731746,1514092,13981486,1292411,3163042,4455453,2797388,2625088,3179932,2039576,2022880,2555629,15220493,29201979,38319296,38319296
Poland,1994,PL,POL,EUR,1323729,3251517,4575246,2988824,2626892,3197231,2011193,1711211,1552343,14087694,1258720,3113060,4371780,2867704,2545007,3196570,2120973,2000984,2609491,15340729,29428423,38375459,38375459
Poland,1995,PL,POL,EUR,1273506,3198375,4471881,3052725,2571503,3190212,2100186,1684446,1596384,14195456,1212337,3058655,4270992,2933553,2488408,3190163,2210935,1972409,2668174,15463642,29659098,38401978,38401978
Poland,1996,PL,POL,EUR,1215579,3142947,4358526,3106670,2542574,3152501,2209293,1649664,1639935,14300637,1157009,3001894,4158903,2988881,2459669,3150604,2323983,1935212,2724986,15583335,29883972,38401408,38401408
Poland,1997,PL,POL,EUR,1162636,3072285,4234921,3159250,2536186,3096089,2334119,1610683,1677683,14414010,1105807,2932354,4038161,3041228,2454545,3089746,2455001,1892679,2775842,15709041,30123051,38396130,38396130
Poland,1998,PL,POL,EUR,1115187,2977514,4092701,3214301,2546320,3028519,2466738,1573800,1709917,14539595,1059691,2840405,3900096,3095277,2465964,3018587,2593679,1852863,2821232,15847602,30387197,38379990,38379990
Poland,1999,PL,POL,EUR,1070093,2873443,3943536,3261156,2570790,2954370,2596488,1544185,1738440,14665429,1015882,2740697,3756579,3140536,2491648,2940549,2729719,1821473,2865488,15989413,30654842,38354956,38354956
Poland,2000,PL,POL,EUR,1037961,2772536,3810497,3300453,2635553,2901501,2754878,1525651,1765415,14883451,985396,2646443,3631839,3177808,2549846,2864210,2874127,1791430,2921219,16178640,31062091,38504431,38504431
Poland,2001,PL,POL,EUR,1012874,2676136,3689010,3313843,2719169,2841162,2888632,1539732,1795202,15097740,962095,2554694,3516789,3190891,2626168,2782110,2987901,1793925,2978332,16359327,31457067,38662862,38662862
Poland,2002,PL,POL,EUR,984407,2582833,3567240,3293768,2790390,2747987,2954032,1591210,1828120,15205507,934608,2464623,3399231,3172223,2696237,2687649,3048965,1843220,3027201,16475495,31681002,38647476,38647476
Poland,2003,PL,POL,EUR,960027,2492032,3452059,3262898,2862476,2658584,2995771,1665883,1856065,15301677,911405,2376885,3288290,3142854,2766951,2597879,3086448,1916380,3068996,16579508,31881185,38621531,38621531
Poland,2004,PL,POL,EUR,943350,2402520,3345870,3219459,2937361,2582117,3021436,1747083,1881359,15388815,895465,2290304,3185769,3101105,2840306,2522453,3107119,1997703,3106892,16675578,32064393,38596042,38596042
Poland,2005,PL,POL,EUR,934772,2315000,3249772,3165654,3008959,2528792,3023488,1834257,1906553,15467703,886912,2206501,3093413,3048258,2911743,2468959,3105562,2086547,3143940,16765009,32232712,38575911,38575911
Poland,2006,PL,POL,EUR,935338,2227935,3163273,3107584,3065777,2500168,2993372,1937956,1925921,15530778,887458,2122962,3010420,2991796,2970312,2440869,3070454,2195999,3173274,16842704,32373482,38547179,38547179
Poland,2007,PL,POL,EUR,949986,2145155,3095141,3033362,3116661,2493034,2942602,2055315,1934958,15575932,901487,2042984,2944471,2922186,3022376,2435179,3013429,2323398,3189762,16906330,32482262,38521874,38521874
Poland,2008,PL,POL,EUR,980765,2071202,3051967,2938019,3169936,2504234,2880939,2179405,1939040,15611573,931163,1971137,2902300,2830745,3076370,2446679,2946411,2458286,3198550,16957041,32568614,38522882,38522882
Poland,2009,PL,POL,EUR,1018967,2009067,3028034,2838101,3215072,2533172,2814767,2301180,1944950,15647242,968353,1909917,2878270,2731642,3121516,2474792,2873911,2590936,3208939,17001736,32648978,38555285,38555285
Poland,2010,PL,POL,EUR,1049815,1964877,3014692,2737695,3242218,2581425,2738906,2425410,1953152,15678806,997491,1865752,2863243,2632038,3148118,2522199,2791048,2726152,3221062,17040617,32719423,38597353,38597353
Poland,2011,PL,POL,EUR,1063966,1936984,3000950,2640363,3244960,2645266,2656041,2523966,1990556,15701152,1009602,1838695,2848297,2535203,3151145,2585575,2701522,2830594,3266412,17070451,32771603,38620847,38620847
Poland,2012,PL,POL,EUR,1062486,1924741,2987227,2550924,3227443,2716843,2573910,2582366,2062702,15714188,1007148,1826950,2834098,2446595,3134249,2655935,2612134,2889374,3352072,17090359,32804547,38625874,38625874
Poland,2013,PL,POL,EUR,1043449,1932360,2975809,2462927,3198596,2788533,2495458,2621193,2147441,15714148,987916,1834691,2822607,2359645,3105896,2725946,2527089,2925816,3450385,17094777,32808925,38607353,38607353
Poland,2014,PL,POL,EUR,1013797,1954119,2967916,2375072,3156661,2862177,2429705,2647592,2236758,15707965,958202,1856213,2814415,2273301,3064643,2797245,2455531,2946488,3554363,17091571,32799536,38581872,38581872
Poland,2015,PL,POL,EUR,987433,1976220,2963653,2288688,3105512,2933052,2386018,2654695,2328537,15696502,932800,1876720,2809520,2189784,3013413,2866772,2405636,2946489,3661366,17083460,32779962,38553146,38553146
Poland,2016,PL,POL,EUR,972663,1993231,2965894,2203798,3054716,2993444,2366538,2635260,2427874,15681630,919868,1891609,2811477,2107693,2961601,2927037,2381942,2915928,3778905,17073106,32754736,38532113,38532113
Poland,2017,PL,POL,EUR,973223,2010435,2983658,2124319,2990425,3050070,2368000,2599482,2530184,15662480,921350,1907011,2828361,2030326,2897986,2983016,2380955,2865858,3900169,17058310,32720790,38532812,38532812
Poland,2018,PL,POL,EUR,981588,2025246,3006834,2053230,2902274,3107219,2386080,2553638,2630819,15633260,929208,1920486,2849694,1961039,2811206,3040059,2396549,2805713,4017116,17031682,32664942,38521457,38521457
Poland,2019,PL,POL,EUR,986462,2036173,3022635,1992583,2804612,3153913,2419266,2501902,2730932,15603208,933453,1930573,2864026,1901348,2715346,3087126,2427042,2739312,4133563,17003737,32606945,38493601,38493601
Poland,2020,PL,POL,EUR,987344,2041404,3028748,1949243,2704029,3180535,2468657,2439771,2819231,15561466,934237,1935002,2869239,1857634,2617593,3114570,2474984,2662521,4241618,16968920,32530386,38428366,38428366
Poland,2021,PL,POL,EUR,980831,2043169,3024000,1922572,2607447,3183097,2531687,2370519,2885023,15500345,927581,1936048,2863629,1830763,2522146,3118729,2538281,2579109,4330722,16919750,32420095,38307726,38307726
Poland,2022,PL,POL,EUR,1008288,2090699,3098987,2155536,2787721,3298923,2659647,2327933,2966930,16196690,955387,1984190,2939577,2083232,2706928,3228286,2658549,2516512,4428393,17621900,33818590,39857145,39857145
Poland,2023,PL,POL,EUR,1030808,2114693,3145501,2316492,2910343,3379542,2777609,2284762,3065225,16733973,977894,2007343,2985237,2257316,2835381,3305621,2770548,2455207,4537283,18161356,34895329,41026067,41026067
Poland,2024,PL,POL,EUR,1011793,2068731,3080524,2177214,2717930,3296895,2832405,2223481,3148943,16396868,957700,1959492,2917192,2105600,2646410,3229941,2827914,2383853,4633425,17827143,34224011,40221726,40221726
Poland,2025,PL,POL,EUR,993004,2031856,3024860,2081770,2553050,3219125,2890809,2184289,3221275,16150318,937853,1923154,2861007,1998336,2485694,3156683,2888880,2335053,4715894,17580540,33730858,39616730,39616730
Poland,2026,PL,POL,EUR,969873,2014206,2984079,2027855,2421133,3158072,2946149,2169574,3281648,16004431,914537,1906888,2821425,1935321,2357427,3097405,2946555,2313239,4782697,17432644,33437075,39242577,39242577
Poland,2027,PL,POL,EUR,948667,2004045,2952712,2010729,2318766,3096999,3003639,2175811,3332891,15938835,893352,1898117,2791469,1912424,2257524,3038207,3004741,2314767,4836978,17364641,33303476,39047654,39047654
Poland,2028,PL,POL,EUR,923174,2003319,2926493,2010209,2232903,3018722,3064985,2198370,3378528,15903717,869046,1897178,2766224,1907976,2173118,2961876,3067049,2333462,4883928,17327409,33231126,38923845,38923845
Poland,2029,PL,POL,EUR,895267,2005307,2900574,2015019,2157068,2933015,3117568,2235092,3419152,15876914,843200,1897894,2741094,1910190,2096993,2878410,3121140,2367195,4924678,17298606,33175520,38817187,38817187
Poland,2030,PL,POL,EUR,871312,2000126,2871438,2019309,2093187,2844119,3151583,2287165,3453070,15848433,820836,1891957,2712793,1912571,2031291,2792642,3156218,2417902,4957231,17267855,33116288,38700518,38700518
Poland,1950,PL,POL,EUR,1465994,2198537,3664531,2365685,1628304,1662424,1277620,707591,511798,8153422,1414796,2155190,3569986,2417014,1843555,1899685,1508954,946183,782906,9398297,17551719,24786236,24786236
Poland,1951,PL,POL,EUR,1588034,2179753,3767787,2372365,1711322,1620295,1331134,730425,521309,8286850,1527788,2133517,3661305,2408317,1917650,1866534,1558902,974313,800620,9526336,17813186,25242274,25242274
Poland,1952,PL,POL,EUR,1692019,2183584,3875603,2377750,1813073,1558403,1382783,754872,532721,8419602,1623096,2134108,3757204,2399507,2010650,1811524,1604554,1004060,821834,9652129,18071731,25704541,25704541
Poland,1953,PL,POL,EUR,1772417,2213630,3986047,2378958,1924356,1487793,1431559,782489,544646,8549801,1696872,2160036,3856908,2388192,2112853,1745170,1646868,1037118,845202,9775403,18325204,26168161,26168161
Poland,1954,PL,POL,EUR,1800008,2308624,4108632,2367272,2025549,1430862,1474912,815425,553264,8667284,1720395,2249248,3969643,2365854,2202995,1689509,1686935,1074961,864535,9884789,18552073,26630354,26630354
Poland,1955,PL,POL,EUR,1800817,2447025,4247842,2340764,2107718,1397496,1509147,853291,563340,8771756,1718868,2378982,4097850,2330254,2271614,1655432,1722428,1116805,885219,9981752,18753508,27099199,27099199
Poland,1956,PL,POL,EUR,1812845,2585238,4398083,2305995,2170264,1386098,1536206,895338,578290,8872191,1729283,2506353,4235636,2287988,2318058,1641014,1755031,1162752,911263,10076106,18948297,27582025,27582025
Poland,1957,PL,POL,EUR,1827152,2750621,4577773,2238072,2217902,1406937,1560532,946824,585072,8955339,1745888,2662144,4408032,2203498,2356503,1641893,1770998,1223221,938833,10134946,19090285,28076084,28076084
Poland,1958,PL,POL,EUR,1834876,2927328,4762204,2169051,2251416,1444323,1577982,1000057,596488,9039317,1755412,2830054,4585466,2121811,2373729,1667669,1779094,1282003,972696,10197002,19236319,28583989,28583989
Poland,1959,PL,POL,EUR,1817369,3092831,4910200,2133710,2274256,1478983,1584101,1048489,620169,9139708,1736100,2985898,4721998,2086375,2364738,1709939,1795807,1328397,1010957,10296213,19435921,29068120,29068120
Poland,1960,PL,POL,EUR,1772702,3260685,5033387,2100889,2289959,1543523,1567112,1094447,646884,9242814,1692718,3143421,4836139,2051590,2348551,1781844,1788697,1372038,1054835,10397555,19640369,29509903,29509903
Poland,1961,PL,POL,EUR,1710533,3389642,5100175,2105227,2302452,1635509,1521520,1139994,678049,9382751,1631787,3262640,4894427,2052684,2332653,1884037,1746691,1413403,1106409,10535877,19918628,29913232,29913232
Poland,1962,PL,POL,EUR,1641052,3461123,5102175,2162566,2312818,1731353,1459511,1189541,709371,9565160,1560761,3328417,4889178,2106615,2322506,1985286,1685578,1458167,1157248,10715400,20280560,30271919,30271919
Poland,1963,PL,POL,EUR,1567044,3505505,5072549,2245793,2306112,1841952,1394695,1236398,742615,9767565,1487404,3369145,4856549,2187244,2301834,2091368,1620730,1501431,1209037,10911644,20679209,30608319,30608319
Poland,1964,PL,POL,EUR,1499234,3530205,5029439,2334829,2286491,1944020,1351403,1280929,776591,9974263,1421899,3389819,4811718,2275585,2272721,2178206,1581342,1544432,1260166,11112452,21086715,30927873,30927873
Poland,1965,PL,POL,EUR,1442211,3525489,4967700,2435848,2254125,2023700,1337049,1320708,816417,10187847,1366035,3383276,4749311,2374218,2235667,2239197,1569228,1578965,1321943,11319218,21507065,31224081,31224081
Poland,1966,PL,POL,EUR,1395800,3485909,4881709,2565729,2208904,2096229,1334849,1349464,861642,10416817,1321922,3342049,4663971,2498647,2190680,2292087,1566778,1604026,1390120,11542338,21959155,31504832,31504832
Poland,1967,PL,POL,EUR,1357746,3426125,4783871,2716747,2158369,2151021,1342664,1370446,907160,10646407,1288076,3280181,4568257,2642403,2141868,2321497,1577655,1631722,1452277,11767422,22413829,31765963,31765963
Poland,1968,PL,POL,EUR,1328563,3352053,4680616,2878876,2111134,2182120,1366473,1383515,953547,10875665,1262224,3206213,4468437,2795858,2096621,2322249,1609060,1654010,1514354,11992152,22867817,32016870,32016870
Poland,1969,PL,POL,EUR,1309129,3268355,4577484,3039660,2073101,2203773,1400610,1385876,997503,11100523,1245465,3123700,4369165,2948245,2060821,2312432,1651193,1668015,1574170,12214876,23315399,32262057,32262057
Poland,2031,PL,POL,EUR,850851,1983837,2834688,2025356,2041367,2758523,3163387,2352717,3481514,15822864,801555,1875349,2676904,1917344,1977846,2708664,3168646,2483792,4983191,17239483,33062347,38573935,38573935
Poland,2032,PL,POL,EUR,833156,1949742,2782898,2037756,2002305,2679931,3156602,2424833,3506321,15807748,784785,1841817,2626602,1928971,1936392,2631596,3162529,2556464,5004318,17220270,33028018,38437517,38437517
Poland,2033,PL,POL,EUR,817154,1910276,2727430,2040749,1982273,2601703,3140003,2497392,3529643,15791763,769601,1803659,2573260,1931250,1913242,2554696,3146916,2629700,5022758,17198562,32990325,38291012,38291012
Poland,2034,PL,POL,EUR,802705,1879856,2682561,2023757,1977623,2521586,3111968,2572349,3553956,15761239,755873,1774043,2529916,1914525,1904700,2476125,3119833,2705044,5041365,17161592,32922831,38135299,38135299
Poland,2035,PL,POL,EUR,790099,1849802,2639901,2005499,1976231,2439810,3075683,2645218,3582719,15725160,743901,1744455,2488356,1898008,1897722,2397072,3083103,2779088,5063132,17118125,32843285,37971541,37971541
Poland,2036,PL,POL,EUR,779173,1813589,2592762,1997416,1973215,2355385,3039255,2708382,3616700,15690353,733536,1709194,2442730,1891831,1888976,2315014,3044909,2843863,5089253,17073846,32764199,37799685,37799685
Poland,2037,PL,POL,EUR,769898,1777489,2547387,1990668,1974547,2271631,2989499,2768136,3656499,15650980,724725,1674017,2398742,1886592,1885644,2232462,2994237,2904214,5120037,17023186,32674166,37620296,37620296
Poland,2038,PL,POL,EUR,762692,1736765,2499457,1990829,1978748,2191726,2917412,2829452,3703657,15611824,717872,1635279,2353151,1886522,1886055,2152822,2921221,2966563,5156730,16969913,32581737,37434342,37434342
Poland,2039,PL,POL,EUR,756960,1694470,2451430,1992905,1983790,2117485,2836154,2881962,3758102,15570398,712426,1595750,2308176,1887271,1888324,2077162,2839299,3020259,5199449,16911764,32482162,37241771,37241771
Poland,2040,PL,POL,EUR,752077,1657964,2410041,1987812,1988318,2055008,2751665,2917234,3820246,15520283,707804,1561450,2269254,1881380,1890760,2011877,2755061,3055508,5248982,16843568,32363851,37043145,37043145
Poland,2041,PL,POL,EUR,748791,1626624,2375415,1971639,1994600,2004417,2670190,2931802,3889745,15462393,704678,1531838,2236516,1864819,1895578,1958796,2672527,3068781,5305668,16766169,32228562,36840499,36840499
Poland,2042,PL,POL,EUR,746927,1599695,2346622,1937720,2007218,1966429,2595324,2928851,3962357,15397899,702893,1506291,2209184,1831360,1907244,1917665,2596754,3063938,5363821,16680782,32078681,36634491,36634491
Poland,2043,PL,POL,EUR,745753,1576529,2322282,1898434,2010497,1947247,2520666,2916528,4034717,15328089,701776,1484282,2186058,1793283,1909578,1894770,2521099,3049770,5420257,16588757,31916846,36425187,36425187
Poland,2044,PL,POL,EUR,745688,1556383,2302071,1868159,1993897,1943245,2444074,2893556,4110961,15253892,701700,1465137,2166837,1763732,1892947,1886428,2443767,3024489,5479841,16491204,31745096,36214005,36214005
Poland,2045,PL,POL,EUR,746307,1538929,2285236,1838234,1976028,1942432,2365850,2862965,4190505,15176014,702258,1448561,2150819,1734203,1876526,1879632,2365965,2989897,5542924,16389147,31565161,36001211,36001211
Poland,2046,PL,POL,EUR,746744,1524747,2271491,1802168,1968260,1939950,2285048,2832104,4267285,15094815,702663,1435094,2137757,1699009,1870418,1871055,2285201,2953859,5603883,16283425,31378240,35787488,35787488
Poland,2047,PL,POL,EUR,747091,1513633,2260724,1766206,1961799,1941698,2204767,2788721,4347521,15010712,702990,1424520,2127510,1663898,1865243,1867849,2203917,2905713,5668378,16174998,31185710,35573947,35573947
Poland,2048,PL,POL,EUR,746782,1505274,2252056,1725647,1962193,1946214,2128079,2724618,4437345,14924096,702684,1416568,2119252,1625232,1865222,1868345,2125461,2836008,5744221,16064489,30988585,35359891,35359891
Poland,2049,PL,POL,EUR,745325,1499502,2244827,1683513,1964469,1951516,2056837,2651891,4527353,14835579,701297,1411063,2112360,1585775,1866023,1870679,2050939,2757700,5821759,15952875,30788454,35145640,35145640
Poland,2050,PL,POL,EUR,743423,1495258,2238681,1647151,1959598,1956285,1996981,2575804,4610173,14745992,699498,1407012,2106510,1551534,1860185,1873173,1986674,2677033,5892565,15841164,30587156,34932339,34932339
Puerto Rico,1970,PR,PRI,AMR,172640,337994,510634,253590,160289,133985,103668,88548,89427,829507,160584,346012,506596,268574,184489,139951,113234,89195,95439,890882,1720389,2737619,2737619
Puerto Rico,1971,PR,PRI,AMR,171876,337611,509487,260955,166266,135640,106284,91239,91148,851532,159366,345095,504461,275007,191532,143766,116876,90561,98797,916539,1768071,2782018,2782018
Puerto Rico,1972,PR,PRI,AMR,171749,337721,509470,266844,173718,137031,109622,93633,92845,873693,159763,343004,502767,280797,199773,148024,120517,92116,102028,943255,1816948,2829184,2829184
Puerto Rico,1973,PR,PRI,AMR,172129,338647,510776,270812,181405,138820,113057,95666,94865,894625,161108,340447,501555,285546,208390,152455,123824,94276,105233,969724,1864349,2876681,2876681
Puerto Rico,1974,PR,PRI,AMR,172960,340404,513364,272638,189310,141227,116382,97443,97323,914323,163281,337544,500825,289214,216850,157465,126600,97086,108637,995852,1910175,2924358,2924358
Puerto Rico,1975,PR,PRI,AMR,173985,342765,516750,273083,197467,143966,119402,99370,100099,933387,165219,335259,500478,292404,224590,162798,129164,100422,112285,1021663,1955050,2972267,2972267
Puerto Rico,1976,PR,PRI,AMR,174782,345547,520329,273892,204460,147283,122135,101527,103113,952410,166403,334477,500880,295597,231210,168334,131719,103910,116067,1046837,1999247,3020456,3020456
Puerto Rico,1977,PR,PRI,AMR,175377,347726,523103,275785,210028,151588,124590,103681,106652,972324,167570,334099,501669,299061,236538,174200,134545,107434,119986,1071764,2044088,3068870,3068870
Puerto Rico,1978,PR,PRI,AMR,175804,348466,524270,279447,214127,157270,126191,105760,110858,993653,168907,333189,502096,303161,240824,180215,137719,111060,124165,1097144,2090797,3117169,3117169
Puerto Rico,1979,PR,PRI,AMR,176629,348150,524779,284908,216433,163984,127045,107620,115946,1015936,170658,331949,502607,307716,244361,186338,140991,114178,129312,1122896,2138832,3166208,3166208
Puerto Rico,1980,PR,PRI,AMR,178275,346083,524358,291793,218138,170383,128705,108918,121174,1039111,172756,329843,502599,312129,247948,191770,144984,116812,134855,1148498,2187609,3214568,3214568
Puerto Rico,1981,PR,PRI,AMR,179730,343000,522730,298451,220319,176519,131267,110318,125181,1062055,174231,327492,501723,314903,252107,197422,149487,119352,139671,1172942,2234997,3259445,3259445
Puerto Rico,1982,PR,PRI,AMR,180077,341362,521439,302553,223152,182866,134134,112034,128415,1083154,174278,326664,500942,315612,255724,204908,152970,122318,144007,1195539,2278693,3301071,3301071
Puerto Rico,1983,PR,PRI,AMR,179186,341163,520349,304942,226606,188426,137317,113645,131502,1102438,172810,327368,500178,315121,259168,212616,155845,125422,148248,1216420,2318858,3339381,3339381
Puerto Rico,1984,PR,PRI,AMR,176614,342246,518860,305996,230077,193601,140957,115100,134759,1120490,169772,329189,498961,313433,262643,219370,159939,127765,152995,1236145,2356635,3374447,3374447
Puerto Rico,1985,PR,PRI,AMR,172339,343963,516302,305706,233665,199076,144521,116551,138382,1137901,165401,331180,496581,311097,266179,225433,164417,130201,158172,1255499,2393400,3406279,3406279
Puerto Rico,1986,PR,PRI,AMR,167639,344361,512000,305587,237794,203701,148002,118324,141969,1155377,160717,332006,492723,309595,269639,230799,168490,133221,163133,1274877,2430254,3434981,3434981
Puerto Rico,1987,PR,PRI,AMR,163504,343337,506841,305521,241821,207445,152333,120055,145546,1172721,156860,331440,488300,308624,272496,235500,173032,136238,168180,1294070,2466791,3461929,3461929
Puerto Rico,1988,PR,PRI,AMR,160923,340898,501821,305460,245312,210904,157205,121538,148967,1189386,154666,329352,484018,307580,274957,239852,177993,138909,173447,1312738,2502124,3487970,3487970
Puerto Rico,1989,PR,PRI,AMR,159989,337098,497087,305928,247498,213895,162712,122779,152802,1205614,153998,325557,479555,307093,276328,243911,183642,140997,179512,1331483,2537097,3513735,3513735
Puerto Rico,1990,PR,PRI,AMR,161090,332452,493542,307047,249748,216864,168022,124541,156501,1222723,155107,320735,475842,307157,277793,248025,189681,143437,185565,1351658,2574381,3543776,3543776
Puerto Rico,1991,PR,PRI,AMR,163541,327848,491389,308150,253094,219889,173259,127224,159091,1240707,157225,315905,473130,307463,279890,251966,196501,146761,190641,1373222,2613929,3578450,3578450
Puerto Rico,1992,PR,PRI,AMR,165199,324062,489261,309139,256179,222042,179446,129780,161824,1258410,158536,311484,470020,308465,281377,254505,204716,149760,196118,1394941,2653351,3612629,3612629
Puerto Rico,1993,PR,PRI,AMR,165735,321335,487070,309872,259662,223831,185237,132170,164388,1275160,158834,307977,466811,309630,282454,257081,212419,152485,201907,1415976,2691136,3645017,3645017
Puerto Rico,1994,PR,PRI,AMR,165268,319430,484698,310162,262622,225938,190563,135457,166336,1291078,158194,305291,463485,310168,282899,260259,219289,156307,207570,1436492,2727570,3675749,3675749
Puerto Rico,1995,PR,PRI,AMR,163979,318300,482279,309517,264550,228372,196048,139100,168662,1306249,156706,303365,460071,309680,283088,263420,226062,160229,213864,1456343,2762592,3704947,3704947
Puerto Rico,1996,PR,PRI,AMR,162238,318040,480278,307954,266637,231131,200499,143060,171201,1320482,154816,302556,457372,307994,283781,266801,231877,163785,220434,1474672,2795154,3732811,3732811
Puerto Rico,1997,PR,PRI,AMR,160428,317761,478189,307266,267484,234300,204081,147327,173914,1334372,152893,302485,455378,305898,284011,269880,236769,168720,226296,1491574,2825946,3759518,3759518
Puerto Rico,1998,PR,PRI,AMR,158651,317420,476071,307766,265886,238413,207312,151654,176907,1347938,150982,302660,453642,304519,282126,272644,241925,174928,231455,1507597,2855535,3785238,3785238
Puerto Rico,1999,PR,PRI,AMR,156913,317110,474023,309153,262173,242591,210628,155979,180613,1361137,149122,302650,451772,304013,277871,276265,246930,181799,236301,1523179,2884316,3810115,3810115
Puerto Rico,2000,PR,PRI,AMR,154951,315517,470468,309063,258705,245680,213353,160083,185247,1372131,147108,301589,448697,301834,274246,279116,250269,188809,241538,1535812,2907943,3827108,3827108
Puerto Rico,2001,PR,PRI,AMR,152089,312571,464660,305481,256972,247402,215122,164945,189731,1379653,144291,299377,443668,296647,273834,278468,252276,195469,247455,1544149,2923802,3832131,3832131
Puerto Rico,2002,PR,PRI,AMR,148116,309524,457640,299551,256947,247179,217030,170756,193808,1385271,140454,296697,437151,290484,274654,276177,253461,202575,253348,1550699,2935970,3830773,3830773
Puerto Rico,2003,PR,PRI,AMR,143316,306242,449558,292991,258020,246200,218330,176671,197893,1390105,135818,293465,429283,284951,274783,273481,254826,209394,259249,1556684,2946789,3825628,3825628
Puerto Rico,2004,PR,PRI,AMR,137952,302211,440163,286942,258643,245189,219103,182580,202085,1394542,130638,289305,419943,280255,274113,270612,256520,215511,265370,1562381,2956923,3817037,3817037
Puerto Rico,2005,PR,PRI,AMR,132304,297273,429577,282086,257694,243718,220375,188204,206644,1398721,125230,284136,409366,276485,272359,268297,257911,221405,271448,1567905,2966626,3805559,3805559
Puerto Rico,2006,PR,PRI,AMR,126963,291282,418245,278540,255448,242067,222067,192385,211869,1402376,120183,277981,398164,273736,269674,266139,259285,226284,277650,1572768,2975144,3791559,3791559
Puerto Rico,2007,PR,PRI,AMR,122539,284125,406664,276059,252436,239957,223640,195499,217648,1405239,116055,270796,386851,271815,266370,263502,260285,230244,284468,1576684,2981923,3775440,3775440
Puerto Rico,2008,PR,PRI,AMR,119048,276031,395079,274758,248316,237002,224993,198193,223974,1407236,112895,262811,375706,270528,262587,259810,260996,233811,291870,1579602,2986838,3757619,3757619
Puerto Rico,2009,PR,PRI,AMR,116554,267425,383979,274514,242938,233566,225783,200439,231068,1408308,110810,254440,365250,269723,257979,255618,261414,236895,299771,1581400,2989708,3738939,3738939
Puerto Rico,2010,PR,PRI,AMR,113778,258758,372536,273529,237659,230425,226251,202173,238462,1408499,108375,246107,354482,268499,252980,251850,261299,239332,308449,1582409,2990908,3717922,3717922
Puerto Rico,2011,PR,PRI,AMR,110106,249945,360051,270581,232645,227875,226518,203314,246136,1407069,104927,237689,342616,266023,247825,248789,260350,241022,317873,1581882,2988951,3691614,3691614
Puerto Rico,2012,PR,PRI,AMR,106159,240636,346795,265848,226779,225676,226152,204245,254174,1402874,101163,228812,329975,262108,242068,246316,258501,242017,327334,1578344,2981218,3657988,3657988
Puerto Rico,2013,PR,PRI,AMR,101614,230525,332139,258916,220296,223358,225367,205541,262056,1395534,96741,219265,316006,256421,235835,244025,256011,242915,336138,1571345,2966879,3615018,3615018
Puerto Rico,2014,PR,PRI,AMR,96155,219575,315730,249044,212926,220327,224402,207675,269683,1384057,91368,209103,300471,248259,228942,241177,253055,244157,344164,1559754,2943811,3560010,3560010
Puerto Rico,2015,PR,PRI,AMR,90298,208042,298340,237252,204877,216466,223360,210484,277252,1369691,85728,198392,284120,238206,221718,237552,249925,245641,352149,1545191,2914882,3497335,3497335
Puerto Rico,2016,PR,PRI,AMR,84456,196499,280955,225116,196677,211917,222138,213500,284805,1354153,80231,187582,267813,227531,214635,233324,246645,247137,360548,1529820,2883973,3432740,3432740
Puerto Rico,2017,PR,PRI,AMR,78308,185556,263864,213028,188583,206916,220283,216381,292159,1337350,74452,177327,251779,216621,207974,228584,242773,248461,369005,1513418,2850768,3366408,3366408
Puerto Rico,2018,PR,PRI,AMR,72552,177481,250033,205235,184017,202731,217322,217977,298849,1326131,69025,169680,238705,208476,204668,224342,238693,249483,378744,1504406,2830537,3319269,3319269
Puerto Rico,2019,PR,PRI,AMR,68408,172095,240503,201453,183192,199170,213623,218215,304604,1320257,65100,164537,229637,203064,204633,220380,234930,250039,389449,1502495,2822752,3292887,3292887
Puerto Rico,2020,PR,PRI,AMR,66152,167144,233296,198112,183497,195136,209947,217942,309909,1314543,62939,159826,222765,198049,205461,215902,231564,249794,400179,1500949,2815492,3271564,3271564
Puerto Rico,2021,PR,PRI,AMR,64917,162455,227372,195091,184667,190863,206873,217110,316010,1310614,61737,155343,217080,193414,206710,211381,228995,248531,411924,1500955,2811569,3256028,3256028
Puerto Rico,2022,PR,PRI,AMR,64796,158830,223626,193923,187811,187230,204551,214990,322003,1310508,61604,151783,213387,190210,209083,207710,227650,246446,423781,1504880,2815388,3252407,3252407
Puerto Rico,2023,PR,PRI,AMR,66560,155663,222223,194623,192980,184810,202709,211765,326855,1313742,63257,148534,211791,188504,212584,205375,227285,243884,434926,1512558,2826300,3260314,3260314
Puerto Rico,2024,PR,PRI,AMR,68211,152639,220850,194943,198102,183242,201189,208468,331444,1317388,64816,145339,210155,186963,215330,204018,227100,241178,445823,1520412,2837800,3268802,3268802
Puerto Rico,2025,PR,PRI,AMR,68482,150960,219442,194286,202766,182262,199728,205403,335845,1320290,65093,143511,208604,184971,216904,203463,226641,238604,456390,1526973,2847263,3275311,3275311
Puerto Rico,2026,PR,PRI,AMR,68393,149732,218125,192646,207060,181782,198152,202563,339828,1322031,65036,142253,207289,182437,217617,203567,225809,236097,466236,1531763,2853794,3279209,3279209
Puerto Rico,2027,PR,PRI,AMR,68324,148209,216533,190605,210715,181951,196548,199605,343377,1322801,64976,140769,205745,179930,217480,204482,224608,233276,475301,1535077,2857878,3280157,3280157
Puerto Rico,2028,PR,PRI,AMR,68316,146592,214908,187996,213372,183024,194862,196275,346756,1322285,64979,139218,204197,177204,216381,206355,222797,230053,483818,1536608,2858893,3277996,3277996
Puerto Rico,2029,PR,PRI,AMR,68163,144724,212887,184700,214834,185022,192827,192856,350085,1320324,64846,137441,202287,174148,214334,208946,220086,226856,491793,1536163,2856487,3271656,3271656
Puerto Rico,2030,PR,PRI,AMR,67732,142568,210300,180356,214886,187679,190332,189907,353219,1316379,64450,135407,199857,170411,211312,211812,216618,224140,498894,1533187,2849566,3259722,3259722
Puerto Rico,1950,PR,PRI,AMR,196113,299622,495735,199234,147808,113417,74513,51188,39719,625879,190633,290411,481044,209741,153458,107944,68348,46391,41202,627084,1252963,2229742,2229742
Puerto Rico,1951,PR,PRI,AMR,196866,304008,500874,198054,147010,115501,75892,52103,41029,629589,190694,296094,486788,208162,155034,110616,69370,47413,42552,633147,1262736,2250405,2250405
Puerto Rico,1952,PR,PRI,AMR,195761,307785,503546,197350,146999,117341,77563,53203,42496,634952,188905,301412,490317,206781,157266,112982,70717,48662,43995,640403,1275355,2269211,2269211
Puerto Rico,1953,PR,PRI,AMR,193204,312411,505615,196113,146544,118631,79458,54422,44049,639217,186058,306639,492697,205506,158942,115036,72186,50092,45517,647279,1286496,2284810,2284810
Puerto Rico,1954,PR,PRI,AMR,189930,317559,507489,194478,145341,119379,81636,55759,45709,642302,183068,311493,494561,204397,159726,116869,73837,51653,47172,653654,1295956,2298008,2298008
Puerto Rico,1955,PR,PRI,AMR,186669,322681,509350,192900,143267,119614,84020,57231,47467,644499,180291,315983,496274,203748,159369,118561,75659,53316,49005,659658,1304157,2309782,2309782
Puerto Rico,1956,PR,PRI,AMR,183865,327014,510879,192148,140158,119480,86565,58723,49361,646435,177989,319619,497608,204057,157659,120282,77675,54913,51052,665638,1312073,2320567,2320567
Puerto Rico,1957,PR,PRI,AMR,181387,329725,511112,192968,135946,118976,89219,60101,51470,648680,176249,321683,497932,205666,154641,122002,79944,56266,53374,671893,1320573,2329614,2329614
Puerto Rico,1958,PR,PRI,AMR,179382,330325,509707,195731,130773,118045,91731,61318,53817,651415,174944,322054,496998,208779,150752,123536,82349,57284,55976,678676,1330091,2336795,2336795
Puerto Rico,1959,PR,PRI,AMR,178482,329192,507674,200120,125019,116695,93746,62382,56335,654297,174639,321059,495698,213400,146588,124698,84636,57946,58757,686025,1340322,2343690,2343690
Puerto Rico,1960,PR,PRI,AMR,179117,327165,506282,207646,122496,115766,95710,63500,59061,664179,175763,319657,495420,220505,144836,125999,87594,58692,61563,699189,1363368,2365072,2365072
Puerto Rico,1961,PR,PRI,AMR,180363,324867,505230,217891,124812,115701,98039,64910,61974,683327,177384,318671,496055,229461,146623,127726,91361,60071,64367,719609,1402936,2404223,2404223
Puerto Rico,1962,PR,PRI,AMR,181256,322857,504113,227335,128756,115947,100312,66689,64898,703937,178733,318129,496862,237867,149869,129273,94845,62214,67305,741373,1445310,2446291,2446291
Puerto Rico,1963,PR,PRI,AMR,181706,322098,503804,234370,133049,116425,102189,68880,67799,722712,179578,318614,498192,244792,153721,130432,97721,65128,70368,762162,1484874,2486863,2486863
Puerto Rico,1964,PR,PRI,AMR,181320,323365,504685,238792,137654,117378,103541,71383,70670,739418,179267,321066,500333,250068,158047,131400,100058,68695,73440,781708,1521126,2526147,2526147
Puerto Rico,1965,PR,PRI,AMR,179974,326413,506387,241195,142442,118938,104311,74098,73623,754607,177806,325289,503095,253886,162664,132287,102080,72684,76578,800179,1554786,2564270,2564270
Puerto Rico,1966,PR,PRI,AMR,178251,330051,508302,242506,147178,121147,104469,76997,76700,768997,175743,330324,506067,256595,167365,133147,104040,76837,79849,817833,1586830,2601197,2601197
Puerto Rico,1967,PR,PRI,AMR,176751,333198,509949,243565,151561,124007,104090,80014,79926,783163,173110,335456,508566,258712,171950,134137,106049,80875,83334,835057,1618220,2636741,2636741
Puerto Rico,1968,PR,PRI,AMR,175452,335684,511136,245145,155048,127424,103440,82994,83285,797336,169563,340229,509792,260903,176144,135469,108150,84464,87138,852268,1649604,2670526,2670526
Puerto Rico,1969,PR,PRI,AMR,174013,337521,511534,247922,157176,131106,102884,85800,86733,811621,164630,344257,508887,263726,179734,137255,110339,87303,91402,869759,1681380,2701800,2701800
Puerto Rico,2031,PR,PRI,AMR,67052,140286,207338,174945,213371,190680,187454,187864,355890,1310204,63820,133269,197089,165872,207292,214506,212824,222259,504680,1527433,2837637,3242061,3242061
Puerto Rico,2032,PR,PRI,AMR,66161,138140,204301,168699,210318,193799,184444,186792,357933,1301985,62988,131282,194270,160616,202390,216699,209116,221345,509007,1519173,2821158,3219727,3219727
Puerto Rico,2033,PR,PRI,AMR,65127,137205,202332,161311,205871,196864,181776,186310,359476,1291608,62020,130445,192465,154162,196827,218229,205922,221067,512283,1508490,2800098,3194891,3194891
Puerto Rico,2034,PR,PRI,AMR,64052,136177,200229,154221,200637,199560,179704,186037,360934,1281093,61005,129525,190530,147763,191231,218704,203564,220883,515240,1497385,2778478,3169240,3169240
Puerto Rico,2035,PR,PRI,AMR,62931,133925,196856,148972,194680,201819,178122,185679,362492,1271764,59940,127457,187397,143046,185441,218026,202011,220395,518252,1487171,2758935,3143193,3143193
Puerto Rico,2036,PR,PRI,AMR,61703,131540,193243,144740,188211,203826,176973,185048,363873,1262671,58772,125267,184039,139275,179498,216604,201170,219511,520935,1476993,2739664,3116945,3116945
Puerto Rico,2037,PR,PRI,AMR,60377,129397,189774,140769,181935,205352,176440,184204,364736,1253436,57508,123281,180789,135671,174043,214494,201209,218223,522860,1466500,2719936,3090506,3090506
Puerto Rico,2038,PR,PRI,AMR,58992,127512,186504,137203,175759,206072,176799,183106,365068,1244007,56194,121524,177718,132372,168861,211616,202288,216308,524204,1455649,2699656,3063872,3063872
Puerto Rico,2039,PR,PRI,AMR,57557,125729,183286,133957,169778,205939,178155,181525,365164,1234518,54826,119858,174684,129308,163969,208116,204229,213531,525420,1444573,2679091,3037059,3037059
Puerto Rico,2040,PR,PRI,AMR,56090,123967,180057,131116,163919,204968,180344,179381,365324,1225052,53428,118197,171625,126573,159204,204166,206682,210055,526688,1433368,2658420,3010093,3010093
Puerto Rico,2041,PR,PRI,AMR,54599,122165,176764,128824,158168,203088,183110,176786,365676,1215652,52010,116498,168508,124320,154450,199808,209219,206345,527936,1422078,2637730,2982999,2982999
Puerto Rico,2042,PR,PRI,AMR,53160,120281,173441,127171,152493,200238,186201,174011,366167,1206281,50637,114713,165350,122675,149593,195064,211477,202792,529092,1410693,2616974,2955760,2955760
Puerto Rico,2043,PR,PRI,AMR,51804,118281,170085,126916,146088,196276,189358,171557,366689,1196884,49346,112809,162155,122367,143815,189900,213177,199792,530084,1399135,2596019,2928255,2928255
Puerto Rico,2044,PR,PRI,AMR,50557,116155,166712,126540,140008,191590,192190,169707,367341,1187376,48160,110784,158944,121971,138106,184741,213857,197630,531032,1387337,2574713,2900369,2900369
Puerto Rico,2045,PR,PRI,AMR,49470,113883,163353,124857,135691,186172,194609,168349,368086,1177764,47124,108618,155742,120370,134016,179375,213396,196266,531893,1375316,2553080,2872173,2872173
Puerto Rico,2046,PR,PRI,AMR,48534,111416,159950,122957,132266,180203,196765,167417,368518,1168126,46236,106266,152502,118574,130786,173810,212168,195598,532198,1363134,2531260,2843718,2843718
Puerto Rico,2047,PR,PRI,AMR,47709,108840,156549,121203,128972,174367,198435,167058,368386,1158421,45452,103811,149263,116913,127629,168682,210236,195771,531553,1350784,2509205,2815019,2815019
Puerto Rico,2048,PR,PRI,AMR,46922,106252,153174,119621,125960,168580,199288,167533,367618,1148600,44701,101337,146038,115418,124695,163781,207516,196943,529920,1338273,2486873,2786081,2786081
Puerto Rico,2049,PR,PRI,AMR,46152,103676,149828,118072,123141,162930,199290,168941,366300,1138674,43967,98882,142849,113953,121904,159114,204159,198937,527509,1325576,2464250,2756931,2756931
Puerto Rico,2050,PR,PRI,AMR,45390,101190,146580,116458,120593,157333,198447,171130,364641,1128602,43240,96517,139757,112419,119349,154512,200327,201412,524659,1312678,2441280,2727624,2727624
Democratic People's Republic of Korea,1970,KP,PRK,SEA,1237772,1848263,3086035,1239018,1329109,636647,339392,237148,165559,3946873,1183029,1790708,2973737,1253419,1437680,999677,624531,355890,319036,4990233,8937106,14996879,14996879
Democratic People's Republic of Korea,1971,KP,PRK,SEA,1261309,1915943,3177252,1244704,1352018,702508,346697,243081,167547,4056555,1204663,1854352,3059015,1251435,1445099,1043829,655460,365060,327915,5088798,9145353,15381626,15381626
Democratic People's Republic of Korea,1972,KP,PRK,SEA,1266284,1984024,3250308,1270715,1364630,776072,355651,249339,168966,4185373,1208499,1918136,3126635,1269082,1445062,1092241,685176,377472,337005,5206038,9391411,15768363,15768363
Democratic People's Republic of Korea,1973,KP,PRK,SEA,1248382,2038262,3286644,1326408,1362992,855399,365880,255883,170377,4336939,1190630,1968286,3158916,1314572,1434682,1143719,713579,392873,346199,5345624,9682563,16128122,16128122
Democratic People's Republic of Korea,1974,KP,PRK,SEA,1207044,2098150,3305194,1381168,1350341,934783,379190,262018,172612,4480112,1150581,2023848,3174429,1358002,1416644,1193740,742544,411121,355216,5477267,9957379,16437002,16437002
Democratic People's Republic of Korea,1975,KP,PRK,SEA,1152962,2167831,3320793,1424828,1339203,1009600,397778,267409,175740,4614558,1098425,2088781,3187206,1392797,1399051,1240137,772908,431709,364087,5600689,10215247,16723252,16723252
Democratic People's Republic of Korea,1976,KP,PRK,SEA,1090401,2235442,3325843,1489394,1305707,1079947,421382,271854,179840,4748124,1038295,2151607,3189902,1451657,1357150,1282603,804244,454748,372893,5723295,10471419,16987170,16987170
Democratic People's Republic of Korea,1977,KP,PRK,SEA,1016579,2301874,3318453,1578571,1250245,1143896,450995,275431,184945,4884083,967532,2213162,3180694,1536067,1293439,1320008,836700,480203,381733,5848150,10732233,17231389,17231389
Democratic People's Republic of Korea,1978,KP,PRK,SEA,954451,2339628,3294079,1667539,1211531,1198184,488564,278817,190478,5035113,907939,2247162,3155101,1620547,1246824,1350476,871273,507796,390883,5987799,11022912,17472094,17472094
Democratic People's Republic of Korea,1979,KP,PRK,SEA,921104,2342344,3263448,1744734,1196260,1239930,535828,283083,195594,5195429,875869,2247690,3123559,1693649,1223860,1372110,909267,536849,400984,6136719,11332148,17719172,17719172
Democratic People's Republic of Korea,1980,KP,PRK,SEA,903200,2329394,3232594,1809315,1198674,1271118,591694,288676,200093,5359570,858564,2233369,3091933,1754534,1218603,1386795,950208,566704,412715,6289559,11649129,17973650,17973650
Democratic People's Republic of Korea,1981,KP,PRK,SEA,900521,2294731,3195252,1877598,1206320,1295224,654560,295760,204158,5533620,855764,2198434,3054198,1818955,1218536,1396484,994498,596515,427148,6452136,11985756,18235202,18235202
Democratic People's Republic of Korea,1982,KP,PRK,SEA,910833,2230438,3141271,1946404,1233763,1309560,724813,304309,208023,5726872,865343,2135250,3000593,1883637,1237623,1398940,1043016,625432,444698,6633346,12360218,18502087,18502087
Democratic People's Republic of Korea,1983,KP,PRK,SEA,924414,2155098,3079512,2001836,1290112,1310241,800642,314046,212076,5928953,878046,2061622,2939668,1935063,1283906,1391309,1094591,653320,465038,6823227,12752180,18771363,18771363
Democratic People's Republic of Korea,1984,KP,PRK,SEA,937327,2085102,3022429,2062934,1345479,1300300,876720,326631,216404,6128468,890101,1993289,2883390,1991881,1328139,1376162,1144910,681932,487840,7010864,13139332,19045154,19045154
Democratic People's Republic of Korea,1985,KP,PRK,SEA,949977,2017436,2967413,2133703,1390036,1291805,948712,344027,220785,6329068,901915,1927298,2829213,2057946,1363924,1361345,1191872,712019,512689,7199795,13528863,19325487,19325487
Democratic People's Republic of Korea,1986,KP,PRK,SEA,962832,1956139,2918971,2202472,1454927,1261521,1016665,365931,225015,6526531,913950,1867546,2781496,2121970,1423249,1322658,1235151,743208,539804,7386040,13912571,19613038,19613038
Democratic People's Republic of Korea,1987,KP,PRK,SEA,974908,1896248,2871156,2270066,1543821,1209769,1078745,393239,229135,6724775,925287,1809290,2734577,2184753,1507649,1262486,1273639,775636,569223,7573386,14298161,19903893,19903893
Democratic People's Republic of Korea,1988,KP,PRK,SEA,987349,1850679,2838028,2309422,1632797,1174187,1131932,427781,233346,6909465,937064,1764811,2701875,2220339,1592315,1218846,1305485,810246,600867,7748098,14657563,20197464,20197464
Democratic People's Republic of Korea,1989,KP,PRK,SEA,999576,1832430,2832006,2314210,1710527,1161367,1173559,471195,237869,7068727,948780,1746557,2695337,2222806,1665976,1198229,1328836,848298,634758,7898903,14967630,20494965,20494965
Democratic People's Republic of Korea,1990,KP,PRK,SEA,1012215,1828833,2841048,2303421,1776084,1165782,1205465,522484,242908,7216144,961051,1742401,2703452,2210467,1727736,1194872,1345502,889345,670967,8038889,15255033,20799523,20799523
Democratic People's Republic of Korea,1991,KP,PRK,SEA,1027161,1840196,2867357,2271038,1845444,1175351,1230950,580226,248774,7351783,975687,1752585,2728272,2177595,1793079,1196557,1357358,933810,709730,8168129,15519912,21115534,21115534
Democratic People's Republic of Korea,1992,KP,PRK,SEA,1044866,1863403,2908269,2209220,1915553,1204352,1247387,644754,255515,7476781,992999,1774173,2767172,2116606,1858794,1217061,1362202,982490,750620,8287773,15764554,21439991,21439991
Democratic People's Republic of Korea,1993,KP,PRK,SEA,1064707,1889988,2954695,2136300,1972667,1261700,1250904,714347,263178,7599096,1012203,1799164,2811367,2045262,1911704,1264486,1357398,1034947,794063,8407860,16006956,21773017,21773017
Democratic People's Republic of Korea,1994,KP,PRK,SEA,1085461,1915108,3000569,2067707,2034243,1317319,1243695,783436,274540,7720940,1032073,1823135,2855208,1978822,1969686,1309661,1344726,1086064,839550,8528509,16249449,22105225,22105225
Democratic People's Republic of Korea,1995,KP,PRK,SEA,1096345,1937325,3033670,1999287,2102503,1360011,1235091,845498,288838,7831228,1042158,1844698,2886856,1913069,2034948,1344967,1329856,1130084,880858,8633782,16465010,22385536,22385536
Democratic People's Republic of Korea,1996,KP,PRK,SEA,1093131,1959242,3052373,1935966,2166796,1420604,1203135,900845,303858,7931204,1038551,1866070,2904621,1852181,2096534,1402070,1289690,1167248,918423,8726146,16657350,22614347,22614347
Democratic People's Republic of Korea,1997,KP,PRK,SEA,1082018,1982276,3064294,1874151,2229486,1503983,1150488,950092,321898,8030098,1027560,1888363,2915923,1792618,2156470,1483442,1228444,1199128,956960,8817062,16847160,22827373,22827373
Democratic People's Republic of Korea,1998,KP,PRK,SEA,1064979,2005621,3070600,1826523,2264052,1586986,1113607,990781,344275,8126224,1011166,1910718,2921884,1746521,2189150,1564681,1183460,1224050,997071,8904933,17031157,23023636,23023636
Democratic People's Republic of Korea,1999,KP,PRK,SEA,1045560,2025810,3071370,1805792,2264368,1658652,1098693,1020907,372102,8220514,992721,1929768,2922489,1726164,2188768,1634688,1160963,1240322,1039217,8990122,17210636,23204498,23204498
Democratic People's Republic of Korea,2000,KP,PRK,SEA,1024044,2040143,3064187,1799377,2249287,1718137,1100299,1042338,404404,8313842,972238,1943152,2915390,1719500,2173531,1692612,1155258,1249830,1082910,9073641,17387483,23367059,23367059
Democratic People's Republic of Korea,2001,KP,PRK,SEA,1000578,2048679,3049257,1807431,2213097,1780923,1106775,1058169,439875,8406270,949787,1951058,2900845,1726693,2137923,1753635,1154432,1254682,1128791,9156156,17562426,23512522,23512522
Democratic People's Republic of Korea,2002,KP,PRK,SEA,975329,2051776,3027105,1826765,2148357,1844232,1131620,1066360,478574,8495908,925670,1953688,2879358,1744739,2074639,1814708,1171800,1253031,1177122,9236039,17731947,23638411,23638411
Democratic People's Republic of Korea,2003,KP,PRK,SEA,952737,2051933,3004670,1849861,2074336,1896602,1184761,1066190,521654,8593404,904261,1953335,2857596,1766387,2002037,1864029,1216216,1244908,1232462,9326039,17919443,23781707,23781707
Democratic People's Republic of Korea,2004,KP,PRK,SEA,935078,2050025,2985103,1872256,2006736,1955603,1238065,1059752,566627,8699039,887664,1950815,2838479,1787368,1935379,1919323,1259535,1232328,1292376,9426309,18125348,23948930,23948930
Democratic People's Republic of Korea,2005,KP,PRK,SEA,918365,2041060,2959425,1894065,1941335,2023256,1280975,1054512,609077,8803220,871868,1941499,2813367,1807884,1870766,1983026,1294394,1219635,1349265,9524970,18328190,24100982,24100982
Democratic People's Republic of Korea,2006,KP,PRK,SEA,900719,2023737,2924456,1917837,1882014,2088486,1341607,1029650,648417,8908011,855071,1924275,2779346,1830278,1811982,2044227,1350805,1184248,1402405,9623945,18531956,24235761,24235761
Democratic People's Republic of Korea,2007,KP,PRK,SEA,883874,1999382,2883256,1942867,1824030,2152143,1423250,985611,684064,9011965,838878,1900647,2739525,1853721,1754457,2103743,1430176,1128530,1451138,9721765,18733730,24356506,24356506
Democratic People's Republic of Korea,2008,KP,PRK,SEA,871202,1968830,2840032,1968469,1779736,2188613,1504956,956285,715883,9113942,826667,1871369,2698036,1877477,1710117,2136624,1509607,1088174,1495044,9817043,18930985,24469047,24469047
Democratic People's Republic of Korea,2009,KP,PRK,SEA,860639,1936420,2797059,1991309,1761587,2191892,1576336,948484,746514,9216122,816579,1840560,2657139,1898435,1691145,2137409,1578653,1069689,1535858,9911189,19127311,24581509,24581509
Democratic People's Republic of Korea,2010,KP,PRK,SEA,846244,1903424,2749668,2008767,1757419,2180263,1636412,957891,779679,9320431,802847,1809326,2612173,1914396,1685868,2124081,1636582,1068108,1575124,10004159,19324590,24686435,24686435
Democratic People's Republic of Korea,2011,KP,PRK,SEA,830582,1868768,2699350,2020881,1767408,2148107,1699719,973149,816483,9425747,787879,1776537,2564416,1925538,1694437,2091183,1698019,1072029,1613065,10094271,19520018,24783789,24783789
Democratic People's Republic of Korea,2012,KP,PRK,SEA,819913,1835406,2655319,2028004,1788454,2088162,1763897,1006035,855104,9529656,777611,1745083,2522694,1932075,1713947,2031511,1760215,1094004,1648345,10180097,19709753,24887770,24887770
Democratic People's Republic of Korea,2013,KP,PRK,SEA,813638,1805555,2619193,2030302,1812396,2017955,1816377,1063193,891931,9632154,771445,1717004,2488449,1934126,1736555,1962064,1810544,1140897,1677841,10262027,19894181,25001819,25001819
Democratic People's Republic of Korea,2014,KP,PRK,SEA,812116,1777976,2590092,2028448,1834852,1952856,1873424,1117897,926602,9734079,769763,1691077,2460840,1932286,1758065,1897814,1865906,1185618,1701429,10341118,20075197,25126131,25126131
Democratic People's Republic of Korea,2015,KP,PRK,SEA,820758,1747284,2568042,2018795,1855979,1889348,1938134,1162590,969918,9834764,777750,1662297,2440047,1923653,1779076,1835302,1928838,1222123,1726169,10415161,20249925,25258015,25258015
Democratic People's Republic of Korea,2016,KP,PRK,SEA,836101,1714149,2550250,2000138,1878181,1831115,1999862,1220946,1002062,9932304,792078,1631208,2423286,1907073,1801802,1778138,1988573,1277440,1730741,10483767,20416071,25389611,25389611
Democratic People's Republic of Korea,2017,KP,PRK,SEA,849852,1686814,2536666,1974721,1901525,1774253,2060018,1295714,1017033,10023264,804860,1605359,2410219,1884169,1825658,1722387,2046810,1353034,1714113,10546171,20569435,25516321,25516321
Democratic People's Republic of Korea,2018,KP,PRK,SEA,860480,1668034,2528514,1943366,1925305,1730698,2094124,1370543,1042414,10106450,814737,1587489,2402226,1855637,1849862,1679663,2079232,1428747,1707822,10600963,20707413,25638149,25638149
Democratic People's Republic of Korea,2019,KP,PRK,SEA,867732,1656142,2523874,1910359,1946231,1712428,2096183,1436166,1082632,10183999,821481,1576125,2397606,1825484,1871205,1661749,2080136,1494571,1716817,10649962,20833961,25755441,25755441
Democratic People's Republic of Korea,2020,KP,PRK,SEA,871673,1650699,2522372,1877046,1961870,1707668,2083734,1491426,1134136,10255880,825086,1570815,2395901,1794898,1887532,1657118,2066877,1549487,1737398,10693310,20949190,25867467,25867467
Democratic People's Republic of Korea,2021,KP,PRK,SEA,873337,1650747,2524084,1842290,1972269,1716533,2051460,1549277,1188470,10320299,826521,1570625,2397146,1762744,1899018,1665938,2034233,1607203,1761239,10730375,21050674,25971909,25971909
Democratic People's Republic of Korea,2022,KP,PRK,SEA,872883,1654198,2527081,1808958,1977801,1736090,1993048,1608599,1253545,10378041,825970,1573535,2399505,1731798,1905795,1685350,1975546,1665972,1800327,10764788,21142829,26069416,26069416
Democratic People's Republic of Korea,2023,KP,PRK,SEA,870196,1658942,2529138,1779229,1978715,1758448,1925325,1658063,1331788,10431568,823332,1577563,2400895,1704118,1908006,1707675,1907429,1713955,1858039,10799222,21230790,26160821,26160821
Democratic People's Republic of Korea,2024,KP,PRK,SEA,865167,1665038,2530205,1751799,1975654,1779271,1862542,1711061,1400868,10481195,818481,1582862,2401343,1678487,1906241,1728743,1844288,1766019,1908062,10831840,21313035,26244582,26244582
Democratic People's Republic of Korea,2025,KP,PRK,SEA,858196,1677850,2536046,1721574,1965905,1799544,1802134,1770968,1460632,10520757,811806,1594583,2406389,1650021,1897878,1749499,1783472,1825609,1950253,10856732,21377489,26319924,26319924
Democratic People's Republic of Korea,2026,KP,PRK,SEA,850100,1694982,2545082,1689211,1948289,1821693,1747647,1828322,1516995,10552157,804106,1610423,2414529,1619298,1881858,1772247,1728556,1882844,1990846,10875649,21427806,26387425,26387425
Democratic People's Republic of Korea,2027,KP,PRK,SEA,840948,1708459,2549407,1662585,1924116,1845013,1694718,1884155,1572559,10583146,795463,1622782,2418245,1593789,1859612,1796153,1675195,1938640,2032508,10895897,21479043,26446694,26446694
Democratic People's Republic of Korea,2028,KP,PRK,SEA,830604,1716665,2547269,1644407,1894162,1868794,1654507,1916162,1637081,10615113,785719,1630203,2415922,1576213,1831822,1820448,1634550,1970057,2085712,10918802,21533915,26497102,26497102
Democratic People's Republic of Korea,2029,KP,PRK,SEA,818739,1719149,2537888,1633059,1862591,1889830,1638253,1918481,1706227,10648441,774537,1632283,2406820,1565121,1802431,1841965,1617957,1971456,2145786,10944716,21593157,26537870,26537870
Democratic People's Republic of Korea,2030,KP,PRK,SEA,806024,1716339,2522363,1628086,1830599,1905628,1634802,1907356,1775849,10682320,762564,1629352,2391916,1560031,1772484,1858446,1614238,1959366,2208232,10972797,21655117,26569401,26569401
Democratic People's Republic of Korea,1950,KP,PRK,SEA,866672,1539751,2406423,991077,614695,436896,318464,213357,122014,2696503,883803,1645039,2528842,1258475,833915,506803,402446,290210,179770,3471619,6168122,11103379,11103379
Democratic People's Republic of Korea,1951,KP,PRK,SEA,776327,1524404,2300731,938556,525630,389177,283071,189892,103783,2430109,788778,1617878,2406656,1257495,832127,494697,389856,280924,165371,3420470,5850579,10557969,10557969
Democratic People's Republic of Korea,1952,KP,PRK,SEA,679064,1512749,2191813,945548,478726,364972,263521,179832,96746,2329345,687808,1593857,2281665,1272332,836528,492563,384383,278314,161122,3425242,5754587,10228066,10228066
Democratic People's Republic of Korea,1953,KP,PRK,SEA,628139,1496869,2125008,995727,461740,357917,255723,178834,96914,2346855,630408,1568369,2198777,1301161,847105,499330,384308,280745,164292,3476941,5823796,10147600,10147600
Democratic People's Republic of Korea,1954,KP,PRK,SEA,616564,1473881,2090445,1062102,460078,356930,253554,180791,99831,2413286,609435,1539098,2148533,1336027,863809,512586,386016,284629,170906,3553973,5967259,10206242,10206242
Democratic People's Republic of Korea,1955,KP,PRK,SEA,624416,1455512,2079928,1133736,472341,359163,255372,184179,104367,2509158,609319,1513282,2122601,1373164,886809,531059,388573,289169,179799,3648573,6157731,10360269,10360269
Democratic People's Republic of Korea,1956,KP,PRK,SEA,663594,1413969,2077563,1204190,493861,361648,259268,187610,109264,2615841,643529,1462447,2105976,1410324,914275,553964,391274,293383,189574,3752794,6368635,10552182,10552182
Democratic People's Republic of Korea,1957,KP,PRK,SEA,748637,1349524,2098161,1269863,524603,363934,265039,191072,114387,2728898,723735,1389111,2112846,1444757,945266,580764,394059,297162,200184,3862192,6591090,10802103,10802103
Democratic People's Republic of Korea,1958,KP,PRK,SEA,841891,1303810,2145701,1325537,565262,366311,271902,194291,119519,2842822,812092,1334930,2147022,1472654,979395,610442,397002,300738,211078,3971309,6814131,11106854,11106854
Democratic People's Republic of Korea,1959,KP,PRK,SEA,901824,1283548,2185372,1367126,616808,369857,278764,196991,124448,2953994,868777,1306448,2175225,1490953,1017168,641701,400883,304523,221555,4076783,7030777,11391376,11391376
Democratic People's Republic of Korea,1960,KP,PRK,SEA,933971,1282242,2216213,1396794,677804,375115,285335,199211,129149,3063408,899084,1296990,2196074,1501667,1057921,673642,406651,308677,231416,4179974,7243382,11655666,11655666
Democratic People's Republic of Korea,1961,KP,PRK,SEA,958023,1286410,2244433,1418449,746367,382247,291875,200903,133659,3173500,921836,1293053,2214889,1506927,1102064,705149,415505,313332,240709,4283686,7457186,11916515,11916515
Democratic People's Republic of Korea,1962,KP,PRK,SEA,964198,1311468,2275666,1429232,822870,391153,298891,201861,137957,3281964,927391,1309361,2236752,1504424,1150556,735216,427860,318584,249477,4386117,7668081,12180505,12180505
Democratic People's Republic of Korea,1963,KP,PRK,SEA,962895,1367045,2329940,1425128,905262,401405,306270,202840,142089,3382994,925484,1354306,2279790,1491218,1202129,763743,443458,324032,257938,4482518,7865512,12475236,12475236
Democratic People's Republic of Korea,1964,KP,PRK,SEA,979693,1421383,2401076,1409585,987492,414924,313074,204916,146042,3476033,940990,1396903,2337893,1470152,1252030,792724,462162,329036,266415,4572519,8048552,12787523,12787523
Democratic People's Republic of Korea,1965,KP,PRK,SEA,1009068,1464083,2473151,1395628,1064645,434059,318879,208209,149769,3571189,968579,1430458,2399037,1449616,1297995,823062,483434,333463,274997,4662567,8233756,13105946,13105946
Democratic People's Republic of Korea,1966,KP,PRK,SEA,1049904,1528302,2578206,1358616,1136859,458517,323422,212671,153368,3643453,1007007,1488736,2495743,1404152,1339726,854297,507375,337467,283632,4726649,8370102,13444048,13444048
Democratic People's Republic of Korea,1967,KP,PRK,SEA,1108691,1617870,2726561,1298995,1202122,489333,326754,218327,156895,3692426,1062464,1573281,2635745,1336394,1376106,886598,533970,341193,292423,4766684,8459110,13821409,13821409
Democratic People's Republic of Korea,1968,KP,PRK,SEA,1160982,1707152,2868134,1256741,1257048,528581,329760,224739,160207,3757076,1111514,1657823,2769337,1286374,1405203,921008,562891,344946,301327,4821749,8578825,14216305,14216305
Democratic People's Republic of Korea,1969,KP,PRK,SEA,1200769,1784241,2985010,1238751,1298674,578088,333798,231102,163102,3843515,1148569,1730577,2879146,1260773,1425060,958874,593334,349556,310216,4897813,8741328,14605481,14605481
Democratic People's Republic of Korea,2031,KP,PRK,SEA,792725,1710060,2502785,1628546,1797128,1916294,1644302,1878249,1850557,10715076,750024,1623174,2373198,1560036,1740874,1870079,1623541,1928964,2277922,11001416,21716492,26592481,26592481
Democratic People's Republic of Korea,2032,KP,PRK,SEA,778826,1700655,2479481,1632329,1765006,1922185,1663837,1825441,1937367,10746165,736889,1614103,2350992,1563101,1710471,1877047,1643039,1874007,2362308,11029973,21776138,26606610,26606610
Democratic People's Republic of Korea,2033,KP,PRK,SEA,764674,1687910,2452584,1637338,1736332,1923503,1685888,1764247,2028183,10775491,723512,1601904,2325416,1567269,1683279,1879478,1665279,1810191,2452781,11058277,21833768,26611771,26611771
Democratic People's Republic of Korea,2034,KP,PRK,SEA,751115,1671332,2422447,1643686,1709907,1920946,1706489,1707858,2114270,10803156,710692,1586065,2296757,1572697,1658119,1877978,1686297,1751231,2539989,11086311,21889467,26608668,26608668
Democratic People's Republic of Korea,2035,KP,PRK,SEA,738364,1651974,2390338,1656619,1680719,1911882,1726606,1654050,2198405,10828281,698629,1567617,2266246,1584488,1630129,1869973,1707043,1694702,2626851,11113186,21941467,26598048,26598048
Democratic People's Republic of Korea,2036,KP,PRK,SEA,725882,1630921,2356803,1673767,1649423,1895172,1748593,1605955,2277305,10850215,686829,1547578,2234407,1600364,1599892,1854417,1729764,1643938,2709762,11138137,21988352,26579554,26579554
Democratic People's Republic of Korea,2037,KP,PRK,SEA,714156,1608212,2322368,1687301,1623754,1872087,1771744,1559678,2354154,10868718,675750,1525997,2201747,1612770,1574826,1832731,1753640,1594869,2791824,11160660,22029378,26553492,26553492
Democratic People's Republic of Korea,2038,KP,PRK,SEA,704060,1584074,2288134,1695629,1606358,1843367,1795338,1525075,2417802,10883569,666215,1503069,2169284,1620268,1557616,1805569,1777888,1557865,2861235,11180441,22064010,26521434,26521434
Democratic People's Republic of Korea,2039,KP,PRK,SEA,695785,1559010,2254795,1698317,1595654,1813076,1816287,1512104,2459103,10894541,658396,1479265,2137661,1622448,1546830,1776828,1799400,1543464,2908149,11197119,22091660,26484115,26484115
Democratic People's Republic of Korea,2040,KP,PRK,SEA,688939,1533897,2222836,1695776,1591193,1782362,1832182,1510790,2488833,10901136,651921,1455422,2107343,1619648,1541995,1747526,1815984,1541234,2943693,11210080,22111216,26441399,26441399
Democratic People's Republic of Korea,2041,KP,PRK,SEA,683818,1508468,2192286,1689810,1592045,1750200,1843147,1521232,2507160,10903594,647072,1431270,2078342,1613613,1542198,1716575,1827819,1551291,2967880,11219376,22122970,26393589,26393589
Democratic People's Republic of Korea,2042,KP,PRK,SEA,680641,1483184,2163825,1680744,1596150,1719334,1849486,1540680,2515237,10901631,644037,1407232,2051269,1604695,1545426,1686803,1835066,1570901,2981769,11224660,22126291,26341393,26341393
Democratic People's Republic of Korea,2043,KP,PRK,SEA,678912,1459267,2138179,1668375,1601455,1691830,1851380,1562345,2519538,10894923,642356,1384491,2026847,1592664,1549748,1660201,1837855,1593061,2992018,11225547,22120470,26285495,26285495
Democratic People's Republic of Korea,2044,KP,PRK,SEA,678518,1437743,2116261,1652208,1608067,1666510,1849518,1582698,2524062,10883063,641944,1364010,2005954,1577004,1555312,1635599,1836784,1614068,3002666,11221433,22104496,26226715,26226715
Democratic People's Republic of Korea,2045,KP,PRK,SEA,679450,1418444,2097894,1633299,1621128,1638469,1841392,1602698,2529454,10866440,642794,1345624,1988418,1558749,1567171,1608187,1829338,1634856,3014150,11212451,22078891,26165201,26165201
Democratic People's Republic of Korea,2046,KP,PRK,SEA,681157,1401117,2082274,1612701,1638317,1608357,1825951,1624571,2535695,10845592,644382,1329108,1973490,1538903,1583063,1578539,1814528,1657597,3026280,11198910,22044502,26100272,26100272
Democratic People's Republic of Korea,2047,KP,PRK,SEA,683262,1386476,2069738,1590462,1651967,1583736,1804396,1647599,2542187,10820347,646376,1315120,1961496,1517519,1595519,1553998,1793729,1681482,3038330,11180577,22000924,26032162,26032162
Democratic People's Republic of Korea,2048,KP,PRK,SEA,685207,1374887,2060094,1566800,1660514,1567196,1777426,1671016,2547907,10790859,648232,1304017,1952249,1494795,1603107,1537220,1767571,1705708,3049205,11157606,21948465,25960806,25960806
Democratic People's Republic of Korea,2049,KP,PRK,SEA,686244,1366432,2052676,1542221,1663536,1557204,1748946,1691942,2553892,10757741,649220,1295885,1945105,1471185,1605428,1526799,1739866,1727285,3059852,11130415,21888156,25885944,25885944
Democratic People's Republic of Korea,2050,KP,PRK,SEA,685980,1360718,2046698,1517590,1661432,1553317,1720049,1708148,2561184,10721720,648961,1290348,1939309,1447539,1602808,1522256,1711599,1744101,3071162,11099465,21821185,25807197,25807197
Portugal,1970,PT,PRT,EUR,421815,843912,1265727,654508,501753,527880,451458,389987,331527,2857113,405022,820370,1225392,705813,569450,586935,503615,461395,508195,3335403,6192516,8683631,8683631
Portugal,1971,PT,PRT,EUR,406113,846843,1252956,665109,496644,525024,459171,391992,340451,2878391,390264,821763,1212027,713449,563193,585320,513567,460488,521124,3357141,6235532,8700519,8700519
Portugal,1972,PT,PRT,EUR,412332,852197,1264529,686868,505260,528547,471450,394959,350437,2937521,394793,825743,1220536,726202,568881,589384,527246,461915,537051,3410679,6348200,8833266,8833266
Portugal,1973,PT,PRT,EUR,415906,854785,1270691,706695,516552,531487,485279,397033,361341,2998387,396853,827780,1224633,734833,579578,592305,542277,462682,552574,3464249,6462636,8957960,8957960
Portugal,1974,PT,PRT,EUR,421257,854480,1275737,723238,531880,533646,500034,398124,371391,3058313,401873,827804,1229677,740968,593081,594762,558225,462984,565850,3515870,6574183,9079603,9079603
Portugal,1975,PT,PRT,EUR,430921,851638,1282559,737825,548609,534529,510251,401225,384614,3117053,410933,825178,1236111,747286,606186,595390,569749,465355,583019,3566985,6684038,9202709,9202709
Portugal,1976,PT,PRT,EUR,438570,853790,1292360,752019,567802,532116,517478,407092,398511,3175018,417299,826730,1244029,755036,621054,592155,578283,470662,601608,3618798,6793816,9330201,9330201
Portugal,1977,PT,PRT,EUR,441864,859954,1301818,766192,588482,529549,525466,413507,410637,3233833,419621,831954,1251575,763385,636800,588818,587641,477362,617769,3671775,6905608,9458997,9458997
Portugal,1978,PT,PRT,EUR,440812,863657,1304469,780475,606161,530162,533051,420794,424198,3294841,417617,834620,1252237,773223,648910,587842,596431,485328,634976,3726710,7021551,9578255,9578255
Portugal,1979,PT,PRT,EUR,432925,866888,1299813,795319,621493,533786,538383,429744,438416,3357141,409988,836546,1246534,785962,657026,590116,602493,494953,652140,3782690,7139831,9686178,9686178
Portugal,1980,PT,PRT,EUR,418756,871092,1289848,809632,635773,538572,542856,440293,452381,3419507,398113,839197,1237310,799311,662480,594228,607272,506603,668691,3838585,7258092,9785252,9785252
Portugal,1981,PT,PRT,EUR,402191,872775,1274966,820389,649040,541850,545826,451154,463296,3471555,383827,839894,1223721,809692,669042,596567,610159,519177,681880,3886517,7358072,9856752,9856752
Portugal,1982,PT,PRT,EUR,389877,869044,1258921,823803,662942,544665,547251,461230,471679,3511570,371931,835963,1207894,813420,679400,598131,610974,531047,693063,3926035,7437605,9904424,9904424
Portugal,1983,PT,PRT,EUR,381522,862100,1243622,822146,674797,551125,548658,472209,477991,3546926,362897,828921,1191818,812086,689282,602874,611393,544473,701352,3961460,7508386,9943821,9943821
Portugal,1984,PT,PRT,EUR,373017,853878,1226895,819584,683597,560435,549458,483084,483544,3579702,353508,821039,1174547,808915,697982,609495,611177,558098,708008,3993675,7573377,9974819,9974819
Portugal,1985,PT,PRT,EUR,362064,843891,1205955,816141,691940,572133,547798,490843,492960,3611815,342086,812111,1154197,804431,707222,617873,608526,567157,719715,4024924,7636739,9996896,9996896
Portugal,1986,PT,PRT,EUR,348983,831249,1180232,812500,699730,586751,542584,496670,506310,3644545,329050,800220,1129270,799778,715899,629944,602127,573610,735634,4056992,7701537,10011030,10011030
Portugal,1987,PT,PRT,EUR,334762,816880,1151642,810611,705917,601169,537429,502395,520064,3677585,315184,785739,1100923,796673,722809,643038,595496,580541,751494,4090051,7767636,10020203,10020203
Portugal,1988,PT,PRT,EUR,320599,800015,1120614,809964,710990,612493,535412,506956,533728,3709543,302026,768204,1070230,794839,728356,653508,591882,586179,768154,4122918,7832461,10023310,10023310
Portugal,1989,PT,PRT,EUR,306982,779497,1086479,810676,714166,622493,536286,509108,548439,3741168,290070,746871,1036941,794208,732763,661594,592075,588804,786277,4155721,7896889,10020315,10020315
Portugal,1990,PT,PRT,EUR,294644,752885,1047529,814760,714209,630986,538800,511161,562877,3772793,279277,720244,999521,796672,733944,667961,594590,590675,803653,4187495,7960288,10007346,10007346
Portugal,1991,PT,PRT,EUR,285459,720748,1006207,820963,712922,637753,541117,513128,576696,3802579,271195,689122,960317,801549,732558,674071,596392,591990,820755,4217315,8019894,9986415,9986415
Portugal,1992,PT,PRT,EUR,282297,689877,972174,823502,714005,645254,543585,514685,590083,3831114,268647,659100,927747,803380,732879,680970,598532,592762,839186,4247709,8078823,9978744,9978744
Portugal,1993,PT,PRT,EUR,284129,665005,949134,820788,719266,651510,549261,516384,602261,3859470,270477,634978,905455,800374,736463,686073,604268,593530,857330,4278038,8137508,9992103,9992103
Portugal,1994,PT,PRT,EUR,284934,645585,930519,816147,726833,657236,557858,518154,614584,3890812,270598,616318,886916,795911,741581,691325,611697,594543,874799,4309856,8200668,10018104,10018104
Portugal,1995,PT,PRT,EUR,284037,628992,913029,810232,734436,665484,568589,518532,628215,3925488,268314,600300,868614,790662,746858,699218,620579,593951,892846,4344114,8269602,10051248,10051248
Portugal,1996,PT,PRT,EUR,282494,615684,898178,802004,742462,674930,582147,515621,642143,3959307,265502,587071,852573,782808,752779,708194,632902,590278,910619,4377580,8336887,10087645,10087645
Portugal,1997,PT,PRT,EUR,281002,605318,886320,792247,750965,685038,596423,512403,656146,3993222,263408,576495,839903,772807,759312,717422,646674,586502,928390,4411107,8404329,10130549,10130549
Portugal,1998,PT,PRT,EUR,280588,596258,876846,781850,758861,696839,608380,511995,669777,4027702,262509,567975,830484,761594,765340,727694,658240,584997,946520,4444385,8472087,10179415,10179415
Portugal,1999,PT,PRT,EUR,282336,588483,870819,769482,767146,709853,619236,514548,681382,4061647,264147,560523,824670,748089,771573,739830,667354,587129,962263,4476238,8537885,10233369,10233369
Portugal,2000,PT,PRT,EUR,283792,581948,865740,756748,776219,723348,631011,518970,695594,4101890,266035,553314,819349,734615,778068,752176,676425,591693,980677,4513654,8615544,10300626,10300626
Portugal,2001,PT,PRT,EUR,285330,578130,863460,739946,788075,735656,642759,522598,711837,4140871,267862,547873,815735,717212,787873,763270,685633,595189,1002571,4551748,8692619,10371819,10371819
Portugal,2002,PT,PRT,EUR,288711,576041,864752,716413,799894,743905,654735,525787,724793,4165527,271091,545282,816373,694540,800651,772296,696133,598280,1022367,4584267,8749794,10430914,10430914
Portugal,2003,PT,PRT,EUR,290833,573940,864773,693735,805297,749057,663862,532336,736239,4180526,272980,544038,817018,672995,809288,778365,704890,605555,1039924,4611017,8791543,10473344,10473344
Portugal,2004,PT,PRT,EUR,289789,572966,862755,673519,805257,753440,669972,541205,748368,4191761,272190,543344,815534,652596,812211,782694,711604,614328,1058038,4631471,8823232,10501522,10501522
Portugal,2005,PT,PRT,EUR,285870,573753,859623,654046,802584,756726,677611,551260,759225,4201452,268798,543933,812731,632602,812009,786381,720216,623441,1074862,4649511,8850963,10523315,10523315
Portugal,2006,PT,PRT,EUR,281328,573151,854479,637559,796539,760407,685926,563867,768466,4212764,265131,543355,808486,615082,807700,790452,729834,635738,1089417,4668223,8880987,10543947,10543947
Portugal,2007,PT,PRT,EUR,276098,571428,847526,623700,786812,765628,694420,577437,777884,4225881,261144,541720,802864,600810,799072,796075,739490,650036,1103798,4689281,8915162,10565551,10565551
Portugal,2008,PT,PRT,EUR,270613,569674,840287,610345,772196,770596,704218,588648,788478,4234481,256914,540179,797093,589163,786667,802069,750034,662454,1118705,4709092,8943573,10580960,10580960
Portugal,2009,PT,PRT,EUR,265324,567107,832431,597967,752485,775289,714731,598139,801294,4239905,253005,539023,792028,578987,769401,808337,762143,671893,1136218,4726979,8966884,10591343,10591343
Portugal,2010,PT,PRT,EUR,258767,563716,822483,587913,726621,781056,724209,607202,814539,4241540,247710,536365,784075,570703,746474,815798,772889,680206,1154238,4740308,8981848,10588401,10588401
Portugal,2011,PT,PRT,EUR,252634,558025,810659,580773,696584,784783,729644,615232,827355,4234371,242112,531240,773352,564518,719017,822823,780595,687486,1172006,4746445,8980816,10564826,10564826
Portugal,2012,PT,PRT,EUR,247998,551109,799107,573587,665886,784520,730514,623416,839042,4216965,237455,524965,762420,557664,689009,827585,785487,695466,1188377,4743588,8960553,10522086,10522086
Portugal,2013,PT,PRT,EUR,241232,545193,786425,566591,638761,778518,728460,628631,852477,4193438,230991,518592,749583,550394,661076,828314,787551,701715,1206041,4735091,8928529,10464535,10464535
Portugal,2014,PT,PRT,EUR,233467,537916,771383,562501,617764,767445,725134,630668,868965,4172477,223174,511470,734644,545686,638077,824806,788917,706483,1225902,4729871,8902348,10408372,10408372
Portugal,2015,PT,PRT,EUR,227035,528707,755742,561270,599019,756830,722260,634760,885730,4159869,216048,503729,719777,544221,617306,819540,790572,713736,1244671,4730046,8889915,10365435,10365435
Portugal,2016,PT,PRT,EUR,221774,521429,743203,559706,583400,745244,721225,639801,902422,4151798,210536,497876,708412,541402,598735,810594,792890,722075,1263643,4729339,8881137,10332753,10332753
Portugal,2017,PT,PRT,EUR,218795,514478,733273,557269,570578,731834,721766,644725,918648,4144820,208116,491765,699881,537688,583449,798115,796548,730196,1283570,4729566,8874386,10307530,10307530
Portugal,2018,PT,PRT,EUR,218943,504604,723547,555805,559735,717747,722316,650516,932879,4138998,209076,483106,692182,536510,572635,784155,800744,739159,1301901,4735104,8874102,10289835,10289835
Portugal,2019,PT,PRT,EUR,221400,494814,716214,556228,553390,703688,724229,657197,946778,4141510,211942,474121,686063,537371,565478,768055,805911,750106,1319216,4746137,8887647,10289923,10289923
Portugal,2020,PT,PRT,EUR,222813,486888,709701,558485,552296,687388,728643,663072,960288,4150172,213314,466791,680105,539504,561769,748367,812738,759960,1335873,4758211,8908383,10298192,10298192
Portugal,2021,PT,PRT,EUR,221104,480106,701210,559793,554321,667285,734584,666897,970639,4153519,211503,460326,671829,541136,560431,724092,819947,767063,1350871,4763540,8917059,10290103,10290103
Portugal,2022,PT,PRT,EUR,217638,474127,691765,558086,556535,646353,740830,669158,983448,4154410,207838,454356,662194,539055,559318,697911,825951,771989,1368280,4762504,8916914,10270865,10270865
Portugal,2023,PT,PRT,EUR,214011,467587,681598,554256,558274,628653,743408,670504,1000072,4155167,203566,448611,652177,534168,558581,674737,828468,774638,1388071,4758663,8913830,10247605,10247605
Portugal,2024,PT,PRT,EUR,209979,461836,671815,548311,561575,614986,741636,672174,1016576,4155258,199202,443129,642331,527688,559567,655457,826810,776735,1407686,4753943,8909201,10223349,10223349
Portugal,2025,PT,PRT,EUR,206228,455977,662205,540048,566721,602346,738073,673305,1034357,4154850,195552,436446,631998,519849,562276,637376,822792,778611,1428156,4749060,8903910,10198116,10198116
Portugal,2026,PT,PRT,EUR,204059,448250,652309,533197,570149,591807,731296,674887,1053142,4154478,193337,428377,621714,513501,562967,621273,814900,780907,1450054,4743602,8898080,10172106,10172106
Portugal,2027,PT,PRT,EUR,203093,441373,644466,526336,571821,582700,721768,677906,1071338,4151869,192228,421884,614112,506598,561702,607136,803059,784514,1472068,4735077,8886946,10145530,10145530
Portugal,2028,PT,PRT,EUR,202408,437570,639978,516292,573736,574636,710772,681145,1089111,4145692,191419,418005,609424,496838,560745,595008,788645,788203,1493858,4723297,8868989,10118394,10118394
Portugal,2029,PT,PRT,EUR,201967,435314,637281,505467,575190,567927,697084,684697,1107099,4137464,190860,415552,606412,486125,560361,584272,770543,792007,1516144,4709452,8846916,10090603,10090603
Portugal,2030,PT,PRT,EUR,201784,432057,633841,495536,576612,563576,679174,689756,1125056,4129710,190564,412096,602660,476513,560625,575655,747851,797013,1538320,4695977,8825687,10062183,10062183
Portugal,1950,PT,PRT,EUR,459149,809402,1268551,782797,593939,519514,381796,269833,229852,2777731,438524,783749,1222273,786375,619923,570012,459489,352907,359696,3148402,5926133,8416952,8416952
Portugal,1951,PT,PRT,EUR,454473,810160,1264633,781115,605936,521297,391605,273147,234094,2807194,434643,787513,1222156,785210,632248,569336,469239,355221,367409,3178663,5985857,8472644,8472644
Portugal,1952,PT,PRT,EUR,457236,807872,1265108,773095,619526,521347,401098,275892,238892,2829850,435572,790655,1226227,779396,645463,566512,478543,357392,375190,3202496,6032346,8523684,8523684
Portugal,1953,PT,PRT,EUR,458065,807896,1265961,764082,633195,518058,412080,279344,244591,2851350,435317,794556,1229873,773715,659572,561018,487965,360718,383232,3226220,6077570,8573397,8573397
Portugal,1954,PT,PRT,EUR,456502,811305,1267807,753370,648776,512430,422841,283240,248669,2869326,433991,799612,1233603,769536,675099,554047,496772,364366,388612,3248432,6117758,8619174,8619174
Portugal,1955,PT,PRT,EUR,459793,816726,1276519,740873,654290,510295,431964,289539,253905,2880866,437598,804538,1242136,762960,682753,550276,503057,370373,396507,3265926,6146792,8665451,8665451
Portugal,1956,PT,PRT,EUR,461922,827237,1289159,727323,651531,510701,440645,297404,258366,2885970,440810,813685,1254495,753400,684371,549139,508967,378321,403263,3277461,6163431,8707083,8707083
Portugal,1957,PT,PRT,EUR,460746,842009,1302755,712272,650930,511783,449242,304061,261136,2889424,440997,826112,1267109,743991,687379,549035,515921,385450,407007,3288783,6178207,8748069,8748069
Portugal,1958,PT,PRT,EUR,463107,851088,1314195,702405,648708,514159,456763,310872,267041,2899948,443614,832958,1276572,739153,688951,551048,521227,392888,415113,3308380,6208328,8799094,8799094
Portugal,1959,PT,PRT,EUR,466496,855116,1321612,699825,642507,518085,462078,318105,273408,2914008,446455,834654,1281109,741405,686723,556370,523706,400853,423809,3332866,6246874,8849589,8849589
Portugal,1960,PT,PRT,EUR,464789,856793,1321582,701057,633931,522610,466014,325930,278339,2927881,443291,833735,1277026,746411,682579,563209,524275,409292,430211,3355977,6283858,8882469,8882469
Portugal,1961,PT,PRT,EUR,464703,851483,1316186,697647,628213,527972,467779,334166,282825,2938602,442480,829132,1271612,742894,679838,570558,522681,417837,436707,3370515,6309117,8896915,8896915
Portugal,1962,PT,PRT,EUR,471001,843288,1314289,687775,624331,534138,466264,342706,287578,2942792,448645,824134,1272779,730647,676815,578508,518857,426363,444391,3375581,6318373,8905437,8905437
Portugal,1963,PT,PRT,EUR,475940,836340,1312280,680241,618001,540736,462256,351629,291316,2944179,452691,819982,1272673,721297,671439,587393,513341,434914,450182,3378566,6322745,8907702,8907702
Portugal,1964,PT,PRT,EUR,481452,829860,1311312,675207,608416,547950,456427,360443,293785,2942228,457567,815796,1273363,713480,665146,597105,506346,443096,453488,3378661,6320889,8905558,8905558
Portugal,1965,PT,PRT,EUR,486052,826979,1313031,668621,594652,549873,452973,369036,300290,2935445,462300,813407,1275707,705585,654235,601082,501157,449642,463203,3374904,6310349,8899092,8899092
Portugal,1966,PT,PRT,EUR,484455,829427,1313882,663347,576665,547194,452407,376008,307926,2923547,460903,815342,1276245,702128,637570,599894,499126,455060,474387,3368165,6291712,8881847,8881847
Portugal,1967,PT,PRT,EUR,477190,834933,1312123,661235,556544,545164,451571,381578,313268,2909360,454848,818606,1273454,702986,619380,599484,498266,460390,481206,3361712,6271072,8856641,8856641
Portugal,1968,PT,PRT,EUR,466405,839507,1305912,657815,537943,541944,451016,386058,319548,2894324,445676,819765,1265441,703707,601692,598301,498764,462982,490410,3355856,6250180,8821528,8821528
Portugal,1969,PT,PRT,EUR,451236,842947,1294183,654916,520495,535788,450557,388664,324756,2875176,431766,820922,1252688,704495,585586,593726,500182,463078,499030,3346097,6221273,8768151,8768151
Portugal,2031,PT,PRT,EUR,201787,427544,629331,487410,576249,562861,658221,696154,1141905,4122800,190463,407274,597737,468674,559818,570690,721769,803227,1559237,4683415,8806215,10033283,10033283
Portugal,2032,PT,PRT,EUR,201781,422910,624691,481226,573237,563880,637417,702524,1157399,4115683,190364,402300,592664,462469,556296,568339,695418,809183,1578861,4670566,8786249,10003604,10003604
Portugal,2033,PT,PRT,EUR,201803,418612,620415,474718,569473,565700,620363,705488,1172122,4107864,190301,397224,587525,456739,551440,567650,672599,811875,1597101,4657404,8765268,9973208,9973208
Portugal,2034,PT,PRT,EUR,201882,414151,616033,468995,563596,569066,607215,704234,1186702,4099808,190312,392312,582624,451269,544987,568678,653617,810445,1614702,4643698,8743506,9942165,9942165
Portugal,2035,PT,PRT,EUR,201860,410223,612083,463159,555416,574267,595075,701269,1201641,4090827,190238,388374,578612,444602,537179,571424,635827,806708,1632894,4628634,8719461,9910155,9910155
Portugal,2036,PT,PRT,EUR,201578,408066,609644,455462,548634,577752,584988,695249,1217651,4079736,189931,386066,575997,436550,530862,572157,620003,799191,1652817,4611580,8691316,9876958,9876958
Portugal,2037,PT,PRT,EUR,201030,407101,608131,448607,541834,579485,576295,686621,1234162,4067004,189385,384864,574249,430067,523985,570934,606125,787818,1673945,4592874,8659878,9842256,9842256
Portugal,2038,PT,PRT,EUR,200257,406445,606702,444816,531858,581451,568610,676580,1250224,4053539,188630,383995,572625,426197,514254,570012,594225,773913,1694729,4573330,8626869,9806203,9806203
Portugal,2039,PT,PRT,EUR,199249,406089,605338,442573,521098,582952,562239,663981,1266602,4039445,187659,383454,571113,423753,503569,569664,583699,756394,1715983,4553062,8592507,9768966,9768966
Portugal,2040,PT,PRT,EUR,198014,405889,603903,439329,511233,584418,558160,647408,1284249,4024797,186479,383086,569565,420306,493986,569955,575256,734390,1738158,4532051,8556848,9730312,9730312
Portugal,2041,PT,PRT,EUR,196644,405616,602260,434832,503164,584106,557626,627941,1301970,4009639,185171,382684,567855,415494,486169,569180,570425,709065,1760011,4510344,8519983,9690101,9690101
Portugal,2042,PT,PRT,EUR,195257,405065,600322,430213,497033,581156,558784,608619,1318330,3994135,183845,382042,565887,410528,479988,565698,568185,683479,1780180,4488058,8482193,9648403,9648403
Portugal,2043,PT,PRT,EUR,193639,404318,597957,425933,490571,577461,560729,592837,1330780,3978311,182307,381232,563539,405462,474278,560885,567590,661333,1795740,4465288,8443599,9605092,9605092
Portugal,2044,PT,PRT,EUR,191698,403392,595090,421484,484890,571668,564202,580726,1339235,3962205,180468,380277,560745,400555,468833,554483,568702,642930,1806494,4441997,8404202,9560036,9560036
Portugal,2045,PT,PRT,EUR,189655,402140,591795,417574,479104,563586,569486,569586,1346524,3945860,178540,379024,557564,396630,462187,546731,571518,625699,1815446,4418211,8364071,9513430,9513430
Portugal,2046,PT,PRT,EUR,187636,400494,588130,415429,471455,556898,573073,560407,1352050,3929312,176631,377414,554045,394328,454157,540463,572330,610392,1822380,4394050,8323362,9465531,9465531
Portugal,2047,PT,PRT,EUR,185600,398566,584166,414470,464640,550181,574911,552540,1355741,3912483,174708,375545,550253,393133,447693,533632,571196,596992,1826801,4369447,8281930,9416346,9416346
Portugal,2048,PT,PRT,EUR,183649,396174,579823,413823,460884,540298,576966,545617,1357888,3895476,172864,373253,546117,392271,443837,523953,570363,585532,1828525,4344481,8239957,9365892,9365892
Portugal,2049,PT,PRT,EUR,181866,393231,575097,413472,458663,529634,578547,539914,1358140,3878370,171177,370453,541630,391732,441406,513318,570084,575390,1827266,4319196,8197566,9314293,9314293
Portugal,2050,PT,PRT,EUR,180061,389954,570015,413283,455448,519862,580078,536376,1356019,3861066,169472,367346,536818,391371,437971,503783,570436,567283,1822570,4293414,8154480,9261305,9261305
Paraguay,1970,PY,PRY,AMR,207533,354740,562273,228654,140691,101380,76033,49450,41498,637706,200089,340464,540553,231892,140540,109005,78382,55142,53296,668257,1305963,2408787,2408787
Paraguay,1971,PY,PRY,AMR,208505,363024,571529,236081,145258,102648,78842,51267,42484,656580,200912,348587,549499,239269,145426,109202,81271,56747,54250,686165,1342745,2463777,2463777
Paraguay,1972,PY,PRY,AMR,209620,370972,580592,244762,149963,104186,81864,52975,43287,677037,201902,356382,558284,247594,150887,109313,84793,58115,54900,705602,1382639,2521508,2521508
Paraguay,1973,PY,PRY,AMR,211306,377903,589209,253295,155998,106734,85253,54592,44811,700683,203380,363640,567020,255418,156835,109684,88670,59295,56342,726244,1426927,2583160,2583160
Paraguay,1974,PY,PRY,AMR,213695,383996,597691,261194,163483,110252,88702,56160,46959,726750,205514,370296,575810,262645,163369,110488,92461,60351,58519,747833,1474583,2648082,2648082
Paraguay,1975,PY,PRY,AMR,216713,389734,606447,269345,171201,114290,91679,57749,49029,753293,208328,376293,584621,270379,170218,111883,95760,61350,60705,770295,1523588,2714664,2714664
Paraguay,1976,PY,PRY,AMR,220490,394760,615250,277531,178865,119284,94155,59423,51339,780597,211874,381454,593328,278360,176634,114421,98348,62351,63335,793449,1574046,2782624,2782624
Paraguay,1977,PY,PRY,AMR,225154,399134,624288,285691,186552,125260,96136,61196,53823,808658,216282,385808,602090,286638,182609,118218,100226,63378,66324,817393,1626051,2852430,2852430
Paraguay,1978,PY,PRY,AMR,230545,403181,633726,293991,194348,131840,97778,63112,56322,837391,221420,389664,611084,295305,188490,122905,101521,64536,69407,842164,1679555,2924370,2924370
Paraguay,1979,PY,PRY,AMR,236772,407348,644120,302613,202306,138477,99355,65260,58641,866652,227362,393514,620876,304374,194677,127989,102479,66038,72216,867773,1734425,2999415,2999415
Paraguay,1980,PY,PRY,AMR,244139,412080,656219,311689,210392,144750,101089,67710,60604,896234,234427,397768,632195,313863,201465,133120,103308,68066,74444,894266,1790500,3078912,3078912
Paraguay,1981,PY,PRY,AMR,252806,417573,670379,320972,218616,150598,103092,70502,62257,926037,242768,402650,645418,323461,208942,138191,104040,70729,76101,921464,1847501,3163299,3163299
Paraguay,1982,PY,PRY,AMR,262287,424488,686775,330909,226549,155762,105167,73550,63209,955146,251920,408669,660589,333373,217281,143135,104651,74003,76732,949175,1904321,3251678,3251678
Paraguay,1983,PY,PRY,AMR,272156,432737,704893,341386,233944,160736,107338,76687,63609,983700,261443,415899,677342,343306,226162,148378,105206,77670,76623,977345,1961045,3343276,3343276
Paraguay,1984,PY,PRY,AMR,282199,441926,724125,351509,241063,166323,109887,79672,64198,1012652,271049,424362,695411,352312,235142,154305,105872,81318,76755,1005704,2018356,3437892,3437892
Paraguay,1985,PY,PRY,AMR,291858,452536,744394,361265,248467,172095,112947,82238,65061,1042073,280207,434490,714697,360385,244583,160478,107052,84551,77279,1034328,2076401,3535498,3535498
Paraguay,1986,PY,PRY,AMR,300622,464966,765588,370441,256585,177738,116786,84247,66220,1072017,288460,446559,735019,367514,254734,166473,109236,87185,78269,1063411,2135428,3636027,3636027
Paraguay,1987,PY,PRY,AMR,308535,479028,787563,378838,265347,183392,121445,85703,67699,1102424,295889,460290,756179,373659,265502,172303,112555,89187,79684,1092890,2195314,3739050,3739050
Paraguay,1988,PY,PRY,AMR,315952,494237,810189,386499,274787,189219,126583,86785,69488,1133361,302822,475131,777953,379059,276758,178273,116671,90647,81525,1122933,2256294,3844437,3844437
Paraguay,1989,PY,PRY,AMR,322604,510452,833056,393594,284736,195330,131762,87774,71579,1164775,309020,490852,799872,384108,288173,184646,121139,91758,83759,1153583,2318358,3951288,3951288
Paraguay,1990,PY,PRY,AMR,328475,527403,855878,400411,294969,201744,136684,88945,73990,1196743,314465,507192,821657,389152,299433,191564,125647,92703,86422,1184921,2381664,4059195,4059195
Paraguay,1991,PY,PRY,AMR,333819,544719,878538,407252,305230,208449,141256,90399,76680,1229266,319361,523842,843203,394461,310259,199103,130094,93521,89549,1216987,2446253,4167996,4167996
Paraguay,1992,PY,PRY,AMR,338554,562044,900598,414492,315264,215359,145601,92146,79602,1262464,323645,540449,864094,400452,320372,207234,134575,94199,93058,1249890,2512354,4277051,4277051
Paraguay,1993,PY,PRY,AMR,342474,579328,921802,422345,324951,222177,150185,94195,82629,1296482,327186,556940,884126,407355,329646,215640,139499,94812,96832,1283784,2580266,4386202,4386202
Paraguay,1994,PY,PRY,AMR,345759,596034,941793,431117,334282,228748,155349,96562,85549,1331607,330148,572800,902948,415475,338010,224176,145098,95549,100649,1318957,2650564,4495301,4495301
Paraguay,1995,PY,PRY,AMR,348395,611585,959980,441254,343177,235571,160656,99347,88195,1368200,332526,587460,919986,425220,345406,233155,150939,96744,104286,1355750,2723950,4603917,4603917
Paraguay,1996,PY,PRY,AMR,350228,625709,975937,453146,351361,242974,165771,102758,90473,1406483,334182,600660,934842,436849,351725,242733,156575,98845,107662,1394389,2800872,4711655,4711655
Paraguay,1997,PY,PRY,AMR,351358,638384,989742,466625,358669,250915,170836,106829,92427,1446301,335189,612427,947616,450116,356962,252841,162030,101966,110724,1434639,2880940,4818289,4818289
Paraguay,1998,PY,PRY,AMR,351779,649739,1001518,481232,365173,259432,176013,111267,94189,1487306,335528,622929,958457,464487,361385,263355,167599,105797,113550,1476173,2963479,4923449,4923449
Paraguay,1999,PY,PRY,AMR,351374,659667,1011041,496711,370959,268358,181395,115688,96022,1529133,335115,632095,967210,479607,365298,273942,173522,109931,116355,1518655,3047788,5026031,5026031
Paraguay,2000,PY,PRY,AMR,350125,668103,1018228,512522,376014,277316,186932,119827,98165,1570776,333920,639843,973763,494915,368741,284167,179886,114075,119266,1561050,3131826,5123819,5123819
Paraguay,2001,PY,PRY,AMR,347872,675008,1022880,527622,379816,285666,192449,123561,100695,1609809,331771,646104,977875,509369,371172,293387,186612,118085,122347,1600972,3210781,5211541,5211541
Paraguay,2002,PY,PRY,AMR,344546,680329,1024875,541427,382300,292916,197759,126959,103544,1644905,328608,650835,979443,522376,372548,301089,193596,122044,125632,1637285,3282190,5286512,5286512
Paraguay,2003,PY,PRY,AMR,340356,682165,1022521,554493,385588,299833,202781,130409,106792,1679896,324621,652430,977051,534941,375104,307915,200619,126207,128997,1673783,3353679,5353254,5353254
Paraguay,2004,PY,PRY,AMR,335929,680721,1016650,566720,390674,306833,207538,134261,110343,1716369,320413,651087,971500,547038,379856,314159,207645,130793,132319,1711810,3428179,5416324,5416324
Paraguay,2005,PY,PRY,AMR,331931,677883,1009814,577601,396919,313409,212480,138189,113960,1752558,316634,648415,965049,557760,386056,319422,215007,135536,135683,1749464,3502022,5476878,5476878
Paraguay,2006,PY,PRY,AMR,328706,673440,1002146,586753,404651,319244,217907,141897,117771,1788223,313615,644220,957835,566725,393903,323565,222843,140031,139409,1786476,3574699,5534675,5534675
Paraguay,2007,PY,PRY,AMR,326443,667550,993993,594163,413707,324156,223800,145553,121887,1823266,311517,638636,950153,573954,403146,326560,231099,144329,143648,1822736,3646002,5590145,5590145
Paraguay,2008,PY,PRY,AMR,324979,660858,985837,600270,423823,328283,230272,149340,126170,1858158,310188,632242,942430,579907,413446,328739,239721,148735,148179,1858727,3716885,5645148,5645148
Paraguay,2009,PY,PRY,AMR,324159,654027,978186,605485,435170,331968,237315,153370,130503,1893811,309478,625687,935165,584970,424876,330673,248539,153516,152839,1895413,3789224,5702574,5702574
Paraguay,2010,PY,PRY,AMR,323975,648048,972023,610837,448187,335824,244968,157723,134828,1932367,309352,619914,929266,590092,437866,333031,257511,158889,157566,1934955,3867322,5768613,5768613
Paraguay,2011,PY,PRY,AMR,324209,643337,967546,616504,462673,340161,253049,162412,139182,1973981,309613,615319,924932,595415,452248,336114,266436,164944,162337,1977494,3951475,5843939,5843939
Paraguay,2012,PY,PRY,AMR,324607,639430,964037,621602,477804,345061,261176,167353,143697,2016693,310023,611501,921524,600082,467219,340056,274904,171598,167205,2021064,4037757,5923322,5923322
Paraguay,2013,PY,PRY,AMR,325746,636217,961963,625506,493292,350583,269150,172297,148668,2059496,311129,608369,919498,603544,482469,344925,282712,178556,172493,2064699,4124195,6005652,6005652
Paraguay,2014,PY,PRY,AMR,328224,633698,961922,628070,508483,356969,276892,177108,154112,2101634,313507,605916,919423,605699,497349,350969,289743,185662,178315,2107737,4209371,6090721,6090721
Paraguay,2015,PY,PRY,AMR,331972,631800,963772,629296,522781,364689,284324,182189,159646,2142925,317078,604090,921168,606548,511269,358634,295956,193190,184483,2150080,4293005,6177950,6177950
Paraguay,2016,PY,PRY,AMR,336527,630672,967199,629014,535909,374156,291193,187823,165203,2183298,321415,603033,924448,605952,523926,368219,301255,201297,191016,2191665,4374963,6266615,6266615
Paraguay,2017,PY,PRY,AMR,341243,630513,971756,627352,547812,385246,297305,193986,170875,2222576,325911,602926,928837,604023,535312,379497,305595,209919,197888,2232234,4454810,6355404,6355404
Paraguay,2018,PY,PRY,AMR,345174,631776,976950,624727,558573,397538,302683,200687,176570,2260778,329668,604197,933865,601140,545552,391985,309177,218921,204961,2271736,4532514,6443328,6443328
Paraguay,2019,PY,PRY,AMR,347499,634842,982341,621473,568097,410944,307505,207832,182242,2298093,331906,607185,939091,597666,554556,405509,312405,228057,212309,2310502,4608595,6530026,6530026
Paraguay,2020,PY,PRY,AMR,348484,639838,988322,618394,576666,425452,312116,215143,187892,2335663,332865,611944,944809,594492,562674,420055,315712,236996,219967,2349896,4685559,6618695,6618695
Paraguay,2021,PY,PRY,AMR,348615,646051,994666,615792,584352,440609,316514,221916,191415,2370598,333018,617819,950837,591958,569940,435296,319189,245182,226126,2387691,4758289,6703799,6703799
Paraguay,2022,PY,PRY,AMR,348123,652639,1000762,613161,590245,455633,320983,228125,193225,2401372,332575,624052,956627,589337,575341,450461,323134,252541,231170,2421984,4823356,6780744,6780744
Paraguay,2023,PY,PRY,AMR,347170,659321,1006491,611012,594191,470720,326354,234898,197740,2434915,331699,630354,962053,586941,578712,465552,328110,259780,238971,2458066,4892981,6861524,6861524
Paraguay,2024,PY,PRY,AMR,345919,665591,1011510,609797,596826,485601,332920,242192,204698,2472034,330553,636289,966842,585356,580750,480279,334425,266785,249278,2496873,4968907,6947270,6947270
Paraguay,2025,PY,PRY,AMR,344467,671462,1015929,609325,598128,499549,340735,249230,211922,2508889,329222,641857,971079,584517,581484,493971,342285,273028,260154,2535439,5044328,7031341,7031341
Paraguay,2026,PY,PRY,AMR,342864,676977,1019841,609724,597958,512293,350178,255766,219513,2545432,327758,647104,974862,584563,580793,506364,351976,278411,271637,2573744,5119176,7113876,7113876
Paraguay,2027,PY,PRY,AMR,341108,681929,1023037,611167,596464,523790,361121,261652,227580,2581774,326131,651833,977964,585661,578814,517448,363274,282902,283785,2611884,5193658,7194655,7194655
Paraguay,2028,PY,PRY,AMR,339185,685569,1024754,614087,594089,534138,373177,266929,236192,2618612,324320,655335,979655,588215,575943,527362,375722,286724,296540,2650506,5269118,7273521,7273521
Paraguay,2029,PY,PRY,AMR,337097,687253,1024350,618812,591176,543239,386259,271786,245305,2656577,322337,656995,979332,592530,572549,536020,389130,290249,309734,2690212,5346789,7350459,7350459
Paraguay,2030,PY,PRY,AMR,334904,687127,1022031,624960,588019,551078,400167,276457,254761,2695442,320250,656952,977202,598213,568954,543373,403303,293782,323149,2730774,5426216,7425448,7425448
Paraguay,1950,PY,PRY,AMR,145949,210991,356940,134147,91483,61192,42306,32792,24897,386817,140804,199459,340263,139265,96915,70417,47622,35357,31215,420791,807608,1504810,1504810
Paraguay,1951,PY,PRY,AMR,149917,216913,366830,134978,94150,63120,43146,32754,25883,394031,144170,205685,349855,139665,99798,72437,48541,35575,32456,428472,822503,1539188,1539188
Paraguay,1952,PY,PRY,AMR,153705,222829,376534,136217,97112,65009,43948,32605,27017,401908,147557,212001,359558,140060,103350,74158,49349,35732,33775,436424,838332,1574419,1574419
Paraguay,1953,PY,PRY,AMR,156946,229208,386154,137915,100170,66868,44767,32516,28105,410341,150613,218792,369405,140581,107280,75635,50157,35948,35048,444649,854990,1610541,1610541
Paraguay,1954,PY,PRY,AMR,159511,236371,395882,140158,102975,68711,45703,32545,29076,419168,153195,226237,379432,141484,111075,76945,51147,36284,36202,453137,872305,1647627,1647627
Paraguay,1955,PY,PRY,AMR,161990,243758,405748,143154,105230,70558,46843,32756,29868,428409,155687,233762,389449,143215,114281,78194,52501,36797,37166,462154,890563,1685747,1685747
Paraguay,1956,PY,PRY,AMR,164676,250883,415559,147215,106805,72413,48224,33159,30466,438282,158274,240766,399040,146296,116689,79402,54270,37496,37906,472059,910341,1724937,1724937
Paraguay,1957,PY,PRY,AMR,167437,257811,425248,152411,107739,74282,49835,33741,30897,448905,160938,247184,408122,150853,118324,80589,56434,38371,38475,483046,931951,1765319,1765319
Paraguay,1958,PY,PRY,AMR,170322,264640,434962,158410,108255,76211,51618,34459,31233,460186,163711,253261,416972,156502,119350,81884,58855,39365,38945,494901,955087,1807018,1807018
Paraguay,1959,PY,PRY,AMR,173367,271456,444823,164757,108716,78318,53493,35229,31540,472053,166639,259242,425881,162724,120043,83532,61297,40376,39407,507379,979432,1850143,1850143
Paraguay,1960,PY,PRY,AMR,176632,278271,454903,171100,109432,80699,55379,35995,31909,484514,169781,265269,435050,169134,120645,85757,63549,41330,39945,520360,1004874,1894829,1894829
Paraguay,1961,PY,PRY,AMR,180167,285077,465244,177329,110523,83403,57233,36732,32351,497571,173187,271429,444616,175572,121225,88672,65521,42186,40601,533777,1031348,1941208,1941208
Paraguay,1962,PY,PRY,AMR,183974,291820,475794,183562,112006,86392,59056,37460,32872,511348,176854,277708,454562,182101,121807,92227,67205,42960,41367,547667,1059015,1989376,1989376
Paraguay,1963,PY,PRY,AMR,188213,298586,486799,189091,113808,89608,60969,38351,33755,525582,181098,284413,465511,188264,122023,96154,68565,43723,42766,561495,1087077,2039390,2039390
Paraguay,1964,PY,PRY,AMR,192641,305430,498071,194245,115911,92725,62982,39478,34949,540290,185636,291530,477166,194350,122022,99948,69715,44613,44668,575316,1115606,2090840,2090840
Paraguay,1965,PY,PRY,AMR,196749,312669,509418,199672,118530,95333,65007,40763,36108,555413,189783,298932,488715,200763,122639,103156,70842,45791,46417,589608,1145021,2143153,2143153
Paraguay,1966,PY,PRY,AMR,200301,320548,520849,204993,121949,97298,67048,42242,37235,570765,193309,306787,500096,206969,124395,105569,71981,47315,48015,604244,1175009,2195955,2195955
Paraguay,1967,PY,PRY,AMR,203081,328850,531931,210367,126224,98645,69099,43902,38327,586564,196005,315020,511025,212933,127436,107182,73157,49166,49489,619363,1205927,2248882,2248882
Paraguay,1968,PY,PRY,AMR,205065,337474,542539,216008,131035,99562,71214,45703,39387,602909,197869,323531,521400,218931,131416,108133,74476,51223,50854,635033,1237942,2301887,2301887
Paraguay,1969,PY,PRY,AMR,206451,346194,552645,222078,135960,100378,73496,47577,40434,619923,199144,332082,531226,225208,135887,108675,76155,53277,52130,651332,1271255,2355122,2355122
Paraguay,2031,PY,PRY,AMR,332529,685744,1018273,631813,585038,557710,414585,281162,264429,2734737,317985,655722,973707,604599,565550,549460,417964,297558,336608,2771739,5506476,7498454,7498454
Paraguay,2032,PY,PRY,AMR,330176,683549,1013725,638718,582491,563145,429197,286196,274133,2773880,315739,653706,969445,611075,562599,554285,432785,301938,349921,2812603,5586483,7569644,7569644
Paraguay,2033,PY,PRY,AMR,328037,680717,1008754,645400,580597,567178,443948,291706,283822,2812651,313704,651062,964766,617376,560291,557690,447673,307091,362972,2853093,5665744,7639257,7639257
Paraguay,2034,PY,PRY,AMR,326127,677431,1003558,651680,579491,569872,458343,297961,293486,2850833,311876,647980,959856,623325,558762,559772,462128,313306,375741,2893034,5743867,7707287,7707287
Paraguay,2035,PY,PRY,AMR,324428,673837,998265,657555,579124,571262,471851,305390,303111,2888293,310246,644608,954854,628901,557979,560566,475590,321001,388239,2932276,5820569,7773694,7773694
Paraguay,2036,PY,PRY,AMR,323002,669911,992913,663073,579612,571213,484233,314329,312605,2925065,308874,640921,949795,634159,558070,559951,487784,330435,400394,2970793,5895858,7838570,7838570
Paraguay,2037,PY,PRY,AMR,321881,665859,987740,668032,581132,569874,495429,324646,321915,2961028,307790,637091,944881,638901,559207,558060,498714,341396,412250,3008528,5969556,7902181,7902181
Paraguay,2038,PY,PRY,AMR,320797,661849,982646,671688,584104,567673,505536,335978,331133,2996112,306733,633288,940021,642424,561789,555296,508512,353447,423973,3045441,6041553,7964226,7964226
Paraguay,2039,PY,PRY,AMR,319742,657902,977644,673399,588867,564948,514466,348250,340376,3030306,305704,629519,935223,644112,566122,552013,517088,366422,435736,3081493,6111799,8024671,8024671
Paraguay,2040,PY,PRY,AMR,318783,654064,972847,673318,595033,561989,522190,361276,349745,3063551,304767,625846,930613,644096,571818,548535,524398,380121,447630,3116598,6180149,8083610,8083610
Paraguay,2041,PY,PRY,AMR,317857,650315,968172,671995,601899,559204,528768,374767,359282,3095915,303860,622249,926109,642902,578210,545249,530477,394278,459718,3150834,6246749,8141028,8141028
Paraguay,2042,PY,PRY,AMR,316874,646889,963763,669860,608817,556853,534204,388433,369133,3127300,302897,618957,921854,640923,584690,542409,535327,408592,472157,3184098,6311398,8197013,8197013
Paraguay,2043,PY,PRY,AMR,315963,643720,959683,667096,615509,555143,538302,402221,379364,3157635,302008,615901,917909,638319,590999,540213,538791,422972,485020,3216314,6373949,8251538,8251538
Paraguay,2044,PY,PRY,AMR,315178,640799,955977,663879,621809,554211,541117,415690,390189,3186895,301234,613081,914315,635277,596955,538784,540963,436935,498539,3247453,6434348,8304646,8304646
Paraguay,2045,PY,PRY,AMR,314434,638190,952624,660358,627712,553998,542687,428371,401967,3215093,300507,610546,911053,631948,602543,538091,541878,449964,513110,3277534,6492627,8356299,8356299
Paraguay,2046,PY,PRY,AMR,313700,635880,949580,656508,633258,554623,542872,440052,414908,3242221,299785,608300,908085,628304,607809,538261,541417,461812,528942,3306545,6548766,8406438,8406438
Paraguay,2047,PY,PRY,AMR,312949,633819,946768,652526,638252,556256,541822,450688,428848,3268392,299044,606283,905327,624517,612563,539459,539710,472468,545850,3334567,6602959,8455070,8455070
Paraguay,2048,PY,PRY,AMR,312142,631867,944009,648592,641964,559322,539945,460340,443565,3293728,298250,604366,902616,620758,616105,542089,537147,482058,563603,3361760,6655488,8502115,8502115
Paraguay,2049,PY,PRY,AMR,311300,630074,941374,644718,643762,564146,537571,468941,459094,3318232,297421,602595,900016,617028,617823,546453,534080,490495,582214,3388093,6706325,8547721,8547721
Paraguay,2050,PY,PRY,AMR,310249,628408,938657,640958,643786,570355,534983,476464,475353,3341899,296386,600957,897343,613396,617854,552169,530826,497734,601604,3413583,6755482,8591486,8591486
"occupied Palestinian territory, including east Jerusalem",1970,PS,PSE,EMR,114978,163771,278749,107922,73119,44614,25723,17173,15432,283983,111944,161310,273254,104759,69705,44857,29490,17700,15745,282256,566239,1118241,1118241
"occupied Palestinian territory, including east Jerusalem",1971,PS,PSE,EMR,116859,167072,283931,109244,74264,45944,26047,16986,15163,287648,113652,164406,278058,106937,70440,45732,29994,17776,15634,286513,574161,1136148,1136148
"occupied Palestinian territory, including east Jerusalem",1972,PS,PSE,EMR,120029,172208,292237,111796,76199,47822,26734,17009,15092,294652,116597,169310,285907,110404,71835,47289,30730,18066,15730,294054,588706,1166851,1166851
"occupied Palestinian territory, including east Jerusalem",1973,PS,PSE,EMR,123902,178256,302158,112558,75416,48523,26997,16771,14705,294970,120194,175120,295314,114651,73372,49031,31500,18488,15912,302954,597924,1195399,1195399
"occupied Palestinian territory, including east Jerusalem",1974,PS,PSE,EMR,127914,184450,312364,114245,74309,49021,27360,16589,14324,295848,123892,181019,304911,118568,75566,50708,32290,19014,16096,312242,608090,1225364,1225364
"occupied Palestinian territory, including east Jerusalem",1975,PS,PSE,EMR,131820,190556,322376,119049,75997,50672,28420,16817,14330,305285,127485,186750,314235,122222,78181,52384,33112,19632,16266,321797,627082,1263706,1263706
"occupied Palestinian territory, including east Jerusalem",1976,PS,PSE,EMR,135610,196427,332037,123759,77747,52160,29547,17063,14322,314598,130943,192241,323184,126038,80515,53949,33864,20308,16424,331098,645696,1300913,1300913
"occupied Palestinian territory, including east Jerusalem",1977,PS,PSE,EMR,139257,202138,341395,128463,79528,53492,30749,17337,14302,323871,134249,197544,331793,129766,82897,55404,34572,21051,16572,340262,664133,1337323,1337323
"occupied Palestinian territory, including east Jerusalem",1978,PS,PSE,EMR,142817,207920,350737,133163,81447,54823,32009,17658,14290,333390,137470,202884,340354,133594,85342,56798,35357,21819,16726,349636,683026,1374123,1374123
"occupied Palestinian territory, including east Jerusalem",1979,PS,PSE,EMR,146444,213974,360418,137908,83620,56240,33334,18043,14314,343459,140774,208436,349210,137604,87962,58178,36313,22544,16936,359537,702996,1412626,1412626
"occupied Palestinian territory, including east Jerusalem",1980,PS,PSE,EMR,150255,220372,370627,142791,86115,57735,34754,18497,14377,354269,144275,214280,358555,141883,90811,59589,37419,23242,17223,370167,724436,1453620,1453620
"occupied Palestinian territory, including east Jerusalem",1981,PS,PSE,EMR,154300,227197,381497,147857,88918,59336,36269,19036,14483,365899,148038,220519,368557,146430,93925,61031,38696,23963,17550,381595,747494,1497547,1497547
"occupied Palestinian territory, including east Jerusalem",1982,PS,PSE,EMR,158815,234658,393473,153272,92108,61097,37932,19684,14651,378744,152291,227331,379622,151405,97424,62539,40233,24676,17967,394244,772988,1546087,1546087
"occupied Palestinian territory, including east Jerusalem",1983,PS,PSE,EMR,164370,243435,407805,159508,96195,63047,39801,20504,14925,393980,157567,235409,392976,157260,101736,64258,42041,25500,18544,409339,803319,1604100,1604100
"occupied Palestinian territory, including east Jerusalem",1984,PS,PSE,EMR,171241,253924,425165,166815,101464,65255,41829,21556,15326,412245,164122,245146,409268,164211,106369,67039,44053,26513,19322,427507,839752,1674189,1674189
"occupied Palestinian territory, including east Jerusalem",1985,PS,PSE,EMR,176752,262320,439072,172756,106075,67000,43412,22527,15621,427391,169384,252884,422268,169827,109947,69617,45659,27304,19997,442351,869742,1731085,1731085
"occupied Palestinian territory, including east Jerusalem",1986,PS,PSE,EMR,180925,268741,449666,177392,109936,68374,44584,23404,15817,439507,173369,258743,432112,174151,113028,71460,46892,27867,20583,453981,893488,1775266,1775266
"occupied Palestinian territory, including east Jerusalem",1987,PS,PSE,EMR,189576,281633,471209,186302,116532,71469,46735,24929,16418,462385,181650,270863,452513,182648,118822,75164,49196,29099,21735,476664,939049,1862765,1862765
"occupied Palestinian territory, including east Jerusalem",1988,PS,PSE,EMR,199637,296377,496014,196475,123884,75146,49191,26671,17154,488521,191289,284803,476092,192354,125488,79406,51760,30588,23039,502635,991156,1963256,1963256
"occupied Palestinian territory, including east Jerusalem",1989,PS,PSE,EMR,207507,307648,515155,204375,129740,78067,51098,28139,17723,509142,198821,295436,494257,199781,130728,82803,53653,31830,24040,522835,1031977,2041380,2041380
"occupied Palestinian territory, including east Jerusalem",1990,PS,PSE,EMR,216114,319498,535612,212731,135829,81338,53100,29717,18369,531084,207047,306658,513705,207579,136291,86463,55593,33215,25067,544208,1075292,2124609,2124609
"occupied Palestinian territory, including east Jerusalem",1991,PS,PSE,EMR,225524,332127,557651,221716,142261,84986,55251,31412,19103,554729,216042,318678,534720,215933,142234,90453,57608,34779,26160,567167,1121896,2214272,2214272
"occupied Palestinian territory, including east Jerusalem",1992,PS,PSE,EMR,235419,345749,581168,231256,149018,88988,57536,33239,19934,579971,225498,331688,557186,224790,148563,94800,59669,36580,27275,591677,1171648,2309999,2309999
"occupied Palestinian territory, including east Jerusalem",1993,PS,PSE,EMR,245314,360420,605734,241252,156048,93544,59787,35140,20868,606639,234944,345731,580675,234088,155235,99606,61715,38495,28458,617597,1224236,2410644,2410644
"occupied Palestinian territory, including east Jerusalem",1994,PS,PSE,EMR,254682,376137,630819,251736,163359,98780,61974,37011,21926,634786,243849,360782,604631,243844,162200,104234,64465,40412,29766,644921,1279707,2515164,2515164
"occupied Palestinian territory, including east Jerusalem",1995,PS,PSE,EMR,263166,392968,656134,262725,171021,104410,64361,38874,23123,664514,251880,376906,628786,254091,169501,108903,67685,42365,31168,673713,1338227,2623144,2623144
"occupied Palestinian territory, including east Jerusalem",1996,PS,PSE,EMR,270527,410818,681345,274246,179048,110318,67008,40746,24440,695806,258844,394012,652856,264867,177135,114105,70842,44384,32665,703998,1399804,2734001,2734001
"occupied Palestinian territory, including east Jerusalem",1997,PS,PSE,EMR,276700,429478,706178,286299,187452,116575,69852,42621,25896,728695,264680,411884,676564,276167,185085,119539,74272,46434,34279,735776,1464471,2847213,2847213
"occupied Palestinian territory, including east Jerusalem",1998,PS,PSE,EMR,281118,446606,727724,297628,194855,122465,72703,44463,27408,759522,268904,428624,697528,287070,192412,124806,77580,48325,35950,766143,1525665,2950918,2950918
"occupied Palestinian territory, including east Jerusalem",1999,PS,PSE,EMR,284402,461486,745888,308226,201145,127822,75566,46293,28963,788015,272119,443536,715655,297596,199037,129815,80788,50015,37682,794933,1582948,3044486,3044486
"occupied Palestinian territory, including east Jerusalem",2000,PS,PSE,EMR,287883,475889,763772,319273,207762,133198,78669,48174,30599,817675,275498,457882,733380,308674,205969,135036,84227,51712,39518,825136,1642811,3139954,3139954
"occupied Palestinian territory, including east Jerusalem",2001,PS,PSE,EMR,291057,488468,779525,329942,213575,138147,81867,50066,32306,845903,278623,470763,749386,319884,212659,140198,87749,53301,41478,855269,1701172,3230078,3230078
"occupied Palestinian territory, including east Jerusalem",2002,PS,PSE,EMR,293489,497873,791362,340115,217886,142394,85103,51964,34133,871595,281157,481160,762317,331115,218550,145062,91235,54652,43595,884209,1755804,3309486,3309486
"occupied Palestinian territory, including east Jerusalem",2003,PS,PSE,EMR,295250,505346,800596,350668,221798,146232,88657,53771,36039,897165,283068,489856,772924,342866,224226,149804,94962,55825,45811,913494,1810659,3384190,3384190
"occupied Palestinian territory, including east Jerusalem",2004,PS,PSE,EMR,296845,512103,808948,362055,226207,149868,92694,55459,37942,924225,284772,497654,782426,355478,230333,154576,98480,57608,48047,944522,1868747,3460125,3460125
"occupied Palestinian territory, including east Jerusalem",2005,PS,PSE,EMR,298985,518360,817345,374686,231807,153594,97007,57297,39874,954265,286988,504569,791557,369101,237220,159506,102051,59831,50313,978022,1932287,3541193,3541193
"occupied Palestinian territory, including east Jerusalem",2006,PS,PSE,EMR,301475,524367,825842,388385,238813,157503,101492,59347,41852,987392,289491,510829,800320,383594,245070,164642,106166,62024,52622,1014118,2001510,3627668,3627668
"occupied Palestinian territory, including east Jerusalem",2007,PS,PSE,EMR,303851,530279,834130,402667,247059,161579,106169,61545,43843,1022862,291757,516687,808444,398599,253869,169988,110505,64533,54954,1052448,2075310,3717878,3717878
"occupied Palestinian territory, including east Jerusalem",2008,PS,PSE,EMR,306925,535007,841932,416494,256246,165947,110974,63905,45913,1059479,294927,521494,816421,412607,263223,175467,115115,67282,57289,1090983,2150462,3808818,3808818
"occupied Palestinian territory, including east Jerusalem",2009,PS,PSE,EMR,311057,538811,849868,428991,265979,170581,115815,66423,48093,1095882,299351,525758,825109,424829,272876,181038,119889,70270,59648,1128550,2224432,3899398,3899398
"occupied Palestinian territory, including east Jerusalem",2010,PS,PSE,EMR,316109,543127,859236,440265,276113,175443,120636,69132,50374,1131963,304477,530740,835217,435910,282858,186797,124776,73470,62051,1165862,2297825,3992278,3992278
"occupied Palestinian territory, including east Jerusalem",2011,PS,PSE,EMR,322091,548107,870198,450210,286684,180666,125406,72020,52783,1167769,310284,536506,846790,445774,293190,192862,129731,76894,64544,1202995,2370764,4087744,4087744
"occupied Palestinian territory, including east Jerusalem",2012,PS,PSE,EMR,328468,553578,882046,458569,297832,186271,130079,75075,55316,1203142,316314,542840,859154,454152,304016,199232,134732,80547,67135,1239814,2442956,4184161,4184161
"occupied Palestinian territory, including east Jerusalem",2013,PS,PSE,EMR,334862,559531,894393,465770,309682,192314,134635,78483,57849,1238733,322269,549668,871937,461369,315402,205918,139759,84533,69756,1276737,2515470,4281794,4281794
"occupied Palestinian territory, including east Jerusalem",2014,PS,PSE,EMR,341029,566237,907266,471873,321966,198744,138979,82307,60209,1274078,327987,557178,885165,467711,327317,212967,144749,88296,72932,1313972,2588050,4380475,4380475
"occupied Palestinian territory, including east Jerusalem",2015,PS,PSE,EMR,347355,574780,922135,477148,335117,205780,143230,86377,62665,1310317,333793,566230,900023,473273,339981,220524,149794,92061,76506,1352139,2662456,4484614,4484614
"occupied Palestinian territory, including east Jerusalem",2016,PS,PSE,EMR,353348,584853,938201,482020,349195,213638,147524,90663,65336,1348376,339256,576474,915730,478274,353290,228676,154934,96285,80082,1391541,2739917,4593848,4593848
"occupied Palestinian territory, including east Jerusalem",2017,PS,PSE,EMR,358409,597083,955492,485870,362939,221610,151479,95034,67989,1384921,343531,587782,931313,482202,365814,236791,159975,100627,83811,1429220,2814141,4700947,4700947
"occupied Palestinian territory, including east Jerusalem",2018,PS,PSE,EMR,362332,611599,973931,489082,375782,229664,155167,99369,70709,1419773,346503,600255,946758,485448,377113,244800,164956,105142,87617,1465076,2884849,4805547,4805547
"occupied Palestinian territory, including east Jerusalem",2019,PS,PSE,EMR,364645,626518,991163,493121,387720,238406,159014,103735,73648,1455644,348175,612864,961039,489484,387671,253232,170085,109824,91623,1501919,2957563,4909775,4909775
"occupied Palestinian territory, including east Jerusalem",2020,PS,PSE,EMR,364997,642268,1007265,499545,399575,248278,163275,108081,76602,1495356,348218,626012,974230,495878,398283,262470,175571,114667,95679,1542548,3037904,5019401,5019401
"occupied Palestinian territory, including east Jerusalem",2021,PS,PSE,EMR,364352,658139,1022491,508183,411017,259197,168015,112249,79274,1537935,347509,639081,986590,504465,408785,272485,181487,119561,99591,1586374,3124309,5133392,5133392
"occupied Palestinian territory, including east Jerusalem",2022,PS,PSE,EMR,364231,672813,1037044,518411,421409,271170,173244,116263,81905,1582402,347398,650988,998386,514559,418547,283303,187799,124477,103544,1632229,3214631,5250072,5250072
"occupied Palestinian territory, including east Jerusalem",2023,PS,PSE,EMR,364976,685813,1050789,530134,431147,284295,179087,120278,85038,1629979,348140,661438,1009578,525959,427900,295025,194554,129476,107971,1680885,3310864,5371230,5371230
"occupied Palestinian territory, including east Jerusalem",2024,PS,PSE,EMR,366404,696773,1063177,542965,440034,298297,185566,124398,89147,1680407,349553,670136,1019689,538138,436596,307424,201745,134571,113211,1731685,3412092,5494963,5494963
"occupied Palestinian territory, including east Jerusalem",2025,PS,PSE,EMR,368360,705386,1073746,557357,447973,313141,192700,128561,94005,1733737,351448,676840,1028288,551540,444497,320523,209406,139737,119124,1784827,3518564,5620605,5620605
"occupied Palestinian territory, including east Jerusalem",2026,PS,PSE,EMR,370613,712080,1082693,572793,455205,328574,200506,132654,99137,1788869,353628,681965,1035593,565648,451804,334179,217549,144919,125363,1839462,3628331,5746618,5746618
"occupied Palestinian territory, including east Jerusalem",2027,PS,PSE,EMR,373215,717841,1091056,588173,462147,344290,209023,136742,104530,1844905,356132,686468,1042600,579376,458908,348170,226164,150157,131938,1894713,3739618,5873269,5873269
"occupied Palestinian territory, including east Jerusalem",2028,PS,PSE,EMR,376105,722933,1099038,603582,469039,359787,218243,140928,110147,1901726,358902,690604,1049506,592824,465984,362071,235246,155525,138827,1950477,3852203,6000743,6000743
"occupied Palestinian territory, including east Jerusalem",2029,PS,PSE,EMR,378884,727150,1106034,619203,476543,374506,228215,145299,115950,1959716,361562,694160,1055722,606211,473655,375376,244822,161071,146007,2007142,3966858,6128606,6128606
"occupied Palestinian territory, including east Jerusalem",2030,PS,PSE,EMR,381636,729802,1111438,635379,485215,388218,238879,149921,121917,2019529,364196,696441,1060637,619828,482470,387899,254830,166838,153481,2065346,4084875,6256949,6256949
"occupied Palestinian territory, including east Jerusalem",1950,PS,PSE,EMR,90776,132150,222926,84348,52274,40642,34687,29472,24068,265491,83693,123273,206966,82111,56214,37269,28172,24637,21012,249415,514906,944807,944807
"occupied Palestinian territory, including east Jerusalem",1951,PS,PSE,EMR,91266,134290,225556,86814,52786,40075,33769,28915,23694,266053,85832,124714,210546,83622,57211,37370,27841,24242,20964,251250,517303,953408,953408
"occupied Palestinian territory, including east Jerusalem",1952,PS,PSE,EMR,91761,136485,228246,89411,53463,39568,33020,28307,23320,267089,88076,126054,214130,85460,58098,37523,27720,23759,20886,253446,520535,962908,962908
"occupied Palestinian territory, including east Jerusalem",1953,PS,PSE,EMR,92539,138508,231047,92060,54320,39149,32400,27648,22974,268551,90574,127223,217797,87498,58898,37786,27739,23207,20807,255935,524486,973331,973331
"occupied Palestinian territory, including east Jerusalem",1954,PS,PSE,EMR,93925,140222,234147,94555,55389,38864,31849,26946,22662,270265,92695,129028,221723,89494,59686,38240,27784,22638,20751,258593,528858,984729,984729
"occupied Palestinian territory, including east Jerusalem",1955,PS,PSE,EMR,95681,141913,237594,96844,56695,38714,31327,26211,22397,272188,94331,131633,225964,91404,60473,38885,27815,22073,20717,261367,533555,997117,997117
"occupied Palestinian territory, including east Jerusalem",1956,PS,PSE,EMR,97548,143831,241379,98950,58224,38692,30858,25438,22164,274326,96126,134374,230500,93248,61250,39708,27863,21511,20712,264292,538618,1010491,1010491
"occupied Palestinian territory, including east Jerusalem",1957,PS,PSE,EMR,99569,145922,245491,100891,59975,38785,30442,24625,21975,276693,98060,137267,235327,95023,62007,40716,27933,20939,20733,267351,544044,1024868,1024868
"occupied Palestinian territory, including east Jerusalem",1958,PS,PSE,EMR,101739,148108,249847,102798,61875,39006,30066,23842,21788,279375,100137,140318,240455,96722,62860,41819,28003,20422,20749,270575,549950,1040254,1040254
"occupied Palestinian territory, including east Jerusalem",1959,PS,PSE,EMR,104035,150346,254381,104763,63860,39346,29722,23162,21566,282419,102335,143546,245881,98328,63916,42879,28092,20034,20689,273938,556357,1056620,1056620
"occupied Palestinian territory, including east Jerusalem",1960,PS,PSE,EMR,106415,152647,259062,106767,65933,39790,29408,22589,21294,285781,104613,146955,251568,99852,65162,43840,28242,19785,20542,277423,563204,1073842,1073842
"occupied Palestinian territory, including east Jerusalem",1961,PS,PSE,EMR,108844,155011,263855,108795,68076,40339,29124,22117,20988,289439,106928,150536,257464,101268,66584,44737,28419,19661,20324,280993,570432,1091751,1091751
"occupied Palestinian territory, including east Jerusalem",1962,PS,PSE,EMR,111315,157435,268750,110790,70289,40997,28859,21746,20652,293333,109262,154284,263546,102533,68229,45516,28619,19671,20037,284605,577938,1110229,1110229
"occupied Palestinian territory, including east Jerusalem",1963,PS,PSE,EMR,113719,160066,273785,112477,72451,41742,28629,21419,20275,296993,111519,158226,269745,103513,69926,46178,28870,19737,19699,287923,584916,1128441,1128441
"occupied Palestinian territory, including east Jerusalem",1964,PS,PSE,EMR,115558,162518,278076,113288,74076,42439,28347,21010,19789,298949,113215,161039,274254,104586,71189,46590,29128,19701,19271,290465,589414,1141753,1141753
"occupied Palestinian territory, including east Jerusalem",1965,PS,PSE,EMR,116691,164240,280931,113363,75030,43038,27985,20484,19191,299091,114203,162469,276672,105610,71892,46698,29337,19523,18760,291820,590911,1148517,1148517
"occupied Palestinian territory, including east Jerusalem",1966,PS,PSE,EMR,117017,164850,281867,112807,75275,43475,27515,19852,18468,297392,114395,162965,277360,105849,72007,46445,29455,19224,18145,291125,588517,1147743,1147743
"occupied Palestinian territory, including east Jerusalem",1967,PS,PSE,EMR,116352,164222,280574,111199,74519,43589,26862,19065,17572,292806,113627,162196,275823,105283,71432,45788,29445,18775,17424,288147,580953,1137357,1137357
"occupied Palestinian territory, including east Jerusalem",1968,PS,PSE,EMR,115239,163084,278323,109279,73450,43599,26211,18262,16671,287472,112439,160921,273360,104406,70514,45048,29370,18270,16701,284309,571781,1123463,1123463
"occupied Palestinian territory, including east Jerusalem",1969,PS,PSE,EMR,114538,162581,277119,108023,72911,43874,25798,17608,15939,284153,111640,160280,271920,104004,69786,44662,29328,17867,16110,281757,565910,1114945,1114945
"occupied Palestinian territory, including east Jerusalem",2031,PS,PSE,EMR,384552,731630,1116182,651454,495055,400670,250200,154908,128019,2080306,366974,698127,1065101,633134,492358,399438,265250,172918,161210,2124308,4204614,6385896,6385896
"occupied Palestinian territory, including east Jerusalem",2032,PS,PSE,EMR,387438,734264,1121702,666226,505884,411597,262335,160296,134222,2140560,369713,700677,1070390,645160,503076,409730,276244,179309,169168,2182687,4323247,6515333,6515333
"occupied Palestinian territory, including east Jerusalem",2033,PS,PSE,EMR,390244,737964,1128208,679233,517613,421326,275330,166116,140500,2200118,372388,704256,1076644,655623,514469,419063,287882,186016,177353,2240406,4440524,6645371,6645371
"occupied Palestinian territory, including east Jerusalem",2034,PS,PSE,EMR,393192,742231,1135423,690196,530428,430193,289147,172429,146855,2259248,375199,708379,1083578,664339,526641,427746,300170,193094,185744,2297734,4556982,6775991,6775991
"occupied Palestinian territory, including east Jerusalem",2035,PS,PSE,EMR,396297,746977,1143274,698824,544781,438116,303762,179297,153327,2318107,378153,712945,1091098,671057,540024,435630,313139,200595,194381,2354826,4672933,6907306,6907306
"occupied Palestinian territory, including east Jerusalem",2036,PS,PSE,EMR,399378,752189,1151567,705539,560177,445341,318959,186810,159941,2376767,381092,717940,1099032,676199,554111,442934,326660,208566,203267,2411737,4788504,7039101,7039101
"occupied Palestinian territory, including east Jerusalem",2037,PS,PSE,EMR,402396,757711,1160107,711327,575522,452285,334446,195001,166749,2435330,383973,723213,1107186,680720,567818,450039,340519,217004,212467,2468567,4903897,7171180,7171180
"occupied Palestinian territory, including east Jerusalem",2038,PS,PSE,EMR,405255,763442,1168697,716450,590896,459183,349720,203873,173801,2493923,386696,728684,1115380,684876,581256,457122,354295,225894,222003,2525446,5019369,7303440,7303440
"occupied Palestinian territory, including east Jerusalem",2039,PS,PSE,EMR,407977,769203,1177180,720703,606485,466697,364234,213473,181144,2552736,389287,734179,1123466,688452,594625,464797,367478,235273,231907,2582532,5135268,7435910,7435910
"occupied Palestinian territory, including east Jerusalem",2040,PS,PSE,EMR,410448,775092,1185540,723397,622630,475370,377761,223737,188820,2611715,391639,739792,1131431,690762,608232,473611,379892,245085,242224,2639806,5251521,7568488,7568488
"occupied Palestinian territory, including east Jerusalem",2041,PS,PSE,EMR,412582,781118,1193700,725277,638681,485204,390055,234635,196909,2670761,393662,745534,1139196,692480,621530,483487,391342,255292,252987,2697118,5367879,7700773,7700773
"occupied Palestinian territory, including east Jerusalem",2042,PS,PSE,EMR,414515,787051,1201566,727962,653440,496017,400853,246326,205408,2730006,395497,751179,1146676,695051,633552,494190,401555,266068,264188,2754604,5484610,7832855,7832855
"occupied Palestinian territory, including east Jerusalem",2043,PS,PSE,EMR,416270,792749,1209019,731705,666449,507728,410487,258847,214326,2789542,397145,756596,1153741,698652,644018,505563,410830,277477,275817,2812357,5601899,7964663,7964663
"occupied Palestinian territory, including east Jerusalem",2044,PS,PSE,EMR,417669,798451,1216120,736013,677429,520522,419294,272158,223712,2849128,398446,762018,1160464,702795,652745,517716,419471,289525,287908,2870160,5719288,8095875,8095875
"occupied Palestinian territory, including east Jerusalem",2045,PS,PSE,EMR,418667,804057,1222724,740796,686085,534841,427182,286251,233680,2908835,399360,767342,1166702,707384,659478,531071,427332,302240,300540,2928045,5836880,8226308,8226308
"occupied Palestinian territory, including east Jerusalem",2046,PS,PSE,EMR,419346,809300,1228646,746046,692845,550199,434407,300914,244299,2968710,399962,772329,1172291,712392,664648,545128,434625,315500,313769,2986062,5954772,8355710,8355710
"occupied Palestinian territory, including east Jerusalem",2047,PS,PSE,EMR,419675,814281,1233956,751605,698681,565509,441372,315861,255661,3028689,400231,777065,1177296,717685,669195,558811,441733,329095,327636,3044155,6072844,8484102,8484102
"occupied Palestinian territory, including east Jerusalem",2048,PS,PSE,EMR,419551,818927,1238478,757374,703858,580854,448308,330620,267843,3088857,400069,781456,1181525,723176,673379,572218,448827,342616,342175,3102391,6191248,8611246,8611246
"occupied Palestinian territory, including east Jerusalem",2049,PS,PSE,EMR,419106,823080,1242186,763169,708174,596416,455853,344661,280894,3149167,399600,785371,1184971,728687,676987,585570,456510,355564,357430,3160748,6309915,8737073,8737073
"occupied Palestinian territory, including east Jerusalem",2050,PS,PSE,EMR,418526,826580,1245106,769090,710940,612533,464549,357772,294833,3209717,398996,788655,1187651,734317,679333,599155,465321,367763,373389,3219278,6428995,8861747,8861747
French Polynesia,1970,PF,PYF,WPR,10369,16845,27214,10540,8491,6450,3933,2653,1468,33535,10037,16440,26477,10070,7838,5612,3525,2395,1229,30669,64204,117891,117891
French Polynesia,1971,PF,PYF,WPR,10612,17476,28088,11009,8820,6801,4078,2683,1485,34876,10270,17113,27383,10484,8055,5861,3644,2444,1264,31752,66628,122108,122108
French Polynesia,1972,PF,PYF,WPR,10791,18105,28896,11673,9160,7151,4246,2727,1522,36479,10419,17750,28169,10965,8248,6112,3783,2481,1320,32909,69388,126457,126457
French Polynesia,1973,PF,PYF,WPR,10905,18720,29625,12512,9520,7489,4430,2777,1585,38313,10481,18337,28818,11487,8431,6362,3941,2513,1399,34133,72446,130883,130883
French Polynesia,1974,PF,PYF,WPR,10990,19307,30297,13377,9924,7827,4647,2815,1649,40239,10520,18905,29425,12030,8629,6622,4108,2529,1472,35390,75629,135349,135349
French Polynesia,1975,PF,PYF,WPR,11053,19854,30907,14261,10351,8180,4877,2853,1713,42235,10549,19434,29983,12605,8839,6888,4280,2545,1549,36706,78941,139833,139833
French Polynesia,1976,PF,PYF,WPR,11115,20350,31465,15146,10829,8543,5125,2894,1784,44321,10588,19896,30484,13190,9085,7145,4455,2564,1643,38082,82403,144356,144356
French Polynesia,1977,PF,PYF,WPR,11194,20790,31984,16041,11396,8916,5388,2948,1868,46557,10654,20299,30953,13774,9392,7391,4618,2598,1747,39520,86077,149007,149007
French Polynesia,1978,PF,PYF,WPR,11257,21211,32468,16830,11924,9289,5666,3003,1947,48659,10698,20731,31429,14428,9773,7665,4792,2664,1872,41194,89853,153745,153745
French Polynesia,1979,PF,PYF,WPR,11309,21605,32914,17522,12373,9652,5967,3076,2018,50608,10729,21182,31911,15175,10220,7972,4986,2765,2014,43132,93740,158563,158563
French Polynesia,1980,PF,PYF,WPR,11424,21966,33390,18224,12856,10020,6280,3171,2086,52637,10831,21567,32398,15953,10711,8272,5187,2889,2153,45165,97802,163591,163591
French Polynesia,1981,PF,PYF,WPR,11642,22304,33946,18922,13379,10391,6605,3295,2143,54735,11038,21890,32928,16750,11243,8563,5412,3035,2278,47281,102016,168892,168892
French Polynesia,1982,PF,PYF,WPR,11916,22626,34542,19590,13939,10755,6944,3446,2191,56865,11301,22165,33466,17553,11811,8847,5664,3205,2390,49470,106335,174343,174343
French Polynesia,1983,PF,PYF,WPR,12210,22761,34971,20102,14409,11071,7299,3650,2279,58810,11583,22195,33778,18310,12247,9098,5941,3396,2486,51478,110288,179042,179042
French Polynesia,1984,PF,PYF,WPR,12639,22659,35298,20551,14896,11325,7617,3855,2344,60588,11995,21963,33958,18932,12741,9311,6203,3565,2551,53303,113891,183146,183146
French Polynesia,1985,PF,PYF,WPR,13192,22574,35766,21042,15541,11563,7891,4033,2343,62413,12514,21767,34281,19400,13473,9520,6445,3691,2596,55125,117538,187578,187578
French Polynesia,1986,PF,PYF,WPR,13690,22644,36334,21441,16239,11800,8166,4229,2356,64231,12983,21751,34734,19734,14250,9751,6704,3822,2647,56908,121139,192196,192196
French Polynesia,1987,PF,PYF,WPR,14125,22817,36942,21745,16981,12043,8439,4435,2391,66034,13388,21864,35252,19930,15064,10019,6958,3942,2723,58636,124670,196856,196856
French Polynesia,1988,PF,PYF,WPR,14613,23066,37679,21957,17746,12310,8713,4650,2445,67821,13844,22074,35918,19998,15906,10332,7220,4048,2822,60326,128147,201740,201740
French Polynesia,1989,PF,PYF,WPR,14980,23488,38468,21982,18468,12611,9009,4882,2542,69494,14185,22487,36672,19996,16644,10685,7490,4179,2947,61941,131435,206571,206571
French Polynesia,1990,PF,PYF,WPR,15113,24080,39193,21833,19128,12952,9319,5125,2667,71024,14310,23085,37395,19961,17250,11076,7766,4337,3088,63478,134502,211089,211089
French Polynesia,1991,PF,PYF,WPR,15160,24726,39886,21627,19739,13343,9618,5376,2804,72507,14352,23728,38080,19884,17804,11524,8021,4512,3228,64973,137480,215444,215444
French Polynesia,1992,PF,PYF,WPR,15128,25365,40493,21405,20286,13803,9895,5636,2944,73969,14321,24354,38675,19800,18298,12040,8253,4721,3370,66482,140451,219621,219621
French Polynesia,1993,PF,PYF,WPR,14945,26139,41084,21163,20769,14317,10165,5905,3085,75404,14145,25093,39238,19692,18740,12598,8483,4957,3519,67989,143393,223714,223714
French Polynesia,1994,PF,PYF,WPR,14666,26929,41595,20938,21189,14875,10432,6180,3239,76853,13877,25836,39713,19594,19134,13202,8706,5216,3661,69513,146366,227682,227682
French Polynesia,1995,PF,PYF,WPR,14334,27539,41873,20856,21537,15484,10685,6459,3412,78433,13561,26408,39969,19614,19464,13859,8915,5498,3820,71170,149603,231446,231446
French Polynesia,1996,PF,PYF,WPR,13969,27980,41949,20968,21780,16147,10942,6751,3620,80208,13212,26812,40024,19806,19702,14547,9152,5796,4005,73008,153216,235189,235189
French Polynesia,1997,PF,PYF,WPR,13608,28284,41892,21150,21957,16853,11235,7066,3849,82110,12866,27084,39950,20122,19922,15288,9440,6103,4205,75080,157190,239036,239036
French Polynesia,1998,PF,PYF,WPR,13197,28520,41717,21368,22058,17601,11564,7407,4102,84100,12472,27272,39744,20513,20131,16062,9780,6413,4420,77319,161419,242882,242882
French Polynesia,1999,PF,PYF,WPR,12879,28605,41484,21729,22046,18349,11920,7753,4401,86198,12170,27308,39478,21020,20265,16818,10167,6720,4676,79666,165864,246821,246821
French Polynesia,2000,PF,PYF,WPR,12769,28451,41220,22250,21931,19078,12316,8100,4722,88397,12063,27117,39180,21655,20346,17541,10604,7019,4963,82128,170525,250927,250927
French Polynesia,2001,PF,PYF,WPR,12751,28164,40915,22864,21744,19766,12764,8437,5080,90655,12048,26805,38853,22354,20371,18218,11106,7301,5277,84627,175282,255049,255049
French Polynesia,2002,PF,PYF,WPR,12762,27817,40579,23526,21505,20397,13278,8757,5467,92930,12058,26444,38502,23058,20345,18834,11677,7567,5640,87121,180051,259137,259137
French Polynesia,2003,PF,PYF,WPR,12781,27340,40121,24389,21194,20948,13854,9080,5892,95357,12073,25960,38033,23889,20211,19352,12310,7841,6053,89656,185013,263173,263173
French Polynesia,2004,PF,PYF,WPR,12690,26898,39588,25336,20871,21417,14474,9409,6354,97861,11982,25517,37499,24754,20031,19781,12986,8122,6509,92183,190044,267132,267132
French Polynesia,2005,PF,PYF,WPR,12493,26600,39093,26132,20677,21799,15142,9722,6834,100306,11792,25222,37014,25457,19959,20140,13716,8390,6982,94644,194950,271060,271060
French Polynesia,2006,PF,PYF,WPR,12327,26375,38702,26666,20709,22050,15851,10015,7303,102594,11631,25009,36640,25912,20105,20378,14466,8668,7443,96972,199566,274901,274901
French Polynesia,2007,PF,PYF,WPR,12197,26293,38490,26685,21055,22122,16569,10229,7696,104356,11493,24965,36458,25929,20566,20451,15184,8934,7810,98874,203230,278178,278178
French Polynesia,2008,PF,PYF,WPR,12160,26034,38194,26470,21443,22051,17255,10424,8072,105715,11443,24745,36188,25761,21089,20424,15819,9215,8153,100461,206176,280558,280558
French Polynesia,2009,PF,PYF,WPR,12239,25505,37744,26220,21737,21879,17890,10685,8485,106896,11523,24253,35776,25559,21522,20356,16363,9535,8540,101875,208771,282283,282283
French Polynesia,2010,PF,PYF,WPR,12347,25027,37374,25790,22115,21611,18477,10985,8902,107880,11634,23825,35459,25178,22017,20229,16841,9893,8916,103074,210954,283788,283788
French Polynesia,2011,PF,PYF,WPR,12397,24657,37054,25328,22516,21291,18996,11348,9322,108801,11680,23522,35202,24770,22494,20079,17269,10294,9308,104214,213015,285265,285265
French Polynesia,2012,PF,PYF,WPR,12361,24371,36732,24870,22865,20950,19441,11782,9728,109636,11646,23282,34928,24386,22889,19919,17648,10740,9707,105289,214925,286584,286584
French Polynesia,2013,PF,PYF,WPR,12211,24300,36511,24261,23323,20599,19815,12287,10130,110415,11499,23237,34736,23837,23394,19808,17991,11234,10106,106370,216785,288032,288032
French Polynesia,2014,PF,PYF,WPR,11982,24327,36309,23730,23788,20310,20148,12843,10556,111375,11281,23269,34550,23307,23919,19777,18339,11779,10522,107643,219018,289873,289873
French Polynesia,2015,PF,PYF,WPR,11738,24263,36001,23412,24046,20171,20419,13442,10988,112478,11049,23189,34238,22958,24260,19860,18654,12389,10952,109073,221551,291787,291787
French Polynesia,2016,PF,PYF,WPR,11462,24149,35611,23132,24105,20229,20594,14069,11444,113573,10794,23057,33851,22626,24414,20129,18889,13023,11416,110497,224070,293541,293541
French Polynesia,2017,PF,PYF,WPR,11209,24019,35228,22940,24019,20446,20678,14730,11959,114772,10564,22887,33451,22381,24393,20525,19069,13674,11953,111995,226767,295450,295450
French Polynesia,2018,PF,PYF,WPR,10987,23925,34912,22754,23895,20737,20701,15423,12535,116045,10362,22746,33108,22160,24276,20968,19216,14332,12589,113541,229586,297606,297606
French Polynesia,2019,PF,PYF,WPR,10745,23886,34631,22537,23701,21108,20638,16118,13170,117272,10139,22670,32809,21930,24040,21478,19308,14966,13288,115010,232282,299717,299717
French Polynesia,2020,PF,PYF,WPR,10478,23829,34307,22479,23378,21572,20515,16793,13826,118563,9892,22580,32472,21876,23652,22043,19367,15570,14063,116571,235134,301920,301920
French Polynesia,2021,PF,PYF,WPR,10267,23657,33924,22599,23043,22060,20331,17393,14426,119852,9698,22383,32081,21998,23236,22578,19401,16120,14840,118173,238025,304032,304032
French Polynesia,2022,PF,PYF,WPR,10103,23385,33488,22831,22744,22492,20130,17944,15161,121302,9545,22096,31641,22214,22870,23006,19433,16639,15687,119849,241151,306279,306279
French Polynesia,2023,PF,PYF,WPR,9963,23030,32993,23190,22367,23005,19921,18468,16101,123052,9413,21736,31149,22517,22417,23498,19458,17128,16659,121677,244729,308872,308872
French Polynesia,2024,PF,PYF,WPR,9856,22590,32446,23491,22084,23495,19734,18922,17075,124801,9315,21300,30615,22750,22045,23975,19489,17577,17691,123527,248328,311383,311383
French Polynesia,2025,PF,PYF,WPR,9787,22100,31887,23644,22018,23777,19685,19310,18083,126517,9246,20832,30078,22829,21863,24271,19622,17982,18768,125335,251852,313810,313810
French Polynesia,2026,PF,PYF,WPR,9717,21633,31350,23711,22034,23861,19824,19595,19147,128172,9179,20397,29576,22804,21749,24385,19921,18309,19895,127063,255235,316166,316166
French Polynesia,2027,PF,PYF,WPR,9658,21230,30888,23708,22096,23798,20092,19777,20249,129720,9123,20023,29146,22708,21690,24326,20335,18565,21077,128701,258421,318455,318455
French Polynesia,2028,PF,PYF,WPR,9607,20876,30483,23701,22097,23692,20423,19873,21384,131170,9074,19696,28770,22613,21608,24176,20794,18768,22288,130247,261417,320673,320673
French Polynesia,2029,PF,PYF,WPR,9562,20543,30105,23720,22064,23508,20827,19882,22543,132544,9030,19390,28420,22557,21528,23915,21304,18910,23521,131735,264279,322807,322807
French Polynesia,2030,PF,PYF,WPR,9521,20215,29736,23699,22137,23190,21313,19806,23730,133875,8992,19086,28078,22475,21570,23504,21865,19005,24753,133172,267047,324860,324860
French Polynesia,1950,PF,PYF,WPR,5267,8979,14246,6361,4425,3772,2402,1361,1137,19458,5114,8796,13910,5962,4144,3271,1778,975,798,16928,36386,64535,64535
French Polynesia,1951,PF,PYF,WPR,5401,9151,14552,6625,4517,3848,2494,1427,1125,20036,5231,8978,14209,6189,4281,3372,1882,1031,799,17554,37590,66350,66350
French Polynesia,1952,PF,PYF,WPR,5604,9287,14891,6873,4632,3898,2587,1487,1118,20595,5408,9113,14521,6425,4431,3444,1990,1079,801,18170,38765,68169,68169
French Polynesia,1953,PF,PYF,WPR,5854,9428,15282,7129,4769,3934,2682,1547,1102,21163,5626,9242,14868,6698,4594,3492,2108,1124,804,18820,39983,70138,70138
French Polynesia,1954,PF,PYF,WPR,6138,9588,15726,7388,4930,3955,2783,1609,1099,21764,5885,9373,15258,6991,4765,3525,2235,1169,809,19494,41258,72240,72240
French Polynesia,1955,PF,PYF,WPR,6450,9759,16209,7653,5107,3966,2888,1671,1103,22388,6184,9506,15690,7294,4935,3554,2365,1218,818,20184,42572,74475,74475
French Polynesia,1956,PF,PYF,WPR,6780,9963,16743,7906,5291,3986,2998,1736,1115,23032,6494,9668,16162,7596,5103,3591,2502,1272,839,20903,43935,76838,76838
French Polynesia,1957,PF,PYF,WPR,7084,10182,17266,8061,5477,4004,3104,1791,1134,23571,6784,9863,16647,7807,5244,3634,2630,1323,863,21501,45072,78983,78983
French Polynesia,1958,PF,PYF,WPR,7355,10420,17775,8112,5652,4038,3203,1836,1159,24000,7045,10078,17123,7922,5351,3690,2749,1373,898,21983,45983,80879,80879
French Polynesia,1959,PF,PYF,WPR,7606,10711,18317,8145,5815,4090,3297,1890,1185,24422,7288,10352,17640,8018,5450,3766,2863,1432,929,22458,46880,82837,82837
French Polynesia,1960,PF,PYF,WPR,7836,11061,18897,8158,5979,4163,3378,1952,1212,24842,7513,10678,18191,8085,5551,3855,2963,1503,960,22917,47759,84851,84851
French Polynesia,1961,PF,PYF,WPR,8042,11469,19511,8164,6134,4258,3446,2021,1233,25256,7714,11059,18773,8132,5667,3963,3044,1583,989,23378,48634,86921,86921
French Polynesia,1962,PF,PYF,WPR,8236,11948,20184,8203,6285,4377,3497,2095,1257,25714,7902,11510,19412,8198,5812,4092,3104,1673,1014,23893,49607,89208,89208
French Polynesia,1963,PF,PYF,WPR,8441,12499,20940,8356,6461,4530,3535,2173,1292,26347,8103,12018,20121,8342,6009,4245,3145,1775,1043,24559,50906,91963,91963
French Polynesia,1964,PF,PYF,WPR,8688,13091,21779,8595,6702,4738,3561,2245,1315,27156,8360,12589,20949,8522,6271,4418,3176,1871,1055,25313,52469,95192,95192
French Polynesia,1965,PF,PYF,WPR,8960,13720,22680,8845,7001,4990,3579,2314,1335,28064,8647,13208,21855,8688,6555,4607,3201,1960,1063,26074,54138,98674,98674
French Polynesia,1966,PF,PYF,WPR,9239,14350,23589,9116,7299,5256,3609,2385,1352,29017,8938,13846,22784,8880,6844,4801,3232,2053,1079,26889,55906,102281,102281
French Polynesia,1967,PF,PYF,WPR,9528,14977,24505,9414,7594,5533,3658,2454,1375,30028,9226,14485,23711,9112,7114,4993,3273,2146,1109,27747,57775,105995,105995
French Polynesia,1968,PF,PYF,WPR,9815,15595,25410,9750,7888,5826,3722,2528,1404,31118,9509,15128,24637,9386,7368,5190,3340,2238,1143,28665,59783,109832,109832
French Polynesia,1969,PF,PYF,WPR,10099,16216,26315,10120,8184,6128,3812,2593,1439,32276,9782,15780,25562,9707,7610,5391,3426,2324,1183,29641,61917,113803,113803
French Polynesia,2031,PF,PYF,WPR,9481,19938,29419,23543,22330,22851,21805,19673,24906,135108,8954,18831,27785,22276,21749,23068,22393,19067,25971,134524,269632,326834,326834
French Polynesia,2032,PF,PYF,WPR,9440,19719,29159,23279,22602,22554,22238,19509,26060,136242,8917,18627,27544,21989,21993,22687,22818,19117,27185,135789,272031,328738,328738
French Polynesia,2033,PF,PYF,WPR,9403,19529,28932,22923,22958,22177,22748,19314,27187,137307,8879,18444,27323,21629,22297,22237,23304,19146,28382,136995,274302,330563,330563
French Polynesia,2034,PF,PYF,WPR,9366,19378,28744,22480,23260,21896,23235,19143,28273,138287,8845,18303,27148,21195,22527,21869,23781,19182,29564,138118,276405,332298,332298
French Polynesia,2035,PF,PYF,WPR,9327,19267,28594,21988,23417,21834,23516,19103,29320,139178,8807,18198,27005,20727,22605,21688,24076,19318,30747,139161,278339,333947,333947
French Polynesia,2036,PF,PYF,WPR,9290,19157,28447,21526,23486,21852,23604,19254,30311,140033,8771,18094,26865,20294,22584,21577,24191,19619,31908,140173,280206,335512,335512
French Polynesia,2037,PF,PYF,WPR,9247,19060,28307,21126,23483,21913,23542,19529,31227,140820,8732,18001,26733,19921,22489,21521,24134,20030,33035,141130,281950,336991,336991
French Polynesia,2038,PF,PYF,WPR,9202,18974,28176,20774,23476,21911,23439,19865,32106,141571,8688,17916,26604,19596,22396,21438,23989,20492,34134,142045,283616,338387,338387
French Polynesia,2039,PF,PYF,WPR,9159,18891,28050,20437,23496,21883,23258,20269,32919,142262,8648,17836,26484,19289,22340,21358,23730,21000,35183,142900,285162,339690,339690
French Polynesia,2040,PF,PYF,WPR,9107,18811,27918,20108,23472,21956,22949,20748,33659,142892,8601,17761,26362,18985,22260,21402,23321,21562,36175,143705,286597,340880,340880
French Polynesia,2041,PF,PYF,WPR,9053,18730,27783,19835,23316,22151,22608,21235,34328,143473,8548,17687,26235,18731,22062,21581,22886,22081,37125,144466,287939,341966,341966
French Polynesia,2042,PF,PYF,WPR,8988,18650,27638,19619,23053,22422,22317,21667,34945,144023,8489,17608,26097,18527,21774,21826,22513,22503,38042,145185,289208,342957,342957
French Polynesia,2043,PF,PYF,WPR,8922,18567,27489,19427,22701,22777,21948,22169,35506,144528,8426,17531,25957,18347,21415,22130,22066,22990,38918,145866,290394,343846,343846
French Polynesia,2044,PF,PYF,WPR,8851,18487,27338,19277,22260,23081,21675,22646,36042,144981,8360,17455,25815,18205,20980,22362,21703,23461,39785,146496,291477,344632,344632
French Polynesia,2045,PF,PYF,WPR,8776,18398,27174,19168,21771,23237,21613,22925,36669,145383,8289,17373,25662,18099,20516,22442,21526,23754,40740,147077,292460,345304,345304
French Polynesia,2046,PF,PYF,WPR,8697,18303,27000,19060,21311,23306,21634,23013,37425,145749,8214,17283,25497,17996,20083,22420,21417,23873,41832,147621,293370,345860,345860
French Polynesia,2047,PF,PYF,WPR,8612,18199,26811,18962,20912,23304,21699,22959,38230,146066,8132,17185,25317,17906,19712,22324,21365,23820,42991,148118,294184,346307,346307
French Polynesia,2048,PF,PYF,WPR,8520,18087,26607,18874,20558,23300,21699,22866,39037,146334,8046,17079,25125,17820,19388,22234,21285,23682,44152,148561,294895,346632,346632
French Polynesia,2049,PF,PYF,WPR,8418,17972,26390,18793,20224,23321,21673,22699,39860,146570,7951,16970,24921,17740,19081,22180,21205,23431,45319,148956,295526,346834,346834
French Polynesia,2050,PF,PYF,WPR,8317,17849,26166,18715,19897,23298,21752,22400,40695,146757,7855,16856,24711,17665,18778,22099,21249,23029,46479,149299,296056,346933,346933
Qatar,1970,QA,QAT,EMR,10572,11469,22041,12242,15698,9940,4937,2422,1563,46802,10123,9815,19938,8227,9306,5849,3029,1616,1199,29226,76028,118007,118007
Qatar,1971,QA,QAT,EMR,11642,15659,27301,15661,17101,10723,5198,2511,1628,52822,10980,11478,22458,8874,9508,6087,3143,1664,1241,30517,83339,133096,133096
Qatar,1972,QA,QAT,EMR,12466,19185,31651,19637,18785,11638,5495,2603,1693,59851,11692,13107,24799,9694,9755,6334,3262,1707,1292,32044,91895,148338,148338
Qatar,1973,QA,QAT,EMR,13139,21980,35119,24035,20823,12689,5837,2697,1748,67829,12295,14669,26964,10655,10087,6596,3383,1759,1337,33817,101646,163734,163734
Qatar,1974,QA,QAT,EMR,13734,24049,37783,28689,23298,13899,6237,2800,1812,76735,12831,16146,28977,11708,10538,6868,3508,1806,1383,35811,112546,179299,179299
Qatar,1975,QA,QAT,EMR,14267,25516,39783,33354,26278,15284,6700,2904,1868,86388,13317,17552,30869,12805,11122,7163,3646,1854,1419,38009,124397,195043,195043
Qatar,1976,QA,QAT,EMR,14787,26502,41289,37768,29805,16884,7244,3028,1918,96647,13799,18857,32656,13912,11861,7476,3789,1900,1458,40396,137043,210990,210990
Qatar,1977,QA,QAT,EMR,15372,27058,42430,41740,33912,18729,7895,3167,1968,107411,14338,20013,34351,15016,12753,7827,3941,1950,1501,42988,150399,227177,227177
Qatar,1978,QA,QAT,EMR,16035,27292,43327,45085,38624,20859,8660,3327,2012,118567,14936,21040,35976,16089,13800,8233,4107,1997,1530,45756,164323,243624,243624
Qatar,1979,QA,QAT,EMR,16779,27346,44125,47616,43943,23313,9559,3514,2040,129985,15596,21962,37558,17111,15002,8702,4285,2046,1552,48698,178683,260368,260368
Qatar,1980,QA,QAT,EMR,17600,27384,44984,49192,49766,26140,10620,3730,2073,141521,16328,22829,39157,18051,16328,9266,4480,2095,1568,51788,193309,277450,277450
Qatar,1981,QA,QAT,EMR,18484,27595,46079,49696,55919,29408,11878,4001,2093,152995,17126,23696,40822,18874,17733,9948,4699,2148,1586,54988,207983,294887,294887
Qatar,1982,QA,QAT,EMR,19369,28079,47448,49118,62256,33182,13343,4334,2115,164348,17960,24590,42550,19563,19182,10776,4941,2206,1593,58261,222609,312608,312608
Qatar,1983,QA,QAT,EMR,20166,28823,48989,47590,68569,37552,15023,4731,2129,175594,18738,25542,44280,20117,20620,11790,5213,2265,1590,61595,237189,330454,330454
Qatar,1984,QA,QAT,EMR,20742,29807,50549,45330,74551,42614,16945,5196,2132,186768,19347,26603,45950,20548,21967,13026,5520,2327,1583,64971,251739,348241,348241
Qatar,1985,QA,QAT,EMR,21040,31004,52044,42649,79801,48414,19154,5766,2148,197932,19696,27805,47501,20897,23154,14494,5881,2395,1569,68390,266322,365868,365868
Qatar,1986,QA,QAT,EMR,21429,32866,54295,41428,82472,53275,21133,6376,2234,206918,20148,29175,49323,21571,24046,15813,6278,2508,1579,71795,278713,382328,382328
Qatar,1987,QA,QAT,EMR,22126,35059,57185,42492,82567,56484,22595,6963,2404,213505,20885,30601,51486,22624,24842,16764,6689,2663,1632,75214,288719,397391,397391
Qatar,1988,QA,QAT,EMR,22939,36664,59603,44478,82208,59432,23948,7550,2602,220218,21657,31916,53573,23571,25888,17628,7113,2845,1699,78744,298962,412142,412142
Qatar,1989,QA,QAT,EMR,23817,37671,61488,46697,81953,62564,25330,8141,2804,227489,22426,33088,55514,24322,27196,18531,7552,3034,1770,82405,309894,426896,426896
Qatar,1990,QA,QAT,EMR,24705,38323,63028,48845,81927,65840,26752,8743,3020,235127,23172,34167,57339,24903,28678,19509,8014,3234,1841,86179,321306,441675,441675
Qatar,1991,QA,QAT,EMR,25357,39037,64394,50634,82263,69230,28249,9350,3250,242976,23675,35393,59068,25366,30209,20619,8495,3440,1921,90050,333026,456486,456486
Qatar,1992,QA,QAT,EMR,25728,39995,65723,51727,83107,72786,29843,9923,3480,250866,23910,36801,60711,25778,31622,21945,8995,3646,2007,93993,344859,471293,471293
Qatar,1993,QA,QAT,EMR,25990,41115,67105,51871,84561,76530,31573,10443,3681,258659,24082,38191,62273,26203,32785,23556,9521,3848,2095,98008,356667,486041,486041
Qatar,1994,QA,QAT,EMR,26143,42410,68553,51013,86597,80443,33498,10914,3847,266312,24207,39524,63731,26686,33608,25480,10082,4045,2185,102086,368398,500683,500683
Qatar,1995,QA,QAT,EMR,26138,43882,70020,49274,89042,84504,35662,11353,3992,273827,24258,40807,65065,27243,34041,27731,10690,4233,2289,106227,380054,515133,515133
Qatar,1996,QA,QAT,EMR,25917,45466,71383,46931,91590,88704,38127,11761,4103,281216,24195,42026,66221,27880,34073,30312,11370,4417,2392,110444,391660,529265,529265
Qatar,1997,QA,QAT,EMR,25919,47248,73167,48357,94315,93015,41453,12346,4286,293772,24423,43251,67674,29762,34348,32522,12214,4609,2522,115977,409749,550591,550591
Qatar,1998,QA,QAT,EMR,26435,48800,75235,54361,97760,97318,45803,13206,4598,313046,25130,44511,69641,32773,35566,34023,13237,4825,2656,123080,436126,580997,580997
Qatar,1999,QA,QAT,EMR,27172,49747,76919,60375,102230,101584,50712,14242,4899,334042,25963,45792,71755,35380,37678,35310,14362,5060,2795,130585,464627,613302,613302
Qatar,2000,QA,QAT,EMR,28020,50492,78512,64946,107727,105924,56048,15491,5167,355303,26805,47164,73969,37308,40486,36567,15557,5311,2922,138151,493454,645937,645937
Qatar,2001,QA,QAT,EMR,28924,51399,80323,67667,114180,110466,61784,17014,5360,376471,27600,48667,76267,38626,43790,37908,16811,5585,3039,145759,522230,678831,678831
Qatar,2002,QA,QAT,EMR,29917,52850,82767,68528,121510,115437,67908,18886,5488,397757,28439,50469,78908,39570,47440,39545,18151,5893,3158,153757,551514,713186,713186
Qatar,2003,QA,QAT,EMR,30733,54848,85581,67677,129387,121051,74374,21153,5565,419207,29029,52525,81554,40312,51086,41697,19568,6252,3263,162178,581385,748525,748525
Qatar,2004,QA,QAT,EMR,31661,57177,88838,66910,134249,124957,79146,23019,5589,433870,29817,55049,84866,41440,54159,43982,20790,6611,3391,170373,604243,777943,777943
Qatar,2005,QA,QAT,EMR,32986,58766,91752,83537,155327,134329,83924,24588,5924,487629,31003,57109,88112,44121,57776,46285,22329,7055,3652,181218,668847,848710,848710
Qatar,2006,QA,QAT,EMR,34104,59342,93446,123680,220504,163094,92940,27028,6908,634154,32119,57444,89563,47769,64887,48717,24517,7900,4108,197898,832052,1015060,1015060
Qatar,2007,QA,QAT,EMR,36703,62227,98930,166759,307691,204440,105540,30012,7984,822426,34461,58936,93397,51262,74377,51609,26485,8760,4641,217134,1039560,1231893,1231893
Qatar,2008,QA,QAT,EMR,40823,68072,108895,203188,386373,244153,119481,33110,8696,995001,37994,63393,101387,55748,83939,56138,28587,9418,5159,238989,1233990,1444277,1444277
Qatar,2009,QA,QAT,EMR,43751,71898,115649,214074,437129,287587,133595,36650,8876,1117911,41158,67518,108676,61030,96577,62512,31794,10600,5517,268030,1385941,1610274,1610274
Qatar,2010,QA,QAT,EMR,46569,74953,121522,203835,448622,326914,147490,40676,8906,1176443,44278,70956,115234,65474,111558,69945,35330,12200,5802,300309,1476752,1713504,1713504
Qatar,2011,QA,QAT,EMR,50762,80616,131378,207829,460200,339501,156814,45310,9849,1219503,48163,75945,124108,68637,124076,78009,38369,13706,6386,329183,1548686,1804171,1804171
Qatar,2012,QA,QAT,EMR,54935,87120,142055,220282,493755,336520,160486,50477,11622,1273142,52219,82349,134568,70126,134880,87016,41438,15198,7237,355895,1629037,1905660,1905660
Qatar,2013,QA,QAT,EMR,58171,94980,153151,233542,538269,347083,166205,55850,13192,1354141,55600,90114,145714,72483,143847,96645,44779,16761,7968,382483,1736624,2035501,2035501
Qatar,2014,QA,QAT,EMR,61449,101721,163170,252392,595505,381622,182264,62711,14165,1488659,58888,96755,155643,75907,151641,105031,47955,18388,8071,406993,1895652,2214465,2214465
Qatar,2015,QA,QAT,EMR,65374,106102,171476,269739,659735,423362,205629,71724,15508,1645697,62704,101403,164107,77524,163253,112558,51295,20386,8276,433292,2078989,2414573,2414573
Qatar,2016,QA,QAT,EMR,69677,111253,180930,284893,713580,455122,224128,79313,17563,1774599,67135,107264,174399,80032,176753,121054,55168,22707,9531,465245,2239844,2595166,2595166
Qatar,2017,QA,QAT,EMR,72598,116964,189562,287510,743017,480058,230939,81449,19002,1841975,70284,113596,183880,83074,187431,131570,58981,24463,10818,496337,2338312,2711755,2711755
Qatar,2018,QA,QAT,EMR,73938,122919,196857,272352,749120,506994,230206,79408,19663,1857743,71368,118963,190331,83891,195008,143309,62439,25575,11584,521806,2379549,2766732,2766732
Qatar,2019,QA,QAT,EMR,76934,131701,208635,246350,731029,535119,235160,79152,20492,1847302,73918,127006,200924,86244,201826,155292,67300,27307,12408,550377,2397679,2807235,2807235
Qatar,2020,QA,QAT,EMR,77409,138577,215986,193607,684792,557544,248307,83627,21531,1789408,74235,133544,207779,78731,191602,162430,72119,29195,13134,547211,2336619,2760385,2760385
Qatar,2021,QA,QAT,EMR,74208,142119,216327,139073,634680,581819,266369,91858,23549,1737348,71024,136559,207583,68555,169213,167196,76909,31134,13972,526979,2264327,2688235,2688235
Qatar,2022,QA,QAT,EMR,71439,146208,217647,120960,608426,599576,282565,99151,25908,1736586,68344,140177,208521,73142,156211,172987,81828,33134,15061,532363,2268949,2695122,2695122
Qatar,2023,QA,QAT,EMR,68660,148995,217655,121865,595115,604258,293887,103960,27693,1746778,65768,142808,208576,83406,147307,176491,85455,34649,16075,543383,2290161,2716391,2716391
Qatar,2024,QA,QAT,EMR,65831,150464,216295,126428,580459,605773,306188,109287,29895,1758030,63228,144291,207519,94396,139082,178924,89370,36255,17191,555218,2313248,2737061,2737061
Qatar,2025,QA,QAT,EMR,62893,151061,213954,134670,565922,602347,319244,115388,32419,1769990,60508,145037,205545,105624,132098,180050,93605,37932,18428,567737,2337727,2757220,2757220
Qatar,2026,QA,QAT,EMR,60579,150431,211010,145555,552250,594582,332533,122238,35182,1782340,58276,144563,202839,116612,126729,179929,98118,39670,19752,580810,2363150,2776990,2776990
Qatar,2027,QA,QAT,EMR,59323,148374,207697,157529,539341,584164,345986,129497,38409,1794926,57043,142593,199636,127004,123251,178493,102838,41511,21180,594277,2389203,2796538,2796538
Qatar,2028,QA,QAT,EMR,58665,145467,204132,169173,527648,572531,359239,137006,42130,1807727,56383,139741,196124,136371,122091,175591,107743,43549,22699,608044,2415771,2816020,2816020
Qatar,2029,QA,QAT,EMR,58364,142042,200406,179066,518816,560209,371379,145025,46193,1820688,56068,136384,192452,143955,124150,171053,112696,45828,24329,622011,2442699,2835555,2835555
Qatar,2030,QA,QAT,EMR,58445,138261,196706,187046,513016,547249,382022,153752,50614,1833699,56124,132701,188825,149992,129266,164777,117513,48398,26116,636062,2469761,2855291,2855291
Qatar,1950,QA,QAT,EMR,2219,3034,5253,2176,1600,1194,896,613,396,6875,2166,3009,5175,2212,1617,1186,890,632,449,6986,13861,24288,24288
Qatar,1951,QA,QAT,EMR,2333,3145,5478,2238,1639,1217,912,626,413,7045,2280,3113,5393,2271,1669,1216,908,648,471,7183,14228,25093,25093
Qatar,1952,QA,QAT,EMR,2449,3262,5711,2300,1681,1244,930,640,429,7224,2391,3224,5615,2334,1718,1246,930,662,490,7380,14604,25934,25934
Qatar,1953,QA,QAT,EMR,2554,3396,5950,2371,1729,1276,948,658,448,7430,2493,3354,5847,2402,1761,1275,950,677,505,7570,15000,26798,26798
Qatar,1954,QA,QAT,EMR,2650,3556,6206,2443,1775,1303,969,671,460,7621,2586,3507,6093,2468,1814,1311,972,693,525,7783,15404,27705,27705
Qatar,1955,QA,QAT,EMR,2744,3727,6471,2523,1831,1336,989,683,480,7842,2678,3674,6352,2540,1871,1346,993,708,549,8007,15849,28668,28668
Qatar,1956,QA,QAT,EMR,2842,3905,6747,2611,1898,1380,1014,698,498,8099,2770,3851,6621,2620,1937,1383,1017,723,565,8245,16344,29712,29712
Qatar,1957,QA,QAT,EMR,2950,4098,7048,2720,1987,1437,1043,713,510,8410,2876,4038,6914,2706,2007,1435,1041,739,582,8510,16920,30880,30880
Qatar,1958,QA,QAT,EMR,3071,4299,7370,2857,2109,1507,1081,732,527,8813,2992,4231,7223,2819,2096,1494,1069,754,606,8838,17651,32246,32246
Qatar,1959,QA,QAT,EMR,3210,4512,7722,3054,2304,1619,1133,760,550,9420,3125,4437,7562,2964,2226,1568,1107,776,628,9269,18689,33973,33973
Qatar,1960,QA,QAT,EMR,3381,4745,8126,3365,2631,1803,1221,806,589,10415,3289,4659,7948,3175,2422,1683,1160,805,651,9896,20311,36385,36385
Qatar,1961,QA,QAT,EMR,3615,5015,8630,3896,3240,2131,1371,876,640,12154,3517,4914,8431,3510,2764,1867,1243,844,681,10909,23063,40111,40111
Qatar,1962,QA,QAT,EMR,3945,5311,9256,4594,4113,2595,1581,974,702,14559,3836,5201,9037,3939,3240,2114,1354,894,724,12265,26824,45123,45123
Qatar,1963,QA,QAT,EMR,4389,5622,10011,5340,5136,3158,1838,1089,779,17340,4270,5497,9767,4414,3796,2408,1484,954,773,13829,31169,50950,50950
Qatar,1964,QA,QAT,EMR,4956,5955,10911,6105,6287,3813,2136,1224,860,20425,4820,5815,10635,4909,4421,2753,1637,1025,820,15565,35990,57531,57531
Qatar,1965,QA,QAT,EMR,5646,6320,11966,6867,7544,4559,2477,1377,956,23780,5489,6171,11660,5406,5108,3143,1813,1102,864,17436,41216,64843,64843
Qatar,1966,QA,QAT,EMR,6463,6748,13211,7657,8947,5423,2878,1552,1057,27514,6275,6587,12862,5930,5874,3593,2011,1190,921,19519,47033,73102,73102
Qatar,1967,QA,QAT,EMR,7377,7287,14664,8494,10534,6436,3342,1754,1171,31731,7158,7106,14264,6489,6734,4110,2246,1288,985,21852,53583,82517,82517
Qatar,1968,QA,QAT,EMR,8366,7960,16326,9364,12267,7593,3880,1981,1313,36398,8114,7754,15868,7066,7684,4706,2513,1401,1054,24424,60822,93022,93022
Qatar,1969,QA,QAT,EMR,9418,8779,18197,10240,14113,8896,4491,2238,1461,41439,9130,8545,17675,7655,8694,5378,2817,1523,1135,27202,68641,104517,104517
Qatar,2031,QA,QAT,EMR,58934,134390,193324,193389,509136,534829,390624,163174,55400,1846552,56573,128927,185500,155052,136573,156990,122041,51320,28036,650012,2496564,2875390,2875390
Qatar,2032,QA,QAT,EMR,59834,130637,190471,197897,507202,522921,397054,173402,60640,1859116,57421,125288,182709,158989,145633,148257,126165,54588,30085,663717,2522833,2896022,2896022
Qatar,2033,QA,QAT,EMR,61127,127207,188334,200688,508118,509680,401746,184554,66487,1871273,58646,122058,180704,161615,155891,139379,129654,58170,32283,676992,2548265,2917304,2917304
Qatar,2034,QA,QAT,EMR,62816,124082,186898,202159,512685,495099,403295,196679,73180,1883097,60251,119206,179457,163103,166867,131178,132085,62037,34646,689916,2573013,2939367,2939367
Qatar,2035,QA,QAT,EMR,64852,121230,186082,202762,520922,480631,399940,209555,80854,1894664,62189,116544,178733,163848,178088,124217,133210,66218,37180,702761,2597425,2962241,2962241
Qatar,2036,QA,QAT,EMR,67139,119413,186552,202135,531799,467019,392266,222674,89422,1905315,64374,114770,179144,163371,189064,118867,133093,70669,39837,714901,2620216,2985916,2985916
Qatar,2037,QA,QAT,EMR,69614,119065,188679,200086,543764,454169,381963,235950,98750,1914682,66742,114385,181127,161405,199448,115408,131677,75327,42672,725937,2640619,3010424,3010424
Qatar,2038,QA,QAT,EMR,72184,119700,191884,197183,555400,442529,370457,249032,108716,1923317,69200,114949,184149,158554,208806,114258,128796,80167,45761,736342,2659659,3035693,3035693
Qatar,2039,QA,QAT,EMR,74744,121085,195829,193767,565290,433742,358270,261009,119408,1931486,71647,116238,187885,155202,216385,116324,124298,85053,49169,746431,2677917,3061640,3061640
Qatar,2040,QA,QAT,EMR,77213,123205,200418,189997,573269,427984,345446,271514,131050,1939260,74009,118235,192244,151523,222415,121441,118069,89810,52975,756233,2695493,3088149,3088149
Qatar,2041,QA,QAT,EMR,79549,125983,205532,186131,579618,424140,333163,280005,143601,1946658,76242,120869,197111,147752,227476,128743,110336,94283,57226,765816,2712474,3115115,3115115
Qatar,2042,QA,QAT,EMR,81721,129361,211082,182388,584128,422241,321381,286368,157252,1953758,78319,124081,202400,144116,231407,137790,101669,98359,61915,775256,2729014,3142502,3142502
Qatar,2043,QA,QAT,EMR,83681,133224,216905,178967,586926,423185,308282,291031,172266,1960657,80188,127765,207953,140886,234034,148028,92860,101813,67004,784625,2745282,3170142,3170142
Qatar,2044,QA,QAT,EMR,85384,137470,222854,175849,588405,427766,293843,292620,188897,1967380,81815,131816,213631,138038,235525,158987,84726,104222,72507,794005,2761385,3197862,3197862
Qatar,2045,QA,QAT,EMR,86825,141975,228800,173003,589020,436010,279501,289395,207057,1973986,83192,136115,219307,135382,236267,170186,77827,105347,78442,803451,2777437,3225544,3225544
Qatar,2046,QA,QAT,EMR,87996,146598,234594,171190,588405,446884,265997,281932,226150,1980558,84309,140533,224842,133607,235794,181144,72532,105248,84720,813045,2793603,3253042,3253042
Qatar,2047,QA,QAT,EMR,88857,151244,240101,170846,586369,458847,253246,271901,245965,1987174,85131,144974,230105,133220,233830,191514,69115,103866,91318,822863,2810037,3280240,3280240
Qatar,2048,QA,QAT,EMR,89395,155776,245171,171486,583484,470472,241699,260699,266025,1993865,85640,149302,234942,133786,230985,200855,68001,101044,98308,832979,2826844,3306947,3306947
Qatar,2049,QA,QAT,EMR,89644,160037,249681,172872,580083,480359,233000,248828,285534,2000676,85870,153373,239243,135078,227635,208421,70081,96628,105604,843447,2844123,3333052,3333052
Qatar,2050,QA,QAT,EMR,89622,163948,253570,174992,576324,488341,227311,236338,304331,2007637,85841,157115,242956,137073,223961,214445,75193,90508,113110,854290,2861927,3358454,3358454
Romania,1970,RO,ROU,EUR,855200,1549972,2405172,1673231,1471007,1537109,954526,925426,744647,7305946,823945,1521838,2345783,1659274,1460898,1539340,1115567,1080903,1009741,7865723,15171669,19922618,19922618
Romania,1971,RO,ROU,EUR,930710,1479097,2409807,1711860,1445306,1552762,1018660,908213,771064,7407865,897145,1458799,2355944,1703855,1435409,1550035,1169575,1075025,1037717,7971616,15379481,20145244,20145244
Romania,1972,RO,ROU,EUR,977757,1454556,2432313,1730927,1426058,1570170,1098108,874401,798790,7498454,942373,1440043,2382416,1731910,1415123,1564710,1240591,1047911,1068739,8068984,15567438,20382169,20382169
Romania,1973,RO,ROU,EUR,981582,1499245,2480827,1723449,1414300,1582820,1192608,827408,826743,7567328,944931,1482547,2427478,1740779,1402719,1577661,1327143,1003335,1100988,8152625,15719953,20628252,20628252
Romania,1974,RO,ROU,EUR,982020,1577239,2559259,1680572,1420340,1590961,1273639,793241,855617,7614370,944693,1551861,2496554,1715822,1411123,1588266,1394512,975555,1134199,8219477,15833847,20889661,20889661
Romania,1975,RO,ROU,EUR,991749,1666455,2658204,1611867,1446370,1588909,1335592,780116,885878,7648732,954466,1631734,2586200,1663725,1438693,1590869,1436523,972481,1171830,8274121,15922853,21167265,21167265
Romania,1976,RO,ROU,EUR,1005180,1762546,2767726,1538544,1479317,1575214,1385402,778885,915836,7673198,970815,1720863,2691678,1603137,1473837,1581656,1464611,981866,1211918,8317025,15990223,21449635,21449635
Romania,1977,RO,ROU,EUR,1017184,1838890,2856074,1490313,1511570,1544113,1418791,785663,947932,7698382,983602,1790921,2774523,1554658,1511517,1553589,1480362,994063,1255534,8349723,16048105,21678700,21678700
Romania,1978,RO,ROU,EUR,1024735,1885312,2910047,1475625,1540120,1501670,1441407,796505,977573,7732900,988424,1834080,2822504,1522802,1550607,1513262,1490221,1004778,1296902,8378572,16111472,21844026,21844026
Romania,1979,RO,ROU,EUR,1020731,1937561,2958292,1463973,1562617,1467602,1452015,818413,999629,7764249,984100,1884094,2868194,1489150,1586434,1480741,1493589,1021735,1331116,8402765,16167014,21993493,21993493
Romania,1980,RO,ROU,EUR,1005359,2000263,3005622,1437137,1598832,1431092,1455380,856303,1008133,7786877,970179,1943526,2913705,1446854,1629494,1445773,1495817,1048739,1352350,8419027,16205904,22125224,22125224
Romania,1981,RO,ROU,EUR,985112,2065422,3050534,1397137,1644390,1392791,1461138,906462,999281,7801199,950680,2007255,2957935,1401957,1671192,1408203,1501665,1090564,1354217,8427798,16228997,22237470,22237470
Romania,1982,RO,ROU,EUR,956427,2076142,3032569,1420680,1672281,1361964,1468359,970175,974611,7868070,923131,2017666,2940797,1419096,1696712,1376111,1510162,1152159,1335392,8489632,16357702,22331065,22331065
Romania,1983,RO,ROU,EUR,921841,2025876,2947717,1516312,1681319,1339626,1467661,1047244,938546,7990708,891000,1967781,2858781,1500673,1709131,1352141,1513614,1229640,1301353,8606552,16597260,22403762,22403762
Romania,1984,RO,ROU,EUR,889373,1982721,2872094,1606660,1665323,1339152,1461685,1105265,919487,8097572,860966,1927066,2788032,1576353,1693204,1351667,1513939,1280776,1291400,8707339,16804911,22465037,22465037
Romania,1985,RO,ROU,EUR,862361,1959484,2821845,1673413,1636451,1359130,1446749,1142554,919283,8177580,836472,1906266,2742738,1633534,1660658,1370593,1505609,1305047,1307749,8783190,16960770,22525363,22525363
Romania,1986,RO,ROU,EUR,844470,1951434,2795904,1719340,1613387,1385272,1420508,1172207,922796,8233510,821051,1896006,2717057,1679579,1630536,1395644,1484650,1321670,1328769,8840848,17074358,22587322,22587322
Romania,1987,RO,ROU,EUR,842676,1941451,2784127,1758415,1591752,1417299,1383103,1193559,933397,8277525,821393,1883676,2705069,1720744,1600336,1428043,1450695,1333046,1354205,8887069,17164594,22653807,22653807
Romania,1988,RO,ROU,EUR,855929,1917402,2773331,1798552,1571331,1454749,1340839,1207889,946771,8320131,836216,1863557,2699773,1758850,1569738,1467543,1410294,1342523,1376910,8925858,17245989,22719093,22719093
Romania,1989,RO,ROU,EUR,873578,1880307,2753885,1852106,1546141,1493225,1306543,1210825,964105,8372945,855203,1833509,2688712,1809188,1534219,1507298,1377246,1345419,1399135,8972505,17345450,22788040,22788040
Romania,1990,RO,ROU,EUR,872611,1838928,2711539,1919990,1506915,1545352,1270017,1210261,984857,8437392,855654,1799406,2655060,1874441,1487054,1557613,1341826,1347792,1423516,9032242,17469634,22836234,22836234
Romania,1991,RO,ROU,EUR,843347,1807162,2650509,1989410,1460557,1599360,1233633,1211390,1004028,8498378,827814,1774111,2601925,1943378,1433440,1608459,1304922,1353840,1447635,9091674,17590052,22842482,22842482
Romania,1992,RO,ROU,EUR,796113,1781899,2578012,1999045,1463932,1634804,1207899,1213455,1026669,8545804,779826,1752083,2531909,1954261,1432693,1644445,1276268,1362183,1475391,9145241,17691045,22800963,22800963
Romania,1993,RO,ROU,EUR,742668,1759604,2502272,1944647,1519609,1653927,1192612,1210689,1054999,8576483,723974,1729584,2453558,1902395,1487606,1667308,1257470,1365700,1508867,9189346,17765829,22721656,22721656
Romania,1994,RO,ROU,EUR,687623,1741592,2429215,1900320,1567541,1646880,1197084,1204238,1082508,8598571,666946,1711662,2378608,1859632,1535740,1662387,1259424,1366600,1542593,9226376,17824947,22632776,22632776
Romania,1995,RO,ROU,EUR,645152,1710032,2355184,1876382,1599374,1620878,1218699,1190803,1108525,8614661,623150,1680808,2303958,1834427,1570097,1637789,1280853,1358864,1577298,9259328,17873989,22533134,22533134
Romania,1996,RO,ROU,EUR,621355,1662949,2284304,1864092,1620759,1590394,1244804,1167465,1131339,8618853,598947,1634054,2233001,1817067,1597791,1608986,1309164,1339051,1609648,9281707,17900560,22417869,22417869
Romania,1997,RO,ROU,EUR,603197,1621563,2224760,1846729,1644183,1551457,1275391,1135204,1152021,8604985,581641,1592026,2173667,1796238,1625511,1572239,1343298,1309482,1639357,9286125,17891110,22289535,22289535
Romania,1998,RO,ROU,EUR,588850,1586787,2175637,1817971,1674661,1507819,1308712,1100469,1170656,8580288,568913,1556745,2125658,1768907,1654165,1530753,1381717,1276113,1667996,9279651,17859939,22161242,22161242
Romania,1999,RO,ROU,EUR,579009,1544711,2123720,1785325,1715621,1458587,1343997,1071478,1187034,8562042,560725,1515256,2075981,1738307,1691576,1482908,1422403,1247479,1694595,9277268,17839310,22039007,22039007
Romania,2000,RO,ROU,EUR,572607,1489939,2062546,1755120,1766542,1399335,1387104,1042377,1205274,8555752,555710,1461932,2017642,1709653,1738920,1423930,1471181,1217801,1722449,9283934,17839686,21919876,21919876
Romania,2001,RO,ROU,EUR,567612,1423319,1990931,1736688,1815810,1339417,1425150,1015774,1225555,8558394,551366,1397794,1949160,1692330,1785214,1362835,1515734,1188924,1754070,9299107,17857501,21797590,21797590
Romania,2002,RO,ROU,EUR,562254,1348566,1910820,1717162,1817388,1332542,1453015,998718,1244778,8563603,544889,1323550,1868439,1673855,1782444,1351282,1549068,1167343,1786678,9310670,17874273,21653532,21653532
Romania,2003,RO,ROU,EUR,555495,1278447,1833942,1684280,1769708,1381363,1471765,992005,1259346,8558467,535642,1251215,1786857,1641380,1730087,1391086,1569789,1155656,1814050,9302048,17860515,21481320,21481320
Romania,2004,RO,ROU,EUR,547441,1217083,1764524,1645460,1729632,1426329,1468560,999458,1269012,8538451,525316,1187631,1712947,1602664,1686505,1426141,1563758,1159943,1834365,9273376,17811827,21289286,21289286
Romania,2005,RO,ROU,EUR,540767,1170588,1711355,1597130,1703710,1457890,1448369,1020953,1272136,8500188,517177,1139826,1657003,1553090,1657931,1448960,1537441,1181363,1844936,9223721,17723909,21092264,21092264
Romania,2006,RO,ROU,EUR,537964,1141881,1679845,1539767,1680167,1483534,1422961,1048380,1271699,8446508,513808,1110561,1624369,1491995,1633634,1466658,1504482,1210525,1851387,9158681,17605189,20909401,20909401
Romania,2007,RO,ROU,EUR,538087,1122654,1660741,1486588,1650464,1509005,1391475,1079530,1270618,8387680,514408,1090528,1604936,1434489,1604088,1484758,1464490,1243991,1859060,9090876,17478556,20744230,20744230
Romania,2008,RO,ROU,EUR,540129,1109531,1649660,1441458,1611790,1536156,1354084,1114835,1269751,8328074,517249,1076092,1593341,1386001,1565596,1505022,1417681,1282497,1869632,9026429,17354503,20597508,20597508
Romania,2009,RO,ROU,EUR,543966,1099327,1643293,1397527,1565397,1570912,1311555,1151074,1273097,8269562,521714,1064390,1586104,1340408,1518873,1533747,1363944,1322249,1888143,8967364,17236926,20466318,20466318
Romania,2010,RO,ROU,EUR,545420,1092690,1638110,1347599,1518947,1612611,1259440,1194351,1276466,8209414,523903,1056525,1580428,1290635,1470678,1570522,1299130,1369645,1906645,8907255,17116669,20335211,20335211
Romania,2011,RO,ROU,EUR,542408,1090019,1632427,1296610,1484961,1651990,1212105,1232941,1280028,8158635,520599,1052834,1573433,1241486,1434244,1607523,1239947,1412927,1919663,8855790,17014425,20220285,20220285
Romania,2012,RO,ROU,EUR,538250,1087962,1626212,1247557,1465504,1657929,1210776,1256413,1286077,8124256,514914,1049982,1564896,1196001,1411651,1614310,1228323,1441584,1929881,8821750,16946006,20137118,20137118
Romania,2013,RO,ROU,EUR,530516,1086261,1616777,1200287,1453655,1621984,1256985,1270093,1295997,8099001,505916,1047461,1553377,1152930,1395867,1580426,1265929,1458256,1943981,8797389,16896390,20066546,20066546
Romania,2014,RO,ROU,EUR,521350,1084316,1605666,1158060,1441091,1586575,1306232,1266682,1316985,8075625,495756,1044469,1540225,1114052,1380637,1546625,1308078,1451964,1972960,8774316,16849941,19995836,19995836
Romania,2015,RO,ROU,EUR,518207,1080121,1598328,1121536,1418867,1566556,1342546,1248841,1342035,8040381,491125,1039655,1530780,1079468,1356793,1526291,1338512,1427355,2008175,8736594,16776975,19906079,19906079
Romania,2016,RO,ROU,EUR,520801,1074679,1595480,1094348,1383764,1550703,1373645,1226753,1363254,7992467,492876,1033192,1526068,1053087,1319916,1508416,1364791,1396974,2040623,8683807,16676274,19797820,19797820
Romania,2017,RO,ROU,EUR,526226,1071347,1597573,1074565,1347678,1531035,1404218,1201115,1383853,7942464,498535,1028168,1526703,1033203,1282334,1486816,1391210,1362368,2076185,8632116,16574580,19698853,19698853
Romania,2018,RO,ROU,EUR,533294,1066386,1599680,1059196,1318532,1504207,1436758,1170589,1404553,7893835,505852,1021750,1527602,1016626,1252732,1458529,1420444,1322451,2114875,8585657,16479492,19606783,19606783
Romania,2019,RO,ROU,EUR,537312,1061321,1598633,1049417,1290189,1473061,1477374,1136820,1425395,7852256,510154,1015494,1525648,1005199,1226102,1426002,1459205,1277244,2153918,8547670,16399926,19524211,19524211
Romania,2020,RO,ROU,EUR,534841,1059230,1594071,1047096,1255239,1446246,1524815,1096686,1441697,7811779,508143,1012034,1520177,1001888,1194546,1397706,1506857,1223796,2191225,8516018,16327797,19442038,19442038
Romania,2021,RO,ROU,EUR,527689,1058620,1586309,1049783,1214371,1424992,1565980,1059320,1444224,7758670,501493,1009942,1511435,1004241,1157008,1375022,1550158,1172272,2213443,8472144,16230814,19328560,19328560
Romania,2022,RO,ROU,EUR,530215,1072292,1602507,1119952,1243911,1444109,1587552,1068876,1442573,7906973,504361,1022667,1527028,1080161,1190833,1390030,1571813,1167588,2222328,8622753,16529726,19659267,19659267
Romania,2023,RO,ROU,EUR,532698,1080900,1613598,1165062,1256803,1461169,1567181,1119623,1443885,8013723,506856,1030356,1537212,1129339,1208440,1403214,1550235,1208691,2228363,8728282,16742005,19892812,19892812
Romania,2024,RO,ROU,EUR,523725,1071692,1595417,1123203,1188930,1436110,1530196,1165373,1452222,7896034,497643,1020084,1517727,1084411,1143748,1378262,1513788,1248763,2240848,8609820,16505854,19618996,19618996
Romania,2025,RO,ROU,EUR,515477,1064909,1580386,1090834,1137802,1408672,1510682,1200312,1465971,7814273,489284,1012157,1501441,1050111,1095145,1351518,1494353,1279561,2257527,8528215,16342488,19424322,19424322
Romania,2026,RO,ROU,EUR,507979,1061388,1569367,1070010,1108975,1377339,1498061,1230315,1475214,7759914,481756,1008177,1489933,1027801,1068729,1320247,1481661,1307670,2266622,8472730,16232644,19291945,19291945
Romania,2027,RO,ROU,EUR,501304,1058207,1559511,1060802,1094903,1350194,1483305,1259282,1480551,7729037,475113,1005503,1480616,1016977,1056531,1292981,1467350,1336193,2269285,8439317,16168354,19208482,19208482
Romania,2028,RO,ROU,EUR,492718,1058718,1551436,1054358,1086381,1331646,1462057,1289509,1482391,7706342,466906,1006151,1473057,1009289,1048764,1275056,1446935,1367308,2266355,8413707,16120049,19144537,19144537
Romania,2029,RO,ROU,EUR,482938,1059545,1542483,1049480,1079604,1312182,1436150,1326757,1482836,7687009,457705,1006855,1464560,1003319,1041708,1258020,1420999,1406967,2260164,8391177,16078186,19085238,19085238
Romania,2030,RO,ROU,EUR,474969,1053671,1528640,1048005,1074347,1282684,1413488,1370278,1482666,7671468,450143,1001232,1451375,1000407,1035897,1232232,1397016,1454213,2252137,8371902,16043370,19023383,19023383
Romania,1950,RO,ROU,EUR,825695,1501659,2327354,1605436,1053130,1067202,851303,492104,486014,5555189,805835,1507994,2313829,1593682,1193848,1163364,930154,628229,687321,6196598,11751787,16392971,16392971
Romania,1951,RO,ROU,EUR,876281,1480401,2356682,1617884,1116034,1045091,878098,511651,474542,5643300,849352,1482997,2332349,1605196,1243718,1155352,948125,652994,675019,6280404,11923704,16612734,16612734
Romania,1952,RO,ROU,EUR,916333,1465299,2381632,1625513,1186773,1016237,905274,535916,462833,5732546,884908,1464330,2349238,1614724,1298753,1139058,966507,683857,662279,6365178,12097724,16828585,16828585
Romania,1953,RO,ROU,EUR,943122,1462948,2406070,1625675,1261745,985145,930610,561814,454891,5819880,909344,1456460,2365804,1619823,1355903,1119680,985586,713732,654645,6449369,12269249,17041122,17041122
Romania,1954,RO,ROU,EUR,957985,1474146,2432131,1618362,1335701,956373,954684,587095,451408,5903623,923876,1460667,2384543,1618871,1411238,1101156,1007067,739233,653141,6530706,12434329,17250994,17250994
Romania,1955,RO,ROU,EUR,963479,1494778,2458257,1605475,1402847,934915,977013,611291,452501,5984042,930904,1474638,2405542,1611200,1460090,1087860,1030820,759964,657517,6607451,12591493,17455291,17455291
Romania,1956,RO,ROU,EUR,969013,1524538,2493551,1588489,1458359,923926,996362,634883,458997,6061016,935696,1498125,2433821,1596275,1498379,1082830,1056208,777255,668700,6679647,12740663,17668031,17668031
Romania,1957,RO,ROU,EUR,973872,1565183,2539055,1566425,1501553,924489,1011704,658790,468574,6131535,937067,1532585,2469652,1573744,1525613,1086149,1082056,793093,684030,6744685,12876220,17884928,17884928
Romania,1958,RO,ROU,EUR,970046,1613698,2583744,1539168,1534126,937930,1022020,683752,479455,6196451,930840,1575706,2506546,1544655,1544300,1097917,1105989,808908,701435,6803204,12999655,18089945,18089945
Romania,1959,RO,ROU,EUR,958350,1666257,2624607,1509863,1556810,966150,1024679,709240,491074,6257816,918005,1623601,2541606,1511853,1556568,1120367,1124053,825501,720142,6858484,13116300,18282518,18282518
Romania,1960,RO,ROU,EUR,938348,1718837,2657185,1481116,1571343,1010294,1016994,735479,502686,6317912,897655,1672173,2569828,1478426,1564009,1155709,1131884,844174,738877,6913079,13230991,18458008,18458008
Romania,1961,RO,ROU,EUR,908395,1768436,2676831,1455905,1581356,1069365,998919,762828,516924,6385297,868458,1717681,2586139,1447988,1569409,1203425,1128107,865372,760338,6974639,13359936,18622911,18622911
Romania,1962,RO,ROU,EUR,869581,1808672,2678253,1438126,1588864,1139819,971677,789708,533828,6462022,831523,1754121,2585644,1424468,1574432,1260181,1113675,887938,783717,7044411,13506433,18770327,18770327
Romania,1963,RO,ROU,EUR,827031,1833221,2660252,1430602,1593552,1216703,938020,815275,552395,6546547,790935,1776332,2567267,1410702,1578260,1321657,1091225,911763,807460,7121067,13667614,18895142,18895142
Romania,1964,RO,ROU,EUR,784323,1842431,2626754,1434761,1594715,1294254,903036,840401,573905,6641072,750002,1784477,2534479,1408701,1579161,1382883,1065281,938091,833634,7207751,13848823,19010052,19010052
Romania,1965,RO,ROU,EUR,745046,1836396,2581442,1451660,1590470,1365605,872399,864794,597977,6742905,712563,1778460,2491023,1420146,1574402,1437576,1041089,966763,861731,7301707,14044612,19117072,19117072
Romania,1966,RO,ROU,EUR,716039,1805371,2521410,1484559,1578466,1424983,854430,887442,625636,6855516,684889,1752045,2436934,1449778,1562970,1479968,1026989,996384,891543,7407632,14263148,19221483,19221483
Romania,1967,RO,ROU,EUR,711597,1748822,2460419,1531638,1556959,1469809,854928,907193,656376,6976903,681043,1704863,2385906,1496629,1543513,1507981,1028893,1025774,922527,7525317,14502220,19348536,19348536
Romania,1968,RO,ROU,EUR,738824,1683476,2422300,1583249,1528361,1501122,872372,921840,687057,7094001,708958,1647469,2356427,1551780,1516574,1523696,1045812,1051906,952797,7642565,14736566,19515298,19515298
Romania,1969,RO,ROU,EUR,789616,1617899,2407515,1629772,1499419,1522253,905258,929028,716878,7202608,759801,1586078,2345879,1606210,1488727,1532403,1074737,1071682,981972,7755731,14958339,19711721,19711721
Romania,2031,RO,ROU,EUR,468524,1042545,1511069,1048943,1071707,1246226,1396297,1409400,1485970,7658543,443990,990510,1434500,999831,1032935,1199286,1378235,1497602,2247016,8354905,16013448,18959017,18959017
Romania,2032,RO,ROU,EUR,463047,1027258,1490305,1053149,1068140,1205803,1383243,1419244,1518174,7647753,438720,975618,1414338,1002769,1029306,1162194,1362733,1508048,2274801,8339851,15987604,18892250,18892250
Romania,2033,RO,ROU,EUR,458268,1011188,1469456,1056006,1063667,1164022,1374843,1395770,1581858,7636166,434105,959984,1394089,1004754,1024468,1123740,1351067,1479799,2339835,8323663,15959829,18823372,18823372
Romania,2034,RO,ROU,EUR,454260,996994,1451254,1054727,1058667,1127145,1365692,1372519,1642535,7621285,430232,946109,1376341,1003009,1018780,1089436,1339863,1451579,2401235,8303902,15925187,18752783,18752783
Romania,2035,RO,ROU,EUR,450807,984291,1435098,1053034,1052062,1098886,1350395,1361985,1687357,7603719,426896,933668,1360564,1000509,1011972,1063290,1323416,1437672,2444225,8281084,15884803,18680470,18680470
Romania,2036,RO,ROU,EUR,447894,972400,1420294,1052131,1045186,1082965,1326573,1355118,1722287,7584260,424091,922021,1346112,999298,1004545,1049535,1298215,1428334,2475977,8255904,15840164,18606572,18606572
Romania,2037,RO,ROU,EUR,445506,961044,1406550,1049886,1041053,1073786,1302841,1344177,1751577,7563320,421796,910886,1332682,997591,999099,1042044,1273423,1415814,2500704,8228675,15791995,18531225,18531225
Romania,2038,RO,ROU,EUR,443395,947926,1391321,1050639,1035932,1066695,1285604,1326235,1778265,7543370,419761,898288,1318049,998479,992765,1035540,1256281,1396614,2521813,8201492,15744862,18454237,18454237
Romania,2039,RO,ROU,EUR,441311,934181,1375492,1051498,1031159,1060176,1266944,1304224,1809531,7523532,417753,885242,1302995,999196,986842,1028574,1239505,1372005,2547420,8173542,15697074,18375560,18375560
Romania,2040,RO,ROU,EUR,439440,922801,1362241,1045665,1029779,1055162,1238767,1285895,1845554,7500822,415964,874369,1290333,993591,983969,1022852,1214142,1349554,2578100,8142208,15643030,18295603,18295603
Romania,2041,RO,ROU,EUR,437735,913479,1351214,1034593,1030802,1052717,1203971,1272814,1880726,7475623,414342,865436,1279778,982896,983429,1019966,1181749,1332237,2607632,8107909,15583532,18214523,18214523
Romania,2042,RO,ROU,EUR,436107,905649,1341756,1019369,1035091,1049361,1165490,1263741,1915606,7448658,412789,857892,1270681,968028,986395,1016412,1145308,1318191,2637000,8071334,15519992,18132423,18132423
Romania,2043,RO,ROU,EUR,434694,898795,1333489,1003361,1038027,1045119,1125876,1259037,1948924,7420344,411450,851261,1262711,952422,988411,1011657,1107576,1307918,2665022,8033006,15453350,18049550,18049550
Romania,2044,RO,ROU,EUR,433462,892730,1326192,989221,1036841,1040369,1091092,1253472,1979890,7390885,410273,845400,1255673,938572,986706,1006063,1073980,1298042,2689913,7993276,15384161,17966025,17966025
Romania,2045,RO,ROU,EUR,432243,887434,1319677,976569,1035238,1034020,1064603,1241871,2008182,7360483,409093,840291,1249384,926157,984242,999346,1048429,1282948,2711353,7952475,15312958,17882022,17882022
Romania,2046,RO,ROU,EUR,430910,882843,1313753,964730,1034412,1027387,1049879,1221753,2031111,7329272,407796,835879,1243675,914529,983056,992007,1035051,1259108,2727067,7910818,15240090,17797514,17797514
Romania,2047,RO,ROU,EUR,429470,878857,1308327,953423,1032245,1023455,1041527,1201104,2045664,7297418,406403,832049,1238452,903415,981379,986638,1027805,1235428,2733839,7868504,15165922,17712699,17712699
Romania,2048,RO,ROU,EUR,427904,875359,1303263,940354,1033068,1018535,1035150,1186037,2051940,7265084,404891,828686,1233577,890839,982291,980378,1021521,1219018,2731701,7825748,15090832,17627677,17627677
Romania,2049,RO,ROU,EUR,426256,872061,1298317,926661,1033994,1013958,1029316,1169681,2058865,7232475,403307,825515,1228822,877816,983031,974524,1014785,1202956,2729777,7782889,15015364,17542502,17542502
Romania,2050,RO,ROU,EUR,424534,868996,1293530,915325,1028255,1012755,1024939,1144866,2073405,7199545,401667,822565,1224232,866963,977457,971718,1009280,1178680,2735806,7739904,14939449,17457213,17457213
Russian Federation,1970,RU,RUS,EUR,4761163,12557272,17318435,11592920,9175641,9665786,4611041,4200171,2715017,41960576,4601439,12096907,16698346,11118310,9295378,10562420,7710754,8120150,7308641,54115653,96076229,130093010,130093010
Russian Federation,1971,RU,RUS,EUR,4783440,12157047,16940487,11996576,8884626,9729536,5027215,4151407,2798092,42587452,4636787,11689775,16326562,11631210,8998137,10413396,8216790,8028838,7576781,54865152,97452604,130719659,130719659
Russian Federation,1972,RU,RUS,EUR,4839149,11792091,16631240,12189962,8707668,9826505,5622783,4049670,2902188,43298776,4693597,11316089,16009686,11864476,8781332,10413169,8774855,7810899,7871994,55516725,98815501,131456435,131456435
Russian Federation,1973,RU,RUS,EUR,4934440,11375593,16310033,12390360,8487030,9921027,6239849,3990953,3002609,44031828,4786201,10907545,15693746,12079434,8520929,10459789,9288401,7659649,8147827,56156029,100187857,132191634,132191634
Russian Federation,1974,RU,RUS,EUR,5043804,10938668,15982472,12549017,8368057,9974816,6838809,3945016,3116373,44792088,4887515,10518089,15405604,12209594,8342278,10508814,9732882,7546963,8449746,56790277,101582365,132970443,132970443
Russian Federation,1975,RU,RUS,EUR,5155811,10525298,15681109,12686717,8398767,9970585,7438839,3831770,3242058,45568736,4996432,10165512,15161944,12296263,8318676,10520323,10184985,7338089,8771721,57430057,102998793,133841842,133841842
Russian Federation,1976,RU,RUS,EUR,5240510,10186707,15427217,12826349,8537046,9947809,7934831,3713315,3370950,46330300,5078545,9868846,14947391,12393277,8413398,10511333,10515289,7135641,9090627,58059565,104389865,134764462,134764462
Russian Federation,1977,RU,RUS,EUR,5295373,9946821,15242194,12911825,8939864,9756130,8314928,3619760,3508475,47050982,5127396,9652721,14780117,12427964,8770557,10335603,10672724,6997364,9434559,58638771,105689753,135712068,135712068
Russian Federation,1978,RU,RUS,EUR,5333532,9790673,15124205,12956194,9635082,9349650,8540505,3589633,3639768,47710832,5165201,9506023,14671224,12392488,9448371,9924228,10613745,6989475,9784566,59152873,106863705,136659133,136659133
Russian Federation,1979,RU,RUS,EUR,5364336,9744615,15108951,12823504,10430475,8959722,8595453,3644219,3747763,48201136,5194163,9451736,14645899,12234270,10247789,9527405,10375186,7071317,10098352,59554319,107755455,137510309,137510309
Russian Federation,1980,RU,RUS,EUR,5398361,9808993,15207354,12515888,11183028,8584307,8633698,3803782,3799822,48520525,5216271,9495889,14712160,11969106,10998353,9135582,10172749,7248234,10293356,59817380,108337905,138257420,138257420
Russian Federation,1981,RU,RUS,EUR,5446326,9925108,15371434,12185453,11668006,8327980,8686132,4135088,3782556,48785215,5253487,9588404,14841891,11681527,11485042,8845280,10055496,7628738,10308260,60004343,108789558,139002880,139002880
Russian Federation,1982,RU,RUS,EUR,5523796,10080319,15604115,11827817,11946290,8155994,8755003,4617981,3728996,49032081,5320988,9722354,15043342,11372012,11766484,8623709,10048849,8136442,10220969,60168465,109200546,139848005,139848005
Russian Federation,1983,RU,RUS,EUR,5660780,10259402,15920182,11432995,12240983,7947929,8831445,5116071,3705161,49274584,5449082,9883121,15332203,11022198,12052829,8354540,10095675,8605571,10196343,60327156,109601740,140854123,140854123
Russian Federation,1984,RU,RUS,EUR,5809929,10429177,16239106,11044870,12484294,7852410,8876439,5585809,3690605,49534427,5595855,10052304,15648159,10663044,12262403,8192997,10134676,9012565,10205173,60470858,110005285,141892552,141892552
Russian Federation,1985,RU,RUS,EUR,5919830,10577075,16496905,10708669,12671861,7907958,8879462,6039858,3638918,49846726,5707805,10219492,15927297,10327426,12415340,8192932,10130651,9421085,10138031,60625465,110472191,142896392,142896392
Russian Federation,1986,RU,RUS,EUR,6034704,10705416,16740120,10447429,12845773,8073182,8869640,6422674,3603728,50262426,5821483,10364748,16186231,10046041,12569348,8301431,10105603,9739770,10095519,60857712,111120138,144046482,144046482
Russian Federation,1987,RU,RUS,EUR,6149206,10834388,16983594,10279070,12927910,8487321,8725237,6732109,3602559,50754206,5930846,10499620,16430466,9851465,12637796,8666776,9927323,9924702,10135678,61143740,111897946,145312019,145312019
Russian Federation,1988,RU,RUS,EUR,6170623,11029425,17200048,10175466,12921783,9172019,8397210,6912267,3644274,51223019,5947158,10691736,16638894,9721061,12633822,9335339,9535752,9910803,10265632,61402409,112625428,146464378,146464378
Russian Federation,1989,RU,RUS,EUR,6068758,11240821,17309579,10109630,12786690,9975934,8067612,6952465,3756344,51648675,5839154,10894661,16733815,9651962,12494302,10145018,9158173,9692449,10507536,61649440,113298115,147341508,147341508
Russian Federation,1990,RU,RUS,EUR,5889810,11415010,17304820,10097717,12525471,10752536,7747359,7001763,3921466,52046312,5652362,11055339,16707701,9666295,12237171,10935150,8796602,9495500,10816152,61946870,113993182,148005704,148005704
Russian Federation,1991,RU,RUS,EUR,5620933,11604402,17225335,10146030,12212939,11270274,7531167,7067192,4150286,52377888,5383100,11234432,16617532,9735742,11965614,11464534,8535313,9381038,11152397,62234638,114612526,148455402,148455402
Russian Federation,1992,RU,RUS,EUR,5237527,11821445,17058972,10272261,11843383,11572653,7382805,7151229,4465003,52687334,5008454,11439046,16447500,9866518,11651076,11780849,8337310,9372072,11523963,62531788,115219122,148725601,148725601
Russian Federation,1993,RU,RUS,EUR,4834168,12005132,16839300,10452638,11446854,11831386,7203030,7245480,4802676,52982064,4613624,11606733,16220357,10056474,11291298,12076208,8098237,9436811,11896516,62855544,115837608,148897270,148897270
Russian Federation,1994,RU,RUS,EUR,4493942,12093040,16586982,10616583,11077204,11985446,7122978,7286040,5076633,53164884,4284202,11681778,15965980,10260800,10917362,12281991,7973938,9486591,12190575,63111257,116276141,148829113,148829113
Russian Federation,1995,RU,RUS,EUR,4210615,12076640,16287255,10746648,10738576,12085786,7165451,7257091,5277394,53270946,4015416,11653388,15668804,10453618,10556359,12438710,8000644,9484323,12396801,63330455,116601401,148557451,148557451
Russian Federation,1996,RU,RUS,EUR,3985113,11949865,15934978,10877529,10425527,12192924,7291182,7190606,5429778,53407546,3800355,11517101,15317456,10624556,10250943,12594264,8120554,9458695,12524420,63573432,116980978,148233411,148233411
Russian Federation,1997,RU,RUS,EUR,3818071,11686661,15504732,11036367,10195661,12226570,7631579,7013247,5557977,53661401,3639211,11252516,14891727,10789781,10044763,12662657,8489938,9292172,12602796,63882107,117543508,147939972,147939972
Russian Federation,1998,RU,RUS,EUR,3697916,11262091,14960007,11288116,10041931,12207285,8202555,6688607,5636366,54064860,3523321,10836792,14360113,11024810,9913772,12671252,9145763,8929453,12602701,64287751,118352611,147672728,147672728
Russian Federation,1999,RU,RUS,EUR,3587680,10766478,14354158,11572304,9973859,12083939,8863335,6352592,5651049,54497078,3416209,10350442,13766651,11291684,9867628,12563605,9932142,8564398,12499046,64718503,119215581,147336388,147336388
Russian Federation,2000,RU,RUS,EUR,3470866,10269797,13740663,11794511,10011560,11846036,9478602,6020466,5688789,54839964,3302585,9859357,13161942,11507371,9924308,12339904,10683701,8201943,12445046,65102273,119942237,146844839,146844839
Russian Federation,2001,RU,RUS,EUR,3374290,9712725,13087015,12015679,10106583,11578863,9875256,5791399,5773994,55141774,3210754,9311897,12522651,11720957,10038031,12092925,11186689,7947866,12497623,65484091,120625865,146235530,146235530
Russian Federation,2002,RU,RUS,EUR,3323062,9078361,12401423,12261218,10241256,11262378,10111808,5650541,5918587,55445788,3164880,8694493,11859373,11947178,10194665,11797662,11499038,7769655,12675353,65883551,121329339,145590136,145590136
Russian Federation,2003,RU,RUS,EUR,3365639,8493822,11859461,12394704,10380538,10892875,10313731,5512834,6093649,55588331,3203098,8127864,11330962,12076638,10369007,11435219,11787183,7551235,12948692,66167974,121756305,144946723,144946723
Russian Federation,2004,RU,RUS,EUR,3483932,8013490,11497422,12366501,10503132,10512113,10433366,5488314,6253252,55556678,3310923,7667189,10978112,12070808,10532242,11041526,11990401,7451902,13234547,66321426,121878104,144353636,144353636
Russian Federation,2005,RU,RUS,EUR,3589249,7594385,11183634,12238768,10617640,10146880,10530868,5581608,6373023,55488787,3411012,7275305,10686317,11966743,10688964,10661204,12151185,7508185,13465028,66441309,121930096,143800049,143800049
Russian Federation,2006,RU,RUS,EUR,3670200,7277964,10948164,12041041,10721024,9831624,10639997,5739562,6432094,55405342,3490092,6971105,10461197,11794208,10828241,10336573,12303902,7654431,13606613,66523968,121929310,143338669,143338669
Russian Federation,2007,RU,RUS,EUR,3765364,7090399,10855763,11781435,10840705,9623087,10678564,6041001,6374880,55339672,3580858,6773791,10354649,11554463,10956869,10116956,12357588,8021136,13560609,66567621,121907293,143117693,143117693
Russian Federation,2008,RU,RUS,EUR,3878611,7021395,10900006,11404468,11038319,9493366,10669096,6483696,6167320,55256265,3688632,6695098,10383730,11176699,11141473,9981402,12346608,8636247,13264116,66546545,121802810,143086549,143086549
Russian Federation,2009,RU,RUS,EUR,4003641,7014158,11017799,10982883,11253886,9444665,10575238,6987669,5922350,55166691,3808544,6685458,10494002,10732990,11337610,9931126,12222380,9370379,12890674,66485159,121651850,143163643,143163643
Russian Federation,2010,RU,RUS,EUR,4098804,7024102,11122906,10593517,11426062,9486330,10396141,7473850,5736081,55111981,3898588,6694926,10593514,10289476,11493066,9977097,11988832,10079715,12586013,66414199,121526180,143242599,143242599
Russian Federation,2011,RU,RUS,EUR,4215509,7065427,11280936,10122236,11629495,9584964,10198436,7807351,5700606,55043088,4006662,6733720,10740382,9771285,11663256,10078868,11729962,10554552,12502213,66300136,121343224,143364543,143364543
Russian Federation,2012,RU,RUS,EUR,4381407,7172826,11554233,9534316,11884881,9725399,9961819,8026820,5803083,54936318,4159758,6834056,10993814,9175537,11859995,10219217,11424604,10841328,12624303,66144984,121081302,143629362,143629362
Russian Federation,2013,RU,RUS,EUR,4518089,7342448,11860537,8957252,12102855,9884801,9702050,8241172,5940911,54829041,4284551,6994700,11279251,8596301,12022891,10385970,11082905,11110013,12789956,65988036,120817077,143956866,143956866
Russian Federation,2014,RU,RUS,EUR,4634213,7541227,12175440,8426636,12237752,10048217,9452112,8408310,6133057,54706084,4389478,7184557,11574035,8065926,12119707,10557317,10739111,11305713,13041738,65829512,120535596,144285070,144285070
Russian Federation,2015,RU,RUS,EUR,4769368,7730032,12499400,7949352,12294209,10214684,9215696,8563126,6352019,54589086,4513808,7364902,11878710,7598471,12151055,10731744,10412396,11462227,13345308,65701201,120290287,144668389,144668389
Russian Federation,2016,RU,RUS,EUR,4872041,7935034,12807075,7582368,12272755,10376171,9011270,8725059,6545325,54512948,4609464,7558738,12168202,7247497,12104533,10894501,10133276,11613215,13627912,65620934,120133882,145109157,145109157
Russian Federation,2017,RU,RUS,EUR,4847640,8187929,13035569,7347985,12137696,10537029,8879606,8822427,6748098,54472841,4586513,7794457,12380970,7026186,11946296,11040591,9944656,11676125,13929302,65563156,120035997,145452536,145452536
Russian Federation,2018,RU,RUS,EUR,4724273,8430327,13154600,7256553,11820514,10763424,8805751,8877275,6951716,54475233,4469403,8020416,12489819,6939653,11613227,11239308,9831141,11682670,14226647,65532646,120007879,145652293,145652293
Russian Federation,2019,RU,RUS,EUR,4544075,8661507,13205582,7242211,11413840,11010608,8794955,8858054,7171861,54491529,4298806,8234915,12533721,6932706,11188193,11452987,9797980,11585650,14553937,65511453,120002982,145742286,145742286
Russian Federation,2020,RU,RUS,EUR,4307400,8904977,13212377,7249581,10978326,11219005,8852916,8749526,7381445,54430799,4075851,8457595,12533446,6948319,10732965,11628020,9849877,11374683,14906845,65440709,119871508,145617329,145617329
Russian Federation,2021,RU,RUS,EUR,4053693,9144225,13197918,7289445,10466290,11429610,8934136,8571182,7504086,54194749,3836610,8677111,12513721,6992470,10213798,11808847,9944733,11114127,15122406,65196381,119391130,145102755,145102755
Russian Federation,2022,RU,RUS,EUR,3857060,9294709,13151769,7441905,9943148,11693265,9045244,8332134,7600975,54056671,3652008,8816629,12468637,7146013,9701621,12036729,10085602,10805544,15260723,65036232,119092903,144713314,144713314
Russian Federation,2023,RU,RUS,EUR,3719253,9312561,13031814,7619603,9408075,11927772,9191662,8110821,7797889,54055822,3522525,8828845,12351370,7317116,9176510,12228347,10258405,10479820,15545157,65005355,119061177,144444359,144444359
Russian Federation,2024,RU,RUS,EUR,3611176,9241638,12852814,7750308,8847349,12065302,9351946,7928369,8073814,54017088,3420060,8755835,12175895,7433329,8619219,12327273,10430906,10162290,15938260,64911277,118928365,143957079,143957079
Russian Federation,2025,RU,RUS,EUR,3536441,9133356,12669797,7884359,8331931,12118054,9515805,7765128,8379290,53994567,3349269,8650191,11999460,7553450,8106527,12346856,10600634,9864022,16358896,64830385,118824952,143494210,143494210
Russian Federation,2026,RU,RUS,EUR,3475944,8975005,12450949,8050250,7914667,12079461,9668832,7629888,8681893,54024991,3292080,8498981,11791061,7703604,7694722,12273463,10751679,9611352,16763585,64798405,118823396,143065413,143065413
Russian Federation,2027,RU,RUS,EUR,3424489,8738478,12162967,8277641,7635000,11930399,9821243,7549134,8924435,54137852,3243486,8275684,11519170,7910535,7419995,12091988,10887430,9443048,17089586,64842582,118980434,142662574,142662574
Russian Federation,2028,RU,RUS,EUR,3376799,8466666,11843465,8503328,7500276,11605952,10035586,7513752,9125598,54284492,3198669,8018247,11216916,8117312,7284087,11739196,11075827,9345366,17356521,64918309,119202801,142263180,142263180
Russian Federation,2029,RU,RUS,EUR,3332485,8180940,11513425,8723314,7443043,11193498,10268455,7528640,9281063,54438013,3157298,7747581,10904879,8318824,7228954,11294553,11278666,9322212,17555422,64998631,119436644,141854940,141854940
Russian Federation,2030,RU,RUS,EUR,3294888,7870199,11165087,8958984,7409163,10756045,10473357,7606888,9399548,54603985,3122183,7454296,10576479,8532535,7196883,10820615,11450799,9386903,17699459,65087194,119691179,141432741,141432741
Russian Federation,1950,RU,RUS,EUR,5367655,9936510,15304165,10801527,5600864,5469347,3443147,2270394,1564558,29149837,5174349,9731604,14905953,11631075,8553563,8882723,6543924,4251009,3357860,43220154,72369991,102580107,102580107
Russian Federation,1951,RU,RUS,EUR,6122694,9295266,15417960,10983976,6032610,5441218,3549989,2272059,1570664,29850516,5863731,9106193,14969924,11604646,8917739,8840491,6758665,4338111,3453632,43913284,73763800,104151680,104151680
Russian Federation,1952,RU,RUS,EUR,6763165,8648129,15411294,11156235,6659539,5356054,3675127,2279177,1585116,30711248,6447284,8481682,14928966,11602362,9460521,8715200,6966319,4430562,3563583,44738547,75449795,105790045,105790045
Russian Federation,1953,RU,RUS,EUR,7317836,8050161,15367997,11295971,7390294,5233140,3817442,2294537,1610529,31641913,6954704,7908403,14863107,11591754,10091499,8536374,7169686,4537212,3693583,45620108,77262021,107493129,107493129
Russian Federation,1954,RU,RUS,EUR,7334483,8139610,15474093,11332190,8071699,5103759,3969988,2316687,1641082,32435405,6967451,7974706,14942157,11503196,10636302,8354623,7376496,4667006,3831795,46369418,78804823,109221068,109221068
Russian Federation,1955,RU,RUS,EUR,7101906,8694748,15796654,11234460,8641484,4996407,4124822,2351168,1680002,33028343,6754689,8471547,15226236,11299586,11025468,8210021,7582903,4823477,3979161,46920616,79948959,110971852,110971852
Russian Federation,1956,RU,RUS,EUR,7142583,9131781,16274364,11061804,9104102,4901431,4290780,2401622,1736933,33496672,6801051,8857352,15658403,11044394,11261727,8080554,7800519,5011531,4155167,47353892,80850564,112783329,112783329
Russian Federation,1957,RU,RUS,EUR,7153915,9723623,16877538,10869099,9436597,4799121,4467170,2460558,1803624,33836169,6820097,9391401,16211498,10788986,11322295,7953740,8026272,5228396,4346099,47665788,81501957,114590996,114590996
Russian Federation,1958,RU,RUS,EUR,7000597,10304499,17305096,10525847,9926800,4782659,4695583,2562730,1952396,34446015,6708510,9965181,16673691,10441303,11341562,7820324,8196313,5509137,4640211,47948850,82394865,116373652,116373652
Russian Federation,1959,RU,RUS,EUR,6793860,11004847,17798707,10065661,10321099,4877431,4902198,2690403,2099832,34956624,6538879,10661413,17200292,9998321,11242168,7786698,8374275,5786605,4933139,48121206,83077830,118076840,118076840
Russian Federation,1960,RU,RUS,EUR,6739349,11824647,18563996,9621390,10424461,5091195,4983624,2796429,2161514,35078613,6480115,11428366,17908481,9548478,11034141,7980520,8520063,5985183,5115617,48184002,83262615,119735095,119735095
Russian Federation,1961,RU,RUS,EUR,6733771,12333476,19067247,9320549,10513601,5542492,4956639,2916747,2225067,35475095,6468740,11893758,18362498,9227471,10891661,8412152,8486624,6181392,5304848,48504148,83979243,121408978,121408978
Russian Federation,1962,RU,RUS,EUR,6665054,12618290,19283344,9099196,10610928,6191197,4845324,3061952,2267313,36075910,6400050,12137825,18537875,8989194,10864981,8991259,8304219,6413973,5453852,49017478,85093388,122914605,122914605
Russian Federation,1963,RU,RUS,EUR,6512005,12864259,19376264,8835032,10698821,6879034,4781549,3215488,2299773,36709697,6246883,12349108,18595991,8706530,10877240,9531328,8171190,6656708,5602773,49545769,86255466,124227725,124227725
Russian Federation,1964,RU,RUS,EUR,6268619,13002064,19270683,8708729,10754231,7544689,4740125,3373401,2342795,37463970,6006633,12485202,18491835,8520099,10871438,10016073,8078084,6896081,5785981,50167756,87631726,125394235,125394235
Russian Federation,1965,RU,RUS,EUR,5933172,13090537,19023709,8757238,10739365,8214665,4623496,3545099,2391752,38271615,5683956,12596644,18280600,8480177,10837517,10499573,7862847,7121708,6022853,50824675,89096290,126400607,126400607
Russian Federation,1966,RU,RUS,EUR,5586565,13155854,18742419,8918384,10680319,8797478,4500325,3723239,2433919,39053664,5352941,12683900,18036841,8545779,10793735,10874056,7626193,7335996,6285261,51461020,90514684,127293948,127293948
Russian Federation,1967,RU,RUS,EUR,5273412,13152449,18425861,9334037,10464486,9253021,4397456,3893223,2483463,39825686,5054688,12689335,17744023,8883520,10584620,11085996,7439922,7580308,6541786,52116152,91941838,128111727,128111727
Russian Federation,1968,RU,RUS,EUR,5002572,13100215,18102787,10043609,10028442,9533825,4354902,4035910,2556853,40553541,4796969,12636827,17433796,9537281,10140909,11066751,7378911,7797269,6811129,52732250,93285791,128822373,128822373
Russian Federation,1969,RU,RUS,EUR,4813052,12928254,17741306,10867257,9605525,9618694,4411439,4151926,2640888,41295729,4626663,12467569,17094232,10321732,9712805,10819927,7432602,8001786,7069332,53358184,94653913,129489455,129489455
Russian Federation,2031,RU,RUS,EUR,3266389,7554554,10820943,9193379,7411539,10250970,10697213,7719762,9489281,54762144,3095543,7156193,10251736,8746455,7196213,10285119,11637949,9501946,17797539,65165221,119927365,141000041,141000041
Russian Federation,2032,RU,RUS,EUR,3247091,7294144,10541235,9333189,7483681,9685648,10951486,7853014,9546947,54853965,3077520,6910464,9987984,8874487,7259213,9703521,11846248,9648766,17844132,65176367,120030332,140559555,140559555
Russian Federation,2033,RU,RUS,EUR,3236976,7100132,10337108,9346764,7618868,9131359,11172975,8002547,9598466,54870979,3068199,6727464,9795663,8882277,7382379,9135936,12021242,9818610,17871470,65111914,119982893,140115666,140115666
Russian Federation,2034,RU,RUS,EUR,3237790,6952447,10190237,9283770,7784279,8622400,11322717,8161960,9657808,54832934,3069196,6588213,9657409,8817738,7535753,8612835,12132565,9993000,17898464,64990355,119823289,139670938,139670938
Russian Federation,2035,RU,RUS,EUR,3250475,6843772,10094247,9180686,7942616,8150516,11389931,8327283,9756865,54747897,3081362,6485865,9567227,8717625,7682113,8126869,12162877,10164916,17964210,64818610,119566507,139227987,139227987
Russian Federation,2036,RU,RUS,EUR,3274108,6757034,10031142,9025327,8121625,7764696,11366257,8482843,9875430,54636178,3103910,6404204,9508114,8569454,7846737,7732000,12097527,10317922,18051700,64615340,119251518,138790761,138790761
Russian Federation,2037,RU,RUS,EUR,3307622,6687334,9994956,8790544,8353471,7504160,11233445,8635135,9987888,54504643,3135761,6338559,9474320,8347600,8059150,7465599,11922016,10454554,18137834,64386753,118891396,138360672,138360672
Russian Federation,2038,RU,RUS,EUR,3348468,6630023,9978491,8520010,8580251,7380247,10934539,8843121,10103029,54361197,3174524,6284852,9459376,8090950,8267606,7333531,11576778,10641992,18228584,64139441,118500638,137938508,137938508
Russian Federation,2039,RU,RUS,EUR,3392691,6586812,9979503,8235442,8800048,7329783,10552558,9067247,10221734,54206812,3216508,6244700,9461208,7820847,8469425,7280275,11140800,10843085,18319839,63874271,118081083,137521801,137521801
Russian Federation,2040,RU,RUS,EUR,3438152,6562153,10000305,7926021,9035032,7301556,10147277,9267163,10362208,54039257,3259631,6221932,9481563,7528139,8683203,7249719,10676212,11015190,18437401,63589864,117629121,137110991,137110991
Russian Federation,2041,RU,RUS,EUR,3484286,6557493,10041779,7611775,9268294,7307791,9679051,9484168,10508173,53859252,3303317,6217987,9521304,7230613,8896956,7250055,10151414,11201886,18556159,63287083,117146335,136709408,136709408
Russian Federation,2042,RU,RUS,EUR,3529770,6571879,10101649,7352566,9407482,7381429,9154893,9727118,10645876,53669364,3346392,6231933,9578325,6985363,9024878,7313400,9581542,11408121,18655165,62968469,116637833,136317799,136317799
Russian Federation,2043,RU,RUS,EUR,3572911,6602751,10175662,7159487,9421538,7516562,8641695,9939675,10794118,53473075,3387248,6261468,9648716,6802742,9032840,7436501,9025732,11581643,18758210,62637668,116110743,135935122,135935122
Russian Federation,2044,RU,RUS,EUR,3611366,6647914,10259280,7012558,9359656,7681030,8171217,10086827,10959957,53271245,3423643,6304529,9728172,6663804,8968650,7589568,8513765,11692909,18867502,62296198,115567443,135554900,135554900
Russian Federation,2045,RU,RUS,EUR,3640956,6706172,10347128,6904498,9257843,7838360,7736203,10161295,11167405,53065604,3451642,6359888,9811530,6561717,8868940,7735598,8038580,11726333,19015849,61947017,115012621,135171274,135171274
Russian Federation,2046,RU,RUS,EUR,3659199,6776045,10435244,6818298,9104361,8015943,7382034,10152533,11385881,52859050,3468821,6426189,9895010,6480289,8721334,7899789,7652933,11666521,19173049,61593915,114452965,134783212,134783212
Russian Federation,2047,RU,RUS,EUR,3665532,6855136,10520668,6749082,8872642,8245407,7144943,10042101,11599770,52653945,3474720,6501174,9975894,6414856,8500335,8111544,7393308,11498589,19321706,61240338,113894283,134390857,134390857
Russian Federation,2048,RU,RUS,EUR,3657045,6939214,10596259,6692237,8605805,8470248,7036046,9783233,11866191,52453760,3466650,6580849,10047499,6361348,8244699,8319449,7265586,11167242,19532334,60890658,113344418,133988174,133988174
Russian Federation,2049,RU,RUS,EUR,3633662,7021987,10655649,6649454,8325254,8688128,6995889,9450213,12151826,52260764,3444386,6659283,10103669,6321379,7975679,8520729,7215169,10748580,19766680,60548216,112808980,133568298,133568298
Russian Federation,2050,RU,RUS,EUR,3599785,7097138,10696923,6625180,8020332,8920566,6976445,9096874,12437973,52077370,3412092,6730471,10142563,6298768,7684166,8733819,7187019,10302848,20009557,60216177,112293547,133133035,133133035
Rwanda,1970,RW,RWA,AFR,363044,568266,931310,391446,212250,186476,104407,60450,52051,1007080,361386,570223,931609,393670,206164,177968,111566,76368,60629,1026365,2033445,3896367,3896367
Rwanda,1971,RW,RWA,AFR,375763,578470,954233,411011,219360,187855,112154,61048,52825,1044253,374193,580381,954574,413616,213666,178975,117163,77259,61666,1062345,2106598,4015403,4015403
Rwanda,1972,RW,RWA,AFR,389198,588409,977607,429418,228492,188190,120263,61572,53598,1081533,387741,590369,978110,432195,223288,179206,123139,77732,62768,1098328,2179861,4135579,4135579
Rwanda,1973,RW,RWA,AFR,402944,598753,1001697,447780,239280,187925,128397,62182,54459,1120023,401662,600844,1002506,450286,234873,179007,129164,77943,63993,1135266,2255289,4259484,4259484
Rwanda,1974,RW,RWA,AFR,416578,609871,1026449,464544,252890,187134,136168,63328,55301,1159365,415566,612171,1027737,466593,249342,178310,134962,78343,65274,1172824,2332189,4386369,4386369
Rwanda,1975,RW,RWA,AFR,429906,622015,1051921,479006,269482,186259,143130,65333,55995,1199205,429248,624639,1053887,480741,266553,177493,140149,79345,66464,1210745,2409950,4515756,4515756
Rwanda,1976,RW,RWA,AFR,443503,635299,1078802,492672,286813,185441,149356,68103,56608,1238993,443210,638341,1081551,494090,284499,176833,144826,80907,67694,1248849,2487842,4648207,4648207
Rwanda,1977,RW,RWA,AFR,457928,649926,1107854,505106,304250,184823,154801,71535,57131,1277646,457979,653471,1111450,506228,302579,176479,149038,82960,69015,1286299,2563945,4783252,4783252
Rwanda,1978,RW,RWA,AFR,473621,666342,1139963,516026,321563,184819,159199,75663,57534,1314804,473944,670507,1144451,516888,320536,176783,152564,85597,70368,1322736,2637540,4921953,4921953
Rwanda,1979,RW,RWA,AFR,491873,685030,1176903,526522,339559,186541,162491,80654,57979,1353746,492264,689926,1182190,527279,339214,178906,155315,89063,71760,1361537,2715283,5074374,5074374
Rwanda,1980,RW,RWA,AFR,513430,706178,1219608,537607,358767,190927,164794,86460,58565,1397120,513591,711895,1225486,538496,359126,183769,157338,93371,73216,1405316,2802436,5247532,5247532
Rwanda,1981,RW,RWA,AFR,538115,730105,1268220,549444,378950,198200,166233,93066,59315,1445208,537780,736658,1274438,550680,379983,191574,158717,98488,74659,1454101,2899309,5441966,5441966
Rwanda,1982,RW,RWA,AFR,565240,756832,1322072,561642,399271,208092,167082,100087,60144,1496318,564193,764169,1328362,563374,400894,202102,159737,104052,75991,1506150,3002468,5652900,5652900
Rwanda,1983,RW,RWA,AFR,592839,785882,1378721,571934,417432,218433,166890,106821,60859,1542369,590950,793885,1384835,574085,419293,213516,159979,109475,77121,1553469,3095838,5859396,5859396
Rwanda,1984,RW,RWA,AFR,618604,817718,1436322,580706,431653,230148,165631,112912,61720,1582770,615863,826217,1442080,583207,433661,226554,159320,114510,78306,1595558,3178328,6056729,6056729
Rwanda,1985,RW,RWA,AFR,641451,853204,1494655,592105,445135,245269,164544,118368,63232,1628653,637942,862012,1499954,595180,447516,242881,158829,119123,79963,1643492,3272145,6266752,6266752
Rwanda,1986,RW,RWA,AFR,661385,892724,1554109,607461,460831,262536,164120,123381,65431,1683760,657210,901640,1558850,611439,463685,261371,159024,123452,82113,1701084,3384844,6497804,6497804
Rwanda,1987,RW,RWA,AFR,678771,935780,1614551,624540,476205,280479,164117,127727,68036,1741104,674068,944568,1618636,629575,479653,280660,159707,127371,84572,1761538,3502642,6735829,6735829
Rwanda,1988,RW,RWA,AFR,693351,980785,1674136,639989,486886,296918,164065,130795,70672,1789325,688270,989201,1677471,645878,490880,298573,160428,130317,86971,1813047,3602372,6953975,6953975
Rwanda,1989,RW,RWA,AFR,704521,1026271,1730792,653445,491632,310901,164194,132244,73269,1825685,699133,1034079,1733212,659861,495961,314049,161451,131840,89129,1852291,3677976,7141974,7141974
Rwanda,1990,RW,RWA,AFR,712246,1071337,1783583,668749,494142,323647,165600,132297,76048,1860483,706535,1078387,1784922,676047,499119,328411,163943,132161,91300,1890981,3751464,7319962,7319962
Rwanda,1991,RW,RWA,AFR,714100,1111959,1826059,687536,496918,335582,168646,130988,78999,1898669,708070,1118178,1826248,696466,503183,342100,168253,131295,93411,1934708,3833377,7485681,7485681
Rwanda,1992,RW,RWA,AFR,712659,1151121,1863780,710952,501223,347104,173625,129011,81911,1943826,706314,1156561,1862875,721853,509270,355557,174766,129950,95326,1986722,3930548,7657208,7657208
Rwanda,1993,RW,RWA,AFR,716571,1200025,1916596,744643,510864,361314,181149,127730,85190,2010890,709916,1204975,1914891,757452,521147,371994,184477,129532,97751,2062353,4073243,7904740,7904740
Rwanda,1994,RW,RWA,AFR,607773,1064491,1672264,631992,406519,287726,147850,95533,66658,1636278,602038,1068985,1671023,665542,436917,312066,157499,102059,79014,1753097,3389375,6732665,6732665
Rwanda,1995,RW,RWA,AFR,509835,945936,1455771,536321,310709,216273,117721,65716,48636,1295376,505094,949734,1454828,589937,362998,255612,133949,76980,61446,1480922,2776298,5686897,5686897
Rwanda,1996,RW,RWA,AFR,581776,1109917,1691693,660716,367757,255032,142954,75013,57541,1559013,576474,1113489,1689963,718025,430302,302466,163891,88214,71947,1774845,3333858,6715510,6715510
Rwanda,1997,RW,RWA,AFR,647356,1251369,1898725,785512,421890,290766,167358,83217,65713,1814456,641438,1255028,1896466,844081,494447,345626,193268,98189,81479,2057090,3871546,7666732,7666732
Rwanda,1998,RW,RWA,AFR,657230,1257855,1915085,837213,439463,303690,177291,85474,70931,1914062,651910,1265073,1916983,893458,514955,360480,207985,103840,87802,2168520,4082582,7914645,7914645
Rwanda,1999,RW,RWA,AFR,663131,1222872,1886003,864051,449530,315089,183826,88458,78255,1979209,659311,1237077,1896388,920602,525085,371575,219777,113375,97573,2247987,4227196,8009587,8009587
Rwanda,2000,RW,RWA,AFR,672414,1187200,1859614,889105,459244,327196,191214,91926,85984,2044669,670408,1207583,1877991,946783,534501,382661,231095,124070,108611,2327721,4372390,8109989,8109989
Rwanda,2001,RW,RWA,AFR,682542,1157358,1839900,912610,468332,339174,200188,95430,94188,2109922,683320,1182659,1865979,972301,543801,393208,242636,135070,121121,2408137,4518059,8223941,8223941
Rwanda,2002,RW,RWA,AFR,698081,1138772,1836853,938490,478745,348887,211477,98783,101418,2177800,701592,1166574,1868166,999158,555798,401784,255349,144271,133129,2489489,4667289,8372306,8372306
Rwanda,2003,RW,RWA,AFR,719202,1136380,1855582,971556,495967,354692,224780,102710,105130,2254835,721732,1163707,1885439,1028310,575372,407841,269828,149928,140853,2572132,4826967,8567992,8567992
Rwanda,2004,RW,RWA,AFR,742084,1145696,1887780,1004066,520976,358552,238625,107910,106913,2337042,740926,1171575,1912501,1053944,601861,412993,285194,154369,146174,2654535,4991577,8791853,8791853
Rwanda,2005,RW,RWA,AFR,764188,1162946,1927134,1026907,551240,362737,252194,114512,109299,2416889,759934,1187856,1947790,1070518,631824,418622,300658,160346,152522,2734490,5151379,9026299,9026299
Rwanda,2006,RW,RWA,AFR,782819,1190079,1972898,1040898,586366,367549,265144,122430,112061,2494448,775721,1214351,1990072,1079580,664490,425120,315884,167954,159622,2812650,5307098,9270066,9270066
Rwanda,2007,RW,RWA,AFR,798269,1225164,2023433,1048501,626051,373428,276931,131425,115164,2571500,788605,1248576,2037181,1084306,699326,433097,330000,176901,167427,2891057,5462557,9523168,9523168
Rwanda,2008,RW,RWA,AFR,812055,1263185,2075240,1052825,669193,380622,287134,141379,118662,2649815,800976,1284606,2085582,1087402,735630,443001,342309,187158,175859,2971359,5621174,9781996,9781996
Rwanda,2009,RW,RWA,AFR,823169,1301790,2124959,1057744,713851,389285,295682,152235,122622,2731419,811343,1320706,2132049,1092021,772114,454888,352854,198756,184674,3055307,5786726,10043737,10043737
Rwanda,2010,RW,RWA,AFR,830738,1341220,2171958,1065748,758212,399790,302609,163777,127137,2817273,818066,1357798,2175864,1100423,807746,468950,361730,211395,193695,3143939,5961212,10309031,10309031
Rwanda,2011,RW,RWA,AFR,834786,1382605,2217391,1076407,800844,412546,307826,175705,132339,2905667,821328,1396489,2217817,1112168,841917,485316,368729,224863,203074,3236067,6141734,10576932,10576932
Rwanda,2012,RW,RWA,AFR,838413,1426192,2264605,1087895,841690,428500,311556,186952,134538,2991131,823925,1436239,2260164,1124729,876798,504178,373614,237933,207193,3324445,6315576,10840334,10840334
Rwanda,2013,RW,RWA,AFR,844934,1468865,2313799,1100879,879408,448669,314691,197318,133957,3074922,829214,1474101,2303315,1137924,911639,525906,377325,250204,206317,3409315,6484237,11101350,11101350
Rwanda,2014,RW,RWA,AFR,853884,1508067,2361951,1117397,911437,473651,318013,207451,134652,3162601,837169,1508274,2345443,1153687,942560,551118,381369,262573,207142,3498449,6661050,11368451,11368451
Rwanda,2015,RW,RWA,AFR,865085,1542993,2408078,1138941,937363,503619,321841,217268,136666,3255698,847526,1538117,2385643,1173660,968824,579928,386160,274903,210063,3593538,6849236,11642959,11642959
Rwanda,2016,RW,RWA,AFR,878593,1573127,2451720,1167300,958705,538615,326653,226640,139819,3357732,860316,1563145,2423461,1200032,991757,612202,392251,286936,214809,3697987,7055719,11930899,11930899
Rwanda,2017,RW,RWA,AFR,893630,1600262,2493892,1200546,976076,578140,332792,235136,143956,3466646,874741,1585394,2460135,1231094,1011652,647606,400243,297995,221078,3809668,7276314,12230339,12230339
Rwanda,2018,RW,RWA,AFR,909321,1625439,2534760,1235947,989692,620595,340294,242456,149076,3578060,889938,1606256,2496194,1263826,1027868,685057,410132,307383,228531,3922797,7500857,12531808,12531808
Rwanda,2019,RW,RWA,AFR,925130,1647614,2572744,1273974,1001836,664444,349308,248698,155091,3693351,905440,1624648,2530088,1298863,1042167,723613,421976,315294,236932,4038845,7732196,12835028,12835028
Rwanda,2020,RW,RWA,AFR,940199,1667813,2608012,1314869,1015234,708823,360269,254037,161898,3815130,920369,1641671,2562040,1336721,1057434,762761,436252,322097,245918,4161183,7976313,13146362,13146362
Rwanda,2021,RW,RWA,AFR,954202,1687668,2641870,1358078,1029624,752576,373384,258095,168617,3940374,934432,1658917,2593349,1376420,1073431,801650,452892,327317,254592,4286302,8226676,13461888,13461888
Rwanda,2022,RW,RWA,AFR,966712,1708265,2674977,1402276,1043144,794058,389222,261317,176045,4066062,947020,1677332,2624352,1416362,1088077,839299,471749,331433,264390,4411310,8477372,13776698,13776698
Rwanda,2023,RW,RWA,AFR,977597,1731254,2708851,1444944,1057538,831653,408860,264579,184842,4192416,957905,1698593,2656498,1454344,1102858,874702,493368,335539,276115,4536926,8729342,14094683,14094683
Rwanda,2024,RW,RWA,AFR,987385,1756756,2744141,1484077,1075282,863852,433030,268073,194036,4318350,967719,1722847,2690566,1488598,1120064,906344,518335,339967,288547,4661855,8980205,14414910,14414910
Rwanda,2025,RW,RWA,AFR,996788,1783518,2780306,1518903,1097718,890167,461873,272080,203611,4444352,977225,1748669,2725894,1518521,1141203,933427,546728,345080,301737,4786696,9231048,14737248,14737248
Rwanda,2026,RW,RWA,AFR,1005826,1811143,2816969,1548838,1125803,911187,494985,276821,213262,4570896,986407,1775661,2762068,1543526,1167551,956321,578009,351208,315310,4911925,9482821,15061867,15061867
Rwanda,2027,RW,RWA,AFR,1014329,1838690,2853019,1575711,1157985,927748,532024,282601,222565,4698634,995018,1802839,2797857,1565697,1197745,975494,611923,358890,328576,5038325,9736959,15387840,15387840
Rwanda,2028,RW,RWA,AFR,1022895,1865403,2888298,1600802,1192919,941325,572023,289613,231253,4827935,1003658,1829387,2833045,1586652,1230315,991771,648113,368410,341075,5166336,9994271,15715617,15715617
Rwanda,2029,RW,RWA,AFR,1031509,1891263,2922772,1623041,1230923,954028,613509,297977,239395,4958873,1012272,1855284,2867556,1605276,1265698,1006754,685631,379815,352890,5296064,10254937,16045268,16045268
Rwanda,2030,RW,RWA,AFR,1039679,1915921,2955600,1643262,1271031,967303,655161,307912,247085,5091754,1020406,1880065,2900471,1622395,1303005,1021854,723284,393262,364077,5427877,10519631,16375704,16375704
Rwanda,1950,RW,RWA,AFR,205534,258095,463629,232901,134543,85331,66598,47955,28046,595374,204463,253733,458196,225568,144005,105004,75512,55448,31484,637021,1232395,2154218,2154218
Rwanda,1951,RW,RWA,AFR,218735,264935,483670,235498,144504,86393,67459,48539,30004,612397,218003,261105,479108,227922,151468,106525,76552,56479,33349,652295,1264692,2227465,2227465
Rwanda,1952,RW,RWA,AFR,230933,274129,505062,237035,155062,87408,68283,49170,31953,628911,230437,270913,501350,229529,159556,107566,77669,57379,35437,667136,1296047,2302453,2302453
Rwanda,1953,RW,RWA,AFR,243028,284820,527848,237708,165672,88509,69212,49832,33848,644781,242372,282568,524940,230501,167760,108253,79067,58177,37601,681359,1326140,2378936,2378936
Rwanda,1954,RW,RWA,AFR,253471,298536,552007,237664,175892,90310,70229,50525,35605,660225,252546,297329,549875,230819,175764,109198,80818,58910,39645,695154,1355379,2457262,2457262
Rwanda,1955,RW,RWA,AFR,261716,315673,577389,237475,185242,93281,71176,51237,37202,675613,260728,315276,576004,230971,183157,110973,82702,59601,41507,708911,1384524,2537919,2537919
Rwanda,1956,RW,RWA,AFR,269754,333929,603683,237301,193825,97313,72114,51968,38632,691153,268701,334296,602997,231200,190000,113463,84799,60234,43181,722877,1414030,2620713,2620713
Rwanda,1957,RW,RWA,AFR,277816,352995,630811,237412,201653,102335,73100,52731,39891,707122,276671,354076,630747,231710,196352,116592,87177,60831,44713,737375,1444497,2706054,2706054
Rwanda,1958,RW,RWA,AFR,285984,372803,658787,238067,208138,108282,74035,53509,41047,723078,284709,374526,659235,232688,201709,120387,89565,61444,46177,751970,1475048,2793070,2793070
Rwanda,1959,RW,RWA,AFR,294165,393013,687178,239761,212749,115138,74806,54231,42181,738866,292722,395305,688027,234723,205498,124977,91564,62107,47655,766524,1505390,2880595,2880595
Rwanda,1960,RW,RWA,AFR,302091,413103,715194,242848,215084,122605,75413,54839,43261,754050,300449,415874,716323,238159,207275,130158,93035,62829,49145,780601,1534651,2966162,2966162
Rwanda,1961,RW,RWA,AFR,309371,432696,742067,247269,214812,130430,75763,55302,44278,767854,307517,435827,743344,242914,206718,135714,93885,63548,50611,793390,1561244,3046654,3046654
Rwanda,1962,RW,RWA,AFR,315548,451617,767165,253389,212541,138248,75844,55649,45256,780927,313535,454945,768480,249384,204418,141301,94098,64264,52083,805548,1586475,3122124,3122124
Rwanda,1963,RW,RWA,AFR,320076,470030,790106,260675,208649,145521,75763,55967,46106,792681,318028,473304,791332,257505,200838,146521,93769,65131,53422,817186,1609867,3191311,3191311
Rwanda,1964,RW,RWA,AFR,323522,487033,810555,271766,204533,152527,76353,56385,46892,808456,321492,490111,811603,269588,197085,151645,93729,66319,54658,833024,1641480,3263640,3263640
Rwanda,1965,RW,RWA,AFR,326857,502596,829453,288034,201930,159500,78332,56919,47773,832488,324839,505471,830310,286575,194647,156834,94725,67757,55847,856385,1688873,3348631,3348631
Rwanda,1966,RW,RWA,AFR,330557,517753,848310,306871,200827,166360,81513,57550,48667,861788,328576,520413,848989,306204,193757,162046,96567,69440,56916,884930,1746718,3444021,3444021
Rwanda,1967,RW,RWA,AFR,335531,532190,867721,327550,201339,173040,85788,58314,49560,895591,333611,534635,868246,327707,194492,167267,99153,71411,57875,917905,1813496,3549461,3549461
Rwanda,1968,RW,RWA,AFR,342523,545438,887961,349166,203381,178973,91097,59104,50418,932139,340686,547681,888367,350120,196727,172022,102500,73411,58766,953546,1885685,3662010,3662010
Rwanda,1969,RW,RWA,AFR,351751,557351,909102,370658,206913,183505,97359,59799,51246,969480,350003,559420,909423,372318,200502,175653,106661,75082,59659,989875,1959355,3777879,3777879
Rwanda,2031,RW,RWA,AFR,1047186,1939061,2986247,1663098,1312928,980984,695940,319707,254290,5226947,1027925,1903433,2931358,1639641,1341619,1037078,760414,408842,374544,5562138,10789085,16706697,16706697
Rwanda,2032,RW,RWA,AFR,1054611,1960251,3014862,1683777,1356347,994321,734791,333976,261261,5364473,1035367,1924900,2960267,1658192,1381173,1051639,796672,426551,384666,5698893,11063366,17038488,17038488
Rwanda,2033,RW,RWA,AFR,1061915,1979910,3041825,1706837,1398527,1008780,770105,351534,268309,5504092,1042690,1944824,2987514,1679646,1419096,1066641,830926,446720,394970,5837999,11342091,17371424,17371424
Rwanda,2034,RW,RWA,AFR,1068940,1998515,3067455,1732377,1437236,1026470,800432,373147,275727,5645389,1049793,1963646,3013439,1704061,1453330,1084028,861623,470020,405974,5979036,11624425,17705321,17705321
Rwanda,2035,RW,RWA,AFR,1076234,2016291,3092525,1759155,1471739,1048705,825345,398943,283746,5787633,1057172,1981671,3038843,1730028,1483292,1105274,888019,496551,418044,6121208,11908841,18040220,18040220
Rwanda,2036,RW,RWA,AFR,1084125,2033040,3117165,1786780,1501457,1076412,845395,428536,292314,5930894,1065085,1998744,3063829,1757155,1508415,1131633,910456,525798,431166,6264623,12195517,18376507,18376507
Rwanda,2037,RW,RWA,AFR,1092417,2049171,3141588,1814312,1528194,1108083,861369,461571,301338,6074867,1073371,2015174,3088545,1784464,1530749,1161769,929378,557500,445195,6409055,12483922,18714064,18714064
Rwanda,2038,RW,RWA,AFR,1100296,2065248,3165544,1841014,1553191,1142427,874651,497155,310777,6219215,1081264,2031495,3112759,1811149,1551882,1194236,945576,591310,459997,6554150,12773365,19051669,19051669
Rwanda,2039,RW,RWA,AFR,1107353,2081080,3188433,1866866,1575416,1179757,887188,533957,320809,6363993,1088317,2047560,3135877,1837177,1570730,1229475,960581,626336,475722,6700021,13064014,19388318,19388318
Rwanda,2040,RW,RWA,AFR,1113574,2096734,3210308,1891524,1595681,1219149,900324,570784,331689,6509151,1094511,2063411,3157922,1862097,1588102,1266621,975747,661475,492588,6846630,13355781,19724007,19724007
Rwanda,2041,RW,RWA,AFR,1119141,2112309,3231450,1914683,1615589,1260271,913876,606732,343661,6654812,1100095,2079162,3179257,1885611,1605610,1305056,991052,696092,510601,6994022,13648834,20059538,20059538
Rwanda,2042,RW,RWA,AFR,1124031,2128204,3252235,1935904,1636328,1302840,927114,640906,357398,6800490,1105034,2095204,3200238,1907240,1624413,1344402,1005739,729887,530084,7141765,13942255,20394731,20394731
Rwanda,2043,RW,RWA,AFR,1128112,2143564,3271676,1955620,1659404,1344182,941416,671965,373818,6946405,1109121,2110715,3219836,1927328,1646080,1382133,1020873,761848,551819,7290081,14236486,20728002,20728002
Rwanda,2044,RW,RWA,AFR,1132271,2157826,3290097,1974294,1684905,1382153,958784,698714,393772,7092622,1113278,2125163,3238441,1946319,1670680,1416244,1038333,790596,576831,7439003,14531625,21060157,21060157
Rwanda,2045,RW,RWA,AFR,1136698,2171519,3308217,1992140,1711615,1416055,980453,720827,417493,7238583,1117728,2139016,3256744,1964510,1696805,1446172,1059541,815472,605531,7588031,14826614,21391576,21391576
Rwanda,2046,RW,RWA,AFR,1141046,2185137,3326183,2008970,1739146,1445347,1007322,738805,444571,7384161,1122053,2152777,3274830,1981753,1724073,1471371,1085712,836782,637410,7737101,15121262,21722279,21722279
Rwanda,2047,RW,RWA,AFR,1145417,2198475,3343892,2025187,1766591,1471787,1037945,753369,474603,7529482,1126357,2166251,3292608,1998348,1751518,1493848,1115545,854938,672093,7886290,15415772,22052274,22052274
Rwanda,2048,RW,RWA,AFR,1150009,2210599,3360608,2041344,1793221,1496561,1071088,765712,506739,7674665,1130879,2178481,3309360,2014834,1778346,1515168,1147636,870673,709130,8035787,15710452,22380425,22380425
Rwanda,2049,RW,RWA,AFR,1154397,2221994,3376391,2057262,1819021,1518691,1107095,777552,540016,7819637,1135174,2189945,3325119,2031057,1804526,1534263,1182434,885405,747816,8185501,16005138,22706656,22706656
Rwanda,2050,RW,RWA,AFR,1157941,2232829,3390770,2073006,1843649,1538964,1145095,790049,573644,7964407,1138614,2200834,3339448,2047066,1829609,1551937,1219102,900360,787350,8335424,16299831,23030046,23030046
Saudi Arabia,1970,SA,SAU,EMR,600092,826110,1426202,572542,424004,301074,197659,125176,91843,1712298,569630,782382,1352012,537243,387694,275828,186756,125220,102933,1615674,3327972,6106191,6106191
Saudi Arabia,1971,SA,SAU,EMR,628472,861303,1489775,604463,450819,318962,207692,129790,94923,1806649,596737,815853,1412590,562999,407190,288470,194228,128864,105891,1687642,3494291,6396658,6396658
Saudi Arabia,1972,SA,SAU,EMR,659459,899682,1559141,640875,483069,340389,219493,135204,98438,1917468,626361,852330,1478691,591695,429606,302977,202643,132964,109078,1768963,3686431,6724260,6724260
Saudi Arabia,1973,SA,SAU,EMR,693399,941245,1634644,682124,519644,365342,233101,141432,102356,2043999,658865,891842,1550707,623926,454091,319327,212025,137535,112506,1859410,3903409,7088758,7088758
Saudi Arabia,1974,SA,SAU,EMR,730367,985961,1716328,724068,561309,393041,248251,148425,106630,2181724,694269,934404,1628673,657319,481377,337089,222263,142569,116161,1956778,4138502,7483506,7483506
Saudi Arabia,1975,SA,SAU,EMR,772326,1054979,1827305,771814,600663,415953,261921,155373,110872,2316596,731030,984462,1715492,685611,504040,350503,230699,147248,120048,2038149,4354745,7897544,7897544
Saudi Arabia,1976,SA,SAU,EMR,814092,1145158,1959250,829743,635780,433493,273562,162108,115094,2449780,765971,1041316,1807287,711183,520439,359145,236987,151363,124121,2103238,4553018,8319556,8319556
Saudi Arabia,1977,SA,SAU,EMR,849690,1234406,2084096,895662,675864,452587,285619,169320,119677,2598729,798026,1100438,1898464,740785,538118,367963,243258,155491,128312,2173927,4772656,8755219,8755219
Saudi Arabia,1978,SA,SAU,EMR,883010,1321208,2204218,969403,721971,473825,298167,177060,124689,2765115,829546,1160817,1990363,774654,557332,377103,249510,159629,132643,2250871,5015986,9210564,9210564
Saudi Arabia,1979,SA,SAU,EMR,916898,1401474,2318372,1047871,773993,497715,311195,185272,130164,2946210,862198,1220811,2083009,812393,578363,386945,255833,163782,137107,2334423,5280633,9682002,9682002
Saudi Arabia,1980,SA,SAU,EMR,950467,1476728,2427195,1130425,832901,524981,324817,193949,136141,3143214,894734,1281864,2176598,853791,601517,397631,262176,167902,141687,2424704,5567918,10171710,10171710
Saudi Arabia,1981,SA,SAU,EMR,985407,1545611,2531018,1214444,898579,556145,339240,203036,142667,3354111,928199,1343265,2271464,898159,627087,409391,268654,171987,146340,2521618,5875729,10678211,10678211
Saudi Arabia,1982,SA,SAU,EMR,1023184,1607294,2630478,1297894,971066,591793,354689,212462,149756,3577660,963990,1403823,2367813,944996,655460,422371,275325,176012,151038,2625202,6202862,11201154,11201154
Saudi Arabia,1983,SA,SAU,EMR,1060090,1667573,2727663,1380786,1051949,632734,371399,222196,157476,3816540,1000155,1466052,2466207,994071,687378,436517,281990,179897,155747,2735600,6552140,11746020,11746020
Saudi Arabia,1984,SA,SAU,EMR,1096059,1727122,2823181,1460466,1138892,680735,389590,232168,165833,4067684,1036573,1530344,2566917,1044593,722123,453061,288687,183673,160451,2852588,6920272,12310361,12310361
Saudi Arabia,1985,SA,SAU,EMR,1133144,1784103,2917247,1534531,1229057,736885,409653,242363,174782,4327271,1073922,1595881,2669803,1095946,758767,473107,295611,187398,165097,2975926,7303197,12890245,12890245
Saudi Arabia,1986,SA,SAU,EMR,1170911,1839529,3010440,1601911,1321468,800243,432132,252835,184328,4592917,1111665,1662868,2774533,1147772,797718,496125,303024,191177,169637,3105453,7698370,13483349,13483349
Saudi Arabia,1987,SA,SAU,EMR,1208800,1895165,3103965,1662274,1414963,870837,457656,263688,194415,4863833,1149186,1731803,2880989,1199835,839166,521796,311101,195096,174021,3241015,8104848,14089798,14089798
Saudi Arabia,1988,SA,SAU,EMR,1245845,1954889,3200734,1715050,1509234,949747,486998,275036,205009,5141074,1185654,1804114,2989768,1251485,883060,550289,319942,199175,178188,3382139,8523213,14713715,14713715
Saudi Arabia,1989,SA,SAU,EMR,1280587,2021762,3302349,1758230,1602577,1037294,521000,287057,216054,5422212,1219724,1880817,3100541,1301899,929024,581785,329859,203445,182111,3528123,8950335,15353227,15353227
Saudi Arabia,1990,SA,SAU,EMR,1311264,2096675,3407939,1791485,1693240,1133498,560589,299970,227540,5706322,1249715,1961779,3211494,1351176,976534,616460,341219,207874,185743,3679006,9385328,16004763,16004763
Saudi Arabia,1991,SA,SAU,EMR,1335250,2179076,3514326,1814078,1776605,1236225,606329,313987,239396,5986620,1273216,2046087,3319303,1399232,1024338,654214,354662,212521,189054,3834021,9820641,16654276,16654276
Saudi Arabia,1992,SA,SAU,EMR,1349300,2263839,3613139,1839991,1847539,1335630,655061,328491,251059,6257771,1288250,2127977,3416227,1450819,1070249,692372,370518,217823,192430,3994211,10251982,17281350,17281350
Saudi Arabia,1993,SA,SAU,EMR,1352899,2329359,3682258,1932740,1907564,1392743,684721,338983,260973,6517724,1300507,2184760,3485267,1523914,1111620,717755,386004,224837,197089,4161219,10678943,17846461,17846461
Saudi Arabia,1994,SA,SAU,EMR,1351034,2359989,3711023,2101952,1982150,1409296,686929,343652,269593,6793572,1316161,2211205,3527366,1617059,1156713,728603,397321,232734,203132,4335562,11129134,18367528,18367528
Saudi Arabia,1995,SA,SAU,EMR,1355299,2370214,3725513,2257118,2075366,1435537,687282,347110,278271,7080684,1333636,2234329,3567965,1702160,1213002,742267,406672,240655,209939,4514695,11595379,18888857,18888857
Saudi Arabia,1996,SA,SAU,EMR,1370841,2373467,3744308,2369509,2177435,1479417,693155,350387,286747,7356650,1351109,2263805,3614914,1770791,1278844,762746,415408,248977,217639,4694405,12051055,19410280,19410280
Saudi Arabia,1997,SA,SAU,EMR,1394670,2373296,3767966,2459220,2297787,1533330,697040,351286,294707,7633370,1367646,2296334,3663980,1827132,1354544,786347,421534,257254,226247,4873058,12506428,19938377,19938377
Saudi Arabia,1998,SA,SAU,EMR,1421790,2379447,3801237,2516907,2433466,1601667,702048,348961,302014,7905063,1379482,2337965,3717447,1868767,1437972,815417,426004,265127,235548,5048835,12953898,20472580,20472580
Saudi Arabia,1999,SA,SAU,EMR,1446139,2399717,3845856,2533070,2578362,1688979,713946,343141,308272,8165770,1384825,2392095,3776920,1894482,1525401,852925,431043,272102,245158,5221111,13386881,21009660,21009660
Saudi Arabia,2000,SA,SAU,EMR,1465366,2430988,3896354,2509910,2735755,1797104,732874,332437,312821,8420901,1387152,2452749,3839901,1905495,1615263,900050,437251,277588,254590,5390237,13811138,21547390,21547390
Saudi Arabia,2001,SA,SAU,EMR,1477898,2471560,3949458,2452205,2904377,1926754,759491,316014,315531,8674372,1388799,2516043,3904842,1904591,1705104,957723,445202,281113,263525,5557258,14231630,22085929,22085929
Saudi Arabia,2002,SA,SAU,EMR,1481429,2523668,4005097,2365469,3070133,2077243,798344,295219,316579,8922987,1389284,2581261,3970545,1897061,1789533,1027091,456608,282421,272073,5724787,14647774,22623415,22623415
Saudi Arabia,2003,SA,SAU,EMR,1473222,2586428,4059650,2267242,3208983,2242740,853931,273435,315650,9161981,1386901,2644104,4031005,1893893,1860417,1107882,473505,281814,280698,5898209,15060190,23150847,23150847
Saudi Arabia,2004,SA,SAU,EMR,1457754,2658860,4116614,2185894,3259705,2397277,943874,269277,317067,9373094,1380651,2697560,4078211,1916919,1902166,1196035,504931,283410,290424,6093885,15466979,23661808,23661808
Saudi Arabia,2005,SA,SAU,EMR,1441546,2730989,4172535,2242557,3301482,2521825,1050589,290717,320537,9727707,1372054,2735123,4107177,2014288,1950830,1290151,553315,286532,295115,6390231,16117938,24397644,24397644
Saudi Arabia,2006,SA,SAU,EMR,1433058,2792923,4225981,2413542,3406497,2635821,1152618,323222,323406,10255106,1368891,2757383,4126274,2159332,2032301,1387969,612650,289976,293281,6775509,17030615,25382870,25382870
Saudi Arabia,2007,SA,SAU,EMR,1441316,2843853,4285169,2564603,3524544,2760829,1260857,359256,328114,10798203,1378412,2769261,4147673,2286469,2127294,1485890,682090,297228,290058,7169029,17967232,26400068,26400068
Saudi Arabia,2008,SA,SAU,EMR,1464077,2881669,4345746,2686665,3653910,2905735,1375636,397401,335095,11354442,1397913,2774056,4171969,2388089,2235598,1586305,760940,309006,285258,7565196,18919638,27437353,27437353
Saudi Arabia,2009,SA,SAU,EMR,1495654,2904006,4399660,2779199,3789533,3077810,1495668,437452,344792,11924454,1425853,2770279,4196132,2465034,2354525,1691861,846662,326203,279262,7963547,19888001,28483797,28483797
Saudi Arabia,2010,SA,SAU,EMR,1535121,2911239,4446360,2803158,3853836,3286671,1632993,487608,354488,12418754,1463263,2760274,4223537,2510672,2445683,1809848,925265,352692,279123,8323283,20742037,29411929,29411929
Saudi Arabia,2011,SA,SAU,EMR,1575476,2912991,4488467,2755119,3785998,3527221,1799850,558700,361154,12788042,1501440,2755247,4256687,2528037,2475386,1947215,987876,390377,288859,8617750,21405792,30150945,30150945
Saudi Arabia,2012,SA,SAU,EMR,1606071,2919651,4525722,2699837,3640395,3773208,1989512,648752,367050,13118754,1530262,2762216,4292478,2535949,2465875,2098031,1047196,434584,302951,8884586,22003340,30821543,30821543
Saudi Arabia,2013,SA,SAU,EMR,1627529,2930701,4558230,2662592,3465447,3999435,2196382,751380,375572,13450808,1550293,2778063,4328356,2539330,2440882,2249002,1116245,480669,318983,9145111,22595919,31482498,31482498
Saudi Arabia,2014,SA,SAU,EMR,1641668,2945934,4587602,2639578,3274353,4189614,2419866,864196,388943,13776550,1563328,2799649,4362977,2536530,2407911,2388659,1201575,525948,337812,9398435,23174985,32125564,32125564
Saudi Arabia,2015,SA,SAU,EMR,1646447,2969274,4615721,2603085,3164559,4349326,2662558,982789,396072,14158389,1567493,2828487,4395980,2498474,2399343,2473767,1286126,557954,364092,9579756,23738145,32749848,32749848
Saudi Arabia,2016,SA,SAU,EMR,1642017,3001476,4643493,2568678,3226833,4484801,2889319,1090604,387572,14647807,1562900,2863771,4426671,2445137,2458153,2491676,1343564,569407,390362,9698299,24346106,33416270,33416270
Saudi Arabia,2017,SA,SAU,EMR,1635651,3040581,4676232,2631590,3344867,4577495,3045222,1170032,383181,15152387,1556483,2902305,4458788,2472450,2555761,2504659,1389428,579013,404402,9905713,25058100,34193122,34193122
Saudi Arabia,2018,SA,SAU,EMR,1634022,3085011,4719033,2761168,3433832,4635666,3159137,1236079,390574,15616456,1554691,2941986,4496677,2554619,2652903,2529569,1440623,595984,412263,10185961,25802417,35018133,35018133
Saudi Arabia,2019,SA,SAU,EMR,1637859,3130927,4768786,2868276,3533720,4682671,3274423,1307799,400413,16067302,1558209,2983092,4541301,2624156,2749442,2549436,1491148,615369,420419,10449970,26517272,35827362,35827362
Saudi Arabia,2020,SA,SAU,EMR,1637851,3163634,4801485,2788722,3431536,4614562,3408871,1415523,426153,16085367,1557443,3015102,4572545,2597537,2747087,2539040,1570434,647044,436568,10537710,26623077,35997107,35997107
Saudi Arabia,2021,SA,SAU,EMR,1633815,3187416,4821231,2651289,3212285,4461800,3581242,1565975,472422,15945013,1552976,3037780,4590756,2543584,2689586,2513796,1689595,694542,462289,10593392,26538405,35950396,35950396
Saudi Arabia,2022,SA,SAU,EMR,1628508,3211638,4840146,2663028,3109760,4331406,3772092,1731070,531730,16139086,1548232,3058572,4606804,2575658,2679463,2504805,1820256,751200,491400,10822782,26961868,36408820,36408820
Saudi Arabia,2023,SA,SAU,EMR,1614896,3231330,4846226,2715252,3029516,4193610,3953733,1904062,603737,16399910,1535735,3075401,4611136,2631815,2670252,2500088,1948359,815664,523573,11089751,27489661,36947025,36947025
Saudi Arabia,2024,SA,SAU,EMR,1594264,3247248,4841512,2779522,2949880,4050526,4117171,2080997,686913,16665009,1516576,3089213,4605789,2693434,2651759,2502171,2068057,887663,558533,11361617,28026626,37473929,37473929
Saudi Arabia,2025,SA,SAU,EMR,1567559,3259191,4826750,2853159,2869051,3909288,4260189,2261186,780900,16933773,1491692,3099616,4591308,2757908,2624506,2514835,2176712,967960,596209,11638130,28571903,37989969,37989969
Saudi Arabia,2026,SA,SAU,EMR,1542525,3260271,4802796,2925188,2800531,3771575,4377537,2444085,886240,17205156,1468201,3100136,4568337,2817557,2596463,2539513,2271268,1056850,636932,11918583,29123739,38494876,38494876
Saudi Arabia,2027,SA,SAU,EMR,1524682,3248802,4773484,2988449,2757044,3636654,4463350,2629056,1004919,17479472,1451315,3089084,4540399,2868521,2574265,2574054,2349516,1154120,681656,12202132,29681604,38995485,38995485
Saudi Arabia,2028,SA,SAU,EMR,1510303,3231899,4742202,3050702,2729258,3507686,4510710,2817101,1138139,17753596,1437731,3073024,4510755,2916769,2554313,2614362,2409323,1260095,731028,12485890,30239486,39492450,39492450
Saudi Arabia,2029,SA,SAU,EMR,1498060,3213047,4711107,3112514,2705671,3394651,4513371,3009123,1286716,18022046,1426186,3055228,4481414,2965643,2539426,2651523,2449083,1374944,785653,12766272,30788318,39980836,39980836
Saudi Arabia,2030,SA,SAU,EMR,1488132,3194440,4682572,3168666,2688680,3300504,4469672,3204092,1451136,18282750,1416795,3037793,4454588,3012959,2540381,2674749,2469646,1497469,846256,13041460,31324210,40461368,40461368
Saudi Arabia,1950,SA,SAU,EMR,276320,387489,663809,289772,211572,158635,118023,78487,49136,905625,266977,374008,640985,277309,202223,150989,114895,80282,53566,879264,1784889,3089693,3089693
Saudi Arabia,1951,SA,SAU,EMR,290144,398078,688222,297537,217539,161822,120316,80330,51253,928797,278485,385111,663596,285173,208086,154205,117187,82223,56094,902968,1831765,3183582,3183582
Saudi Arabia,1952,SA,SAU,EMR,304249,409004,713253,305362,223641,165110,122626,82154,53357,952250,290274,396465,686739,293177,214128,157561,119508,84135,58592,927101,1879351,3279345,3279345
Saudi Arabia,1953,SA,SAU,EMR,320007,419330,739337,313024,229667,168443,124918,83962,55446,975460,303543,407277,710820,301164,220251,161042,121839,86030,61081,951407,1926867,3377019,3377019
Saudi Arabia,1954,SA,SAU,EMR,335020,431767,766787,320521,235721,171930,127203,85766,57502,998643,316872,419259,736131,309080,226517,164714,124183,87930,63548,975972,1974615,3477534,3477534
Saudi Arabia,1955,SA,SAU,EMR,346942,448783,795725,328056,241964,175681,129516,87578,59526,1022321,328195,434614,762809,317033,232994,168640,126560,89846,65987,1001060,2023381,3581910,3581910
Saudi Arabia,1956,SA,SAU,EMR,357973,468056,826029,335727,248352,179673,131860,89396,61525,1046533,338683,452036,790719,325138,239657,172812,128974,91768,68400,1026749,2073282,3690028,3690028
Saudi Arabia,1957,SA,SAU,EMR,369347,488297,857644,343640,254895,183901,134242,91217,63496,1071391,349480,470304,819784,333527,246515,177226,131426,93701,70803,1053198,2124589,3802027,3802027
Saudi Arabia,1958,SA,SAU,EMR,381065,509454,890519,351654,261231,188210,136607,93029,65453,1096184,360621,489327,849948,342204,253373,181815,133923,95642,73189,1080146,2176330,3916797,3916797
Saudi Arabia,1959,SA,SAU,EMR,393204,531484,924688,360428,267761,192821,139084,94853,67371,1122318,372173,509019,881192,351603,260393,186676,136541,97603,75554,1108370,2230688,4036568,4036568
Saudi Arabia,1960,SA,SAU,EMR,405958,554423,960381,370848,275307,198178,141903,96761,69290,1152287,384335,529426,913761,362249,267969,192002,139395,99608,77901,1139124,2291411,4165563,4165563
Saudi Arabia,1961,SA,SAU,EMR,419552,578335,997887,383067,284389,204488,145171,98830,71278,1187223,397324,550636,947960,374165,276404,197902,142544,101705,80266,1172986,2360209,4306048,4306048
Saudi Arabia,1962,SA,SAU,EMR,434120,603451,1037571,396672,295158,211800,148911,101082,73320,1226943,411243,572985,984228,386955,285839,204414,146012,103908,82642,1209770,2436713,4458516,4458516
Saudi Arabia,1963,SA,SAU,EMR,449842,630834,1080676,410221,307145,219914,153088,103484,75417,1269269,426250,597426,1023676,399545,296009,211451,149789,106205,85039,1248038,2517307,4621655,4621655
Saudi Arabia,1964,SA,SAU,EMR,467048,658154,1125202,425943,319966,228723,157689,106006,77535,1315862,442636,622565,1065201,413375,306638,218951,153879,108567,87451,1288861,2604723,4795130,4795130
Saudi Arabia,1965,SA,SAU,EMR,485618,683260,1168878,446088,333585,238227,162765,108655,79709,1369029,460311,646443,1106754,430491,317701,226901,158298,110994,89880,1334265,2703294,4978922,4978922
Saudi Arabia,1966,SA,SAU,EMR,505447,708403,1213850,468410,348091,248453,168325,111436,81911,1426626,479224,670348,1149572,449632,329320,235323,163066,113508,92343,1383192,2809818,5173237,5173237
Saudi Arabia,1967,SA,SAU,EMR,526903,734936,1261839,492004,363940,259657,174462,114398,84164,1488625,499729,695582,1195311,469818,341829,244358,168245,116138,94863,1435251,2923876,5381026,5381026
Saudi Arabia,1968,SA,SAU,EMR,549849,763169,1313018,517172,381629,272066,181330,117625,86546,1556368,521663,722454,1244117,491146,355551,254096,173892,118929,97465,1491079,3047447,5604582,5604582
Saudi Arabia,1969,SA,SAU,EMR,574056,793505,1367561,543851,401390,285748,188995,121186,89094,1630264,544779,751347,1296126,513533,370693,264533,180037,121939,100154,1550889,3181153,5844843,5844843
Saudi Arabia,2031,SA,SAU,EMR,1480476,3176424,4656900,3211881,2693791,3215525,4384077,3398806,1631124,18535204,1409542,3021057,4430599,3049722,2563495,2684330,2474844,1625057,913632,13311080,31846284,40933778,40933778
Saudi Arabia,2032,SA,SAU,EMR,1474824,3155209,4630033,3239712,2728436,3135039,4267286,3587924,1825573,18783970,1404170,3001383,4405553,3073079,2607962,2684991,2471370,1753740,988563,13579705,32363675,41399264,41399264
Saudi Arabia,2033,SA,SAU,EMR,1471235,3127483,4598718,3260298,2783265,3057669,4134292,3763873,2033163,19032560,1400699,2975565,4376264,3090473,2665464,2676925,2467945,1878186,1071887,13850880,32883440,41858423,41858423
Saudi Arabia,2034,SA,SAU,EMR,1469220,3094889,4564109,3276955,2850021,2980991,3996249,3922527,2252493,19279236,1398712,2945136,4343848,3104770,2728391,2659736,2471300,1994581,1164373,14123151,33402387,42310341,42310341
Saudi Arabia,2035,SA,SAU,EMR,1468947,3058551,4527498,3289524,2926001,2903250,3860177,4061711,2482419,19523082,1398419,2911148,4309567,3115597,2794126,2633949,2485168,2100380,1266612,14395832,33918914,42755976,42755976
Saudi Arabia,2036,SA,SAU,EMR,1470549,3026169,4496718,3291151,3000262,2837831,3727665,4176398,2722808,19756115,1399910,2880706,4280616,3116506,2854998,2607496,2510921,2192641,1379130,14661692,34417807,43195155,43195155
Saudi Arabia,2037,SA,SAU,EMR,1473457,3002889,4476346,3280074,3064659,2796278,3597373,4260785,2974588,19973757,1402628,2858662,4261290,3105739,2906608,2586413,2546156,2269140,1502480,14916536,34890293,43627940,43627940
Saudi Arabia,2038,SA,SAU,EMR,1476786,2985042,4461828,3263436,3126976,2769238,3472308,4308287,3239644,20179889,1405778,2841721,4247499,3089862,2954921,2567064,2586787,2327826,1637514,15163974,35343863,44053187,44053187
Saudi Arabia,2039,SA,SAU,EMR,1480973,2970900,4451873,3244835,3188859,2746350,3362759,4313227,3519589,20375619,1409734,2828293,4238027,3072238,3003849,2552719,2624188,2367269,1784917,15405180,35780799,44470702,44470702
Saudi Arabia,2040,SA,SAU,EMR,1485813,2960807,4446620,3226461,3245112,2730006,3271610,4274045,3813824,20561058,1414298,2818705,4233003,3054967,3051213,2554056,2647689,2388296,1944179,15640400,36201458,44881078,44881078
Saudi Arabia,2041,SA,SAU,EMR,1490669,2954856,4445525,3208659,3288495,2735583,3189244,4195027,4119002,20736010,1418893,2813032,4231925,3038389,3088049,2577368,2657606,2394621,2113450,15869483,36605493,45282942,45282942
Saudi Arabia,2042,SA,SAU,EMR,1494762,2952200,4446962,3187671,3316581,2770471,3111105,4086389,4429113,20901330,1422764,2810460,4233224,3018865,3111535,2621898,2658670,2392718,2289615,16093301,36994631,45674812,45674812
Saudi Arabia,2043,SA,SAU,EMR,1498350,2952025,4450375,3160185,3337462,2825392,3035918,3962415,4735875,21057247,1426135,2810214,4236349,2993210,3129081,2679380,2651132,2390990,2468317,16312110,37369357,46056082,46056082
Saudi Arabia,2044,SA,SAU,EMR,1501422,2954277,4455699,3127853,3354430,2892149,2961383,3833777,5034158,21203750,1429007,2812253,4241260,2962955,3143537,2742243,2634652,2395957,2646565,16525909,37729659,46426615,46426615
Saudi Arabia,2045,SA,SAU,EMR,1503344,2958923,4462267,3091788,3367327,2968062,2885825,3707223,5321032,21341257,1430774,2816590,4247364,2929148,3154533,2807895,2609795,2411216,2822453,16735040,38076297,46785937,46785937
Saudi Arabia,2046,SA,SAU,EMR,1504424,2965454,4469878,3059669,3369328,3042280,2822472,3584105,5591736,21469590,1431733,2822730,4254463,2898875,3155640,2868728,2584413,2438053,2993578,16939287,38408877,47133219,47133219
Saudi Arabia,2047,SA,SAU,EMR,1504546,2972528,4477074,3036616,3358664,3106719,2782657,3462929,5841781,21589366,1431788,2829375,4261163,2876976,3145098,2920365,2564445,2474051,3158246,17139181,38728547,47466783,47466783
Saudi Arabia,2048,SA,SAU,EMR,1503300,2979512,4482812,3018975,3342449,3169085,2757090,3346466,6067051,21701116,1430556,2835957,4266513,2860169,3129452,2968723,2546226,2515176,3315280,17335026,39036142,47785458,47785458
Saudi Arabia,2049,SA,SAU,EMR,1500332,2986833,4487165,3005028,3324270,3231000,2735588,3244621,6263947,21804454,1427718,2842834,4270552,2846864,3112058,3017660,2532898,2552966,3463907,17526353,39330807,48088523,48088523
Saudi Arabia,2050,SA,SAU,EMR,1495187,2993660,4488847,2995114,3306310,3287298,2720532,3160105,6430637,21899996,1422825,2849219,4272044,2837392,3095007,3065011,2534937,2576958,3604358,17713663,39613659,48374543,48374543
Serbia & Montenegro,1970,YU,SCG,EUR,308821,604053,912874,659335,606724,630699,340258,314057,261041,2812114,293084,599602,892686,691899,621341,642400,400025,390151,360319,3106135,5918249,7723801,7723801
Serbia & Montenegro,1971,YU,SCG,EUR,303756,607399,911155,657674,599565,642101,369832,298820,273917,2841909,288421,593172,881593,696913,613989,648918,432256,372601,378962,3143639,5985548,7778289,7778289
Serbia & Montenegro,1972,YU,SCG,EUR,300964,613040,914004,651291,596602,649157,404622,282054,286014,2869740,285812,590849,876661,695637,610047,653298,468668,352983,396325,3176958,6046698,7837367,7837367
Serbia & Montenegro,1973,YU,SCG,EUR,301171,618678,919849,642470,598152,651922,440612,267235,297811,2898202,285962,591179,877141,689024,610587,655543,504615,335106,412597,3207472,6105674,7902648,7902648
Serbia & Montenegro,1974,YU,SCG,EUR,302062,621594,923656,632945,605333,650728,474075,257230,309475,2929786,286791,592030,878821,677511,617158,655920,535931,322401,428661,3237582,6167368,7969841,7969841
Serbia & Montenegro,1975,YU,SCG,EUR,304762,620577,925339,624406,617208,645909,503220,253135,320602,2964480,289460,592012,881472,664058,627845,654337,561006,316240,444327,3267813,6232293,8039112,8039112
Serbia & Montenegro,1976,YU,SCG,EUR,310065,616784,926849,622601,626009,637997,527931,254901,330669,3000108,294644,589686,884330,656194,636046,650295,580264,316713,458799,3298311,6298419,8109597,8109597
Serbia & Montenegro,1977,YU,SCG,EUR,314388,615829,930217,622192,633822,627581,549549,261472,338823,3033439,298916,589225,888141,648120,646052,643361,595670,323175,471215,3327593,6361032,8179402,8179402
Serbia & Montenegro,1978,YU,SCG,EUR,316269,617382,933651,621389,643287,615399,569056,272001,344051,3065183,300878,591172,892050,636922,660993,633742,608788,335082,480211,3355738,6420921,8246634,8246634
Serbia & Montenegro,1979,YU,SCG,EUR,316627,619971,936598,622510,651069,603032,586333,287110,345151,3095205,301330,594169,895499,626634,675838,622930,619808,353144,484175,3382529,6477734,8309834,8309834
Serbia & Montenegro,1980,YU,SCG,EUR,315308,622262,937570,624506,656063,592574,600656,307563,341951,3123313,299922,596873,896795,618454,687528,613026,628346,378034,483279,3408667,6531980,8366334,8366334
Serbia & Montenegro,1981,YU,SCG,EUR,310600,623588,934188,627281,655808,585431,611004,333216,335063,3147803,294942,598415,893357,612627,693594,605442,634125,408674,478639,3433101,6580904,8408451,8408451
Serbia & Montenegro,1982,YU,SCG,EUR,304533,624498,929031,630147,650279,581905,616947,362700,325772,3167750,288510,599266,887776,608836,693168,600960,637382,442378,471484,3454208,6621958,8438768,8438768
Serbia & Montenegro,1983,YU,SCG,EUR,299980,624558,924538,632212,641659,582718,618808,392720,317070,3185187,283615,599087,882702,606553,686992,600942,638585,474987,464895,3472954,6658141,8465369,8465369
Serbia & Montenegro,1984,YU,SCG,EUR,297268,623295,920563,631585,631959,589107,617042,420238,311760,3201691,280669,597451,878120,604461,675864,606956,638078,502906,462418,3490683,6692374,8491057,8491057
Serbia & Montenegro,1985,YU,SCG,EUR,295074,622168,917242,627277,622664,600180,612055,444011,311248,3217435,278391,595765,874156,601397,662538,617112,635845,524945,466031,3507868,6725303,8516691,8516691
Serbia & Montenegro,1986,YU,SCG,EUR,293157,621065,914222,620476,619223,608310,604340,464082,315056,3231487,276491,593960,870451,596081,654251,624870,631373,541664,475150,3523389,6754876,8539542,8539542
Serbia & Montenegro,1987,YU,SCG,EUR,291944,618054,909998,616635,616156,615236,594202,481593,321348,3245170,275323,590237,865560,592690,644945,634305,624078,554865,487516,3538399,6783569,8559117,8559117
Serbia & Montenegro,1988,YU,SCG,EUR,290110,613925,904035,615453,611970,623769,582465,497501,329136,3260294,273533,585399,858932,591816,631815,648705,614231,566150,502232,3554949,6815243,8578208,8578208
Serbia & Montenegro,1989,YU,SCG,EUR,286187,609846,896033,615510,609360,630991,570797,511758,338226,3276642,269693,580562,850255,592113,619104,663360,603415,575769,519054,3572815,6849457,8595737,8595737
Serbia & Montenegro,1990,YU,SCG,EUR,281041,604797,885838,615990,608130,635387,560893,523777,348628,3292805,264692,574814,839506,592852,608554,674947,593606,583560,537300,3590819,6883624,8608971,8608971
Serbia & Montenegro,1991,YU,SCG,EUR,276842,596117,872959,615474,605504,629480,550793,532836,360317,3294404,261202,566089,827291,592895,598206,677617,584111,589000,552932,3594761,6889165,8589410,8589410
Serbia & Montenegro,1992,YU,SCG,EUR,270552,587755,858307,615650,603487,619812,544878,540141,374068,3298036,255988,558433,814421,594088,591268,675894,578488,594093,566565,3600396,6898432,8571167,8571167
Serbia & Montenegro,1993,YU,SCG,EUR,262825,581865,844690,617012,603709,613479,547053,546172,390316,3317741,249034,553755,802789,596532,589598,673976,580166,599786,581339,3621397,6939138,8586625,8586625
Serbia & Montenegro,1994,YU,SCG,EUR,257109,574990,832099,617291,601297,605621,554283,549002,408366,3335860,243690,548519,792209,597513,588092,666699,587719,603751,596975,3640749,6976609,8600919,8600919
Serbia & Montenegro,1995,YU,SCG,EUR,253495,566592,820087,617805,595640,597345,565829,548505,427866,3352990,239965,542116,782081,598263,585757,656325,599406,605531,614086,3659368,7012358,8614528,8614528
Serbia & Montenegro,1996,YU,SCG,EUR,250586,558842,809428,618490,587809,593959,574638,545106,447741,3367743,236890,536363,773253,598966,581420,650229,609110,604705,631591,3676021,7043764,8626450,8626450
Serbia & Montenegro,1997,YU,SCG,EUR,247914,550194,798108,617350,583691,590060,582457,538367,467448,3379373,234053,529344,763397,597590,579341,642067,620749,600113,650398,3690258,7069631,8631132,8631132
Serbia & Montenegro,1998,YU,SCG,EUR,240058,540164,780222,614775,583034,584031,591652,528566,486835,3388893,226307,520475,746782,594557,579950,628748,637286,591645,671335,3703521,7092414,8619409,8619409
Serbia & Montenegro,1999,YU,SCG,EUR,228078,529507,757585,611532,583841,578524,599073,517472,505186,3395628,214789,510773,725562,590880,581647,614814,653887,581088,692376,3714692,7110320,8593467,8593467
Serbia & Montenegro,2000,YU,SCG,EUR,218932,519323,738255,606940,585786,574405,603862,507067,521762,3399822,205965,501233,707198,585756,584088,602738,667522,570616,712350,3723070,7122892,8568346,8568346
Serbia & Montenegro,2001,YU,SCG,EUR,213904,511202,725106,599827,589391,573125,603558,498968,537379,3402248,200933,493026,693959,578111,587229,593785,675371,561846,733209,3729551,7131799,8550858,8550858
Serbia & Montenegro,2002,YU,SCG,EUR,212206,502493,714699,592125,593805,573656,598160,494530,551659,3403935,199133,483908,683041,570312,590598,588092,676493,556433,753411,3735339,7139274,8537006,8537006
Serbia & Montenegro,2003,YU,SCG,EUR,216001,488372,704373,584709,597294,574205,590077,494485,564083,3404853,202613,469487,672100,563002,592637,584293,671800,556031,770739,3738502,7143355,8519814,8519814
Serbia & Montenegro,2004,YU,SCG,EUR,221366,472541,693907,576049,599393,572879,581082,499321,574781,3403505,207593,453107,660700,554590,592634,580777,661740,561738,786344,3737823,7141328,8495940,8495940
Serbia & Montenegro,1950,YU,SCG,EUR,332503,575011,907514,678738,395676,402979,334519,191416,163349,2166677,327573,574098,901671,692158,454827,431875,370209,256693,238310,2444072,4610749,6419943,6419943
Serbia & Montenegro,1951,YU,SCG,EUR,349816,563557,913373,682805,427047,385363,347662,193718,163733,2200328,340650,562368,903018,689943,488533,418840,377407,259973,239486,2474182,4674510,6490888,6490888
Serbia & Montenegro,1952,YU,SCG,EUR,364380,557964,922344,681360,463972,365048,359741,197546,165360,2233027,351166,556422,907588,683912,526382,402860,384143,263783,242193,2503273,4736300,6566231,6566231
Serbia & Montenegro,1953,YU,SCG,EUR,377314,559123,936437,674758,501845,346134,370570,203820,168108,2265235,359953,557242,917195,674530,563372,387852,390691,268789,246485,2531719,4796954,6650597,6650597
Serbia & Montenegro,1954,YU,SCG,EUR,376776,570795,947571,667956,535207,330410,378465,211292,166885,2290215,361428,569979,931407,667113,592810,375260,400392,273452,246872,2555899,4846114,6725098,6725098
Serbia & Montenegro,1955,YU,SCG,EUR,364741,590625,955366,661854,562571,319592,383317,220257,161385,2308976,357567,591253,948820,662418,613514,366690,412289,279509,242344,2576764,4885740,6789926,6789926
Serbia & Montenegro,1956,YU,SCG,EUR,353220,607050,960270,653602,585200,315578,385789,232088,155602,2327859,353177,609534,962711,656484,628223,364208,422107,289980,236488,2597490,4925349,6848345,6848345
Serbia & Montenegro,1957,YU,SCG,EUR,339060,622574,961634,644588,604227,317173,385120,245421,149424,2345953,344537,629591,974128,649754,638397,366998,429805,303322,229364,2617640,4963593,6899350,6899350
Serbia & Montenegro,1958,YU,SCG,EUR,322282,639192,961474,635656,620763,323688,380890,259216,143155,2363368,331358,653965,985323,642704,645569,374827,434726,318103,221487,2637416,5000784,6947578,6947578
Serbia & Montenegro,1959,YU,SCG,EUR,308503,652537,961040,628127,634953,336203,371780,273141,137306,2381510,319967,677038,997005,636728,650159,388959,434628,333778,213781,2658033,5039543,6997600,6997600
Serbia & Montenegro,1960,YU,SCG,EUR,300323,660051,960374,621993,647144,356769,357434,287360,134130,2404830,311388,694017,1005405,631829,653630,411392,426044,350937,208593,2682425,5087255,7053035,7053035
Serbia & Montenegro,1961,YU,SCG,EUR,304320,657251,961571,614294,658323,387479,340187,302295,138723,2441301,306043,698561,1004604,624719,659074,443697,406528,370241,211321,2715580,5156881,7123048,7123048
Serbia & Montenegro,1962,YU,SCG,EUR,312442,648260,960702,608541,666407,424957,321565,315262,148077,2484809,302866,694348,997214,618753,664267,481742,382828,387229,219530,2754349,5239158,7197079,7197079
Serbia & Montenegro,1963,YU,SCG,EUR,317211,638247,955458,609207,669465,462898,304230,324396,158483,2528679,301732,686550,988282,618971,666396,518561,362965,398911,229872,2795676,5324355,7268081,7268081
Serbia & Montenegro,1964,YU,SCG,EUR,318592,627187,945779,615586,668327,498089,291774,330624,171489,2575889,300517,673633,974150,625190,666591,550489,348446,406836,244066,2841618,5417507,7337443,7337443
Serbia & Montenegro,1965,YU,SCG,EUR,317106,616604,933710,626686,663302,528627,285515,334537,186215,2624882,299501,658411,957912,635464,664722,575822,340647,411811,261212,2889678,5514560,7406177,7406177
Serbia & Montenegro,1966,YU,SCG,EUR,314774,612489,927263,634559,654950,554424,285633,336466,202042,2668074,298095,648426,946521,643148,660323,595087,339772,414402,280627,2933359,5601433,7475213,7475213
Serbia & Montenegro,1967,YU,SCG,EUR,313479,609532,923011,641304,643871,576953,291194,335951,217917,2707190,296947,637857,934804,652583,652935,610308,345198,414235,301013,2976272,5683462,7541285,7541285
Serbia & Montenegro,1968,YU,SCG,EUR,312365,605893,918258,649569,630902,597325,301510,332721,233042,2745069,296058,623758,919816,666919,642797,623148,356465,410972,321106,3021407,5766476,7604540,7604540
Serbia & Montenegro,1969,YU,SCG,EUR,311409,604029,915438,655880,617767,615469,317505,325667,247404,2779692,295352,610302,905654,681029,631498,633861,374489,403271,340935,3065083,5844775,7665865,7665865
Sudan,1970,SD,SDN,EMR,1434767,2010351,3445118,1369700,933057,657245,440027,255881,173295,3829205,1404808,1984104,3388912,1377887,978463,693466,456865,276373,201325,3984379,7813584,14647616,14647616
Sudan,1971,SD,SDN,EMR,1478955,2076113,3555068,1407353,955123,669185,452672,260946,175978,3921257,1447888,2047722,3495610,1416883,1005454,710499,472966,282488,205491,4093781,8015038,15065729,15065729
Sudan,1972,SD,SDN,EMR,1525514,2147614,3673128,1449487,980967,683692,466722,266847,179807,4027522,1493210,2116277,3609487,1458312,1034358,728843,490359,289209,210758,4211839,8239361,15521975,15521975
Sudan,1973,SD,SDN,EMR,1573310,2222803,3796113,1497575,1010195,700680,482171,273637,184762,4149020,1539758,2188262,3728020,1503877,1064288,748311,508858,296510,217061,4338905,8487925,16012056,16012056
Sudan,1974,SD,SDN,EMR,1626727,2309490,3936217,1557661,1050737,722920,496289,285115,190881,4303603,1589360,2264279,3853639,1565366,1101953,766653,523008,305996,224148,4487124,8790727,16580570,16580570
Sudan,1975,SD,SDN,EMR,1684302,2408349,4092651,1625358,1102352,749802,508138,300462,197742,4483854,1641203,2344603,3985806,1639067,1150176,783806,531960,317089,231421,4653519,9137373,17215822,17215822
Sudan,1976,SD,SDN,EMR,1741886,2513253,4255139,1692848,1157033,778909,520438,315570,205387,4670185,1694154,2430287,4124441,1710575,1203614,802721,541002,328026,238915,4824853,9495038,17874622,17874622
Sudan,1977,SD,SDN,EMR,1801970,2623500,4425470,1762662,1216296,811276,533349,330536,213815,4867934,1750015,2519928,4269943,1783145,1263246,823493,549665,338709,246652,5004910,9872844,18568262,18568262
Sudan,1978,SD,SDN,EMR,1867951,2736667,4604618,1836218,1280227,847601,547034,345344,222935,5079359,1812094,2610484,4422578,1858016,1329238,846642,557700,349030,254532,5195158,10274517,19301717,19301717
Sudan,1979,SD,SDN,EMR,1939948,2850373,4790321,1912505,1346257,887648,561749,359778,232645,5300582,1880874,2701444,4582318,1932659,1399534,873263,565635,359041,262475,5392607,10693189,20065826,20065826
Sudan,1980,SD,SDN,EMR,2016612,2966484,4983096,1992165,1414361,931891,577680,373868,242888,5532853,1954452,2795891,4750343,2007892,1474288,903986,573503,368852,270758,5599279,11132132,20865598,20865598
Sudan,1981,SD,SDN,EMR,2096139,3086180,5182319,2075212,1483096,979837,595280,387634,253582,5774641,2030998,2895936,4926934,2083219,1552040,939139,581970,378575,279366,5814309,11588950,21698202,21698202
Sudan,1982,SD,SDN,EMR,2175564,3203465,5379029,2158188,1545134,1028361,615300,399894,264446,6011323,2109141,3000672,5109813,2151125,1625599,979779,593680,388548,288034,6026765,12038088,22526928,22526928
Sudan,1983,SD,SDN,EMR,2237671,3305011,5542682,2229822,1585671,1069001,636906,407042,273322,6201764,2174650,3106995,5281645,2196122,1682080,1025970,612196,398794,295273,6210435,12412199,23236536,23236536
Sudan,1984,SD,SDN,EMR,2286445,3388158,5674603,2276895,1611270,1099569,651188,411588,281576,6332086,2222740,3194712,5417452,2223120,1723416,1062351,624954,408115,302774,6344730,12676816,23768876,23768876
Sudan,1985,SD,SDN,EMR,2336579,3466627,5803206,2309807,1635164,1128022,657960,416874,291477,6439304,2265219,3264386,5529605,2249568,1758750,1088019,627282,416025,312406,6452050,12891354,24224171,24224171
Sudan,1986,SD,SDN,EMR,2393344,3549898,5943242,2345936,1655570,1158866,665613,421918,303026,6550929,2314934,3335481,5650415,2280751,1788580,1116611,629304,423435,323857,6562538,13113467,24707119,24707119
Sudan,1987,SD,SDN,EMR,2442779,3630335,6073114,2373740,1662864,1184452,670993,423658,312687,6628394,2360349,3402356,5762705,2312184,1810662,1145088,629766,428261,334173,6660134,13288528,25124341,25124341
Sudan,1988,SD,SDN,EMR,2427126,3695699,6122825,2383526,1649507,1197206,669612,416864,312975,6629690,2343193,3452704,5795897,2337218,1822959,1170906,626889,426282,336038,6720292,13349982,25268698,25268698
Sudan,1989,SD,SDN,EMR,2412042,3762778,6174820,2397916,1637980,1211395,671645,410760,315006,6644702,2326652,3502744,5829396,2359527,1830677,1197670,625772,423290,339489,6776425,13421127,25425335,25425335
Sudan,1990,SD,SDN,EMR,2450040,3849413,6299453,2433901,1642365,1235683,684127,411540,325528,6733144,2362739,3573039,5935778,2392169,1842621,1230434,631980,424575,351549,6873328,13606472,25841703,25841703
Sudan,1991,SD,SDN,EMR,2493799,3940242,6434041,2479542,1652535,1261088,700296,413624,336572,6843657,2403989,3646515,6050504,2434927,1858528,1265526,642408,426523,364773,6992685,13836342,26320896,26320896
Sudan,1992,SD,SDN,EMR,2538168,4013623,6551791,2520795,1658311,1279587,715235,414263,345169,6933360,2446484,3703250,6149734,2477406,1872294,1296681,653008,426559,376197,7102145,14035505,26737028,26737028
Sudan,1993,SD,SDN,EMR,2573676,4083442,6657118,2582000,1657942,1292286,736972,411465,349874,7030539,2485889,3774375,6260264,2530249,1884685,1336406,674243,423367,384551,7233501,14264040,27181423,27181423
Sudan,1994,SD,SDN,EMR,2608061,4179396,6787457,2688360,1674407,1312557,772759,411772,356399,7216254,2527358,3886044,6413402,2605672,1905002,1390923,711076,421970,394737,7429380,14645634,27846494,27846494
Sudan,1995,SD,SDN,EMR,2643763,4279340,6923103,2811204,1706563,1333341,812824,417122,363576,7444630,2567136,4004589,6571725,2693574,1931957,1443902,754100,424126,405524,7653183,15097813,28592644,28592644
Sudan,1996,SD,SDN,EMR,2678168,4361441,7039609,2932454,1742766,1344836,852032,424374,367436,7663898,2603180,4111055,6714235,2786585,1962171,1488757,800812,427833,413260,7879418,15543316,29297152,29297152
Sudan,1997,SD,SDN,EMR,2716656,4436590,7153246,3061398,1791778,1354860,892596,435740,370557,7906929,2640774,4214333,6855107,2889627,2001005,1530219,852395,435057,420187,8128490,16035419,30043782,30043782
Sudan,1998,SD,SDN,EMR,2737209,4498805,7236014,3188747,1844556,1360004,929940,448963,370191,8142401,2660458,4306466,6966924,3000141,2043295,1566493,905650,444328,423335,8383242,16525643,30728580,30728580
Sudan,1999,SD,SDN,EMR,2767415,4561999,7329414,3324928,1909272,1367926,967931,467474,370861,8408392,2689640,4395485,7085125,3121220,2091019,1600860,962553,458726,427001,8661379,17069771,31484307,31484307
Sudan,2000,SD,SDN,EMR,2830599,4636855,7467454,3473533,1993291,1384279,1009244,493775,376170,8730292,2750650,4489628,7240278,3251785,2147977,1635819,1024265,480592,434742,8975180,17705472,32413213,32413213
Sudan,2001,SD,SDN,EMR,2900858,4714138,7614996,3608677,2082466,1400277,1046559,523390,381515,9042884,2818900,4582761,7401661,3374665,2207199,1666152,1085220,506726,442169,9282131,18325015,33341684,33341684
Sudan,2002,SD,SDN,EMR,2975942,4799655,7775597,3721777,2175306,1417057,1078825,555415,387018,9335398,2891796,4680983,7572779,3481961,2267979,1692821,1143946,536695,449232,9572634,18908032,34256418,34256418
Sudan,2003,SD,SDN,EMR,3049077,4893517,7942594,3820291,2277745,1438010,1107436,589213,393366,9626061,2962520,4781668,7744188,3584618,2337322,1718793,1201293,570205,456278,9868509,19494570,35181344,35181344
Sudan,2004,SD,SDN,EMR,3108442,4990257,8098699,3924130,2395610,1467678,1133930,623992,400718,9946058,3020019,4880620,7900639,3702533,2423160,1748908,1258341,606831,463496,10203269,20149327,36148668,36148668
Sudan,2005,SD,SDN,EMR,3156138,5094190,8250328,4036882,2533859,1511464,1159099,661064,410074,10312442,3066277,4984437,8050714,3835859,2531036,1788487,1314047,648420,471894,10589743,20902185,37203231,37203231
Sudan,2006,SD,SDN,EMR,3209145,5211190,8420335,4148785,2689587,1570825,1183301,701527,422826,10716851,3117313,5098370,8215683,3970144,2655909,1838210,1366524,695967,482864,11009618,21726469,38362485,38362485
Sudan,2007,SD,SDN,EMR,3279719,5336096,8615815,4256688,2854852,1642005,1206807,743883,438822,11143057,3185225,5218039,8403264,4101436,2790140,1894751,1415703,748080,496740,11446850,22589907,39608986,39608986
Sudan,2008,SD,SDN,EMR,3371256,5460850,8832106,4354220,3020407,1719088,1228526,785870,457060,11565171,3273510,5337316,8610826,4222752,2928437,1953017,1460792,803162,512860,11881020,23446191,40889129,40889129
Sudan,2009,SD,SDN,EMR,3482741,5582341,9065082,4440327,3181936,1800064,1248701,826431,477687,11975146,3381188,5454192,8835380,4329202,3068024,2011445,1501418,860111,531562,12301762,24276908,42177382,42177382
Sudan,2010,SD,SDN,EMR,3609096,5702792,9311888,4514635,3333638,1885153,1267835,864612,500848,12366721,3503518,5570421,9073939,4418744,3203313,2071221,1537441,917792,553276,12701787,25068508,43454352,43454352
Sudan,2011,SD,SDN,EMR,2872299,4497830,7370129,3615941,2680346,1431612,978576,735562,414187,9856224,2783415,4391898,7175313,3519134,2494638,1554819,1235423,782834,431104,10017952,19874176,34419624,34419624
Sudan,2012,SD,SDN,EMR,2941911,4600444,7542355,3636743,2753211,1489516,979115,756739,435923,10051247,2851100,4491083,7342183,3551256,2562471,1582963,1245182,829875,452259,10224006,20275253,35159792,35159792
Sudan,2013,SD,SDN,EMR,3000416,4720460,7720876,3676985,2823907,1562231,985016,775246,460825,10284210,2907975,4607708,7515683,3599784,2636728,1624443,1255329,875701,477951,10469936,20754146,35990704,35990704
Sudan,2014,SD,SDN,EMR,3060494,4852256,7912750,3746229,2909468,1656061,1000283,792626,489137,10593804,2966323,4736680,7703003,3676187,2732661,1685771,1269531,921026,508502,10793678,21387482,37003245,37003245
Sudan,2015,SD,SDN,EMR,3127431,4992197,8119628,3839381,3004912,1767807,1025809,807833,521320,10967062,3031201,4873727,7904928,3775462,2842576,1764440,1288889,963541,544653,11179561,22146623,38171178,38171178
Sudan,2016,SD,SDN,EMR,3202508,5132637,8335145,3939387,3091114,1887268,1059188,818923,555787,11351667,3103760,5010673,8114433,3878680,2947670,1851884,1311881,1000382,585428,11575925,22927592,39377169,39377169
Sudan,2017,SD,SDN,EMR,3289048,5272000,8561048,4051422,3182039,2017985,1102065,828653,592489,11774653,3187391,5146434,8333825,3991991,3061740,1951908,1340120,1033661,630882,12010302,23784955,40679828,40679828
Sudan,2018,SD,SDN,EMR,3379086,5416629,8795715,4157472,3269634,2152461,1150594,837173,630157,12197491,3274522,5287191,8561713,4098160,3173563,2059143,1369779,1063309,680192,12444146,24641637,41999059,41999059
Sudan,2019,SD,SDN,EMR,3462516,5571020,9033536,4241952,3339602,2281153,1201284,843466,666648,12574105,3355236,5437174,8792410,4181782,3265730,2166579,1398295,1088036,731616,12832038,25406143,43232093,43232093
Sudan,2020,SD,SDN,EMR,3535477,5738476,9273953,4320496,3402506,2406585,1257697,848413,699786,12935483,3425636,5599963,9025599,4258476,3347680,2277341,1430071,1108257,783628,13205453,26140936,44440486,44440486
Sudan,2021,SD,SDN,EMR,3598103,5908887,9506990,4408739,3466401,2527892,1322661,853590,728449,13307732,3485865,5765796,9251661,4344384,3428242,2389818,1468461,1125047,834865,13590817,26898549,45657202,45657202
Sudan,2022,SD,SDN,EMR,3653535,6070174,9723709,4512516,3532396,2639541,1396202,861184,754457,13696296,3539030,5922609,9461639,4445265,3508877,2498450,1513917,1140137,885916,13992562,27688858,46874204,46874204
Sudan,2023,SD,SDN,EMR,3702764,6223042,9925806,4631667,3603342,2740879,1480215,872544,780018,14108665,3586321,6071209,9657530,4561260,3589983,2604305,1568639,1154664,938155,14417006,28525671,48109006,48109006
Sudan,2024,SD,SDN,EMR,3745345,6369664,10115009,4759260,3677236,2835219,1574548,888966,806092,14541321,3627711,6213687,9841398,4685802,3670784,2709096,1633041,1169990,991787,14860500,29401821,49358228,49358228
Sudan,2025,SD,SDN,EMR,3781884,6509796,10291680,4892614,3755016,2920901,1677497,911577,832376,14989981,3664139,6349597,10013736,4816211,3753696,2809418,1706307,1187623,1045982,15319237,30309218,50614633,50614633
Sudan,2026,SD,SDN,EMR,3817649,6646358,10464007,5027216,3837971,2995953,1787019,941005,857551,15446715,3700394,6481937,10182331,4947921,3839219,2903417,1787425,1208646,1099140,15785768,31232483,51878825,51878825
Sudan,2027,SD,SDN,EMR,3853978,6784273,10638251,5159953,3922596,3063787,1901398,976377,881001,15905112,3737271,6615781,10353052,5077785,3923955,2994271,1875193,1232294,1150519,16254017,32159129,53150426,53150426
Sudan,2028,SD,SDN,EMR,3889007,6918590,10807597,5298777,4004366,3128652,2019127,1016598,903313,16370833,3772761,6746569,10519330,5213659,4005113,3083345,1969772,1257097,1200458,16729444,33100277,54427201,54427201
Sudan,2029,SD,SDN,EMR,3923447,7042283,10965730,5450333,4082464,3192285,2138661,1061675,924703,16850121,3807377,6867597,10674974,5362102,4082962,3169340,2071514,1283513,1248727,17218158,34068279,55708982,55708982
Sudan,2030,SD,SDN,EMR,3959633,7151208,11110841,5615395,4160006,3254112,2257466,1113010,945496,17345485,3843426,6974813,10818239,5524053,4159936,3250698,2178764,1313995,1295086,17722532,35068017,56997099,56997099
Sudan,1950,SD,SDN,EMR,798081,1150608,1948689,844894,596232,394271,265380,184209,134228,2419214,782797,1135069,1917866,837008,582228,387231,264634,186417,140101,2397619,4816833,8683400,8683400
Sudan,1951,SD,SDN,EMR,813777,1184057,1997834,865348,616699,404276,271499,186025,136869,2480716,798968,1166693,1965661,857886,603257,396488,271329,189087,143530,2461577,4942293,8905789,8905789
Sudan,1952,SD,SDN,EMR,831460,1218456,2049916,886784,637555,414292,278273,187762,139658,2544324,817020,1199324,2016344,879176,624965,405773,278746,191628,146973,2527261,5071585,9137842,9137842
Sudan,1953,SD,SDN,EMR,852561,1252225,2104786,908880,658635,424359,285543,189560,142547,2609524,838323,1231381,2069704,900639,647170,415134,286637,194123,150467,2594170,5203694,9378177,9378177
Sudan,1954,SD,SDN,EMR,878429,1284584,2163013,931352,677269,437368,293119,191637,145443,2676188,864358,1261848,2126206,922214,667241,427465,294686,196806,154057,2662469,5338657,9627877,9627877
Sudan,1955,SD,SDN,EMR,907303,1317491,2224794,954305,693522,453518,300947,194106,148283,2744681,892878,1293282,2186160,944201,685147,443023,302765,199876,157757,2732769,5477450,9888414,9888414
Sudan,1956,SD,SDN,EMR,936604,1352368,2288972,977755,709816,470005,308938,196870,151003,2814387,921232,1327266,2248498,966686,703382,459131,310840,203213,161493,2804745,5619132,10156597,10156597
Sudan,1957,SD,SDN,EMR,965666,1388714,2354380,1001573,725837,486562,316968,199818,153552,2884310,949369,1362878,2312247,989647,721777,475619,318787,206700,165229,2877759,5762069,10428695,10428695
Sudan,1958,SD,SDN,EMR,993863,1424470,2418333,1024635,740355,502226,324448,202785,155739,2950188,976776,1398479,2375255,1012402,739254,491786,326119,210220,168693,2948474,5898662,10692252,10692252
Sudan,1959,SD,SDN,EMR,1021944,1460495,2482439,1048166,754082,517338,331542,205983,157640,3014751,1004159,1434737,2438896,1036055,756122,507981,333088,214056,171751,3019053,6033804,10955143,10955143
Sudan,1960,SD,SDN,EMR,1051280,1498813,2550093,1074258,768664,532974,338881,209768,159541,3084086,1032668,1473266,2505934,1062141,773425,525027,340292,218553,174643,3094081,6178167,11234186,11234186
Sudan,1961,SD,SDN,EMR,1081829,1538881,2620710,1102281,784142,549015,346325,214093,161456,3157312,1062295,1513488,2575783,1090038,791164,542792,347613,223655,177385,3172647,6329959,11526443,11526443
Sudan,1962,SD,SDN,EMR,1114849,1580854,2695703,1131501,800724,565445,353810,218955,163389,3233824,1094295,1555532,2649827,1119121,809495,561251,355009,229355,180015,3254246,6488070,11833608,11833608
Sudan,1963,SD,SDN,EMR,1150200,1625957,2776157,1159656,817138,581530,360848,223719,164663,3307554,1128458,1601141,2729599,1148474,828615,580547,362623,235425,182336,3338020,6645574,12151329,12151329
Sudan,1964,SD,SDN,EMR,1189438,1676884,2866322,1187976,834765,596067,370730,228783,165951,3384272,1166180,1652770,2818950,1177712,848997,598806,373415,241921,185015,3425866,6810138,12495403,12495403
Sudan,1965,SD,SDN,EMR,1231544,1731014,2962558,1217317,852912,608542,383388,234095,167541,3463795,1206659,1707071,2913730,1207911,869756,615144,387079,248439,187991,3516320,6980115,12856407,12856407
Sudan,1966,SD,SDN,EMR,1272584,1783318,3055902,1245075,868081,618790,394859,238583,168396,3533784,1246400,1759420,3005820,1239060,889649,630657,400366,254265,190304,3604301,7138085,13199810,13199810
Sudan,1967,SD,SDN,EMR,1313496,1836134,3149630,1273277,882290,628059,405883,242789,169106,3601404,1286319,1812134,3098453,1271339,909593,645994,413725,259783,192533,3692967,7294371,13542457,13542457
Sudan,1968,SD,SDN,EMR,1354375,1891842,3246217,1303979,897961,637759,417264,247233,170262,3674458,1326232,1867398,3193630,1305462,930879,661745,427653,265351,195230,3786320,7460778,13900624,13900624
Sudan,1969,SD,SDN,EMR,1394416,1949939,3344355,1336134,914785,647458,428641,251593,171655,3750266,1365312,1924782,3290094,1340983,953740,677564,442016,270858,198161,3883322,7633588,14268037,14268037
Sudan,2031,SD,SDN,EMR,3996437,7249172,11245609,5783018,4245824,3315763,2371941,1172149,966158,17854853,3880012,7071805,10951817,5688635,4244735,3329534,2287199,1350699,1339661,18240463,36095316,58292751,58292751
Sudan,2032,SD,SDN,EMR,4033848,7340128,11373976,5941905,4347695,3380423,2477770,1239288,987462,18374543,3917328,7162210,11079538,5844443,4345203,3409325,2392353,1394204,1382781,18768309,37142852,59596368,59596368
Sudan,2033,SD,SDN,EMR,4074713,7423223,11497936,6092410,4463942,3449279,2573475,1315429,1009768,18904303,3958042,7245055,11203097,5992028,4460043,3489111,2494548,1446032,1424296,19306058,38210361,60911388,60911388
Sudan,2034,SD,SDN,EMR,4119306,7499259,11618565,6236957,4588493,3521042,2662531,1400413,1033788,19443224,4002306,7321223,11323529,6133712,4583406,3568710,2595731,1506597,1464684,19852840,39296064,62238161,62238161
Sudan,2035,SD,SDN,EMR,4165600,7571871,11737471,6375569,4719025,3596849,2743580,1492836,1060534,19988393,4048246,7394477,11442723,6269236,4712811,3650636,2692763,1575287,1504916,20405649,40394042,63574240,63574240
Sudan,2036,SD,SDN,EMR,4211970,7644922,11856892,6510933,4851026,3677846,2814781,1591030,1090982,20536598,4094270,7468500,11562770,6401444,4843675,3735291,2783866,1651280,1545877,20961433,41498031,64917690,64917690
Sudan,2037,SD,SDN,EMR,4259712,7719125,11978837,6647554,4981212,3760457,2879289,1693494,1125209,21087215,4141431,7543843,11685274,6535106,4972712,3819197,2871993,1733435,1587422,21519865,42607080,66271201,66271201
Sudan,2038,SD,SDN,EMR,4306138,7795477,12101615,6780593,5117302,3840324,2941113,1798762,1162793,21640887,4187264,7621190,11808454,6665730,5107649,3899614,2958470,1821817,1628698,22081978,43722865,67632933,67632933
Sudan,2039,SD,SDN,EMR,4349842,7874945,12224787,6903222,5265781,3916682,3001881,1905397,1203886,22196849,4230519,7701213,11931732,6786720,5254970,3976813,3042049,1916736,1670037,22647325,44844174,69000685,69000685
Sudan,2040,SD,SDN,EMR,4393127,7957865,12350992,7011403,5427418,3992519,3061035,2011178,1249870,22753423,4273244,7784361,12057605,6894070,5415611,4053171,3121244,2016701,1713556,23214353,45967776,70376379,70376379
Sudan,2041,SD,SDN,EMR,4436507,8041502,12478009,7108881,5591612,4076372,3120101,2112957,1302378,23312301,4316074,7868142,12184216,6991327,5578887,4137213,3198065,2117735,1761360,23784587,47096888,71759106,71759106
Sudan,2042,SD,SDN,EMR,4480077,8127074,12607151,7199509,5747401,4175758,3181991,2206854,1362031,23873544,4359287,7953768,12313055,7082073,5733600,4236636,3275807,2215643,1814322,24358081,48231625,73151831,73151831
Sudan,2043,SD,SDN,EMR,4523867,8214791,12738658,7282474,5895142,4289082,3247831,2291668,1429773,24435970,4402784,8041467,12444251,7165364,5880289,4350183,3353593,2310839,1873732,24934000,49369970,74552881,74552881
Sudan,2044,SD,SDN,EMR,4565707,8303519,12869226,7358560,6037179,4410506,3316537,2370737,1505923,24999442,4444289,8130152,12574441,7242073,6021232,4472149,3431302,2405220,1940335,25512311,50511753,75955416,75955416
Sudan,2045,SD,SDN,EMR,4606933,8393552,13000485,7431325,6173497,4537771,3389120,2442824,1589878,25564415,4485150,8220010,12705160,7315921,6156152,4600094,3511312,2495825,2014302,26093606,51658021,77363663,77363663
Sudan,2046,SD,SDN,EMR,4649669,8483798,13133467,7504547,6306692,4666490,3466575,2506248,1680767,26131319,4527491,8310094,12837585,7390542,6287829,4729504,3593981,2581004,2095632,26678492,52809811,78780862,78780862
Sudan,2047,SD,SDN,EMR,4691361,8575578,13266939,7578920,6441141,4793476,3545553,2563911,1777202,26700203,4568859,8401682,12970541,7466487,6420956,4857148,3675972,2663532,2183084,27267179,53967382,80204857,80204857
Sudan,2048,SD,SDN,EMR,4732332,8666355,13398687,7655448,6572178,4926192,3621959,2619434,1877397,27272608,4609518,8492289,13101807,7544446,6551146,4990601,3754641,2744622,2275766,27861222,55133830,81634331,81634331
Sudan,2049,SD,SDN,EMR,4773563,8752608,13526171,7735080,6693169,5070893,3695070,2674241,1980024,27848477,4650476,8578422,13228898,7625085,6671892,5136214,3830239,2823142,2374131,28460703,56309180,83064247,83064247
Sudan,2050,SD,SDN,EMR,4812812,8837857,13650669,7818125,6800191,5228327,3767700,2727773,2084173,28426289,4689604,8663375,13352979,7708833,6779246,5294904,3905053,2897746,2478549,29064331,57490620,84494269,84494269
Senegal,1970,SN,SEN,AFR,402857,566897,969754,405001,303337,229147,154396,93586,56752,1242219,395497,555082,950579,390157,287423,214408,151542,99069,62589,1205188,2447407,4367744,4367744
Senegal,1971,SN,SEN,AFR,415442,582604,998046,419514,312306,236118,159618,96536,58460,1282552,407740,570426,978166,403181,295042,219989,155553,101688,64394,1239847,2522399,4498616,4498616
Senegal,1972,SN,SEN,AFR,428856,598954,1027810,434325,320883,243140,165004,99581,60218,1323151,420815,586418,1007233,416733,302412,225720,159694,104400,66292,1275251,2598402,4633452,4633452
Senegal,1973,SN,SEN,AFR,443003,616106,1059109,449838,328547,250064,170505,102731,62065,1363750,434646,603227,1037873,431225,309097,231495,163966,107209,68320,1311312,2675062,4772039,4772039
Senegal,1974,SN,SEN,AFR,457821,634090,1091911,466315,333952,256314,175896,105912,63933,1402322,449132,620877,1070009,447148,314208,236972,168299,110084,70465,1347176,2749498,4911421,4911421
Senegal,1975,SN,SEN,AFR,473271,653088,1126359,479745,339440,261306,180924,109030,65743,1436188,464262,639562,1103824,461344,320089,241848,172586,112984,72703,1381554,2817742,5047922,5047922
Senegal,1976,SN,SEN,AFR,489390,673339,1162729,488968,345670,264933,185506,112054,67525,1464656,480130,659544,1139674,472709,327535,246134,176797,115910,75047,1414132,2878788,5181195,5181195
Senegal,1977,SN,SEN,AFR,505930,694882,1200812,496387,349074,266946,189466,114915,69250,1486038,496447,680913,1177360,483222,333896,249781,180864,118833,77494,1444090,2930128,5308297,5308297
Senegal,1978,SN,SEN,AFR,522393,717918,1240311,503245,350533,267934,192967,117707,71004,1503390,512681,703861,1216542,493526,339558,253141,184848,121804,80106,1472983,2976373,5433225,5433225
Senegal,1979,SN,SEN,AFR,538396,742787,1281183,511566,352028,268951,196377,120652,72931,1522505,528411,728699,1257110,504710,345490,256761,188872,124920,82920,1503673,3026178,5564474,5564474
Senegal,1980,SN,SEN,AFR,553810,769575,1323385,521784,354054,270212,199740,123784,75045,1544619,543455,755555,1299010,517067,351960,260753,192926,128203,85950,1536859,3081478,5703869,5703869
Senegal,1981,SN,SEN,AFR,568544,798275,1366819,534047,356979,271613,203125,127102,77334,1570200,557798,784404,1342202,530775,359186,264967,197077,131641,89161,1572807,3143007,5852029,5852029
Senegal,1982,SN,SEN,AFR,582583,828635,1411218,548332,361255,272725,206579,130594,79787,1599272,571468,814925,1386393,545929,367462,268989,201391,135212,92530,1611513,3210785,6008392,6008392
Senegal,1983,SN,SEN,AFR,596235,860015,1456250,564423,367394,273116,209971,134206,82378,1631488,584836,846440,1431276,562461,377260,272429,205761,138904,96044,1652859,3284347,6171874,6171874
Senegal,1984,SN,SEN,AFR,609673,891803,1501476,582131,376332,272220,213105,137876,85109,1666773,598101,878416,1476517,580302,389432,274805,210024,142729,99736,1697028,3363801,6341801,6341801
Senegal,1985,SN,SEN,AFR,622904,923838,1546742,602030,385729,273473,216020,141642,88056,1706950,611284,910664,1521948,599873,401761,278924,214167,146707,103639,1745071,3452021,6520705,6520705
Senegal,1986,SN,SEN,AFR,635629,956187,1591816,624589,395196,278168,218941,145567,91271,1753732,624123,943189,1567312,621573,413577,285875,218344,150868,107783,1798020,3551752,6710885,6710885
Senegal,1987,SN,SEN,AFR,648004,988667,1636671,649104,406808,283437,221894,149602,94724,1805569,636560,975877,1612437,645100,426663,293420,222636,155187,112151,1855157,3660726,6909837,6909837
Senegal,1988,SN,SEN,AFR,659649,1021081,1680730,674899,419874,288916,224874,153652,98335,1860550,648233,1008549,1656782,670136,440645,301340,227116,159625,116723,1915585,3776135,7113636,7113636
Senegal,1989,SN,SEN,AFR,670735,1053129,1723864,701967,434204,294569,227951,157662,102091,1918444,659345,1040858,1700203,696763,455436,309604,231880,164122,121516,1979321,3897765,7321832,7321832
Senegal,1990,SN,SEN,AFR,682521,1084469,1766990,730320,449767,300476,231143,161573,105990,1979269,670939,1072431,1743370,725027,471048,318257,236936,168616,126491,2046375,4025644,7536001,7536001
Senegal,1991,SN,SEN,AFR,694815,1114486,1809301,759991,466512,306829,234280,165429,110008,2043049,682715,1102661,1785376,754872,487520,327405,242083,173130,131552,2116562,4159611,7754289,7754289
Senegal,1992,SN,SEN,AFR,707017,1143166,1850183,790757,484339,314001,236938,169251,114104,2109390,694153,1131411,1825564,785979,504879,337295,246917,177687,136621,2189378,4298768,7974514,7974514
Senegal,1993,SN,SEN,AFR,719852,1170530,1890382,821957,502990,322495,238726,172919,118237,2177324,706097,1158702,1864799,817693,523040,348383,251077,182190,141660,2264043,4441367,8196551,8196551
Senegal,1994,SN,SEN,AFR,732738,1196901,1929639,852667,521830,332997,239030,176226,122350,2245100,718050,1184829,1902879,849240,541657,361366,254033,186461,146623,2339380,4584480,8416997,8416997
Senegal,1995,SN,SEN,AFR,744480,1223246,1967726,882174,540176,342417,240637,179039,126384,2310827,728986,1210697,1939683,880114,560479,373683,258266,190414,151491,2414447,4725274,8632681,8632681
Senegal,1996,SN,SEN,AFR,756044,1248905,2004949,910437,557735,349675,244396,181388,130299,2373930,739907,1235611,1975518,910234,579471,384306,264634,194125,156257,2489027,4862957,8843423,8843423
Senegal,1997,SN,SEN,AFR,768528,1273394,2041922,937796,574698,357281,247878,183382,134051,2435086,751920,1259014,2010934,939783,598813,395225,271132,197713,160927,2563593,4998679,9051539,9051539
Senegal,1998,SN,SEN,AFR,782256,1297163,2079419,965002,591834,365493,251166,185205,137682,2496382,765248,1281436,2046684,969101,618915,406515,277739,201310,165456,2639036,5135418,9261526,9261526
Senegal,1999,SN,SEN,AFR,798668,1319985,2118653,992586,610071,374593,254460,187037,141301,2560048,781111,1302711,2083822,998197,640249,418253,284492,205023,169825,2716039,5276087,9478564,9478564
Senegal,2000,SN,SEN,AFR,817690,1342111,2159801,1020446,629865,384763,257928,188964,144909,2626875,799389,1323135,2122524,1026884,663122,430591,291496,208921,174076,2795090,5421965,9704287,9704287
Senegal,2001,SN,SEN,AFR,837908,1364656,2202564,1047918,651431,396024,261777,190845,148554,2696549,818683,1343874,2162557,1054714,687717,443690,298929,212905,178396,2876351,5572900,9938027,9938027
Senegal,2002,SN,SEN,AFR,859251,1388342,2247593,1074911,674732,408366,266384,192362,152324,2769079,838919,1365695,2204614,1081568,713863,457644,307064,216653,182874,2959666,5728745,10180950,10180950
Senegal,2003,SN,SEN,AFR,881865,1414226,2296091,1101190,699236,421627,272236,193167,156108,2843564,860362,1389778,2250140,1107425,741050,472468,316370,219869,187528,3044710,5888274,10434504,10434504
Senegal,2004,SN,SEN,AFR,904848,1443394,2348242,1126866,724428,435651,280165,192795,159787,2919692,882163,1417140,2299303,1132515,768810,488106,327610,222126,192284,3131451,6051143,10698691,10698691
Senegal,2005,SN,SEN,AFR,928660,1474856,2403516,1152801,750213,450494,287734,193879,163334,2998455,904690,1446721,2351411,1157654,796958,504659,338569,225760,197078,3220678,6219133,10974057,10974057
Senegal,2006,SN,SEN,AFR,955497,1508247,2463744,1178243,776636,466171,294121,197227,166751,3079149,930236,1478220,2408456,1182176,825526,522291,348401,231610,202028,3312032,6391181,11263387,11263387
Senegal,2007,SN,SEN,AFR,983557,1544352,2527909,1202698,803658,482686,301508,200639,170097,3161286,957196,1512494,2469690,1205490,854496,541075,358911,237799,207218,3404989,6566275,11563869,11563869
Senegal,2008,SN,SEN,AFR,1010822,1583366,2594188,1226592,831298,500127,309837,204068,173455,3245377,983444,1549851,2533295,1228104,883818,561097,370038,244264,212746,3500067,6745444,11872929,11872929
Senegal,2009,SN,SEN,AFR,1039461,1625701,2665162,1249642,859293,518679,319041,207532,176900,3331087,1011027,1590611,2601638,1249912,913214,582546,381759,251013,218704,3597148,6928235,12195029,12195029
Senegal,2010,SN,SEN,AFR,1068818,1671718,2740536,1272078,887328,538528,329168,211137,180441,3418680,1039413,1634926,2674339,1271169,942383,605605,394161,258114,225136,3696568,7115248,12530121,12530121
Senegal,2011,SN,SEN,AFR,1096221,1722080,2818301,1295019,914796,559884,340234,215055,184009,3508997,1065952,1683494,2749446,1292941,970811,630380,407351,265691,231967,3799141,7308138,12875880,12875880
Senegal,2012,SN,SEN,AFR,1123327,1774661,2897988,1319096,941578,582655,352170,219533,187245,3602277,1092256,1734335,2826591,1315909,998319,656662,421380,273922,238786,3904978,7507255,13231833,13231833
Senegal,2013,SN,SEN,AFR,1151007,1827445,2978452,1345077,967270,606305,364819,224960,189796,3698227,1119179,1785458,2904637,1341004,1024734,683893,436219,283174,245218,4014242,7712469,13595566,13595566
Senegal,2014,SN,SEN,AFR,1176567,1881704,3058271,1374937,993078,630965,378343,232181,191377,3800881,1144182,1837962,2982144,1369617,1050737,711847,451903,294141,250767,4129012,7929893,13970308,13970308
Senegal,2015,SN,SEN,AFR,1198103,1937370,3135473,1408454,1020874,657090,393017,239294,194092,3912821,1165525,1891792,3057317,1401208,1077708,740639,468658,304942,257416,4250571,8163392,14356181,14356181
Senegal,2016,SN,SEN,AFR,1216055,1993966,3210021,1444878,1049822,684746,408879,245641,198625,4032591,1183592,1946671,3130263,1435341,1104993,770352,486691,314920,266180,4378477,8411068,14751356,14751356
Senegal,2017,SN,SEN,AFR,1231941,2051390,3283331,1484631,1079223,713842,425906,253025,203271,4159898,1199766,2002579,3202345,1472558,1131819,800880,506012,325591,275360,4512220,8672118,15157793,15157793
Senegal,2018,SN,SEN,AFR,1247669,2108598,3356267,1527228,1108804,744053,444051,261335,208011,4293482,1215787,2058280,3274067,1512685,1158246,831951,526595,336820,284792,4651089,8944571,15574909,15574909
Senegal,2019,SN,SEN,AFR,1263678,2164891,3428569,1572598,1137798,774918,463391,270469,212877,4432051,1231975,2113178,3345153,1555856,1183959,863220,548622,348631,294725,4795013,9227064,16000781,16000781
Senegal,2020,SN,SEN,AFR,1281351,2217853,3499204,1622137,1167463,806602,484177,280222,217119,4577720,1249610,2165059,3414669,1602739,1209695,894589,572233,360855,304412,4944523,9522243,16436120,16436120
Senegal,2021,SN,SEN,AFR,1301384,2265350,3566734,1676293,1198718,838406,506411,290365,220127,4730320,1269380,2211694,3481074,1653782,1236256,925328,597264,373207,312753,5098590,9828910,16876720,16876720
Senegal,2022,SN,SEN,AFR,1321884,2310272,3632156,1730969,1229951,869279,529805,301071,222811,4883886,1289546,2255996,3545542,1706110,1263336,954977,623587,386083,320766,5254859,10138745,17316449,17316449
Senegal,2023,SN,SEN,AFR,1341720,2355586,3697306,1784606,1262270,899393,554411,312820,226685,5040185,1309147,2300807,3609954,1758119,1292192,983824,651144,400137,330302,5415718,10455903,17763163,17763163
Senegal,2024,SN,SEN,AFR,1360686,2399131,3759817,1839364,1297557,929455,580174,325794,232345,5204689,1327992,2343983,3671975,1811436,1324190,1012341,679689,415515,341917,5585088,10789777,18221567,18221567
Senegal,2025,SN,SEN,AFR,1378897,2440097,3818994,1895089,1334567,960165,606944,339951,239595,5376311,1346132,2384811,3730943,1865838,1358151,1041207,708961,432177,355214,5761548,11137859,18687800,18687800
Senegal,2026,SN,SEN,AFR,1397036,2479646,3876682,1951476,1372847,990820,634724,355132,247934,5552933,1364171,2424378,3788549,1920997,1393649,1069700,738875,450034,369628,5942883,11495816,19161050,19161050
Senegal,2027,SN,SEN,AFR,1415553,2517427,3932980,2008610,1413167,1020912,663422,371182,256981,5734274,1382533,2462279,3844812,1977076,1431510,1097202,769360,469009,384819,6128976,11863250,19641034,19641034
Senegal,2028,SN,SEN,AFR,1434722,2554005,3988727,2065583,1455687,1050723,692988,388172,266730,5919883,1401413,2499047,3900460,2033004,1472006,1124146,800338,489157,400726,6319377,12239260,20128434,20128434
Senegal,2029,SN,SEN,AFR,1455037,2589746,4044783,2121762,1500782,1079915,723180,406251,277172,6109062,1421295,2535004,3956299,2088152,1515413,1150341,831505,510651,417368,6513430,12622492,20623578,20623578
Senegal,2030,SN,SEN,AFR,1476381,2626482,4102863,2174656,1548834,1108616,753691,425594,288383,6299774,1442200,2571846,4014046,2140250,1561888,1175975,862568,533657,434853,6709191,13008965,21125872,21125872
Senegal,1950,SN,SEN,AFR,215179,302011,517190,231082,170728,123498,85216,53243,38198,701965,217394,310632,528026,238266,178245,130888,92601,61740,47147,748887,1450852,2496065,2496065
Senegal,1951,SN,SEN,AFR,224302,309960,534262,236921,175789,126948,87540,54256,38577,720031,224805,317918,542723,243456,182294,133897,94844,62543,47105,764139,1484170,2561152,2561152
Senegal,1952,SN,SEN,AFR,233561,317861,551422,243025,181151,130575,89896,55444,39000,739091,232628,325110,557738,248903,186533,137020,97145,63532,47129,780262,1519353,2628508,2628508
Senegal,1953,SN,SEN,AFR,243707,325296,569003,249278,186778,134383,92306,56804,39464,759013,241526,331765,573291,254494,190956,140243,99506,64695,47214,797108,1556121,2698414,2698414
Senegal,1954,SN,SEN,AFR,255853,331648,587501,255472,192592,138374,94837,58314,39938,779527,252485,337321,589806,260020,195550,143556,101936,66014,47340,814416,1593943,2771247,2771247
Senegal,1955,SN,SEN,AFR,266440,340705,607145,261527,198556,142545,97507,59952,40429,800516,262397,345065,607462,265414,200311,146959,104439,67477,47540,832140,1632656,2847262,2847262
Senegal,1956,SN,SEN,AFR,274237,353606,627843,267574,204678,146904,100317,61719,40956,822148,270053,356098,626151,270812,205242,150463,107013,69077,47820,850427,1672575,2926572,2926572
Senegal,1957,SN,SEN,AFR,282186,367098,649284,273776,210940,151426,103263,63622,41495,844522,277846,367759,645605,276363,210356,154063,109658,70817,48194,869451,1713973,3008862,3008862
Senegal,1958,SN,SEN,AFR,290246,380994,671240,280321,217288,156123,106329,65605,42069,867735,285751,379891,665642,282254,215605,157768,112366,72664,48667,889324,1757059,3093941,3093941
Senegal,1959,SN,SEN,AFR,298539,395167,693706,287347,223663,161032,109504,67610,42742,891898,293874,392423,686297,288632,220927,161615,115141,74582,49258,910155,1802053,3182056,3182056
Senegal,1960,SN,SEN,AFR,307000,409615,716615,294940,230022,166167,112782,69627,43536,917074,302164,405362,707526,295546,226266,165616,117995,76559,49981,931963,1849037,3273177,3273177
Senegal,1961,SN,SEN,AFR,315559,424426,739985,302935,236453,171512,116172,71662,44447,943181,310573,418776,729349,302786,231702,169757,120925,78578,50821,954569,1897750,3367082,3367082
Senegal,1962,SN,SEN,AFR,324280,439883,764163,310863,243029,177074,119686,73705,45471,969828,319144,432881,752025,309897,237305,174024,123931,80619,51734,977510,1947338,3463524,3463524
Senegal,1963,SN,SEN,AFR,333072,456460,789532,318343,249688,182824,123330,75778,46593,996556,327789,448165,775954,316515,243019,178431,127014,82703,52749,1000431,1996987,3562469,3562469
Senegal,1964,SN,SEN,AFR,341825,475098,816923,324903,256372,188764,127130,77938,47789,1022896,336372,465539,801911,322180,248734,183024,130190,84857,53883,1022868,2045764,3664599,3664599
Senegal,1965,SN,SEN,AFR,350740,492327,843067,334273,263201,194961,131144,80230,49080,1052889,345056,481985,827041,330001,254448,187806,133460,87062,55093,1047870,2100759,3770874,3770874
Senegal,1966,SN,SEN,AFR,360039,506891,866930,347571,270357,201457,135383,82663,50458,1087889,354066,496332,850398,341053,260328,192822,136842,89334,56400,1076779,2164668,3881994,3881994
Senegal,1967,SN,SEN,AFR,369797,521679,891476,361610,277955,208228,139832,85229,51928,1124782,363505,510880,874385,352810,266509,198066,140340,91677,57819,1107221,2232003,3997869,3997869
Senegal,1968,SN,SEN,AFR,380116,536600,916716,376016,286011,215173,144484,87923,53471,1163078,373468,525515,898983,365000,273062,203464,143946,94078,59330,1138880,2301958,4117659,4117659
Senegal,1969,SN,SEN,AFR,391109,551620,942729,390512,294483,222171,149347,90713,55088,1202314,384090,540190,924280,377456,280023,208928,147672,96538,60908,1171525,2373839,4240859,4240859
Senegal,2031,SN,SEN,AFR,1498307,2665633,4163940,2222158,1600529,1137780,783954,446383,300413,6491217,1463700,2610908,4074608,2187224,1612122,1202009,893008,558285,453278,6905926,13397143,21635686,21635686
Senegal,2032,SN,SEN,AFR,1521086,2705566,4226652,2267270,1653975,1167981,813897,468589,313302,6685014,1485972,2650599,4136571,2231991,1664308,1229117,922724,584399,472748,7105287,13790301,22153523,22153523
Senegal,2033,SN,SEN,AFR,1544193,2745196,4289389,2312756,1707333,1200119,843442,491894,327054,6882598,1508517,2689868,4198385,2277178,1716567,1258299,951694,611567,493333,7308638,14191236,22679016,22679016
Senegal,2034,SN,SEN,AFR,1567322,2784878,4352200,2356400,1761758,1235092,872790,515999,341783,7083822,1531056,2729112,4260168,2320602,1769988,1290434,980151,639420,515184,7515779,14599601,23211962,23211962
Senegal,2035,SN,SEN,AFR,1591250,2824996,4416246,2397560,1817237,1271828,902772,540927,357642,7287966,1554280,2768787,4323067,2361701,1824490,1324499,1008922,667871,538522,7726005,15013971,23753290,23753290
Senegal,2036,SN,SEN,AFR,1615881,2865777,4481658,2437366,1873442,1309878,932760,566798,374746,7494990,1578115,2809084,4387199,2401578,1879775,1360119,1037346,696955,563493,7939266,15434256,24303115,24303115
Senegal,2037,SN,SEN,AFR,1640568,2907731,4548299,2475396,1930361,1349907,962236,593584,393132,7704616,1601968,2850401,4452369,2439758,1935936,1398051,1064818,726643,590142,8155348,15859964,24860626,24860626
Senegal,2038,SN,SEN,AFR,1664907,2950614,4615521,2512209,1987090,1392076,991478,621235,412813,7916901,1625494,2892436,4517930,2476782,1991913,1438557,1091751,756863,618485,8374351,16291252,25424698,25424698
Senegal,2039,SN,SEN,AFR,1688159,2994618,4682777,2548179,2043014,1436755,1020150,649541,433902,8131541,1648017,2935400,4583417,2512976,2047089,1481918,1117952,787317,648662,8595914,16727455,25993655,25993655
Senegal,2040,SN,SEN,AFR,1710241,3040406,4750647,2585106,2095672,1484308,1048375,678233,456624,8348318,1669388,2980026,4649414,2550022,2099204,1528283,1143603,817732,680927,8819771,17168089,26568156,26568156
Senegal,2041,SN,SEN,AFR,1731264,3087445,4818709,2624402,2142984,1535412,1077065,706793,481185,8567841,1689721,3025803,4715524,2589241,2146193,1578342,1169644,847621,715441,9046482,17614323,27148556,27148556
Senegal,2042,SN,SEN,AFR,1750350,3135360,4885710,2664458,2187923,1588230,1106778,735156,507523,8790068,1708132,3072321,4780453,2629068,2190974,1630313,1196735,876863,752107,9276060,18066128,27732291,27732291
Senegal,2043,SN,SEN,AFR,1768917,3183233,4952150,2704208,2233231,1640967,1138382,763213,535334,9015335,1725975,3118748,4844723,2668468,2236156,1682350,1225863,905425,790528,9508790,18524125,28321000,28321000
Senegal,2044,SN,SEN,AFR,1788870,3230043,5018913,2744018,2276741,1694772,1172752,791141,564405,9243829,1745103,3164140,4909243,2707830,2279595,1735545,1257890,933516,830425,9744801,18988630,28916792,28916792
Senegal,2045,SN,SEN,AFR,1808532,3276476,5085008,2784265,2317817,1749649,1208875,819730,594863,9475199,1763897,3209055,4972952,2747624,2320726,1789827,1291841,961939,871867,9983824,19459023,29516982,29516982
Senegal,2046,SN,SEN,AFR,1826611,3322541,5149152,2825178,2357573,1805253,1246301,848402,626905,9709612,1781173,3253519,5034692,2788033,2360647,1844890,1327329,990069,915050,10226018,19935630,30119469,30119469
Senegal,2047,SN,SEN,AFR,1844717,3366734,5211451,2867264,2395593,1861586,1285674,876682,660563,9947362,1798503,3296072,5094575,2829458,2398886,1900827,1365091,1017313,959964,10471539,20418901,30724934,30724934
Senegal,2048,SN,SEN,AFR,1862405,3410071,5272476,2910274,2432432,1917757,1327152,904835,695799,10188249,1815454,3337727,5153181,2871597,2435980,1956601,1405397,1044071,1006566,10720212,20908461,31334118,31334118
Senegal,2049,SN,SEN,AFR,1878741,3453704,5332445,2954407,2468445,1973164,1371071,932536,732507,10432130,1831151,3379650,5210801,2914661,2472253,2011583,1448518,1070159,1054713,10971887,21404017,31947265,31947265
Senegal,2050,SN,SEN,AFR,1894376,3495879,5390255,3000318,2505406,2025370,1417787,959886,770634,10679401,1846161,3420082,5266243,2959383,2509371,2063538,1494595,1095743,1104333,11226963,21906364,32562869,32562869
Singapore,1970,SG,SGP,WPR,122407,295766,418173,228384,134611,109689,82564,58669,30020,643937,114216,275008,389224,213859,130907,100797,72214,54281,38436,610494,1254431,2061831,2061831
Singapore,1971,SG,SGP,WPR,117584,294062,411646,241013,137703,112146,84350,60346,31676,667234,109856,273479,383335,225698,133480,104634,73653,55910,40311,633686,1300920,2095900,2095900
Singapore,1972,SG,SGP,WPR,115023,289980,405003,251238,144366,114144,86292,61839,33490,691369,107595,269788,377383,235173,139696,107672,75506,57405,42363,657815,1349184,2131565,2131565
Singapore,1973,SG,SGP,WPR,114371,283849,398220,260421,152210,116272,88490,63239,35511,716143,107097,264287,371384,243572,146998,110740,77814,58772,44722,682618,1398761,2168363,2168363
Singapore,1974,SG,SGP,WPR,113730,276155,389885,268975,159615,119241,90904,64576,37695,741006,106838,257191,364029,251320,153470,114841,80426,60077,47268,707402,1448408,2202329,2202329
Singapore,1975,SG,SGP,WPR,111904,267492,379396,276866,167325,122630,93299,65842,40085,766047,105303,249530,354833,258408,160019,119332,83198,61308,49892,732157,1498204,2232425,2232425
Singapore,1976,SG,SGP,WPR,109790,259356,369146,283694,176150,125548,95599,66933,42663,790587,103124,242602,345726,264628,167756,123073,85984,62364,52667,756472,1547059,2261936,2261936
Singapore,1977,SG,SGP,WPR,106590,253210,359800,288841,186889,127661,97841,67894,45273,814399,99942,237203,337145,269656,177747,125786,88775,63331,55528,780823,1595222,2292166,2292166
Singapore,1978,SG,SGP,WPR,102458,247977,350435,292415,199378,129691,100018,68997,47831,838330,95927,232504,328431,273604,189737,128226,91623,64409,58462,806061,1644391,2323251,2323251
Singapore,1979,SG,SGP,WPR,100483,241621,342104,294742,213349,131813,102328,70335,50237,862804,93958,226686,320644,276660,203491,130599,94921,65650,61350,832671,1695475,2358229,2358229
Singapore,1980,SG,SGP,WPR,101470,234159,335629,296588,229194,134035,105218,72026,52547,889608,94784,219735,314519,278968,219074,132690,99142,67051,64050,860975,1750583,2400729,2400729
Singapore,1981,SG,SGP,WPR,102782,229190,331972,297675,244623,138974,108161,73782,54877,918092,95788,215088,310876,280197,234079,137100,103827,68917,66659,890779,1808871,2451722,2451722
Singapore,1982,SG,SGP,WPR,103833,227018,330851,296640,258110,147470,110901,75433,57229,945783,96542,212941,309483,279723,247204,144944,108367,71488,69375,921101,1866884,2507219,2507219
Singapore,1983,SG,SGP,WPR,105745,225824,331569,293173,271040,157284,114186,77271,59598,972552,98448,211284,309732,277381,259612,153916,113144,74603,72271,950927,1923479,2564773,2564773
Singapore,1984,SG,SGP,WPR,107998,225446,333444,288444,283532,168151,117775,79205,61928,999035,101182,210077,311259,274037,271542,163896,117922,78023,75214,980634,1979669,2624370,2624370
Singapore,1985,SG,SGP,WPR,110570,224346,334916,284614,295701,180513,120324,81063,64156,1026371,104274,208363,312637,272510,283384,175621,121041,81350,78164,1012070,2038441,2685994,2685994
Singapore,1986,SG,SGP,WPR,113293,221995,335288,283556,307471,193547,121362,82787,66259,1054982,106847,205995,312842,274981,295889,188213,122036,84309,81185,1046613,2101595,2749727,2749727
Singapore,1987,SG,SGP,WPR,116029,219303,335332,283934,318353,207092,121998,84501,68343,1084221,108963,203500,312463,278978,308659,201394,122270,87163,84263,1082727,2166948,2814742,2814742
Singapore,1988,SG,SGP,WPR,118054,217262,335316,283994,328445,221586,123038,86311,70462,1113836,110390,201600,311990,282083,321347,215711,122686,90157,87381,1119365,2233201,2880504,2880504
Singapore,1989,SG,SGP,WPR,119046,216027,335073,283314,337481,236623,125097,88169,72576,1143260,110956,200440,311396,283543,333857,230862,123990,93098,90616,1155966,2299226,2945693,2945693
Singapore,1990,SG,SGP,WPR,121331,216846,338177,281032,345992,253462,130655,90879,74879,1176899,112980,200982,313962,281227,345203,247469,128678,96467,94132,1193176,2370075,3022209,3022209
Singapore,1991,SG,SGP,WPR,126665,220710,347375,277459,353652,273754,140816,95746,77569,1218996,118037,204202,322239,275208,353205,266374,137797,101371,98055,1232010,2451006,3120620,3120620
Singapore,1992,SG,SGP,WPR,132234,225738,357972,274389,358967,295931,153692,102513,80517,1266009,123322,208655,331977,268715,357675,286365,149446,107776,102296,1272273,2538282,3228231,3228231
Singapore,1993,SG,SGP,WPR,135752,230454,366206,272938,361310,317880,168760,110068,83578,1314534,126684,213099,339783,263673,359490,305887,163139,114662,106762,1313613,2628147,3334131,3334131
Singapore,1994,SG,SGP,WPR,137209,235345,372554,272792,361325,338942,186536,117754,86906,1364255,128160,217967,346127,260021,359032,324330,179448,121288,111557,1355676,2719931,3438613,3438613
Singapore,1995,SG,SGP,WPR,138031,241868,379899,273403,360456,358888,206341,124011,90622,1413721,129099,224125,353224,257840,357472,341225,197366,126422,116710,1397035,2810756,3543875,3543875
Singapore,1996,SG,SGP,WPR,139695,250329,390024,274633,360960,377311,227092,127979,94457,1462432,130768,231621,362389,257123,356825,356290,215429,129405,121988,1437060,2899492,3651903,3651903
Singapore,1997,SG,SGP,WPR,140491,258456,398947,276891,362923,394496,248699,131760,98287,1513056,131499,239051,370550,257309,357687,370068,233665,132041,127330,1478100,2991156,3760649,3760649
Singapore,1998,SG,SGP,WPR,138564,264439,403003,280596,364953,410701,271364,137162,102211,1566987,129600,245208,374808,258147,359286,382764,252571,135874,132854,1521496,3088483,3866293,3866293
Singapore,1999,SG,SGP,WPR,133285,268340,401625,285639,366995,425306,294484,144720,106429,1623573,124506,250008,374514,259582,361420,394049,271671,141439,138610,1566771,3190344,3966481,3966481
Singapore,2000,SG,SGP,WPR,127682,272120,399802,289840,366799,434905,315269,153331,111314,1671458,119129,254583,373712,261670,362107,402341,289333,148399,144778,1608628,3280086,4053602,4053602
Singapore,2001,SG,SGP,WPR,125808,277103,402911,291593,362662,436254,331373,160739,116793,1699414,117360,259472,376832,264747,360225,405837,304618,155362,151391,1642180,3341594,4121337,4121337
Singapore,2002,SG,SGP,WPR,125153,281025,406178,293262,357435,432595,344744,168089,122087,1718212,116831,262962,379793,268740,358153,406237,318646,162834,157999,1672609,3390821,4176794,4176794
Singapore,2003,SG,SGP,WPR,122413,281874,404287,296983,353305,427510,357250,177762,126219,1739029,114441,263810,378251,273282,357487,405605,332103,172532,163836,1704845,3443874,4226413,4226413
Singapore,2004,SG,SGP,WPR,117176,279708,396884,303200,349693,422121,368596,189966,128710,1762286,109835,262176,372011,278719,357885,404771,344633,184813,168400,1739221,3501507,4270401,4270401
Singapore,2005,SG,SGP,WPR,112221,278698,390919,314095,350639,420826,383045,205340,131132,1805077,105527,260867,366394,287073,359792,405325,357724,199390,172945,1782249,3587326,4344637,4344637
Singapore,2006,SG,SGP,WPR,111502,281649,393151,330895,361443,428047,404450,225386,135212,1885433,105045,261965,367010,299524,364938,408821,372735,216089,178891,1840998,3726431,4486583,4486583
Singapore,2007,SG,SGP,WPR,113249,283237,396486,350427,378325,440359,428868,249808,140141,1987928,106786,262262,369048,313438,373413,414549,388141,234599,185657,1909797,3897725,4663256,4663256
Singapore,2008,SG,SGP,WPR,114181,279793,393974,370112,396290,453802,452600,277502,145169,2095475,107883,259468,367351,326397,384076,421392,402473,254659,192609,1981606,4077081,4838402,4838402
Singapore,2009,SG,SGP,WPR,113236,272667,385903,389726,414441,468907,475088,307478,151415,2207055,107474,254491,361965,338306,396192,429718,415479,275594,200498,2055787,4262842,5010704,5010704
Singapore,2010,SG,SGP,WPR,111911,266982,378893,405475,427876,482336,493416,334539,161044,2304686,106753,250215,356968,347668,405398,437911,426422,294840,210805,2123044,4427730,5163590,5163590
Singapore,2011,SG,SGP,WPR,113463,266355,379818,413889,433548,489542,504434,355262,173825,2370500,108284,248712,356996,352875,408602,443635,434150,311382,223389,2174033,4544533,5281344,5281344
Singapore,2012,SG,SGP,WPR,116586,266724,383310,418917,436978,493173,510449,375000,186953,2421470,110893,248149,359042,355636,409863,447718,439374,327959,236636,2217186,4638656,5381005,5381005
Singapore,2013,SG,SGP,WPR,118069,264316,382385,424823,442353,496791,514573,397804,199102,2475446,111935,246666,358601,358003,412542,451682,443370,346070,249956,2261623,4737069,5478055,5478055
Singapore,2014,SG,SGP,WPR,116850,259482,376332,431338,449597,500027,517980,422654,210535,2532131,110518,244305,354823,359838,416612,455456,446934,364932,263440,2307212,4839343,5570502,5570502
Singapore,2015,SG,SGP,WPR,114908,253569,368477,434162,456138,501313,519671,446985,225030,2583299,108500,241327,349827,359115,419255,458269,449580,383094,279096,2348409,4931708,5650018,5650018
Singapore,2016,SG,SGP,WPR,115770,248081,363851,428880,459957,499565,518718,466832,247131,2621083,109085,237820,346905,354186,417974,459362,450801,398554,299216,2380093,5001176,5711933,5711933
Singapore,2017,SG,SGP,WPR,118702,244058,362760,416889,463118,496340,516873,481528,275246,2649994,111501,234382,345883,345918,415043,459377,451715,410936,322868,2405857,5055851,5764487,5764487
Singapore,2018,SG,SGP,WPR,122361,241505,363866,400987,466968,493119,515269,492656,306326,2675325,114494,231442,345936,335588,412350,459020,453024,420860,348567,2429409,5104734,5814537,5814537
Singapore,2019,SG,SGP,WPR,127908,240083,367991,382456,471640,490109,514298,500566,339509,2698578,119117,229042,348159,323945,410218,458151,454923,428502,375930,2451669,5150247,5866405,5866405
Singapore,2020,SG,SGP,WPR,130205,239533,369738,362702,477249,487495,513943,505662,373219,2720270,121064,227354,348418,311401,408400,456307,457025,434132,404176,2471441,5191711,5909869,5909869
Singapore,2021,SG,SGP,WPR,127337,239865,367202,342735,483013,485693,513689,508468,406692,2740290,118666,226651,345317,298588,406529,453723,458982,437886,432544,2488252,5228542,5941060,5941060
Singapore,2022,SG,SGP,WPR,123658,241149,364807,323536,488050,484776,513258,509388,441272,2760280,115588,227100,342688,287491,405804,451244,460960,440323,462095,2507917,5268197,5975689,5975689
Singapore,2023,SG,SGP,WPR,119360,243379,362739,306045,491556,484505,512670,508824,476899,2780499,111994,228617,340611,278401,405871,448743,462899,441928,493041,2530883,5311382,6014723,6014723
Singapore,2024,SG,SGP,WPR,113941,247104,361045,290919,491993,485137,511546,507772,512356,2799723,107418,231576,338994,270389,404722,446110,464443,443259,524031,2552954,5352677,6052709,6052709
Singapore,2025,SG,SGP,WPR,111409,248647,360056,278984,487900,486719,509603,506290,548062,2817558,105308,232780,338088,263841,401378,443510,465531,444334,555248,2573842,5391400,6089541,6089541
Singapore,2026,SG,SGP,WPR,112275,247651,359926,270441,478854,489067,506963,504542,583953,2833820,106112,231889,338001,258777,395612,440909,466217,445175,586722,2593412,5427232,6125154,6125154
Singapore,2027,SG,SGP,WPR,112878,247566,360444,264931,465262,492235,503951,503032,619246,2848657,106675,231869,338544,255024,387603,438539,466489,446288,617864,2611807,5460464,6159440,6159440
Singapore,2028,SG,SGP,WPR,113333,247796,361129,261868,448213,496092,500933,501766,653535,2862407,107096,232191,339287,252409,377959,436485,466402,447791,648304,2629350,5491757,6192172,6192172
Singapore,2029,SG,SGP,WPR,113522,247965,361487,260469,428956,500658,498037,501064,686260,2875444,107269,232505,339774,250628,367360,434990,465758,449846,677779,2646361,5521805,6223066,6223066
Singapore,2030,SG,SGP,WPR,113438,247535,360973,260074,408777,505990,495441,500911,717031,2888224,107186,232324,339510,249491,356539,434350,464429,452233,706241,2663283,5551507,6251988,6251988
Singapore,1950,SG,SGP,WPR,84488,122286,206774,90442,87528,73174,39199,12939,8682,311964,79230,122536,201766,88485,73034,57152,36025,17091,14408,286195,598159,1006701,1006701
Singapore,1951,SG,SGP,WPR,90909,126655,217564,93236,87908,75868,42378,13417,7993,320800,85529,125614,211143,93734,75962,59918,38027,17846,13940,299427,620227,1048937,1048937
Singapore,1952,SG,SGP,WPR,98346,131330,229676,96514,88272,78634,45560,14165,7599,330744,92846,128765,221611,99463,79156,62875,40074,18926,13702,314196,644940,1096232,1096232
Singapore,1953,SG,SGP,WPR,107117,136413,243530,100115,88736,81332,48724,15227,7403,341537,101435,132234,233669,105327,82619,65965,42179,20274,13643,330007,671544,1148751,1148751
Singapore,1954,SG,SGP,WPR,117213,141917,259130,103838,89520,83796,51901,16684,7339,353078,111204,136294,247498,110911,86516,69119,44427,21794,13734,346501,699579,1206218,1206218
Singapore,1955,SG,SGP,WPR,126811,149130,275941,107610,90733,85995,55112,18559,7393,365402,120376,142322,262698,116025,90936,72329,46857,23457,13971,363575,728977,1267611,1267611
Singapore,1956,SG,SGP,WPR,135562,158430,293992,111441,92336,87905,58297,20805,7525,378309,128688,150584,279272,120701,95727,75582,49430,25251,14312,381003,759312,1332581,1332581
Singapore,1957,SG,SGP,WPR,144222,169093,313315,115321,94295,89503,61386,23410,7707,391622,136921,160309,297230,124931,100741,78853,52125,27159,14722,398531,790153,1400696,1400696
Singapore,1958,SG,SGP,WPR,151830,181388,333218,119164,96485,90748,64382,26266,7952,404997,144155,171758,315913,128526,105751,82034,54878,29139,15228,415556,820553,1469690,1469690
Singapore,1959,SG,SGP,WPR,157858,195108,352966,122987,98832,91713,67344,29222,8336,418434,149860,184747,334607,131499,110675,85083,57662,31156,15942,432017,850451,1538021,1538021
Singapore,1960,SG,SGP,WPR,160438,212220,372658,127745,102457,91806,70008,32347,9050,433413,151737,200642,352379,133075,113078,85990,60214,33253,17013,442623,876036,1601079,1601079
Singapore,1961,SG,SGP,WPR,160234,229907,390141,132895,106243,91665,72356,35526,10097,448782,150902,216994,367896,134314,114262,85955,62460,35307,18432,450730,899512,1657549,1657549
Singapore,1962,SG,SGP,WPR,158684,244989,403673,138504,109126,92151,74556,38577,11382,464296,149236,231088,380324,137399,116445,86983,64547,37275,20105,462754,927050,1711053,1711053
Singapore,1963,SG,SGP,WPR,155494,259051,414545,145526,112399,93024,76417,41574,12950,481890,146005,243983,389988,142041,118380,87935,66388,39326,22026,476096,957986,1762516,1762516
Singapore,1964,SG,SGP,WPR,151860,271212,423072,153303,116204,94500,77854,44488,14787,501136,142418,254877,397295,147655,120611,89065,67930,41489,24080,490830,991966,1812329,1812329
Singapore,1965,SG,SGP,WPR,147900,281115,429015,161935,120052,96354,79024,47332,16895,521592,138902,263527,402429,154428,123263,90717,69274,43744,26191,507617,1029209,1860651,1860651
Singapore,1966,SG,SGP,WPR,143644,288458,432102,172310,123799,98607,79795,50092,19302,543905,135093,269768,404861,163182,125679,92442,70212,46049,28416,525980,1069885,1906846,1906846
Singapore,1967,SG,SGP,WPR,139454,293107,432561,184593,127082,101169,80220,52671,21962,567697,131045,273602,404647,174028,127385,94058,70783,48329,30790,545373,1113070,1950283,1950283
Singapore,1968,SG,SGP,WPR,134622,295581,430203,198146,129940,103745,80728,54924,24860,592343,126379,275575,401954,186236,128924,95824,71301,50495,33389,566169,1158512,1990676,1990676
Singapore,1969,SG,SGP,WPR,128586,296143,424729,213262,132774,106706,81368,56860,27798,618768,120276,275641,395917,199902,130200,97706,71552,52487,36151,587998,1206766,2027411,2027411
Singapore,2031,SG,SGP,WPR,113080,245850,358930,260607,388778,511646,493732,500882,745722,2901367,106844,231043,337887,249226,346057,434431,462773,454666,733528,2680681,5582048,6278864,6278864
Singapore,2032,SG,SGP,WPR,112366,242955,355321,262015,369696,516737,492947,500705,772659,2914759,106170,228703,334873,249885,336157,434776,460830,456943,759879,2698470,5613229,6303417,6303417
Singapore,2033,SG,SGP,WPR,111360,239117,350477,264249,352244,520250,492765,500371,798141,2928020,105217,225533,330750,251404,327078,434854,458380,458972,785603,2716291,5644311,6325533,6325533
Singapore,2034,SG,SGP,WPR,110125,233894,344019,267972,337160,520700,493474,499513,822609,2941428,104048,221130,325178,254367,319077,433716,455800,460613,810851,2734424,5675852,6345049,6345049
Singapore,2035,SG,SGP,WPR,108723,231279,340002,269520,325253,516636,495118,497864,846528,2950919,102721,218941,321662,255571,312541,430389,453250,461814,835779,2749344,5700263,6361936,6361936
Singapore,2036,SG,SGP,WPR,107230,231786,339016,268523,316735,507630,497523,495560,869994,2955965,101306,219408,320714,254680,307487,424641,450709,462619,860440,2760576,5716541,6376275,6376275
Singapore,2037,SG,SGP,WPR,105728,231680,337408,268438,311240,494090,500741,492919,892751,2960179,99888,219296,319184,254660,303737,416658,448398,463030,884725,2771208,5731387,6387977,6387977
Singapore,2038,SG,SGP,WPR,104286,231130,335416,268672,308186,477108,504644,490272,914426,2963308,98520,218766,317286,254985,301127,407039,446406,463085,908385,2781027,5744335,6397036,6397036
Singapore,2039,SG,SGP,WPR,103012,230090,333102,268839,306796,457923,509250,487747,934819,2965374,97319,217772,315091,255302,299352,396470,444970,462592,931314,2790000,5755374,6403564,6403564
Singapore,2040,SG,SGP,WPR,101982,228603,330585,268409,306409,437829,514611,485510,953593,2966361,96344,216363,312707,255122,298218,385680,444376,461420,953267,2798083,5764444,6407736,6407736
Singapore,2041,SG,SGP,WPR,101080,226751,327831,266726,306943,417918,520286,484116,970265,2966254,95491,214610,310101,253840,297957,375227,444502,459923,973804,2805253,5771507,6409441,6409441
Singapore,2042,SG,SGP,WPR,100314,224542,324856,263838,308361,398923,525395,483602,984942,2965061,94767,212519,307286,251500,298622,365355,444885,458130,992990,2811482,5776543,6408677,6408677
Singapore,2043,SG,SGP,WPR,99806,222092,321898,260001,310596,381558,528927,483660,997971,2962713,94289,210204,304493,248334,300142,356311,444998,455837,1011055,2816677,5779390,6405781,6405781
Singapore,2044,SG,SGP,WPR,99551,219588,319139,254784,314324,366550,529416,484580,1009520,2959174,94046,207833,301879,243935,303107,348339,443897,453415,1028046,2820739,5779913,6400931,6400931
Singapore,2045,SG,SGP,WPR,99459,217159,316618,252175,315873,354710,525420,486408,1019879,2954465,93959,205537,299496,241748,304315,341824,440612,451029,1044091,2823619,5778084,6394197,6394197
Singapore,2046,SG,SGP,WPR,99611,214765,314376,252686,314884,346240,516513,488979,1029329,2948631,94098,203270,297368,242218,303427,336792,434914,448646,1059355,2825352,5773983,6385724,6385724
Singapore,2047,SG,SGP,WPR,100057,212500,312557,252579,314801,340779,503110,492345,1038014,2941628,94519,201127,295646,242108,303409,333058,426989,446501,1073815,2825880,5767508,6375719,6375719
Singapore,2048,SG,SGP,WPR,100624,210552,311176,252031,315036,337748,486301,496383,1046012,2933511,95051,199285,294336,241576,303732,330460,417442,444671,1087333,2825214,5758725,6364240,6364240
Singapore,2049,SG,SGP,WPR,101226,209024,310250,250990,315209,336373,467317,501101,1053335,2924325,95616,197845,293461,240584,304051,328693,406950,443385,1099679,2823342,5747667,6351377,6351377
Singapore,2050,SG,SGP,WPR,101842,207906,309748,249507,314782,335997,447448,506545,1059887,2914166,96197,196786,292983,239176,303875,327568,396242,442929,1110547,2820337,5734503,6337235,6337235
Solomon Islands,1970,SB,SLB,WPR,16303,25176,41479,16639,11668,8542,5982,3946,3831,50608,15180,22385,37565,14954,10751,7557,4913,2835,2169,43179,93787,172833,172833
Solomon Islands,1971,SB,SLB,WPR,16986,26012,42998,16718,11892,8678,6104,4086,4038,51516,15712,23083,38795,15203,10919,7660,5034,2891,2253,43960,95476,177264,177264
Solomon Islands,1972,SB,SLB,WPR,17842,26905,44747,16724,12105,8757,6190,4220,4166,52162,16386,23870,40256,15549,11113,7702,5099,2932,2319,44714,96876,181876,181876
Solomon Islands,1973,SB,SLB,WPR,18613,27902,46515,16846,12336,8859,6278,4344,4286,52949,17037,24698,41735,15959,11359,7767,5166,2986,2383,45620,98569,186816,186816
Solomon Islands,1974,SB,SLB,WPR,19275,29054,48329,17076,12579,8992,6371,4455,4387,53860,17652,25641,43293,16401,11656,7867,5252,3063,2439,46678,100538,192155,192155
Solomon Islands,1975,SB,SLB,WPR,19735,30379,50114,17488,12813,9164,6472,4548,4456,54941,18154,26731,44885,16896,12000,8014,5354,3165,2487,47916,102857,197853,197853
Solomon Islands,1976,SB,SLB,WPR,20043,31757,51800,18203,13066,9391,6588,4619,4450,56317,18576,27936,46512,17485,12406,8235,5497,3300,2525,49448,105765,204082,204082
Solomon Islands,1977,SB,SLB,WPR,20395,33078,53473,19121,13342,9674,6740,4697,4450,58024,19023,29176,48199,18176,12836,8505,5680,3456,2575,51228,109252,210932,210932
Solomon Islands,1978,SB,SLB,WPR,20873,34304,55177,20127,13618,9978,6922,4814,4502,59961,19507,30406,49913,18967,13259,8783,5864,3615,2649,53137,113098,218193,218193
Solomon Islands,1979,SB,SLB,WPR,21442,35456,56898,21225,13896,10305,7121,4945,4585,62077,20028,31615,51643,19858,13659,9082,6062,3776,2734,55171,117248,225786,225786
Solomon Islands,1980,SB,SLB,WPR,22085,36538,58623,22413,14172,10650,7335,5096,4691,64357,20592,32792,53384,20844,14044,9393,6264,3941,2821,57307,121664,233668,233668
Solomon Islands,1981,SB,SLB,WPR,22767,37595,60362,23662,14478,10999,7563,5253,4811,66766,21197,33942,55139,21905,14425,9724,6479,4100,2926,59559,126325,241827,241827
Solomon Islands,1982,SB,SLB,WPR,23451,38655,62106,24920,14869,11339,7811,5420,4944,69303,21815,35080,56895,23009,14853,10070,6698,4260,3047,61937,131240,250250,250250
Solomon Islands,1983,SB,SLB,WPR,24142,39723,63865,26172,15373,11676,8066,5592,5090,71969,22448,36210,58658,24130,15357,10437,6922,4421,3179,64446,136415,258945,258945
Solomon Islands,1984,SB,SLB,WPR,24852,40778,65630,27473,15954,12006,8335,5770,5244,74782,23102,37311,60413,25315,15899,10820,7155,4582,3321,67092,141874,267913,267913
Solomon Islands,1985,SB,SLB,WPR,25582,41787,67369,28859,16616,12320,8613,5952,5405,77765,23779,38357,62136,26594,16490,11210,7390,4743,3468,69895,147660,277158,277158
Solomon Islands,1986,SB,SLB,WPR,26296,42804,69100,30250,17382,12613,8880,6109,5525,80759,24469,39374,63843,27887,17157,11623,7631,4909,3625,72832,153591,286527,286527
Solomon Islands,1987,SB,SLB,WPR,26959,43873,70832,31570,18225,12889,9132,6231,5602,83649,25156,40410,65566,29113,17887,12052,7875,5080,3777,75784,159433,295836,295836
Solomon Islands,1988,SB,SLB,WPR,27596,44964,72560,32779,19162,13154,9390,6357,5683,86525,25812,41465,67277,30290,18671,12471,8135,5255,3941,78763,165288,305132,305132
Solomon Islands,1989,SB,SLB,WPR,28245,46070,74315,33892,20203,13411,9669,6503,5794,89472,26454,42545,68999,31433,19516,12865,8413,5429,4123,81779,171251,314560,314560
Solomon Islands,1990,SB,SLB,WPR,28909,47204,76113,34931,21334,13661,9968,6661,5912,92467,27086,43665,70751,32545,20434,13235,8713,5609,4304,84840,177307,324171,324171
Solomon Islands,1991,SB,SLB,WPR,29578,48354,77932,35933,22518,13943,10277,6833,6046,95550,27714,44818,72532,33626,21407,13594,9024,5798,4490,87939,183489,333952,333952
Solomon Islands,1992,SB,SLB,WPR,30254,49481,79735,36925,23726,14308,10581,7017,6195,98752,28337,45975,74312,34699,22405,13990,9357,5988,4678,91117,189869,343916,343916
Solomon Islands,1993,SB,SLB,WPR,30953,50599,81552,37887,24924,14783,10884,7218,6359,102055,28982,47126,76108,35766,23406,14438,9707,6181,4870,94368,196423,354086,354086
Solomon Islands,1994,SB,SLB,WPR,31693,51723,83416,38802,26170,15333,11183,7434,6542,105464,29667,48279,77946,36796,24450,14915,10074,6375,5072,97682,203146,364505,364505
Solomon Islands,1995,SB,SLB,WPR,32486,52857,85343,39632,27489,15968,11469,7664,6733,108955,30400,49431,79831,37759,25583,15427,10440,6574,5275,101058,210013,375189,375189
Solomon Islands,1996,SB,SLB,WPR,33296,54008,87304,40440,28784,16708,11746,7899,6937,112514,31147,50578,81725,38708,26738,15993,10817,6775,5491,104522,217036,386069,386069
Solomon Islands,1997,SB,SLB,WPR,34070,55178,89248,41300,29987,17540,12024,8151,7154,116156,31862,51732,83594,39692,27862,16619,11195,6985,5701,108054,224210,397050,397050
Solomon Islands,1998,SB,SLB,WPR,34802,56395,91197,42205,31097,18466,12295,8418,7386,119867,32540,52901,85441,40712,28951,17299,11560,7209,5923,111654,231521,408145,408145
Solomon Islands,1999,SB,SLB,WPR,35472,57630,93102,43093,32123,19485,12564,8720,7654,123639,33146,54081,87227,41746,29989,18033,11899,7449,6149,115265,238904,419229,419229
Solomon Islands,2000,SB,SLB,WPR,36138,58914,95052,43917,33003,20530,12796,8976,7896,127118,33732,55185,88917,42787,31018,18818,12191,7700,6376,118890,246008,429978,429978
Solomon Islands,2001,SB,SLB,WPR,36839,60235,97074,44665,33750,21560,13013,9176,8085,130249,34351,56190,90541,43813,32055,19657,12457,7961,6599,122542,252791,440395,440395
Solomon Islands,2002,SB,SLB,WPR,37536,61555,99091,45352,34468,22587,13304,9373,8271,133355,34973,57170,92143,44786,33083,20516,12745,8230,6820,126180,259535,450760,450760
Solomon Islands,2003,SB,SLB,WPR,38210,62901,101111,46033,35151,23603,13696,9559,8463,136505,35589,58169,93758,45710,34105,21383,13087,8512,7042,129839,266344,461216,461216
Solomon Islands,2004,SB,SLB,WPR,38830,64314,103144,46727,35774,24661,14151,9748,8647,139708,36160,59234,95394,46595,35099,22310,13457,8803,7277,133541,273249,471785,471785
Solomon Islands,2005,SB,SLB,WPR,39425,65766,105191,47440,36300,25789,14678,9931,8829,142967,36713,60350,97063,47440,36029,23334,13867,9094,7505,137269,280236,482486,482486
Solomon Islands,2006,SB,SLB,WPR,40073,67230,107303,48185,36795,26900,15296,10102,9004,146282,37317,61495,98812,48250,36937,24391,14331,9381,7739,141029,287311,493430,493430
Solomon Islands,2007,SB,SLB,WPR,40787,68679,109466,48987,37333,27909,15992,10277,9191,149689,37979,62658,100637,49038,37867,25427,14843,9667,7979,144821,294510,504619,504619
Solomon Islands,2008,SB,SLB,WPR,41537,70093,111630,49867,37910,28828,16759,10452,9386,153202,38675,63807,102482,49831,38820,26445,15415,9939,8232,148682,301884,516001,516001
Solomon Islands,2009,SB,SLB,WPR,42341,71480,113821,50904,38523,29672,17607,10625,9577,156908,39433,64970,104403,50677,39792,27467,16068,10200,8496,152700,309608,527833,527833
Solomon Islands,2010,SB,SLB,WPR,43242,72860,116102,52152,39198,30458,18537,10800,9776,160921,40293,66165,106458,51599,40800,28495,16804,10440,8774,156912,317833,540394,540394
Solomon Islands,2011,SB,SLB,WPR,44210,74300,118510,53573,39916,31219,19521,11008,9968,165205,41232,67473,108705,52573,41834,29534,17614,10679,9072,161306,326511,553721,553721
Solomon Islands,2012,SB,SLB,WPR,45235,75841,121076,55100,40653,31983,20520,11292,10149,169697,42223,68928,111151,53589,42846,30601,18471,10956,9375,165838,335535,567763,567763
Solomon Islands,2013,SB,SLB,WPR,46344,77405,123749,56713,41421,32727,21517,11671,10338,174387,43283,70457,113740,54657,43812,31677,19341,11297,9698,170482,344869,582365,582365
Solomon Islands,2014,SB,SLB,WPR,47504,78949,126453,58408,42231,33416,22561,12108,10548,179272,44378,71997,116375,55819,44741,32735,20282,11663,10033,175273,354545,597375,597375
Solomon Islands,2015,SB,SLB,WPR,48611,80540,129151,60149,43091,34019,23686,12608,10744,184297,45418,73596,119014,57055,45632,33738,21320,12074,10371,180190,364487,612660,612660
Solomon Islands,2016,SB,SLB,WPR,49578,82235,131813,61900,44023,34591,24795,13196,10950,189455,46322,75295,121617,58345,46499,34720,22398,12541,10712,185215,374670,628102,628102
Solomon Islands,2017,SB,SLB,WPR,50380,84035,134415,63635,45038,35212,25821,13851,11164,194721,47073,77089,124162,59680,47338,35728,23467,13057,11061,190331,385052,643634,643634
Solomon Islands,2018,SB,SLB,WPR,51010,85948,136958,65318,46168,35877,26762,14576,11388,200089,47663,78977,126640,61034,48199,36757,24523,13636,11413,195562,395651,659249,659249
Solomon Islands,2019,SB,SLB,WPR,51496,87966,139462,66929,47438,36567,27634,15374,11625,205567,48118,80955,129073,62377,49102,37795,25577,14281,11763,200895,406462,674993,674993
Solomon Islands,2020,SB,SLB,WPR,51913,90069,141982,68545,48879,37319,28450,16227,11831,211251,48525,83011,131536,63724,50086,38866,26636,14996,12099,206407,417658,691191,691191
Solomon Islands,2021,SB,SLB,WPR,52331,92134,144465,70254,50453,38114,29237,17121,12033,217212,48944,85041,133985,65161,51136,39970,27706,15778,12437,212188,429400,707851,707851
Solomon Islands,2022,SB,SLB,WPR,52762,94105,146867,71953,51936,38844,29982,18022,12297,223034,49393,87000,136393,66643,52133,41019,28784,16589,12808,217976,441010,724273,724273
Solomon Islands,2023,SB,SLB,WPR,53196,96001,149197,73606,53331,39520,30666,18913,12638,228674,49848,88914,138762,68141,53108,42009,29863,17428,13247,223796,452470,740424,740424
Solomon Islands,2024,SB,SLB,WPR,53608,97790,151398,75278,54811,40223,31294,19848,13037,234491,50266,90738,141004,69688,54153,42957,30925,18327,13718,229768,464259,756673,756673
Solomon Islands,2025,SB,SLB,WPR,54025,99420,153445,77033,56345,40965,31839,20850,13484,240516,50677,92425,143102,71332,55268,43861,31936,19327,14237,235961,476477,773027,773027
Solomon Islands,2026,SB,SLB,WPR,54430,100875,155305,78920,57903,41754,32356,21838,13997,246768,51071,93948,145019,73117,56420,44726,32924,20359,14806,242352,489120,789449,789449
Solomon Islands,2027,SB,SLB,WPR,54823,102168,156991,80928,59473,42605,32908,22744,14572,253230,51448,95317,146765,75035,57615,45560,33941,21387,15421,248959,502189,805947,805947
Solomon Islands,2028,SB,SLB,WPR,55263,103279,158542,83052,61021,43555,33498,23571,15200,259897,51869,96505,148374,77079,58832,46395,34975,22409,16092,255782,515679,822593,822593
Solomon Islands,2029,SB,SLB,WPR,55731,104222,159953,85285,62529,44622,34112,24331,15882,266761,52318,97524,149842,79243,60047,47261,36017,23426,16808,262802,529563,839363,839363
Solomon Islands,2030,SB,SLB,WPR,56224,105082,161306,87538,63995,45815,34755,25024,16622,273749,52791,98450,151241,81451,61258,48172,37074,24434,17581,269970,543719,856264,856264
Solomon Islands,1950,SB,SLB,WPR,10127,14221,24348,10317,7795,5616,4055,2815,2797,33395,8981,13026,22007,9481,6349,3923,2590,1683,1429,25455,58850,105209,105209
Solomon Islands,1951,SB,SLB,WPR,10032,14685,24717,10544,7939,5710,4091,2794,2727,33805,9034,13378,22412,9751,6588,4045,2661,1708,1432,26185,59990,107119,107119
Solomon Islands,1952,SB,SLB,WPR,10030,15167,25197,10789,8085,5811,4136,2792,2658,34271,9147,13749,22896,10029,6823,4178,2738,1740,1438,26946,61217,109309,109309
Solomon Islands,1953,SB,SLB,WPR,10123,15667,25790,11052,8231,5922,4181,2797,2592,34775,9320,14140,23460,10310,7063,4327,2814,1775,1445,27734,62509,111760,111760
Solomon Islands,1954,SB,SLB,WPR,10292,16176,26468,11334,8379,6047,4234,2812,2539,35345,9539,14552,24091,10592,7297,4489,2894,1815,1454,28541,63886,114448,114448
Solomon Islands,1955,SB,SLB,WPR,10607,16603,27210,11633,8527,6170,4291,2838,2490,35949,9844,14929,24773,10871,7535,4668,2978,1855,1472,29379,65328,117314,117314
Solomon Islands,1956,SB,SLB,WPR,10988,16999,27987,11941,8681,6303,4355,2871,2445,36596,10175,15300,25475,11147,7769,4864,3060,1899,1491,30230,66826,120288,120288
Solomon Islands,1957,SB,SLB,WPR,11295,17482,28777,12268,8840,6442,4423,2908,2412,37293,10449,15744,26193,11425,8007,5067,3148,1946,1513,31106,68399,123373,123373
Solomon Islands,1958,SB,SLB,WPR,11577,18025,29602,12620,9014,6590,4500,2945,2396,38065,10726,16247,26973,11709,8247,5281,3241,1996,1541,32015,70080,126649,126649
Solomon Islands,1959,SB,SLB,WPR,11883,18542,30425,12999,9205,6732,4583,2985,2376,38880,11056,16746,27802,12004,8499,5505,3339,2048,1565,32960,71840,130071,130071
Solomon Islands,1960,SB,SLB,WPR,12254,18972,31226,13334,9408,6881,4679,3040,2441,39783,11440,17142,28582,12260,8727,5715,3438,2107,1595,33842,73625,133440,133440
Solomon Islands,1961,SB,SLB,WPR,12667,19383,32050,13609,9617,7027,4787,3113,2583,40736,11833,17476,29309,12484,8937,5908,3542,2174,1649,34694,75430,136780,136780
Solomon Islands,1962,SB,SLB,WPR,13068,19850,32918,13897,9832,7180,4898,3194,2707,41708,12222,17858,30080,12713,9150,6098,3651,2241,1692,35545,77253,140254,140254
Solomon Islands,1963,SB,SLB,WPR,13441,20386,33827,14203,10056,7334,5015,3272,2836,42716,12580,18307,30887,12957,9366,6286,3773,2314,1740,36436,79152,143863,143863
Solomon Islands,1964,SB,SLB,WPR,13827,20949,34776,14533,10285,7488,5140,3357,2957,43760,12945,18784,31729,13216,9582,6474,3909,2384,1788,37353,81113,147609,147609
Solomon Islands,1965,SB,SLB,WPR,14230,21546,35776,14875,10511,7646,5266,3438,3077,44813,13319,19291,32610,13494,9796,6657,4057,2456,1838,38298,83111,151495,151495
Solomon Islands,1966,SB,SLB,WPR,14628,22197,36825,15234,10735,7806,5397,3525,3201,45898,13690,19846,33536,13788,9999,6835,4217,2528,1893,39260,85158,155514,155514
Solomon Islands,1967,SB,SLB,WPR,15027,22881,37908,15611,10959,7974,5537,3616,3320,47017,14055,20433,34488,14102,10196,7014,4385,2602,1956,40255,87272,159667,159667
Solomon Islands,1968,SB,SLB,WPR,15429,23601,39030,16006,11188,8151,5679,3716,3444,48184,14424,21067,35491,14422,10393,7199,4560,2677,2015,41266,89450,163973,163973
Solomon Islands,1969,SB,SLB,WPR,15850,24367,40217,16372,11426,8340,5826,3818,3600,49382,14799,21733,36532,14722,10585,7384,4739,2753,2086,42269,91651,168399,168399
Solomon Islands,2031,SB,SLB,WPR,56790,105912,162702,89682,65503,47091,35412,25684,17410,280782,53330,99329,152659,83577,62544,49111,38131,25435,18406,277204,557986,873346,873346
Solomon Islands,2032,SB,SLB,WPR,57434,106738,164172,91690,67102,48415,36060,26333,18248,287848,53941,100185,154126,85588,63962,50050,39151,26450,19293,284494,572342,890636,890636
Solomon Islands,2033,SB,SLB,WPR,58117,107613,165730,93579,68744,49797,36719,26955,19135,294929,54590,101069,155659,87503,65457,51021,40127,27469,20246,291823,586752,908135,908135
Solomon Islands,2034,SB,SLB,WPR,58832,108501,167333,95363,70404,51255,37410,27532,20075,302039,55268,101948,157216,89333,67004,52069,41061,28476,21276,299219,601258,925799,925799
Solomon Islands,2035,SB,SLB,WPR,59592,109414,169006,96990,72147,52767,38131,28041,21092,309168,55982,102835,158817,91022,68649,53178,41952,29435,22410,306646,615814,943640,943640
Solomon Islands,2036,SB,SLB,WPR,60360,110387,170747,98439,74019,54307,38899,28527,22133,316324,56706,103780,160486,92547,70428,54334,42808,30380,23610,314107,630431,961667,961667
Solomon Islands,2037,SB,SLB,WPR,61123,111427,172550,99730,76008,55855,39731,29044,23130,323498,57425,104773,162198,93921,72343,55524,43638,31352,24848,321626,645124,979865,979865
Solomon Islands,2038,SB,SLB,WPR,61901,112549,174450,100845,78119,57383,40654,29593,24094,330688,58160,105846,164006,95115,74387,56734,44468,32341,26103,329148,659836,998284,998284
Solomon Islands,2039,SB,SLB,WPR,62696,113739,176435,101788,80331,58873,41695,30162,25033,337882,58910,106977,165887,96136,76544,57947,45327,33342,27390,336686,674568,1016888,1016888
Solomon Islands,2040,SB,SLB,WPR,63479,114992,178471,102646,82564,60322,42851,30757,25935,345075,59649,108173,167822,97066,78746,59154,46233,34353,28697,344249,689324,1035616,1035616
Solomon Islands,2041,SB,SLB,WPR,64227,116327,180554,103478,84695,61810,44098,31367,26844,352292,60357,109437,169794,97951,80864,60435,47160,35369,30034,351813,704105,1054447,1054447
Solomon Islands,2042,SB,SLB,WPR,64944,117734,182678,104312,86686,63391,45386,31969,27760,359504,61032,110773,171805,98815,82873,61846,48091,36353,31423,359401,718905,1073371,1073371
Solomon Islands,2043,SB,SLB,WPR,65590,119192,184782,105188,88560,65010,46723,32585,28693,366759,61639,112155,173794,99702,84783,63335,49055,37290,32847,367012,733771,1092351,1092351
Solomon Islands,2044,SB,SLB,WPR,66160,120706,186866,106075,90332,66654,48141,33233,29615,374050,62179,113590,175769,100585,86609,64875,50091,38192,34322,374674,748724,1111355,1111355
Solomon Islands,2045,SB,SLB,WPR,66695,122247,188942,106991,91946,68377,49612,33913,30534,381373,62682,115047,177729,101483,88296,66507,51190,39059,35834,382369,763742,1130412,1130412
Solomon Islands,2046,SB,SLB,WPR,67190,123762,190952,107967,93391,70227,51107,34632,31446,388770,63152,116479,179631,102428,89816,68280,52332,39887,37372,390115,778885,1149476,1149476
Solomon Islands,2047,SB,SLB,WPR,67646,125240,192886,109007,94673,72194,52608,35415,32344,396241,63582,117876,181458,103425,91189,70181,53511,40698,38947,397951,794192,1168539,1168539
Solomon Islands,2048,SB,SLB,WPR,68056,126667,194723,110129,95783,74279,54093,36278,33229,403791,63972,119219,183191,104498,92386,72212,54706,41508,40544,405854,809645,1187560,1187560
Solomon Islands,2049,SB,SLB,WPR,68430,128036,196466,111318,96725,76462,55539,37253,34104,411401,64322,120513,184835,105637,93412,74354,55907,42352,42160,413822,825223,1206524,1206524
Solomon Islands,2050,SB,SLB,WPR,68744,129354,198098,112570,97586,78670,56950,38338,34979,419093,64615,121757,186372,106831,94343,76534,57100,43237,43796,421841,840934,1225407,1225407
Sierra Leone,1970,SL,SLE,AFR,237837,330411,568248,236349,188697,143993,106194,71622,51218,798073,234012,329442,563454,240922,196602,152041,115734,81208,62274,848781,1646854,2778557,2778557
Sierra Leone,1971,SL,SLE,AFR,242712,339819,582531,239679,192046,146050,107803,72808,52396,810782,238741,338455,577196,243910,200193,154141,117469,82592,63577,861882,1672664,2832392,2832392
Sierra Leone,1972,SL,SLE,AFR,247574,349219,596793,243300,195375,148165,109365,73971,53554,823730,243443,347474,590917,247146,203764,156294,119158,83955,64873,875190,1698920,2886642,2886642
Sierra Leone,1973,SL,SLE,AFR,252569,358678,611247,248345,197788,150349,110933,75133,54697,837245,248266,356571,604837,251641,206531,158511,120853,85311,66155,889002,1726247,2942333,2942333
Sierra Leone,1974,SL,SLE,AFR,257877,367969,625846,255307,198743,152440,112471,76278,55820,851059,253382,365517,618899,258202,207626,160645,122504,86643,67428,903048,1754107,2998843,2998843
Sierra Leone,1975,SL,SLE,AFR,263404,377065,640469,262547,199887,154401,113979,77407,56901,865122,258724,374282,633006,265289,208623,162670,124095,87951,68691,917319,1782441,3055916,3055916
Sierra Leone,1976,SL,SLE,AFR,268847,385930,654777,269530,201684,156287,115460,78517,57968,879446,264000,382833,646833,272070,210272,164648,125637,89230,69956,931813,1811259,3112863,3112863
Sierra Leone,1977,SL,SLE,AFR,274456,394961,669417,276964,203651,158298,117034,79650,59008,894605,269438,391557,660995,279297,212086,166798,127243,90531,71227,947182,1841787,3172195,3172195
Sierra Leone,1978,SL,SLE,AFR,280458,404257,684715,284954,205788,160585,118726,80820,60044,910917,275259,400573,675832,287079,214036,169272,128954,91867,72498,963706,1874623,3235170,3235170
Sierra Leone,1979,SL,SLE,AFR,286463,413751,700214,293231,208082,163157,120432,82009,61072,927983,281077,409804,690881,295128,216099,172048,130672,93217,73792,980956,1908939,3300032,3300032
Sierra Leone,1980,SL,SLE,AFR,292438,423685,716123,301654,210721,166061,122167,83242,62106,945951,286855,419477,706332,303303,218484,175169,132425,94600,75089,999070,1945021,3367477,3367477
Sierra Leone,1981,SL,SLE,AFR,298631,433848,732479,310161,213750,169077,123962,84489,63137,964576,292838,429381,722219,311551,221237,178410,134257,95992,76387,1017834,1982410,3437108,3437108
Sierra Leone,1982,SL,SLE,AFR,305166,444204,749370,318835,217139,172158,125861,85750,64159,983902,299160,439445,738605,319967,224329,181718,136201,97409,77696,1037320,2021222,3509197,3509197
Sierra Leone,1983,SL,SLE,AFR,312173,455187,767360,327785,221977,174494,127900,87056,65189,1004401,305961,450089,756050,328667,228728,184384,138294,98876,79017,1057966,2062367,3585773,3585773
Sierra Leone,1984,SL,SLE,AFR,319672,466718,786390,336883,228729,175654,129954,88408,66240,1025868,313267,461233,774500,337501,235200,185657,140413,100372,80359,1079502,2105370,3666262,3666262
Sierra Leone,1985,SL,SLE,AFR,327609,478503,806112,346032,235819,177130,131957,89783,67303,1048024,321023,472602,793625,346367,242215,186982,142503,101882,81704,1101653,2149677,3749419,3749419
Sierra Leone,1986,SL,SLE,AFR,336574,491589,828163,355955,243306,179647,134229,91373,68517,1073027,329788,485223,815011,355976,249570,189389,144915,103624,83250,1126724,2199751,3842917,3842917
Sierra Leone,1987,SL,SLE,AFR,346596,506194,852790,366817,251739,182650,136873,93231,69900,1101210,339593,499301,838894,366479,257852,192268,147755,105621,84992,1154967,2256177,3947865,3947865
Sierra Leone,1988,SL,SLE,AFR,356716,521432,878148,377905,260652,185746,139712,95134,71295,1130444,349524,513965,863489,377178,266568,195177,150827,107645,86739,1184134,2314578,4056215,4056215
Sierra Leone,1989,SL,SLE,AFR,365928,536127,902055,388574,269387,188633,142536,96845,72541,1158516,358581,528076,886657,387429,275058,197814,153884,109446,88310,1211941,2370457,4159163,4159163
Sierra Leone,1990,SL,SLE,AFR,380464,559059,939523,405314,282177,194524,147672,99940,74839,1204466,372828,550293,923121,403694,287629,203546,159437,112818,91155,1258279,2462745,4325388,4325388
Sierra Leone,1991,SL,SLE,AFR,384987,567549,952536,411350,287395,195481,148887,100368,75096,1218577,377262,558287,935549,409342,292529,204125,160785,113212,91521,1271514,2490091,4378169,4378169
Sierra Leone,1992,SL,SLE,AFR,378235,559439,937674,405091,283971,190772,145595,97802,73026,1196257,370660,549961,920621,402778,288731,198807,157322,110273,89110,1247021,2443278,4301566,4301566
Sierra Leone,1993,SL,SLE,AFR,378120,560140,938260,405461,284892,190315,143843,96856,72158,1193525,370550,550364,920914,402758,289404,197805,155680,109182,88166,1242995,2436520,4295689,4295689
Sierra Leone,1994,SL,SLE,AFR,380632,563816,944448,408246,287167,192392,141781,96364,71635,1197585,372968,553719,926687,405150,291538,199627,153608,108659,87657,1246239,2443824,4314953,4314953
Sierra Leone,1995,SL,SLE,AFR,382209,566288,948497,409990,288458,193970,139694,95529,70867,1198508,374450,555906,930356,406632,292861,201237,151335,107833,86885,1246783,2445291,4324149,4324149
Sierra Leone,1996,SL,SLE,AFR,384990,570578,955568,413095,290529,195914,138637,94993,70381,1203549,377111,559897,937008,409306,294876,203112,150149,107360,86439,1251242,2454791,4347370,4347370
Sierra Leone,1997,SL,SLE,AFR,390750,579341,970091,419607,294874,199612,138696,95255,70494,1218538,382690,568277,950967,415128,299018,206718,150098,107775,86694,1265431,2483969,4405028,4405028
Sierra Leone,1998,SL,SLE,AFR,395079,586820,981899,424823,297959,202724,138256,95253,70294,1229309,386908,575389,962297,420024,302285,209922,149595,108010,86637,1276473,2505782,4449975,4449975
Sierra Leone,1999,SL,SLE,AFR,397832,592191,990023,427463,298789,204519,137073,94832,69642,1232318,389591,580389,969980,423322,304392,212308,148549,107994,86261,1282826,2515144,4475145,4475145
Sierra Leone,2000,SL,SLE,AFR,408026,608236,1016262,438482,305566,210101,138705,96381,70381,1259616,399492,595823,995315,434323,312130,218419,150380,110104,87521,1312877,2572493,4584067,4584067
Sierra Leone,2001,SL,SLE,AFR,432278,645588,1077866,466216,324201,223531,145702,101495,73792,1334937,423085,632132,1055217,460674,330736,232097,157663,116040,91864,1389074,2724011,4857096,4857096
Sierra Leone,2002,SL,SLE,AFR,457062,684411,1141473,495139,343608,237494,153112,106768,77345,1413466,447132,669899,1117031,488113,349935,246263,165311,122149,96376,1468147,2881613,5140113,5140113
Sierra Leone,2003,SL,SLE,AFR,474598,714016,1188614,517178,358614,248220,159237,109841,79756,1472846,464022,698657,1162679,508703,364377,256996,171372,125853,99467,1526768,2999614,5350907,5350907
Sierra Leone,2004,SL,SLE,AFR,487807,740810,1228617,536496,372240,257718,165820,111442,81718,1525434,476649,724603,1201252,526702,377199,266394,177993,127752,101991,1578031,3103465,5533329,5533329
Sierra Leone,2005,SL,SLE,AFR,496638,763974,1260612,552825,384040,265762,171597,112675,83180,1570079,485008,746891,1231899,541866,387939,274228,183845,128972,103894,1620744,3190823,5683334,5683334
Sierra Leone,2006,SL,SLE,AFR,502865,784006,1286871,566885,394493,272687,176569,113924,84337,1608895,490821,766084,1256905,554943,397117,280810,188691,130158,105384,1657103,3265998,5809774,5809774
Sierra Leone,2007,SL,SLE,AFR,508709,804188,1312897,581293,405463,279823,181938,115267,85601,1649385,496337,785487,1281824,568545,406681,287544,193872,131395,107019,1695056,3344441,5939163,5939163
Sierra Leone,2008,SL,SLE,AFR,516217,826439,1342656,598042,418287,288076,188257,117100,87312,1697074,503639,807018,1310657,584613,418066,295387,200013,133145,109252,1740476,3437550,6090860,6090860
Sierra Leone,2009,SL,SLE,AFR,525882,849174,1375056,616596,432539,297349,195326,119423,89457,1750690,513169,829094,1342263,602560,430839,304212,206865,135361,111991,1791828,3542518,6259842,6259842
Sierra Leone,2010,SL,SLE,AFR,536276,871730,1408006,635963,447601,307332,202727,122126,91874,1807623,523533,851039,1374572,621412,444409,313695,213998,137929,115053,1846496,3654119,6436698,6436698
Sierra Leone,2011,SL,SLE,AFR,545628,893745,1439373,655451,462960,317489,210180,125071,94343,1865494,532991,872457,1405448,640501,458315,323277,221131,140702,118140,1902066,3767560,6612385,6612385
Sierra Leone,2012,SL,SLE,AFR,554167,915257,1469424,675326,478685,327885,217808,128291,96905,1924900,541678,893410,1435088,660055,472654,333018,228411,143710,121329,1959177,3884077,6788587,6788587
Sierra Leone,2013,SL,SLE,AFR,561322,936326,1497648,695791,494530,338760,225585,132342,99051,1986059,548995,914000,1462995,680257,487263,343127,235833,147529,124150,2018159,4004218,6964859,6964859
Sierra Leone,2014,SL,SLE,AFR,566631,956893,1523524,717233,510410,350152,233459,137460,100554,2049268,554468,934213,1488681,701412,502079,353634,243353,152625,126117,2079220,4128488,7140688,7140688
Sierra Leone,2015,SL,SLE,AFR,570451,976302,1546753,739384,526439,361892,241402,142760,102299,2114176,558423,953450,1511873,723207,517228,364354,250933,158021,128226,2141969,4256145,7314773,7314773
Sierra Leone,2016,SL,SLE,AFR,573920,995221,1569141,762519,543135,374303,249641,148199,104543,2182340,561912,972366,1534278,745973,533248,375652,258809,163474,130997,2208153,4390493,7493913,7493913
Sierra Leone,2017,SL,SLE,AFR,577682,1013472,1591154,786215,560415,387360,258166,154013,106934,2253103,565525,990707,1556232,769322,550016,387501,266964,169308,133953,2277064,4530167,7677565,7677565
Sierra Leone,2018,SL,SLE,AFR,582178,1030139,1612317,809293,578016,400845,266811,160134,109525,2324624,569687,1007603,1577290,792144,567267,399753,275249,175465,137162,2347040,4671664,7861281,7861281
Sierra Leone,2019,SL,SLE,AFR,587831,1045994,1633825,831058,596039,414762,275787,166546,112439,2396631,574849,1023792,1598641,813747,585069,412435,283857,181903,140733,2417744,4814375,8046828,8046828
Sierra Leone,2020,SL,SLE,AFR,594393,1061266,1655659,852342,614601,429190,285114,172818,115041,2469106,580862,1039380,1620242,834807,603422,425605,292800,188229,144099,2488962,4958068,8233970,8233970
Sierra Leone,2021,SL,SLE,AFR,601033,1075222,1676255,873805,633781,444161,294626,178953,117256,2542582,587037,1053581,1640618,855937,622407,439327,301903,194424,147179,2561177,5103759,8420641,8420641
Sierra Leone,2022,SL,SLE,AFR,606714,1088289,1695003,894879,653389,459534,304382,185272,119730,2617186,592390,1066739,1659129,876656,641845,453483,311173,200747,150490,2634394,5251580,8605718,8605718
Sierra Leone,2023,SL,SLE,AFR,611291,1100832,1712123,915527,673554,475055,314678,191890,122854,2693558,596747,1079223,1675970,897029,661916,467912,320876,207327,154372,2709432,5402990,8791092,8791092
Sierra Leone,2024,SL,SLE,AFR,614731,1112728,1727459,935616,694581,490637,325616,198923,126991,2772364,600139,1090946,1691085,917035,682895,482586,331111,214282,159147,2787056,5559420,8977972,8977972
Sierra Leone,2025,SL,SLE,AFR,617493,1123985,1741478,954749,716384,506464,337022,206225,131799,2852643,603002,1101905,1704907,936290,704624,497695,341699,221490,164546,2866344,5718987,9165377,9165377
Sierra Leone,2026,SL,SLE,AFR,620262,1134397,1754659,972999,738788,522660,348863,213653,136924,2933887,605929,1111910,1717839,954770,726930,513358,352623,228813,170273,2946767,5880654,9353150,9353150
Sierra Leone,2027,SL,SLE,AFR,623059,1143792,1766851,990419,761566,539277,361203,221255,142345,3016065,608889,1120890,1729779,972489,749618,529596,363956,236313,176322,3028294,6044359,9540988,9540988
Sierra Leone,2028,SL,SLE,AFR,625911,1152968,1778879,1006738,784037,556399,374066,229040,148063,3098343,611866,1129663,1741529,989162,772029,546462,375764,243986,182693,3110096,6208439,9728849,9728849
Sierra Leone,2029,SL,SLE,AFR,629083,1162360,1791443,1022382,805298,573966,387352,237112,154106,3180216,615118,1138667,1753785,1005214,793274,563861,387971,251944,189395,3191659,6371875,9917103,9917103
Sierra Leone,2030,SL,SLE,AFR,632364,1171882,1804246,1037130,825786,591808,401032,245536,160398,3261690,618462,1147853,1766315,1020379,813757,581633,400576,260248,196347,3272940,6534630,10105188,10105188
Sierra Leone,1950,SL,SLE,AFR,160278,231974,392252,185670,144387,108628,76332,46942,25839,587798,160645,235123,395768,188689,149342,113497,83300,55602,34539,624969,1212767,2000790,2000790
Sierra Leone,1951,SL,SLE,AFR,159659,235601,395260,187828,146187,110196,77846,48239,27229,597525,159712,238995,398707,190935,151346,115274,84760,56865,36049,635229,1232754,2026722,2026722
Sierra Leone,1952,SL,SLE,AFR,159202,239256,398458,190105,147958,111745,79329,49524,28610,607271,158910,242895,401805,193282,153320,117038,86205,58118,37546,645509,1252780,2053036,2053036
Sierra Leone,1953,SL,SLE,AFR,160096,241733,401829,192390,149675,113256,80771,50795,29974,616861,159276,245775,405051,195638,155237,118767,87623,59353,39023,655641,1272502,2079381,2079381
Sierra Leone,1954,SL,SLE,AFR,163301,242514,405815,194605,151379,114766,82174,52050,31323,626297,162108,246766,408874,197929,157122,120484,89042,60573,40488,665638,1291935,2106618,2106618
Sierra Leone,1955,SL,SLE,AFR,167084,243641,410725,196775,153123,116316,83579,53303,32654,635750,165800,247738,413538,200196,159021,122227,90489,61774,41926,675633,1311383,2135644,2135644
Sierra Leone,1956,SL,SLE,AFR,170594,245698,416292,198960,154934,117897,84975,54544,33981,645291,169190,249622,418812,202522,160944,123987,91959,62964,43354,685730,1331021,2166117,2166117
Sierra Leone,1957,SL,SLE,AFR,174388,247939,422327,201249,156817,119494,86354,55770,35280,654964,172850,251657,424507,204992,162903,125765,93452,64140,44767,696019,1350983,2197811,2197811
Sierra Leone,1958,SL,SLE,AFR,178423,250165,428588,203698,158701,121065,87691,56969,36563,664687,176751,253611,430362,207644,164824,127502,94925,65289,46180,706364,1371051,2230000,2230000
Sierra Leone,1959,SL,SLE,AFR,182670,252625,435295,206540,160645,122690,89050,58167,37846,674938,180856,255746,436602,210705,166786,129273,96427,66446,47570,717207,1392145,2264044,2264044
Sierra Leone,1960,SL,SLE,AFR,187180,255625,442805,209897,162704,124424,90474,59378,39118,685995,185168,258384,443552,214296,168890,131158,98017,67650,48947,728958,1414953,2301310,2301310
Sierra Leone,1961,SL,SLE,AFR,191945,259163,451108,213476,164893,126216,91934,60594,40369,697482,189711,261533,451244,218122,171144,133105,99667,68883,50312,741233,1438715,2341065,2341065
Sierra Leone,1962,SL,SLE,AFR,196863,263195,460058,217188,167253,128041,93419,61814,41610,709325,194432,265137,459569,222095,173587,135106,101358,70144,51669,753959,1463284,2382914,2382914
Sierra Leone,1963,SL,SLE,AFR,201970,268810,470780,219953,169723,129891,94928,63039,42844,720378,199341,270146,469487,225275,176149,137145,103084,71438,53017,766108,1486486,2426750,2426750
Sierra Leone,1964,SL,SLE,AFR,207290,276680,483970,221240,172183,131772,96463,64270,44061,729989,204465,277538,482003,226803,178729,139214,104845,72768,54360,776719,1506708,2472686,2472686
Sierra Leone,1965,SL,SLE,AFR,212604,285108,497712,222874,174620,133705,98047,65511,45263,740020,209597,285742,495339,228356,181327,141325,106653,74143,55696,787500,1527520,2520576,2520576
Sierra Leone,1966,SL,SLE,AFR,217767,293447,511214,225324,177075,135690,99653,66748,46459,750949,214582,293809,508391,230724,183972,143455,108471,75539,57019,799180,1550129,2569736,2569736
Sierra Leone,1967,SL,SLE,AFR,222979,302207,525186,227913,179614,137742,101280,67979,47669,762197,219588,302281,521869,233198,186742,145613,110295,76957,58335,811140,1573337,2620396,2620396
Sierra Leone,1968,SL,SLE,AFR,228118,311420,539538,230559,182364,139848,102921,69211,48867,773770,224537,311173,535710,235661,189742,147786,112130,78383,59650,823352,1597122,2672370,2672370
Sierra Leone,1969,SL,SLE,AFR,232984,320889,553873,233311,185377,141929,104553,70419,50050,785639,229276,320299,549575,238170,193020,149924,113936,79801,60970,835821,1621460,2724901,2724901
Sierra Leone,2031,SL,SLE,AFR,635167,1181290,1816457,1050487,846323,610130,415204,254221,166917,3343282,621338,1157037,1778375,1034097,834244,599971,413709,268792,203551,3354364,6697646,10292481,10292481
Sierra Leone,2032,SL,SLE,AFR,637826,1189701,1827527,1063254,866727,629021,429834,263184,173703,3425723,624056,1165406,1789462,1047087,854600,618947,427376,277572,211055,3436637,6862360,10479347,10479347
Sierra Leone,2033,SL,SLE,AFR,640608,1197078,1837686,1075680,886879,648554,444633,272562,180715,3509023,626886,1172880,1799766,1059562,874747,638616,441340,286710,218827,3519802,7028825,10666285,10666285
Sierra Leone,2034,SL,SLE,AFR,643057,1203894,1846951,1087536,906598,669010,459461,282379,187932,3592916,629394,1179868,1809262,1071327,894575,659194,455502,296204,226811,3603613,7196529,10852747,10852747
Sierra Leone,2035,SL,SLE,AFR,644937,1210308,1855245,1098804,925438,690263,474522,292544,195361,3676932,631335,1186558,1817893,1082353,913690,680512,470071,305955,235040,3687621,7364553,11037683,11037683
Sierra Leone,2036,SL,SLE,AFR,646495,1216247,1862742,1109250,943420,712099,489936,303086,203027,3760818,632966,1192852,1825818,1092442,932051,702395,485170,316015,243528,3771601,7532419,11220979,11220979
Sierra Leone,2037,SL,SLE,AFR,647682,1222070,1869752,1118696,960606,734306,505759,314075,210965,3844407,634243,1199006,1833249,1101527,949674,724664,500828,326460,252319,3855472,7699879,11402875,11402875
Sierra Leone,2038,SL,SLE,AFR,648137,1228044,1876181,1127928,976723,756217,522072,325542,219158,3927640,634778,1205269,1840047,1110409,966282,746679,517101,337342,261416,3939229,7866869,11583095,11583095
Sierra Leone,2039,SL,SLE,AFR,648128,1233998,1882126,1137373,992185,776964,538817,337392,227718,4010449,634857,1211483,1846340,1119521,982277,767570,533895,348606,270899,4022768,8033217,11761685,11761685
Sierra Leone,2040,SL,SLE,AFR,648115,1239517,1887632,1146939,1006777,796966,555836,349600,236631,4092749,634925,1217244,1852169,1128813,997410,787723,551057,360246,280748,4105997,8198746,11938548,11938548
Sierra Leone,2041,SL,SLE,AFR,648098,1244268,1892366,1156389,1020020,817019,573320,362244,245803,4174795,634985,1222257,1857242,1138105,1011133,807903,568776,372373,290885,4189175,8363970,12113574,12113574
Sierra Leone,2042,SL,SLE,AFR,647775,1248510,1896285,1164863,1032701,836949,591356,375293,255284,4256446,634749,1226747,1861496,1146588,1024144,827961,587115,384996,301339,4272143,8528589,12286370,12286370
Sierra Leone,2043,SL,SLE,AFR,647344,1252124,1899468,1172325,1045044,856646,610008,388498,265154,4337675,634426,1230593,1865019,1154194,1036658,847834,606130,397900,312176,4354892,8692567,12457058,12457058
Sierra Leone,2044,SL,SLE,AFR,647084,1254948,1902032,1179237,1056838,875930,629534,401731,275402,4418672,634274,1233671,1867945,1161321,1048483,867411,626018,410985,323348,4437566,8856238,12626220,12626220
Sierra Leone,2045,SL,SLE,AFR,646890,1257218,1904108,1185756,1068059,894377,649809,415164,285974,4499139,634191,1236185,1870376,1168157,1059594,886307,646625,424443,334817,4519943,9019082,12793558,12793558
Sierra Leone,2046,SL,SLE,AFR,646702,1259175,1905877,1191807,1078478,911996,670649,428924,296930,4578784,634110,1238385,1872495,1174596,1069784,904490,667786,438400,346653,4601709,9180493,12958858,12958858
Sierra Leone,2047,SL,SLE,AFR,646784,1260462,1907246,1197737,1087923,928852,691847,443073,308340,4657772,634294,1239943,1874237,1180904,1078986,921966,689330,452884,358936,4683006,9340778,13122257,13122257
Sierra Leone,2048,SL,SLE,AFR,646708,1260910,1907618,1203816,1097158,944672,712778,457681,320222,4736327,634336,1240671,1875007,1187314,1087994,938452,710642,467948,371714,4764064,9500391,13283013,13283013
Sierra Leone,2049,SL,SLE,AFR,645843,1261060,1906903,1209871,1106594,959846,732595,472695,332574,4814175,633602,1241106,1874708,1193672,1097220,954342,730883,483517,385027,4844661,9658836,13440438,13440438
Sierra Leone,2050,SL,SLE,AFR,644570,1261251,1905821,1215489,1116143,974169,751694,487971,345375,4890841,632472,1241590,1874062,1199579,1106617,969383,750422,499438,398865,4924304,9815145,13595023,13595023
El Salvador,1970,SV,SLV,AMR,337175,524019,861194,334267,227210,162019,103504,67296,54902,949198,326704,500494,827198,340820,229720,165418,110553,71853,63124,981488,1930686,3619090,3619090
El Salvador,1971,SV,SLV,AMR,338290,541922,880212,345986,232386,166447,106333,67951,54386,973489,329682,516506,846188,352073,236391,169716,113614,73155,63176,1008125,1981614,3708010,3708010
El Salvador,1972,SV,SLV,AMR,340661,557330,897991,359202,237605,170630,109396,68656,54146,999635,333584,531293,864877,363648,243315,173861,116788,74502,63496,1035610,2035245,3798109,3798109
El Salvador,1973,SV,SLV,AMR,343896,570746,914642,373753,243451,174632,112615,69595,54116,1028162,338035,545327,883362,375500,250867,177943,120092,76057,64013,1064472,2092634,3890639,3890639
El Salvador,1974,SV,SLV,AMR,347476,582784,930260,388613,250230,178412,115931,70776,54242,1058204,342532,558787,901319,387079,259216,181928,123519,77834,64697,1094273,2152477,3984049,3984049
El Salvador,1975,SV,SLV,AMR,352266,592616,944882,403261,257701,181821,119296,72105,54497,1088681,347743,570730,918473,398307,268239,185791,127042,79793,65545,1124717,2213398,4076751,4076751
El Salvador,1976,SV,SLV,AMR,357767,600513,958280,417702,265248,184734,122505,73584,54860,1118633,353284,581087,934371,409607,277416,189539,130522,81952,66576,1155612,2274245,4166890,4166890
El Salvador,1977,SV,SLV,AMR,363267,607621,970888,432467,272619,187357,125523,75194,55298,1148458,358651,590662,949313,421823,286614,193538,133990,84294,67777,1188036,2336494,4256699,4256699
El Salvador,1978,SV,SLV,AMR,368959,613895,982854,447388,279619,189897,128411,76820,55798,1177933,364003,599452,963455,434973,295827,198073,137524,86724,69159,1222280,2400213,4346522,4346522
El Salvador,1979,SV,SLV,AMR,374516,619382,993898,461544,285900,192230,131110,78350,56331,1205465,369131,607383,976514,448391,304881,203015,141071,89126,70681,1257165,2462630,4433041,4433041
El Salvador,1980,SV,SLV,AMR,379086,624056,1003142,473569,290812,193826,133276,79544,56593,1227620,373301,614243,987544,461416,313535,208026,144405,91313,71990,1290685,2518305,4508992,4508992
El Salvador,1981,SV,SLV,AMR,381307,625118,1006425,479304,292415,193097,133926,80025,56340,1235107,375163,617184,992347,470865,320142,211751,146663,92924,72953,1315298,2550405,4549173,4549173
El Salvador,1982,SV,SLV,AMR,384276,628528,1012804,484377,295681,192884,134740,80863,56455,1245000,377747,621942,999689,480222,327675,216127,149152,94854,74373,1342403,2587403,4599904,4599904
El Salvador,1983,SV,SLV,AMR,389392,637604,1026996,493332,303022,195247,136748,82522,57296,1268167,382447,631796,1014243,492736,337939,222756,152773,97564,76498,1380266,2648433,4689680,4689680
El Salvador,1984,SV,SLV,AMR,393723,647186,1040909,502643,310938,198718,138802,84366,58389,1293856,386358,641819,1028177,505134,348146,230271,156434,100432,78857,1419274,2713130,4782219,4782219
El Salvador,1985,SV,SLV,AMR,396594,658097,1054691,511961,319878,203429,140972,86518,59737,1322495,388755,652729,1041484,516403,358231,238550,160094,103448,81369,1458095,2780590,4876757,4876757
El Salvador,1986,SV,SLV,AMR,397938,669956,1067894,520842,329647,208716,143074,88831,61311,1352421,389624,664222,1053846,526536,368620,247108,163756,106514,84091,1496625,2849046,4970788,4970788
El Salvador,1987,SV,SLV,AMR,399593,681470,1081063,529620,340578,214309,145224,91277,63096,1384104,390813,675217,1066030,535982,379938,255715,167669,109646,87059,1536009,2920113,5067200,5067200
El Salvador,1988,SV,SLV,AMR,403679,694279,1097958,537649,351639,219747,147643,94139,65272,1416089,394349,687293,1081642,543939,390862,264070,172171,113179,90521,1574742,2990831,5170440,5170440
El Salvador,1989,SV,SLV,AMR,409138,707988,1117126,543779,360790,224089,149883,97191,67673,1443405,399186,700143,1099329,550334,400282,271776,177056,117072,94446,1610966,3054371,5270825,5270825
El Salvador,1990,SV,SLV,AMR,414701,720610,1135311,549759,369389,227962,151937,100220,70165,1469432,404219,711837,1116056,556574,409096,279069,182097,121021,98523,1646380,3115812,5367179,5367179
El Salvador,1991,SV,SLV,AMR,420006,732283,1152289,556965,377655,232122,153821,103251,72969,1496783,409191,722482,1131673,562950,416587,285941,187129,124935,102779,1680321,3177104,5461070,5461070
El Salvador,1992,SV,SLV,AMR,423918,744112,1168030,565359,384523,236847,155548,106074,76030,1524381,412901,733235,1146136,570199,422554,292659,192244,128757,107242,1713655,3238036,5552206,5552206
El Salvador,1993,SV,SLV,AMR,423680,749051,1172731,573080,391782,243333,158671,109185,80078,1556129,412339,738698,1151037,578477,429318,299622,198169,132838,112668,1751092,3307221,5630987,5630987
El Salvador,1994,SV,SLV,AMR,419970,746181,1166151,578664,399583,250656,163384,112558,85179,1590024,407962,737642,1145604,586606,437091,306337,204942,137137,119150,1791263,3381287,5693038,5693038
El Salvador,1995,SV,SLV,AMR,415450,742569,1158019,583744,406108,257306,168515,115691,90708,1622072,402404,735270,1137674,594612,443990,312520,211934,141316,126046,1830418,3452490,5748195,5748195
El Salvador,1996,SV,SLV,AMR,410270,738624,1148894,587787,411616,263608,173739,118678,96723,1652151,395873,731943,1127816,601858,450186,318616,218750,145453,133419,1868282,3520433,5797140,5797140
El Salvador,1997,SV,SLV,AMR,404815,735536,1140351,589778,416656,269969,178916,121689,103163,1680171,388808,728706,1117514,607206,456157,325107,225217,149712,141207,1904606,3584777,5842638,5842638
El Salvador,1998,SV,SLV,AMR,398822,734503,1133325,589507,420741,276379,183988,124868,109933,1705416,381355,726425,1107780,610248,461665,331863,231308,154197,149278,1938559,3643975,5885083,5885083
El Salvador,1999,SV,SLV,AMR,392413,735378,1127791,587033,423853,282540,188895,128204,116979,1727504,373845,724963,1098808,610959,466795,338597,237026,158801,157570,1969748,3697252,5923852,5923852
El Salvador,2000,SV,SLV,AMR,385937,737407,1123344,582573,426148,288192,193570,131675,124302,1746460,366465,723936,1090401,609467,471741,345147,242411,163413,166098,1998277,3744737,5958482,5958482
El Salvador,2001,SV,SLV,AMR,378719,740265,1118984,576887,427689,293065,198085,135245,131831,1762802,358593,723132,1081725,606320,476646,351376,247555,167928,174755,2024580,3787382,5988095,5988095
El Salvador,2002,SV,SLV,AMR,369841,743147,1112988,571211,428485,296924,202482,138912,139463,1777477,349437,721900,1071337,602547,481522,357115,252549,172312,183429,2049474,3826951,6011275,6011275
El Salvador,2003,SV,SLV,AMR,358709,745649,1104358,566276,428229,299879,206454,142712,147164,1790714,338441,720200,1058641,598645,486061,362424,257235,176614,192148,2073127,3863841,6026849,6026849
El Salvador,2004,SV,SLV,AMR,345924,747623,1093547,562592,426572,302182,209650,146532,154930,1802458,326075,718299,1044374,594829,489846,367438,261422,180830,200902,2095267,3897725,6035655,6035655
El Salvador,2005,SV,SLV,AMR,332538,748191,1080729,560787,423229,303571,212019,150191,162815,1812612,313267,715573,1028840,591562,492408,371942,265123,184848,209753,2115636,3928248,6037817,6037817
El Salvador,2006,SV,SLV,AMR,319819,746307,1066126,561644,417810,303976,213661,153627,170873,1821591,301151,711101,1012252,589481,493123,375940,268553,188604,218772,2134473,3956064,6034436,6034436
El Salvador,2007,SV,SLV,AMR,310569,741314,1051883,570115,413940,306011,215631,156450,176105,1838252,292142,704454,996596,591922,492689,381047,273367,192821,225553,2157399,3995651,6044131,6044131
El Salvador,2008,SV,SLV,AMR,305172,732079,1037251,585898,412634,309806,218474,158803,178379,1863994,286583,694391,980974,599441,491598,387186,279838,197728,230090,2185881,4049875,6068099,6068099
El Salvador,2009,SV,SLV,AMR,301843,718558,1020401,603701,411381,313084,221677,161183,180566,1891592,282888,680464,963352,609242,489563,392822,286681,202786,234744,2215838,4107430,6091188,6091188
El Salvador,2010,SV,SLV,AMR,300280,702123,1002403,622260,410446,316033,225187,163547,182796,1920269,280864,663861,944725,620268,486856,398173,293826,207978,239534,2246635,4166904,6114034,6114034
El Salvador,2011,SV,SLV,AMR,299923,684155,984078,640384,410321,318735,229142,165889,185008,1949479,280216,645849,926065,631405,483943,403419,301291,213327,244340,2277725,4227204,6137349,6137349
El Salvador,2012,SV,SLV,AMR,299035,666572,965607,657120,411872,321334,233499,168268,187005,1979098,279404,628291,907695,641794,481628,408713,308934,218836,248980,2308885,4287983,6161289,6161289
El Salvador,2013,SV,SLV,AMR,297537,649396,946933,671748,415675,323954,238131,170658,188846,2009012,278280,611288,889568,650978,480422,414111,316567,224405,253646,2340129,4349141,6185642,6185642
El Salvador,2014,SV,SLV,AMR,296245,632487,928732,683194,421991,326212,242947,172930,190748,2038022,277620,594561,872181,658157,480604,419115,324120,229871,258720,2370587,4408609,6209526,6209526
El Salvador,2015,SV,SLV,AMR,294447,617125,911572,690112,430839,327651,247686,175065,193150,2064503,276679,579329,856008,662058,482364,423091,331464,235235,264769,2398981,4463484,6231066,6231066
El Salvador,2016,SV,SLV,AMR,290864,604328,895192,692036,442535,328295,252195,177149,196493,2088703,274164,566709,840873,662126,486253,425839,338575,240702,272247,2425742,4514445,6250510,6250510
El Salvador,2017,SV,SLV,AMR,285294,594669,879963,688415,456995,328195,256261,179298,200567,2109731,269839,557235,827074,657534,492571,427097,345361,246442,280879,2449884,4559615,6266654,6266654
El Salvador,2018,SV,SLV,AMR,278520,587921,866441,679034,473494,327540,259618,181631,204524,2125841,264291,550666,814957,647526,500980,426768,351623,252525,289685,2469107,4594948,6276342,6276342
El Salvador,2019,SV,SLV,AMR,271251,583393,854644,665737,491527,327095,262351,184246,206940,2137896,258098,546362,804460,633328,511179,425421,357361,258920,297006,2483215,4621111,6280217,6280217
El Salvador,2020,SV,SLV,AMR,264651,580523,845174,652040,512392,328208,265083,187081,207452,2152256,252367,543854,796221,618761,524727,424410,363136,265547,302496,2499077,4651333,6292731,6292731
El Salvador,2021,SV,SLV,AMR,259770,577352,837122,638512,534676,331078,267825,190198,207284,2169573,248071,541435,789506,604696,540423,424059,369051,272380,307356,2517965,4687538,6314167,6314167
El Salvador,2022,SV,SLV,AMR,256598,571628,828226,624914,555497,335542,270570,193775,208011,2188309,245194,537000,782194,590742,555343,424205,375009,279449,312918,2537666,4725975,6336392,6336392
El Salvador,2023,SV,SLV,AMR,254512,564228,818740,611290,574404,342259,273779,198043,211327,2211102,243208,531160,774368,577118,569212,425426,381180,286887,320909,2560732,4771834,6364943,6364943
El Salvador,2024,SV,SLV,AMR,252785,556698,809483,597290,590347,351459,277082,202816,216251,2235245,241486,525296,766782,563258,581156,428088,387109,294552,330620,2584783,4820028,6396289,6396289
El Salvador,2025,SV,SLV,AMR,250933,549098,800031,584396,602379,363387,280000,207655,221092,2258909,239652,519387,759039,550460,590164,432690,392233,302121,340582,2608250,4867159,6426229,6426229
El Salvador,2026,SV,SLV,AMR,249050,541124,790174,573614,609725,378055,282435,212433,226062,2282324,237797,513029,750826,539823,595301,439501,396260,309540,350986,2631411,4913735,6454735,6454735
El Salvador,2027,SV,SLV,AMR,247195,532896,780091,565569,611739,395435,284404,217001,231199,2305347,235992,506304,742296,531932,595760,448902,398970,316737,361891,2654192,4959539,6481920,6481920
El Salvador,2028,SV,SLV,AMR,245232,524651,769883,560177,608358,415337,286205,221200,236475,2327752,234130,499361,733491,526701,591283,461161,400485,323601,373177,2676408,5004160,6507533,6507533
El Salvador,2029,SV,SLV,AMR,243054,516430,759484,556795,600695,436990,288278,224982,241884,2349624,232101,492218,724319,523530,582738,475808,401243,330075,384762,2698156,5047780,6531581,6531581
El Salvador,2030,SV,SLV,AMR,240877,508448,749325,554530,589929,459232,290809,228528,247589,2370617,230064,485126,715190,521586,571193,491738,401449,336335,396791,2719092,5089709,6554224,6554224
El Salvador,1950,SV,SLV,AMR,187866,286464,474330,200225,140338,99781,72881,49981,40194,603400,185369,282213,467582,209665,152879,105160,73118,50710,45558,637090,1240490,2182409,2182409
El Salvador,1951,SV,SLV,AMR,195459,292788,488247,206120,142502,100971,73687,50282,40297,613859,193563,288153,481716,214062,155347,107361,74530,51203,45829,648332,1262191,2232150,2232150
El Salvador,1952,SV,SLV,AMR,203295,298843,502138,212829,144457,102198,74500,50606,40375,624965,201784,294211,495995,219044,157520,109588,75992,51763,46094,660001,1284966,2283105,2283105
El Salvador,1953,SV,SLV,AMR,211676,304764,516440,220090,146344,103532,75338,50981,40478,636763,209994,300715,510709,224409,159470,111863,77513,52404,46371,672030,1308793,2335943,2335943
El Salvador,1954,SV,SLV,AMR,219550,311845,531395,227401,148494,105060,76182,51402,40579,649118,217246,308649,525895,229847,161510,114265,79087,53114,46622,684445,1333563,2390852,2390852
El Salvador,1955,SV,SLV,AMR,226213,320999,547212,234563,151157,106825,77053,51881,40689,662168,223224,318516,541740,235292,163881,116831,80741,53905,46860,697510,1359678,2448633,2448633
El Salvador,1956,SV,SLV,AMR,232585,331265,563850,241562,154258,108826,77948,52409,40809,675812,228915,329361,558276,240734,166554,119569,82474,54785,47126,711242,1387054,2509186,2509186
El Salvador,1957,SV,SLV,AMR,239214,342103,581317,248363,157746,111076,78854,53002,40959,690000,234926,340630,575556,246138,169513,122502,84278,55772,47428,725631,1415631,2572504,2572504
El Salvador,1958,SV,SLV,AMR,245967,353545,599512,254809,161547,113383,79765,53638,41139,704281,241143,352360,593503,251406,172667,125433,86124,56854,47810,740294,1444575,2637600,2637600
El Salvador,1959,SV,SLV,AMR,252694,365595,618289,261175,166023,115679,80771,54331,41384,719363,247433,364568,612001,256914,176299,128274,88085,58039,48301,755912,1475275,2705557,2705557
El Salvador,1960,SV,SLV,AMR,259599,378350,637949,267898,171579,118109,81997,55109,41727,736419,254007,377380,631387,263112,180786,131158,90249,59343,48932,773580,1509999,2779327,2779327
El Salvador,1961,SV,SLV,AMR,267004,391804,658808,274761,178192,120651,83419,55989,42178,755190,261154,390792,651946,269763,186088,134047,92585,60768,49690,792941,1548131,2858896,2858896
El Salvador,1962,SV,SLV,AMR,275409,404038,679447,280092,186001,123441,85081,57156,43126,774897,268587,402991,671578,275579,191982,136509,94676,62256,50899,811901,1586798,2937821,2937821
El Salvador,1963,SV,SLV,AMR,284748,415220,699968,283929,194169,126707,86947,58569,44578,794899,276239,413583,689822,280804,197935,138761,96452,63736,52504,830192,1625091,3014885,3014885
El Salvador,1964,SV,SLV,AMR,294753,426603,721356,288786,201464,130562,88924,59995,46134,815865,284679,423472,708151,287347,203393,141448,98253,65196,54157,849794,1665659,3095170,3095170
El Salvador,1965,SV,SLV,AMR,305398,438010,743408,295353,207660,135056,91015,61414,47778,838276,294030,432775,726805,295498,208254,144687,100116,66617,55839,871011,1709287,3179506,3179506
El Salvador,1966,SV,SLV,AMR,316028,450638,766666,302550,212728,140057,93265,62777,49476,860853,303614,442689,746303,304255,212513,148338,102047,67902,57558,892613,1753466,3266436,3266436
El Salvador,1967,SV,SLV,AMR,324983,465877,790860,309897,216812,145398,95699,64031,51207,883044,311994,454580,766574,313096,216387,152296,104062,69004,59281,914126,1797170,3354611,3354611
El Salvador,1968,SV,SLV,AMR,331479,483867,815346,317407,220213,151006,98235,65208,52892,904961,318619,468552,787171,322002,220251,156529,106096,69946,60947,935771,1840732,3443251,3443251
El Salvador,1969,SV,SLV,AMR,335547,503935,839482,324928,223153,156804,100829,66370,54487,926571,323487,484034,807521,330818,224291,160954,108067,70785,62464,957379,1883950,3530958,3530958
El Salvador,2031,SV,SLV,AMR,238618,501813,740431,551551,577259,480953,294152,231935,253765,2389615,227941,479104,707045,519301,557791,507754,401464,342523,409362,2738195,5127810,6575289,6575289
El Salvador,2032,SV,SLV,AMR,236185,496890,733075,546038,564476,501271,298937,235308,260308,2406338,225650,474516,700166,514972,544330,522891,401940,348724,422298,2755155,5161493,6594732,6594732
El Salvador,2033,SV,SLV,AMR,233731,492883,726614,538833,551566,519580,305640,238764,267074,2421457,223333,470702,694035,509198,530878,536690,403347,354965,435411,2770489,5191946,6612593,6612593
El Salvador,2034,SV,SLV,AMR,231194,489012,720206,531510,538412,535153,314638,242120,273920,2435753,220931,466987,687918,503406,517202,548587,406170,360894,448623,2784882,5220635,6628758,6628758
El Salvador,2035,SV,SLV,AMR,228374,485018,713392,524128,526305,547011,326194,245131,280796,2449565,218254,463151,681405,497567,504571,557572,410886,366063,461960,2798619,5248184,6642981,6642981
El Salvador,2036,SV,SLV,AMR,225342,480905,706247,516378,516218,554407,340313,247717,287772,2462805,215363,459205,674568,491278,494080,562728,417756,370184,475565,2811591,5274396,6655215,6655215
El Salvador,2037,SV,SLV,AMR,222099,476651,698750,508386,508760,556715,356982,249888,294752,2475483,212276,455136,667412,484625,486310,563248,427146,373055,489383,2823767,5299250,6665414,6665414
El Salvador,2038,SV,SLV,AMR,218619,472268,690887,500382,503849,553872,376010,251905,301573,2487591,208955,450991,659946,477748,481176,558888,439317,374780,503223,2835132,5322723,6673556,6673556
El Salvador,2039,SV,SLV,AMR,215049,467584,682633,492410,500866,546949,396697,254160,308164,2499246,205541,446583,652124,470676,478081,550509,453810,375781,516964,2845821,5345067,6679834,6679834
El Salvador,2040,SV,SLV,AMR,211490,462618,674108,484678,498951,537066,417959,256845,314830,2510329,202130,441898,644028,463652,476207,539162,469547,376264,530878,2855710,5366039,6684174,6684174
El Salvador,2041,SV,SLV,AMR,208031,457355,665386,478264,496331,525376,438751,260299,321778,2520799,198815,436908,635723,457692,473982,525982,485361,376584,545165,2864766,5385565,6686672,6686672
El Salvador,2042,SV,SLV,AMR,204741,451714,656455,473525,491229,513594,458252,265106,329015,2530721,195660,431557,627217,453156,469730,512750,500309,377374,559734,2873053,5403774,6687447,6687447
El Salvador,2043,SV,SLV,AMR,201686,445816,647502,469674,484484,501700,475902,271698,336508,2539966,192732,425944,618676,449389,464039,499534,513947,379081,574465,2880455,5420421,6686596,6686596
El Salvador,2044,SV,SLV,AMR,198791,439740,638531,465953,477615,489567,491011,280413,343969,2548528,189958,420151,610109,445721,458331,486099,525722,382156,588925,2886954,5435482,6684118,6684118
El Salvador,2045,SV,SLV,AMR,196046,433387,629433,462104,470680,478435,502641,291481,351158,2556499,187328,414084,601412,441929,452571,473701,534641,387044,602737,2892623,5449122,6679967,6679967
El Salvador,2046,SV,SLV,AMR,193435,426929,620364,458140,463392,469213,510084,304905,358059,2563793,184834,407902,592736,438026,446365,463415,539808,393993,615766,2897373,5461166,6674258,6674258
El Salvador,2047,SV,SLV,AMR,190982,420428,611410,454029,455853,462482,512735,320661,364594,2570354,182485,401683,584168,434000,439796,455816,540433,403338,627784,2901167,5471521,6667096,6667096
El Salvador,2048,SV,SLV,AMR,188646,413924,602570,449786,448299,458161,510529,338578,370831,2576184,180248,395454,575702,429893,433003,450817,536272,415331,638708,2904024,5480208,6658486,6658486
El Salvador,2049,SV,SLV,AMR,186408,407488,593896,445246,440771,455669,504471,358016,377091,2581264,178106,389287,567393,425529,426015,447831,528180,429529,648799,2905883,5487147,6648422,6648422
El Salvador,2050,SV,SLV,AMR,184278,401207,585485,440421,433471,454175,495613,377979,383774,2585433,176058,383267,559325,420880,419077,446042,517190,444900,658521,2906610,5492043,6636854,6636854
San Marino,1970,SM,SMR,EUR,803,1657,2460,1482,1343,1269,1109,856,758,6817,727,1440,2167,1369,1256,1191,1074,880,957,6727,13544,18169,18169
San Marino,1971,SM,SMR,EUR,777,1727,2504,1471,1332,1257,1138,844,743,6785,708,1494,2202,1338,1260,1189,1091,874,957,6709,13494,18212,18212
San Marino,1972,SM,SMR,EUR,763,1764,2527,1490,1354,1268,1185,855,765,6917,704,1550,2254,1350,1290,1225,1134,885,991,6875,13792,18575,18575
San Marino,1973,SM,SMR,EUR,748,1789,2537,1523,1381,1309,1214,884,785,7096,702,1596,2298,1384,1325,1272,1168,904,1025,7078,14174,19010,19010
San Marino,1974,SM,SMR,EUR,728,1816,2544,1563,1417,1337,1234,929,808,7288,697,1615,2312,1427,1376,1302,1186,937,1060,7288,14576,19439,19439
San Marino,1975,SM,SMR,EUR,711,1823,2534,1619,1441,1354,1231,986,835,7466,692,1626,2318,1474,1412,1315,1192,986,1108,7487,14953,19803,19803
San Marino,1976,SM,SMR,EUR,705,1815,2520,1680,1469,1364,1232,1024,878,7647,682,1636,2318,1525,1447,1323,1206,1015,1172,7688,15335,20160,20160
San Marino,1977,SM,SMR,EUR,703,1792,2495,1726,1496,1377,1251,1019,943,7812,672,1631,2303,1583,1485,1331,1210,1053,1216,7878,15690,20482,20482
San Marino,1978,SM,SMR,EUR,698,1759,2457,1777,1515,1390,1281,1010,995,7968,662,1621,2283,1637,1530,1351,1227,1073,1266,8084,16052,20795,20795
San Marino,1979,SM,SMR,EUR,690,1733,2423,1817,1540,1404,1306,1033,1031,8131,653,1606,2259,1688,1582,1366,1260,1068,1310,8274,16405,21087,21087
San Marino,1980,SM,SMR,EUR,675,1704,2379,1854,1568,1419,1319,1075,1046,8281,634,1588,2222,1737,1623,1391,1287,1084,1340,8462,16743,21346,21346
San Marino,1981,SM,SMR,EUR,656,1676,2332,1909,1584,1453,1324,1119,1051,8440,610,1566,2176,1781,1641,1431,1303,1130,1360,8646,17086,21596,21596
San Marino,1982,SM,SMR,EUR,640,1652,2292,1948,1598,1475,1338,1151,1067,8577,586,1541,2127,1826,1660,1455,1322,1166,1381,8810,17387,21804,21804
San Marino,1983,SM,SMR,EUR,633,1602,2235,1969,1618,1491,1361,1170,1093,8702,563,1512,2075,1857,1690,1466,1347,1183,1420,8963,17665,21973,21973
San Marino,1984,SM,SMR,EUR,619,1551,2170,1979,1641,1515,1373,1169,1131,8808,549,1485,2034,1849,1747,1487,1364,1174,1461,9082,17890,22096,22096
San Marino,1985,SM,SMR,EUR,608,1510,2118,1962,1695,1534,1380,1161,1186,8918,556,1451,2007,1840,1788,1521,1364,1174,1520,9207,18125,22241,22241
San Marino,1986,SM,SMR,EUR,600,1467,2067,1923,1744,1557,1386,1162,1227,8999,562,1403,1965,1841,1837,1552,1349,1193,1587,9359,18358,22390,22390
San Marino,1987,SM,SMR,EUR,592,1440,2032,1869,1767,1564,1386,1173,1253,9012,551,1346,1897,1821,1912,1579,1354,1187,1651,9504,18516,22437,22437
San Marino,1988,SM,SMR,EUR,592,1413,2005,1821,1806,1572,1390,1196,1266,9051,542,1305,1847,1792,1971,1609,1370,1196,1701,9639,18690,22542,22542
San Marino,1989,SM,SMR,EUR,594,1386,1980,1782,1876,1611,1398,1223,1299,9189,542,1274,1816,1774,2033,1649,1383,1224,1747,9810,18999,22803,22803
San Marino,1990,SM,SMR,EUR,603,1354,1957,1747,1951,1653,1420,1245,1352,9368,553,1253,1806,1747,2112,1685,1410,1251,1801,10006,19374,23132,23132
San Marino,1991,SM,SMR,EUR,623,1314,1937,1715,2020,1700,1452,1255,1399,9541,566,1231,1797,1704,2185,1721,1446,1275,1859,10190,19731,23459,23459
San Marino,1992,SM,SMR,EUR,626,1287,1913,1696,2069,1749,1479,1280,1457,9730,582,1199,1781,1658,2264,1749,1485,1307,1913,10376,20106,23808,23808
San Marino,1993,SM,SMR,EUR,631,1276,1907,1660,2119,1791,1505,1324,1513,9912,606,1160,1766,1626,2331,1785,1528,1353,1969,10592,20504,24181,24181
San Marino,1994,SM,SMR,EUR,640,1273,1913,1620,2144,1835,1541,1349,1548,10037,612,1151,1763,1609,2361,1859,1566,1385,2033,10813,20850,24535,24535
San Marino,1995,SM,SMR,EUR,653,1276,1929,1592,2158,1899,1572,1361,1596,10178,610,1168,1778,1595,2378,1924,1607,1388,2106,10998,21176,24886,24886
San Marino,1996,SM,SMR,EUR,682,1282,1964,1560,2162,1970,1610,1370,1639,10311,621,1182,1803,1577,2401,1983,1649,1376,2171,11157,21468,25235,25235
San Marino,1997,SM,SMR,EUR,710,1283,1993,1544,2149,2043,1651,1387,1682,10456,639,1185,1824,1541,2393,2068,1692,1392,2235,11321,21777,25596,25596
San Marino,1998,SM,SMR,EUR,739,1291,2030,1530,2124,2134,1699,1409,1742,10638,661,1196,1857,1491,2343,2171,1732,1428,2306,11471,22109,25997,25997
San Marino,1999,SM,SMR,EUR,759,1302,2061,1508,2092,2236,1754,1426,1816,10832,680,1207,1887,1444,2258,2281,1791,1466,2378,11618,22450,26404,26404
San Marino,2000,SM,SMR,EUR,771,1331,2102,1491,2112,2309,1800,1435,1871,11018,687,1227,1914,1427,2249,2357,1825,1492,2436,11786,22804,26823,26823
San Marino,2001,SM,SMR,EUR,792,1363,2155,1485,2167,2381,1836,1446,1907,11222,694,1260,1954,1421,2320,2432,1837,1517,2476,12003,23225,27335,27335
San Marino,2002,SM,SMR,EUR,812,1406,2218,1474,2199,2483,1881,1483,1949,11469,711,1290,2001,1410,2360,2541,1884,1558,2527,12280,23749,27969,27969
San Marino,2003,SM,SMR,EUR,827,1450,2277,1454,2214,2576,1933,1530,2009,11716,731,1326,2057,1387,2360,2666,1928,1607,2605,12553,24269,28601,28601
San Marino,2004,SM,SMR,EUR,835,1485,2320,1444,2197,2652,1986,1576,2071,11926,739,1363,2102,1351,2345,2762,1973,1643,2673,12747,24673,29093,29093
San Marino,2005,SM,SMR,EUR,871,1510,2381,1438,2174,2717,2045,1609,2098,12081,764,1383,2147,1330,2347,2823,2039,1674,2691,12904,24985,29508,29508
San Marino,2006,SM,SMR,EUR,959,1532,2491,1439,2180,2783,2115,1621,2070,12208,817,1394,2211,1331,2372,2879,2130,1698,2641,13051,25259,29959,29959
San Marino,2007,SM,SMR,EUR,961,1582,2543,1434,2133,2810,2212,1666,2106,12361,826,1424,2250,1338,2326,2915,2210,1749,2687,13225,25586,30372,30372
San Marino,2008,SM,SMR,EUR,871,1644,2515,1421,2029,2785,2323,1733,2249,12540,785,1474,2259,1344,2183,2921,2284,1810,2849,13391,25931,30700,30700
San Marino,2009,SM,SMR,EUR,831,1688,2519,1411,1964,2761,2423,1787,2356,12702,771,1507,2278,1356,2077,2913,2379,1858,2975,13558,26260,31059,31059
San Marino,2010,SM,SMR,EUR,850,1721,2571,1418,1937,2767,2526,1838,2409,12895,780,1529,2309,1378,2037,2929,2520,1926,3045,13835,26730,31608,31608
San Marino,2011,SM,SMR,EUR,859,1757,2616,1479,1904,2790,2662,1888,2492,13215,818,1539,2357,1401,2012,3014,2735,2026,3119,14307,27522,32495,32495
San Marino,2012,SM,SMR,EUR,857,1771,2628,1530,1856,2782,2788,1934,2572,13462,844,1553,2397,1414,1973,3041,2894,2107,3206,14635,28097,33132,33132
San Marino,2013,SM,SMR,EUR,860,1770,2630,1550,1798,2748,2846,1980,2631,13553,821,1583,2404,1437,1907,2969,2981,2136,3265,14695,28248,33285,33285
San Marino,2014,SM,SMR,EUR,857,1774,2631,1587,1755,2694,2879,2017,2675,13607,799,1599,2398,1480,1826,2904,3053,2164,3324,14751,28358,33389,33389
San Marino,2015,SM,SMR,EUR,828,1793,2621,1621,1736,2613,2923,2070,2746,13709,777,1608,2385,1505,1771,2856,3095,2229,3396,14852,28561,33570,33570
San Marino,2016,SM,SMR,EUR,792,1802,2594,1662,1718,2537,2967,2155,2820,13859,748,1623,2371,1536,1757,2806,3142,2309,3457,15007,28866,33834,33834
San Marino,2017,SM,SMR,EUR,761,1784,2545,1710,1705,2470,2992,2254,2894,14025,706,1635,2341,1569,1758,2735,3194,2380,3515,15151,29176,34056,34056
San Marino,2018,SM,SMR,EUR,712,1779,2491,1751,1687,2404,2998,2339,2955,14134,667,1633,2300,1595,1740,2643,3207,2479,3566,15230,29364,34156,34156
San Marino,2019,SM,SMR,EUR,652,1777,2429,1788,1674,2327,2985,2432,3009,14215,623,1623,2246,1630,1707,2544,3202,2584,3611,15278,29493,34178,34178
San Marino,2020,SM,SMR,EUR,606,1745,2351,1810,1649,2237,2952,2525,3040,14213,572,1627,2199,1624,1667,2433,3185,2671,3660,15240,29453,34007,34007
San Marino,2021,SM,SMR,EUR,565,1700,2265,1821,1645,2119,2913,2605,3055,14158,527,1628,2155,1604,1633,2306,3157,2758,3716,15174,29332,33745,33745
San Marino,2022,SM,SMR,EUR,541,1660,2201,1824,1675,2016,2864,2691,3107,14177,504,1585,2089,1624,1623,2200,3110,2852,3776,15185,29362,33660,33660
San Marino,2023,SM,SMR,EUR,530,1604,2134,1831,1702,1955,2815,2759,3188,14250,498,1504,2002,1663,1631,2109,3043,2958,3852,15256,29506,33642,33642
San Marino,2024,SM,SMR,EUR,526,1532,2058,1844,1729,1912,2749,2806,3279,14319,495,1433,1928,1683,1654,2016,2983,3048,3929,15313,29632,33614,33614
San Marino,2025,SM,SMR,EUR,524,1453,1977,1865,1761,1866,2668,2853,3382,14395,492,1369,1861,1694,1668,1945,2926,3083,4041,15357,29752,33583,33583
San Marino,2026,SM,SMR,EUR,523,1381,1904,1872,1798,1829,2578,2893,3495,14465,493,1297,1790,1704,1684,1906,2856,3110,4142,15402,29867,33559,33559
San Marino,2027,SM,SMR,EUR,523,1329,1852,1847,1840,1801,2489,2913,3622,14512,491,1234,1725,1710,1711,1865,2758,3140,4257,15441,29953,33534,33534
San Marino,2028,SM,SMR,EUR,528,1262,1790,1844,1879,1770,2413,2917,3752,14575,494,1186,1680,1705,1732,1818,2653,3151,4405,15464,30039,33506,33506
San Marino,2029,SM,SMR,EUR,532,1196,1728,1840,1914,1745,2335,2907,3888,14629,500,1132,1632,1697,1761,1779,2553,3145,4558,15493,30122,33480,33480
San Marino,2030,SM,SMR,EUR,536,1148,1684,1812,1954,1732,2253,2882,4032,14665,505,1082,1587,1705,1774,1749,2448,3134,4706,15516,30181,33458,33458
San Marino,1950,SM,SMR,EUR,568,1172,1740,1032,964,848,780,651,578,4853,526,1023,1549,931,916,816,777,648,733,4821,9674,12963,12963
San Marino,1951,SM,SMR,EUR,612,1160,1772,1057,984,856,785,654,584,4920,572,1014,1586,947,934,823,779,650,745,4878,9798,13164,13164
San Marino,1952,SM,SMR,EUR,657,1139,1796,1085,996,861,789,652,595,4978,619,999,1618,968,954,831,780,655,764,4952,9930,13345,13345
San Marino,1953,SM,SMR,EUR,706,1111,1817,1115,1013,875,790,652,608,5053,665,980,1645,993,971,841,779,660,779,5023,10076,13537,13537
San Marino,1954,SM,SMR,EUR,731,1108,1839,1145,1035,891,793,655,619,5138,690,986,1676,1020,981,856,777,668,795,5097,10235,13754,13754
San Marino,1955,SM,SMR,EUR,734,1134,1868,1173,1054,909,792,656,625,5209,690,1017,1707,1041,995,881,780,674,810,5181,10390,13967,13967
San Marino,1956,SM,SMR,EUR,731,1176,1907,1195,1075,938,800,656,634,5298,687,1071,1758,1063,1014,905,782,684,818,5266,10564,14236,14236
San Marino,1957,SM,SMR,EUR,728,1238,1966,1217,1099,970,815,661,642,5404,676,1144,1820,1088,1033,940,799,695,819,5374,10778,14568,14568
San Marino,1958,SM,SMR,EUR,721,1292,2013,1242,1125,1001,842,667,648,5525,667,1211,1878,1112,1052,974,825,701,823,5487,11012,14898,14898
San Marino,1959,SM,SMR,EUR,717,1340,2057,1262,1152,1033,871,670,654,5642,655,1265,1920,1137,1072,1008,852,706,829,5604,11246,15226,15226
San Marino,1960,SM,SMR,EUR,723,1379,2102,1285,1179,1071,898,672,664,5769,648,1306,1954,1163,1100,1047,876,702,843,5731,11500,15556,15556
San Marino,1961,SM,SMR,EUR,741,1405,2146,1313,1203,1112,926,674,678,5906,650,1326,1976,1197,1130,1085,901,704,849,5866,11772,15895,15895
San Marino,1962,SM,SMR,EUR,762,1419,2181,1342,1232,1157,952,679,687,6049,657,1328,1985,1240,1168,1126,923,706,861,6024,12073,16242,16242
San Marino,1963,SM,SMR,EUR,779,1422,2201,1383,1261,1201,974,684,697,6200,667,1314,1981,1293,1207,1161,942,712,878,6193,12393,16583,16583
San Marino,1964,SM,SMR,EUR,788,1421,2209,1427,1293,1233,1005,701,719,6378,685,1296,1981,1346,1237,1182,967,735,886,6353,12731,16926,16926
San Marino,1965,SM,SMR,EUR,788,1425,2213,1466,1338,1241,1055,727,737,6564,709,1279,1988,1382,1256,1193,996,784,900,6511,13075,17273,17273
San Marino,1966,SM,SMR,EUR,788,1451,2239,1489,1363,1239,1099,764,753,6707,725,1287,2012,1399,1262,1198,1019,826,920,6624,13331,17588,17588
San Marino,1967,SM,SMR,EUR,789,1488,2277,1514,1376,1246,1109,818,778,6841,734,1308,2042,1416,1273,1199,1055,863,945,6751,13592,17907,17907
San Marino,1968,SM,SMR,EUR,796,1528,2324,1530,1405,1274,1116,869,800,6994,736,1338,2074,1430,1296,1211,1099,892,969,6897,13891,18291,18291
San Marino,1969,SM,SMR,EUR,806,1585,2391,1513,1393,1289,1115,881,794,6985,739,1380,2119,1422,1288,1208,1103,896,978,6895,13880,18403,18403
San Marino,2031,SM,SMR,EUR,543,1109,1652,1774,1985,1749,2150,2858,4179,14695,510,1041,1551,1710,1778,1736,2333,3109,4865,15531,30226,33433,33433
San Marino,2032,SM,SMR,EUR,551,1086,1637,1733,1993,1783,2050,2817,4325,14701,518,1018,1536,1672,1803,1732,2234,3070,5020,15531,30232,33407,33407
San Marino,2033,SM,SMR,EUR,561,1080,1641,1679,2001,1810,1991,2770,4449,14700,527,1014,1541,1588,1844,1739,2145,3003,5182,15501,30201,33380,33380
San Marino,2034,SM,SMR,EUR,568,1081,1649,1606,2015,1835,1947,2702,4570,14675,536,1016,1552,1516,1861,1758,2051,2945,5336,15467,30142,33352,33352
San Marino,2035,SM,SMR,EUR,578,1086,1664,1527,2035,1871,1902,2626,4695,14656,542,1020,1562,1451,1869,1774,1979,2887,5475,15435,30091,33319,33319
San Marino,2036,SM,SMR,EUR,587,1091,1678,1457,2039,1905,1867,2540,4823,14631,550,1025,1575,1381,1885,1792,1939,2821,5587,15405,30036,33287,33287
San Marino,2037,SM,SMR,EUR,594,1098,1692,1404,2015,1948,1838,2454,4937,14596,558,1034,1592,1315,1892,1820,1903,2727,5707,15364,29960,33248,33248
San Marino,2038,SM,SMR,EUR,602,1111,1713,1338,2011,1987,1808,2378,5039,14561,565,1046,1611,1268,1886,1841,1857,2625,5840,15317,29878,33203,33203
San Marino,2039,SM,SMR,EUR,607,1123,1730,1271,2010,2021,1784,2303,5143,14532,571,1058,1629,1216,1878,1872,1813,2526,5963,15268,29800,33161,33161
San Marino,2040,SM,SMR,EUR,614,1138,1752,1223,1983,2063,1772,2224,5226,14491,577,1071,1648,1164,1886,1882,1786,2424,6072,15214,29705,33112,33112
San Marino,2041,SM,SMR,EUR,617,1155,1772,1188,1945,2092,1791,2125,5312,14453,580,1085,1665,1124,1889,1886,1774,2311,6181,15165,29618,33047,33047
San Marino,2042,SM,SMR,EUR,618,1169,1787,1164,1903,2102,1826,2027,5380,14402,581,1099,1680,1105,1848,1910,1768,2215,6258,15104,29506,32974,32974
San Marino,2043,SM,SMR,EUR,620,1184,1804,1157,1845,2111,1848,1972,5421,14354,582,1115,1697,1099,1769,1949,1776,2128,6321,15042,29396,32900,32900
San Marino,2044,SM,SMR,EUR,616,1199,1815,1156,1778,2123,1876,1930,5446,14309,577,1130,1707,1102,1697,1971,1797,2034,6383,14984,29293,32813,32813
San Marino,2045,SM,SMR,EUR,610,1215,1825,1160,1699,2139,1908,1886,5457,14249,576,1143,1719,1103,1635,1978,1810,1966,6424,14916,29165,32709,32709
San Marino,2046,SM,SMR,EUR,607,1228,1835,1165,1629,2146,1944,1851,5462,14197,569,1153,1722,1110,1560,1991,1829,1928,6429,14847,29044,32600,32600
San Marino,2047,SM,SMR,EUR,599,1236,1835,1176,1575,2125,1988,1823,5457,14144,562,1162,1724,1118,1497,1998,1857,1893,6417,14780,28924,32486,32486
San Marino,2048,SM,SMR,EUR,589,1244,1833,1187,1509,2123,2026,1796,5445,14086,554,1169,1723,1129,1451,1994,1879,1847,6412,14712,28798,32347,32347
San Marino,2049,SM,SMR,EUR,579,1246,1825,1202,1440,2120,2058,1774,5429,14023,545,1173,1718,1140,1397,1984,1908,1808,6392,14629,28652,32196,32196
San Marino,2050,SM,SMR,EUR,568,1248,1816,1214,1396,2092,2098,1762,5402,13964,534,1174,1708,1155,1345,1996,1920,1782,6361,14559,28523,32044,32044
Somalia,1970,SO,SOM,EMR,334581,498588,833169,357042,228995,170992,126037,83605,56524,1023195,327441,490554,817995,353980,235935,169194,128735,89980,68794,1046618,2069813,3720977,3720977
Somalia,1971,SO,SOM,EMR,343253,510583,853836,370876,234237,174330,128298,85509,58234,1051484,335820,502219,838039,367306,241111,173181,130944,91824,70658,1075024,2126508,3818389,3818389
Somalia,1972,SO,SOM,EMR,352329,522933,875262,384189,240006,178046,130618,87420,59952,1080231,344586,514230,858816,380195,246403,177892,133195,93674,72549,1103908,2184139,3918220,3918220
Somalia,1973,SO,SOM,EMR,361984,535905,897889,397476,246371,182046,133021,89342,61685,1109941,353914,526836,880750,392957,252192,183100,135503,95548,74463,1133763,2243704,4022336,4022336
Somalia,1974,SO,SOM,EMR,370980,549078,920058,410119,254048,185826,135317,91142,63307,1139759,362571,539644,902215,405150,259245,188140,137680,97342,76240,1163797,2303556,4125823,4125823
Somalia,1975,SO,SOM,EMR,379452,562331,941783,420481,264680,189213,137485,92807,64811,1169477,370710,552521,923231,415279,269117,192761,139709,99047,77880,1193793,2363270,4228289,4228289
Somalia,1976,SO,SOM,EMR,388733,575907,964640,429414,277250,192487,139626,94445,66383,1199605,379663,565676,945339,423999,280949,197256,141665,100755,79571,1224195,2423800,4333779,4333779
Somalia,1977,SO,SOM,EMR,400270,590484,990754,439028,290309,196061,141923,96177,68160,1231658,390851,579774,970625,433379,293322,202015,143681,102605,81458,1256460,2488118,4449505,4449505
Somalia,1978,SO,SOM,EMR,433107,632566,1065673,469062,316918,208755,150792,102333,73177,1321037,422869,620845,1043714,462968,319502,216085,152362,109193,87175,1347285,2668322,4777703,4777703
Somalia,1979,SO,SOM,EMR,495273,714079,1209352,528416,363562,234460,169063,114800,82740,1493041,483493,700600,1184093,521472,365934,243364,170777,122486,98296,1522329,3015370,5408813,5408813
Somalia,1980,SO,SOM,EMR,545269,775847,1321116,572872,400571,253644,182480,123894,89917,1623378,532184,760965,1293149,565184,402611,263531,184601,132104,106555,1654586,3277964,5892224,5892224
Somalia,1981,SO,SOM,EMR,555363,780022,1335385,573970,407394,253886,182115,123500,90228,1631093,541869,764824,1306693,566087,408980,263604,184878,131552,106661,1661762,3292855,5934938,5934938
Somalia,1982,SO,SOM,EMR,562977,781771,1344748,572366,411401,253345,181179,122517,90037,1630845,549105,766286,1315391,564329,412611,262398,184930,130353,106199,1660820,3291665,5951805,5951805
Somalia,1983,SO,SOM,EMR,586089,807879,1393968,587470,426493,260562,185678,125092,92374,1677669,571435,791618,1363053,579054,427299,269082,190723,132919,108740,1707817,3385486,6142513,6142513
Somalia,1984,SO,SOM,EMR,612153,840137,1452290,605757,443010,270318,190923,128229,95144,1733381,596576,822951,1419527,596901,443449,278272,197348,136039,111824,1763833,3497214,6369020,6369020
Somalia,1985,SO,SOM,EMR,641611,877992,1519603,627166,459405,284258,196680,131896,98337,1797742,624975,859735,1484710,617796,459653,291562,204490,139682,115400,1828583,3626325,6630637,6630637
Somalia,1986,SO,SOM,EMR,672518,919135,1591653,649931,474839,300959,202533,135700,101674,1865636,654733,899706,1554439,639982,474918,307619,211754,143435,119152,1896860,3762496,6908579,6908579
Somalia,1987,SO,SOM,EMR,700433,957715,1658148,669725,487826,316722,207371,138765,104489,1924898,681509,937159,1618668,659206,487728,322759,217953,146327,122325,1956298,3881196,7158004,7158004
Somalia,1988,SO,SOM,EMR,704181,965792,1669973,664784,482032,320530,204550,136575,103104,1911575,684744,944759,1629503,656279,484272,327067,216638,144139,121015,1949410,3860985,7160461,7160461
Somalia,1989,SO,SOM,EMR,695541,958402,1653943,647057,466213,317396,197847,131829,99644,1859986,675924,937169,1613093,641869,472531,325351,211287,139762,117563,1908363,3768349,7035378,7035378
Somalia,1990,SO,SOM,EMR,695114,962562,1657676,638902,457085,317513,194200,129135,97782,1834617,675103,940814,1615917,635497,466671,326770,208443,137685,115818,1890884,3725501,6999096,6999096
Somalia,1991,SO,SOM,EMR,654778,939284,1594062,617125,437262,308417,185348,122291,91144,1761587,634945,917703,1552648,614987,449805,319184,199941,131705,108783,1824405,3585992,6732702,6732702
Somalia,1992,SO,SOM,EMR,597666,912164,1509830,598679,419351,298752,176624,115008,82826,1691240,578151,890734,1468885,596574,433880,310969,191336,125552,99878,1758189,3449429,6428141,6428141
Somalia,1993,SO,SOM,EMR,607708,944921,1552629,622093,431119,309623,181432,117269,83170,1744706,587427,921777,1509204,618355,446693,322857,196483,129258,100546,1814192,3558898,6620729,6620729
Somalia,1994,SO,SOM,EMR,649983,988979,1638962,655135,449519,324742,190650,122231,86954,1829231,628809,963451,1592260,649187,465409,338602,205815,135541,104820,1899374,3728605,6959828,6959828
Somalia,1995,SO,SOM,EMR,690958,1013425,1704383,680387,462344,333721,199643,125256,89528,1890879,669088,985946,1655034,672420,478045,348158,214715,139691,107602,1960631,3851510,7210930,7210930
Somalia,1996,SO,SOM,EMR,739323,1032438,1771761,707107,476151,341813,210238,128274,92145,1955728,716218,1003518,1719736,697394,491355,356824,225362,143823,110463,2025221,3980949,7472450,7472450
Somalia,1997,SO,SOM,EMR,784115,1054856,1838971,734490,490202,349859,220744,131180,94603,2021078,759301,1024879,1784180,723219,504510,365435,235999,147823,113097,2090083,4111161,7734313,7734313
Somalia,1998,SO,SOM,EMR,822955,1097578,1920533,768172,508136,360594,232794,135065,97727,2102488,796655,1065916,1862571,755426,521282,376818,248367,152818,116558,2171269,4273757,8056862,8056862
Somalia,1999,SO,SOM,EMR,856014,1147153,2003167,802960,526291,371418,244762,139013,100933,2185377,828732,1113410,1942142,788853,538022,388275,260743,157640,120260,2253793,4439170,8384479,8384479
Somalia,2000,SO,SOM,EMR,889706,1198054,2087760,838944,545372,382578,256638,143243,104259,2271034,861509,1162227,2023736,823477,555489,400061,273128,162486,124297,2338938,4609972,8721465,8721465
Somalia,2001,SO,SOM,EMR,924318,1250771,2175089,875786,566060,394229,268372,147893,107798,2360138,895379,1212863,2108242,858851,574375,412323,285455,167499,128770,2427273,4787411,9070747,9070747
Somalia,2002,SO,SOM,EMR,957319,1303229,2260548,911049,587012,405424,279213,152640,111334,2446672,927684,1263586,2191270,892505,593380,424035,296934,172331,133425,2512610,4959282,9411103,9411103
Somalia,2003,SO,SOM,EMR,990126,1358364,2348490,945244,609472,416926,289827,157684,114928,2534081,959738,1317358,2277096,924904,613897,435947,308146,177446,138277,2598617,5132698,9758281,9758281
Somalia,2004,SO,SOM,EMR,1023474,1418617,2442091,976808,633640,429087,300079,163648,118387,2621649,992365,1376387,2368752,954597,636281,448357,319068,183559,142993,2684855,5306504,10117354,10117354
Somalia,2005,SO,SOM,EMR,1055350,1484469,2539819,1000612,657710,441128,308279,171368,121435,2700532,1023510,1441024,2464534,976704,658747,460337,327969,191483,147168,2762408,5462940,10467292,10467292
Somalia,2006,SO,SOM,EMR,1083578,1552210,2635788,1014559,680265,452161,314314,179742,123924,2764965,1051000,1507301,2558301,989568,680017,470921,334596,200162,150661,2825925,5590890,10784973,10784973
Somalia,2007,SO,SOM,EMR,1112737,1618845,2731582,1033232,704322,464079,320749,188252,126464,2837098,1079337,1572073,2651410,1007636,703211,482161,341697,209116,154181,2898002,5735100,11118092,11118092
Somalia,2008,SO,SOM,EMR,1141055,1672475,2813530,1063122,728494,475802,327006,196452,128908,2919784,1106853,1624316,2731169,1036586,726843,492951,348624,217843,157534,2980381,5900165,11444870,11444870
Somalia,2009,SO,SOM,EMR,1165604,1712956,2878560,1095471,750659,485817,332071,203709,131021,2998748,1130631,1664084,2794715,1067571,748532,501713,354226,225605,160367,3058014,6056762,11730037,11730037
Somalia,2010,SO,SOM,EMR,1190474,1754853,2945327,1129229,773760,496707,337507,210727,133351,3081281,1154710,1705304,2860014,1100171,771474,511407,360285,233269,163426,3140032,6221313,12026649,12026649
Somalia,2011,SO,SOM,EMR,1204185,1781081,2985266,1153304,789682,504053,340020,215335,134676,3137070,1167976,1731414,2899390,1123457,787360,517442,363253,238412,165183,3195107,6332177,12216837,12216837
Somalia,2012,SO,SOM,EMR,1222971,1810609,3033580,1180882,806731,513398,343471,220015,136867,3201364,1186134,1760701,2946835,1150353,804133,525432,367098,243678,167856,3258550,6459914,12440326,12440326
Somalia,2013,SO,SOM,EMR,1261882,1866297,3128179,1227134,833936,531335,352221,227698,141473,3313797,1223769,1815411,3039180,1195950,830898,542294,376463,252214,173503,3371322,6685119,12852485,12852485
Somalia,2014,SO,SOM,EMR,1305617,1927894,3233511,1280493,860411,551892,362334,235625,147018,3437773,1266177,1875723,3141900,1248816,856843,561977,387100,261096,180221,3496053,6933826,13309235,13309235
Somalia,2015,SO,SOM,EMR,1349597,1988663,3338260,1339673,880286,572624,372594,242167,153807,3561151,1308725,1935237,3243962,1307674,876327,582096,397640,268560,188243,3620540,7181691,13763906,13763906
Somalia,2016,SO,SOM,EMR,1399812,2061121,3460933,1411640,898780,596851,385141,249120,162102,3703634,1356935,2006398,3363333,1379040,894878,606114,410344,276486,198091,3764953,7468587,14292847,14292847
Somalia,2017,SO,SOM,EMR,1450965,2141643,3592608,1484582,923492,623490,399131,256871,170733,3858299,1406118,2085216,3491334,1451009,920063,632902,424306,285310,208384,3921974,7780273,14864221,14864221
Somalia,2018,SO,SOM,EMR,1496760,2219847,3716607,1544713,957815,649859,412649,264333,179164,4008533,1450345,2161445,3611790,1510326,954536,659626,437477,293780,218428,4074173,8082706,15411094,15411094
Somalia,2019,SO,SOM,EMR,1543149,2302145,3845294,1601610,999398,677959,426903,272286,187918,4166074,1495061,2241555,3736616,1566478,995835,688200,451200,302736,228856,4233305,8399379,15981300,15981300
Somalia,2020,SO,SOM,EMR,1586542,2384109,3970651,1657968,1040986,705963,440871,279209,194826,4319823,1536656,2321269,3857925,1621788,1036812,716693,464642,310928,237758,4388621,8708444,16537016,16537016
Somalia,2021,SO,SOM,EMR,1625895,2464438,4090333,1712701,1082003,732774,454335,284579,198907,4465299,1574235,2399302,3973537,1675517,1077061,743968,477798,317852,244218,4536414,9001713,17065581,17065581
Somalia,2022,SO,SOM,EMR,1665505,2544920,4210425,1767505,1124546,759330,468502,289888,202245,4612016,1612022,2477327,4089349,1729402,1119075,770823,491764,324646,250016,4685726,9297742,17597511,17597511
Somalia,2023,SO,SOM,EMR,1705963,2625327,4331290,1823040,1169699,785338,484445,296135,206574,4765231,1650761,2555087,4205848,1784024,1163981,796810,507400,332133,256668,4841016,9606247,18143378,18143378
Somalia,2024,SO,SOM,EMR,1744735,2707190,4451925,1880185,1219194,809313,502416,303858,212716,4927682,1688282,2634316,4322598,1840198,1213444,820474,524975,340735,264894,5004720,9932402,18706922,18706922
Somalia,2025,SO,SOM,EMR,1780395,2789577,4569972,1938769,1275801,828395,521818,312988,220555,5098326,1723377,2713927,4437304,1897975,1270248,839147,543995,350352,274584,5176301,10274627,19281903,19281903
Somalia,2026,SO,SOM,EMR,1814143,2871085,4685228,2000187,1339057,842711,542448,323096,229262,5276761,1757018,2792292,4549310,1958882,1333608,853281,564437,360641,285041,5355890,10632651,19867185,19867185
Somalia,2027,SO,SOM,EMR,1847293,2951216,4798509,2065291,1400484,861141,564158,333725,238046,5462845,1790166,2869458,4659624,2023186,1394743,871949,586258,371260,295622,5543018,11005863,20463994,20463994
Somalia,2028,SO,SOM,EMR,1879841,3029911,4909752,2133527,1453013,890880,586958,344747,246928,5656053,1822624,2945687,4768311,2090186,1447032,901903,609457,382107,306358,5737043,11393096,21071158,21071158
Somalia,2029,SO,SOM,EMR,1913261,3106201,5019462,2204693,1501500,926912,610916,356123,255920,5856064,1855694,3019974,4875668,2159925,1495497,937985,634020,393209,317250,5937886,11793950,21689079,21689079
Somalia,2030,SO,SOM,EMR,1947477,3179559,5127036,2278749,1551322,964034,635724,368152,265024,6063005,1889339,3091757,4981096,2232428,1545351,975143,659550,404937,328314,6145723,12208728,22316857,22316857
Somalia,1950,SO,SOM,EMR,191452,263900,455352,205121,160153,120467,83724,49744,24384,643593,189457,267757,457214,198643,158644,121025,87844,57580,33167,656903,1300496,2213052,2213052
Somalia,1951,SO,SOM,EMR,203209,269815,473024,208958,162827,122954,85636,51514,25803,657692,200630,273522,474152,203161,161200,123304,89684,59147,34962,671458,1329150,2276334,2276334
Somalia,1952,SO,SOM,EMR,213832,276308,490140,213246,165566,125437,87536,53269,27236,672290,210812,279393,490205,208503,163800,125580,91528,60702,36754,686867,1359157,2339499,2339499
Somalia,1953,SO,SOM,EMR,223779,283257,507036,217696,168286,127868,89413,54993,28674,686930,220222,285598,505820,214262,166346,127817,93359,62231,38550,702565,1389495,2402348,2402348
Somalia,1954,SO,SOM,EMR,232692,291729,524421,221932,170951,130237,91320,56670,30157,701267,228681,293228,521909,219852,168779,130036,95197,63741,40342,717947,1419214,2465552,2465552
Somalia,1955,SO,SOM,EMR,238904,303745,542649,225861,173617,132575,93285,58312,31698,715348,234723,304195,538918,225105,171157,132277,97076,65247,42136,732998,1448346,2529910,2529910
Somalia,1956,SO,SOM,EMR,243424,318068,561492,229720,176286,134872,95304,59913,33282,729377,239100,317461,556561,230286,173491,134530,98986,66737,43931,747961,1477338,2595391,2595391
Somalia,1957,SO,SOM,EMR,248157,332674,580831,233722,178933,137115,97373,61472,34915,743530,243681,331072,574753,235583,175720,136798,100925,68214,45724,762964,1506494,2662084,2662084
Somalia,1958,SO,SOM,EMR,253039,347324,600363,237817,181575,139270,99455,62990,36586,757693,248405,344821,593226,240846,177965,139025,102845,69674,47526,777881,1535574,2729160,2729160
Somalia,1959,SO,SOM,EMR,258209,362064,620273,242177,184453,141494,101574,64507,38253,772458,253411,358759,612170,245994,180746,141281,104800,71152,49319,793292,1565750,2798191,2798191
Somalia,1960,SO,SOM,EMR,263811,376892,640703,247161,187684,143887,103770,66064,39910,788476,258828,372896,631724,251314,184270,143627,106843,72689,51089,809832,1598308,2870732,2870732
Somalia,1961,SO,SOM,EMR,269683,391478,661161,252781,191295,146387,106007,67639,41555,805664,264511,386894,651405,256804,188550,146035,108937,74266,52845,827437,1633101,2945662,2945662
Somalia,1962,SO,SOM,EMR,275810,405657,681467,259041,195382,148993,108278,69229,43192,824115,270451,400563,671014,262491,193673,148534,111064,75873,54595,846230,1670345,3022827,3022827
Somalia,1963,SO,SOM,EMR,282195,419730,701925,265876,199727,151664,110562,70852,44827,843508,276661,414015,690676,268633,199285,151061,113217,77517,56345,866058,1709566,3102170,3102170
Somalia,1964,SO,SOM,EMR,288815,433239,722054,274215,203921,154322,112826,72529,46465,864278,283096,426973,710069,276185,204789,153526,115386,79203,58095,887184,1751462,3183590,3183590
Somalia,1965,SO,SOM,EMR,295752,444581,740333,285907,207848,156994,115081,74265,48109,888204,289837,438010,727847,286904,209990,155953,117589,80932,59836,911204,1799408,3267593,3267593
Somalia,1966,SO,SOM,EMR,302966,454555,757521,299779,211701,159660,117299,76057,49769,914265,296837,447707,744544,299798,215117,158332,119803,82696,61595,937341,1851606,3353665,3353665
Somalia,1967,SO,SOM,EMR,310418,464908,775326,313956,215681,162302,119461,77900,51440,940740,304059,457780,761839,313060,220344,160616,122022,84484,63369,963895,1904635,3441799,3441799
Somalia,1968,SO,SOM,EMR,318164,475708,793872,328346,219845,165012,121613,79786,53125,967727,311556,468291,779847,326621,225640,162985,124263,86303,65154,990966,1958693,3532420,3532420
Somalia,1969,SO,SOM,EMR,326204,486898,813102,342755,224202,167901,123792,81692,54824,995166,319335,479181,798516,340310,230779,165803,126500,88136,66960,1018488,2013654,3625274,3625274
Somalia,2031,SO,SOM,EMR,1981600,3250955,5232555,2355459,1602577,1002456,660940,381195,274282,6276909,1922844,3161861,5084705,2307451,1596744,1013583,685493,417686,339556,6360513,12637422,22954690,22954690
Somalia,2032,SO,SOM,EMR,2015382,3322062,5337444,2433391,1654913,1042963,686360,395275,283708,6496610,1956056,3231881,5187937,2383526,1649227,1054334,711537,431520,351011,6581155,13077765,23603148,23603148
Somalia,2033,SO,SOM,EMR,2048696,3392729,5441425,2511897,1708426,1086144,711229,410615,293369,6721680,1988830,3301669,5290499,2459999,1702884,1098081,736808,446731,362691,6807194,13528874,24260802,24260802
Somalia,2034,SO,SOM,EMR,2082054,3462277,5544331,2591824,1763487,1133317,733881,427125,303347,6952981,2021621,3370609,5392230,2537920,1757956,1146041,759625,463287,374629,7039458,13992439,24929000,24929000
Somalia,2035,SO,SOM,EMR,2115082,3530743,5645825,2672611,1820207,1187288,751822,444402,313706,7190036,2054072,3438729,5492801,2616529,1814692,1201016,777593,480850,386857,7277537,14467573,25606196,25606196
Somalia,2036,SO,SOM,EMR,2146137,3598311,5744448,2752835,1879864,1247620,765314,462557,324511,7432701,2084593,3506174,5590767,2694192,1874593,1262295,791255,499587,399425,7521347,14954048,26289267,26289267
Somalia,2037,SO,SOM,EMR,2176195,3664955,5841150,2831772,1943098,1306284,782698,481665,335747,7681264,2114093,3572856,5686949,2770725,1937843,1321506,809268,519580,412312,7771234,15452498,26980593,26980593
Somalia,2038,SO,SOM,EMR,2205492,3730612,5936104,2909360,2009385,1356684,810698,501715,347309,7935151,2142873,3638502,5781375,2846390,2003757,1372362,838033,540812,425440,8026794,15961945,27679425,27679425
Somalia,2039,SO,SOM,EMR,2232409,3797201,6029610,2984664,2078525,1403354,844620,522754,359178,8193095,2169325,3704815,5874140,2920210,2072383,1419637,872653,563266,438846,8286995,16480090,28383844,28383844
Somalia,2040,SO,SOM,EMR,2258113,3864332,6122445,3057164,2150490,1451341,879592,544538,371618,8454743,2194602,3771458,5966060,2991622,2143740,1468287,908335,586604,452877,8551465,17006208,29094714,29094714
Somalia,2041,SO,SOM,EMR,2284150,3929553,6213703,3127799,2225055,1500730,915807,566690,384907,8720988,2220321,3836164,6056485,3061432,2217593,1518465,945263,610335,467893,8820981,17541969,29812160,29812160
Somalia,2042,SO,SOM,EMR,2309148,3993492,6302640,3198184,2300838,1551191,953999,589028,399098,8992338,2245061,3899604,6144665,3131189,2292524,1569743,984416,634163,483928,9095963,18088301,30535607,30535607
Somalia,2043,SO,SOM,EMR,2332843,4056312,6389155,3268170,2377243,1602832,994695,610908,414407,9268255,2268445,3961988,6230433,3200760,2367887,1622200,1026437,657320,501256,9375860,18644115,31263713,31263713
Somalia,2044,SO,SOM,EMR,2356518,4116892,6473410,3337116,2455079,1656004,1039061,630839,430792,9548891,2291777,4022150,6313927,3269538,2444713,1676076,1072426,678244,519854,9660851,19209742,31997075,31997075
Somalia,2045,SO,SOM,EMR,2379147,4176001,6555148,3405048,2533807,1710797,1089592,646551,447961,9833756,2314038,4080894,6394932,3337555,2522258,1731596,1124978,694697,539421,9950505,19784261,32734341,32734341
Somalia,2046,SO,SOM,EMR,2400536,4233647,6634183,3472148,2612069,1768447,1145877,658320,466037,10122898,2335013,4138281,6473294,3404942,2598936,1790227,1183408,707214,560131,10244858,20367756,33475243,33475243
Somalia,2047,SO,SOM,EMR,2421428,4289361,6710789,3538392,2689184,1829557,1200661,673682,485039,10416515,2355538,4193748,6549286,3471621,2674587,1852149,1239940,723844,582015,10544156,20960671,34220748,34220748
Somalia,2048,SO,SOM,EMR,2440732,4343120,6783852,3603730,2765084,1893627,1248000,698670,504853,10713964,2374627,4247249,6621876,3537342,2749462,1916701,1288735,750520,604962,10847722,21561686,34967417,34967417
Somalia,2049,SO,SOM,EMR,2457915,4394602,6852517,3670019,2838871,1960476,1292019,729014,525466,11015865,2391701,4298494,6690195,3603759,2822597,1983923,1334245,782667,628958,11156149,22172014,35714724,35714724
Somalia,2050,SO,SOM,EMR,2473769,4443919,6917688,3736859,2910033,2030071,1337281,760291,546854,11321389,2407451,4347594,6755045,3670533,2893448,2053841,1381089,815809,653989,11468709,22790098,36462830,36462830
Serbia,2005,RS,SRB,EUR,199096,417061,616157,516022,556456,526578,528560,480646,549876,3158138,186769,398057,584826,495949,546053,533053,604656,539369,752738,3471818,6629956,7830944,7830944
Serbia,2006,RS,SRB,EUR,192988,411255,604243,507501,557934,521485,523785,485524,554780,3151009,180980,391147,572127,488522,545436,528143,595516,546115,763682,3467414,6618423,7794792,7794792
Serbia,2007,RS,SRB,EUR,184433,408681,593114,498544,557426,519965,518981,489282,558196,3142394,172827,387502,560329,480626,543000,525755,584948,554563,773442,3462334,6604728,7758174,7758174
Serbia,2008,RS,SRB,EUR,177175,406219,583394,488713,555387,521588,513002,494379,560026,3133095,165948,384111,550059,471694,539232,526259,570389,567740,780934,3456248,6589343,7722794,7722794
Serbia,2009,RS,SRB,EUR,173263,401209,574472,478717,552783,524780,508226,498179,560630,3123315,162241,378530,540771,462315,535085,528192,555912,581122,786844,3449470,6572785,7688034,7688034
Serbia,2010,RS,SRB,EUR,173187,392896,566083,469416,548765,528761,505133,499720,561394,3113189,162117,370068,532185,453305,529812,530823,543772,591745,792842,3442299,6555488,7653748,7653748
Serbia,2011,RS,SRB,EUR,175533,382386,557919,462168,542211,533334,505037,497116,563921,3103787,164277,359741,524018,445886,522459,533871,535413,597302,800265,3435196,6538983,7620918,7620918
Serbia,2012,RS,SRB,EUR,178951,372522,551473,454625,535480,538542,506846,490803,568161,3094457,167458,350190,517648,437910,515355,537307,530353,597241,809599,3427765,6522222,7591350,7591350
Serbia,2013,RS,SRB,EUR,181486,369659,551145,442174,529711,543360,508836,482877,574460,3081418,169829,347287,517116,425198,509612,540136,527459,592341,822255,3417001,6498419,7566676,7566676
Serbia,2014,RS,SRB,EUR,182963,371709,554672,428126,523374,546819,509175,475055,583100,3065649,171238,349040,520278,410801,503849,541518,525310,583140,838742,3403360,6469009,7543960,7543960
Serbia,2015,RS,SRB,EUR,183717,371626,555343,418810,515741,550061,506964,468121,592533,3052230,171955,348803,520758,400644,497326,542614,522789,571621,856176,3391170,6443400,7519496,7519496
Serbia,2016,RS,SRB,EUR,183504,368361,551865,413644,508794,552915,503211,465458,598256,3042278,171779,345506,517285,394432,491581,543336,518730,563911,869858,3381848,6424126,7493288,7493288
Serbia,2017,RS,SRB,EUR,182740,363565,546305,411406,501149,553561,502874,462673,602089,3033752,171100,340771,511871,391132,485027,541966,517080,554801,882953,3372959,6406711,7464880,7464880
Serbia,2018,RS,SRB,EUR,181793,359011,540804,409024,492395,552562,505523,458951,605767,3024222,170206,336364,506570,387799,477158,539131,518237,542006,897902,3362233,6386455,7433818,7433818
Serbia,2019,RS,SRB,EUR,180848,356628,537476,403783,483097,550838,509619,456319,607836,3011492,169296,334069,503365,381919,468448,535756,520765,529386,912448,3348722,6360214,7401056,7401056
Serbia,2020,RS,SRB,EUR,179630,357271,536901,395028,474153,547450,514235,454649,604886,2990401,168155,334605,502760,372932,459737,531067,523935,518766,921505,3327942,6318343,7358005,7358005
Serbia,2021,RS,SRB,EUR,178300,359386,537686,384115,467111,541365,519036,454726,593069,2959422,166899,336561,503460,362109,452463,524276,527400,511124,918831,3296203,6255625,7296769,7296769
Serbia,2022,RS,SRB,EUR,176528,361878,538406,373124,458531,534341,523911,455894,577060,2922861,165207,338878,504085,351276,443363,517031,530820,506038,907485,3256013,6178874,7221365,7221365
Serbia,2023,RS,SRB,EUR,174201,363075,537276,368430,443554,527275,527957,457264,565853,2890333,163013,339959,502972,346357,427959,510069,533170,502928,898023,3218506,6108839,7149077,7149077
Serbia,2024,RS,SRB,EUR,171440,363186,534626,368825,426552,519324,530691,458100,565557,2869049,160417,340033,500450,346310,410425,502623,533964,501022,898564,3192908,6061957,7097028,7097028
Serbia,2025,RS,SRB,EUR,168358,362295,530653,367337,414208,510002,533282,457323,572324,2854476,157523,339179,496702,344536,397047,494274,534466,499102,905126,3174551,6029027,7056385,7056385
Serbia,2026,RS,SRB,EUR,165250,360293,525543,362940,406151,501366,535418,455016,579656,2840547,154616,337285,491901,339990,387774,486713,534542,495642,911761,3156422,5996969,7014413,7014413
Serbia,2027,RS,SRB,EUR,162051,357414,519465,357257,401243,492103,535405,455588,585415,2827011,151630,334568,486198,334271,381635,478423,532552,494441,917018,3138340,5965351,6971014,6971014
Serbia,2028,RS,SRB,EUR,158820,353926,512746,352021,396433,481803,533851,458760,590653,2813521,148617,331263,479880,329106,375709,468897,529138,495901,921259,3120010,5933531,6926165,6926165
Serbia,2029,RS,SRB,EUR,155578,350021,505599,349131,389128,471152,531704,463139,595663,2799917,145586,327558,473144,326252,367620,458720,525252,498627,924822,3101293,5901210,6879958,6879958
Serbia,2030,RS,SRB,EUR,152385,345527,497912,349401,378629,460975,528105,468119,601166,2786395,142600,323323,465923,326385,356741,448660,520111,501947,928525,3082369,5868764,6832604,6832604
Serbia,2031,RS,SRB,EUR,149326,340864,490190,351207,366090,452586,521988,473505,607143,2772519,139731,318930,458661,328007,344148,439946,512857,505579,932340,3062877,5835396,6784260,6784260
Serbia,2032,RS,SRB,EUR,146417,335781,482198,353556,354340,443372,515337,479138,612777,2758520,136997,314141,451138,330176,332478,430139,505482,509312,935423,3043010,5801530,6734876,6734876
Serbia,2033,RS,SRB,EUR,143744,330244,473988,354760,349677,428573,508916,484017,618472,2744415,134485,308949,443434,331260,327582,414837,498746,512094,938244,3022763,5767178,6684595,6684595
Serbia,2034,RS,SRB,EUR,141334,324259,465593,354881,350089,411761,501448,487386,624612,2730177,132222,303339,435561,331341,327541,397412,491508,513238,941182,3002222,5732399,6633549,6633549
Serbia,2035,RS,SRB,EUR,139105,318004,457109,354005,348632,399567,492543,490382,630650,2715779,130127,297470,427597,330491,325781,384124,483356,513969,943584,2981305,5697084,6581784,6581784
Serbia,2036,RS,SRB,EUR,136991,311850,448841,352016,344284,391638,484284,492827,635855,2700904,128140,291703,419843,328599,321258,374924,475971,514234,944756,2959742,5660646,6529329,6529329
Serbia,2037,RS,SRB,EUR,135087,305755,440842,349150,338656,386836,475394,493292,642213,2685541,126350,285994,412344,325890,315564,368851,467852,512503,946931,2937591,5623132,6476324,6476324
Serbia,2038,RS,SRB,EUR,133372,299866,433238,345678,333470,382127,465502,492432,650438,2669647,124738,280476,405214,322588,310420,362985,458518,509439,950842,2914792,5584439,6422894,6422894
Serbia,2039,RS,SRB,EUR,131767,294227,425994,341785,330623,374940,455293,491077,659568,2653286,123229,275188,398417,318891,307588,354962,448545,505944,955461,2891391,5544677,6369081,6369081
Serbia,2040,RS,SRB,EUR,130322,288820,419142,337307,330915,364577,445564,488420,669693,2636476,121869,270118,391987,314661,307731,344158,438696,501255,960958,2867459,5503935,6315060,6315060
Serbia,2041,RS,SRB,EUR,129086,283657,412743,332664,332742,352191,437569,483417,680598,2619181,120706,265270,385976,310273,309359,331649,430174,494521,967066,2843042,5462223,6260938,6260938
Serbia,2042,RS,SRB,EUR,128026,278855,406881,327593,335106,340579,428760,477916,691408,2601362,119710,260754,380464,305491,311531,320052,420563,487662,972807,2818106,5419468,6206813,6206813
Serbia,2043,RS,SRB,EUR,127113,274475,401588,322072,336327,335995,414425,472604,701617,2583040,118855,256637,375492,300304,312620,315198,405499,481414,977640,2792675,5375715,6152783,6152783
Serbia,2044,RS,SRB,EUR,126326,270470,396796,316104,336471,336432,398074,466237,710903,2564221,118122,252867,370989,294700,312711,315170,388310,474646,981272,2766809,5331030,6098809,6098809
Serbia,2045,RS,SRB,EUR,125578,266806,392384,309862,335617,335017,386261,458466,719787,2545010,117421,249420,366841,288838,311866,313430,375225,466965,984310,2740634,5285644,6044880,6044880
Serbia,2046,RS,SRB,EUR,124874,263464,388338,303726,333660,330751,378664,451253,727458,2525512,116760,246276,363036,283078,309988,308952,366201,460002,986036,2714257,5239769,5991145,5991145
Serbia,2047,RS,SRB,EUR,124217,260504,384721,297649,330822,325219,374138,443400,734425,2505653,116143,243496,359639,277376,307292,303307,360276,452300,987075,2687626,5193279,5937644,5937644
Serbia,2048,RS,SRB,EUR,123514,257884,381398,291769,327382,320129,369697,434642,741886,2485505,115484,241033,356517,271862,304005,298219,354552,443427,988776,2660841,5146346,5884256,5884256
Serbia,2049,RS,SRB,EUR,122805,255504,378309,286143,323520,317349,362813,425621,749650,2465096,114818,238794,353612,266581,300316,295424,346685,433949,991016,2633971,5099067,5830980,5830980
Serbia,2050,RS,SRB,EUR,122118,253316,375434,280750,319077,317693,352795,417071,757077,2444463,114176,236734,350910,261515,296102,295583,336056,424596,993145,2606997,5051460,5777806,5777806
South Sudan,2011,SS,SSD,AFR,861839,1332255,2194094,959881,780364,540481,306816,163119,111526,2862187,841514,1301340,2142854,971974,824922,576236,332924,191472,146394,3043922,5906109,10243050,10243050
South Sudan,2012,SS,SSD,AFR,902281,1375478,2277759,1005582,812356,576013,326190,172405,117099,3009645,880788,1343454,2224242,1014885,856892,612820,352448,199784,153135,3189964,6199609,10701604,10701604
South Sudan,2013,SS,SSD,AFR,940532,1420711,2361243,1042989,832163,606984,344640,181608,121811,3130195,917869,1387471,2305340,1048384,876740,645163,371499,208464,158996,3309246,6439441,11106031,11106031
South Sudan,2014,SS,SSD,AFR,965878,1458079,2423957,1034065,810638,613719,353790,187023,122367,3121602,942194,1423415,2365609,1032296,855577,655158,382987,214722,161372,3302112,6423714,11213284,11213284
South Sudan,2015,SS,SSD,AFR,975658,1491031,2466689,1013360,774606,608997,359613,191381,121550,3069507,951325,1455152,2406477,1003348,819109,654305,391895,220430,162538,3251625,6321132,11194299,11194299
South Sudan,2016,SS,SSD,AFR,966619,1523898,2490517,989931,721158,593642,362755,194675,120262,2982423,942124,1486706,2428830,970806,763426,642892,398614,225363,163240,3164341,6146764,11066105,11066105
South Sudan,2017,SS,SSD,AFR,932156,1551963,2484119,940553,624098,553579,356920,193785,116533,2785468,908111,1513156,2421267,910376,662308,607822,397749,227058,162060,2967373,5752841,10658226,10658226
South Sudan,2018,SS,SSD,AFR,882005,1584624,2466629,931305,551204,522915,356322,195211,115638,2672595,859065,1544470,2403535,893071,583745,580667,401365,230656,163075,2852579,5525174,10395329,10395329
South Sudan,2019,SS,SSD,AFR,829579,1624348,2453927,980068,530014,515828,366490,201594,119219,2713213,808061,1583156,2391217,938663,555882,574689,414191,238290,167596,2889311,5602524,10447666,10447666
South Sudan,2020,SS,SSD,AFR,785766,1658264,2444030,1046528,528778,515443,379901,209431,123954,2804035,765492,1616044,2381536,1004627,547498,574261,429890,247264,173084,2976624,5780659,10606227,10606227
South Sudan,2021,SS,SSD,AFR,752556,1681668,2434224,1108830,531167,509487,392112,216773,127994,2886363,733285,1638445,2371730,1067296,542378,567716,444553,256023,177988,3055954,5942317,10748272,10748272
South Sudan,2022,SS,SSD,AFR,731655,1693129,2424784,1173437,546850,498260,404224,224686,132295,2979752,713069,1649225,2362294,1133216,550557,555023,458953,265453,183131,3146333,6126085,10913164,10913164
South Sudan,2023,SS,SSD,AFR,728349,1684937,2413286,1238613,571827,483981,415590,233365,137248,3080624,709878,1640959,2350837,1199825,568125,538936,472462,275760,188954,3244062,6324686,11088796,11088796
South Sudan,2024,SS,SSD,AFR,737494,1661698,2399192,1299714,602829,475844,425952,242981,143079,3190399,718805,1618190,2336995,1262305,591899,528779,484758,287093,195677,3350511,6540910,11277092,11277092
South Sudan,2025,SS,SSD,AFR,750063,1632502,2382565,1354241,641657,472788,434719,253535,149704,3306644,731157,1589762,2320919,1318151,624292,522945,495239,299453,203229,3463309,6769953,11473439,11473439
South Sudan,2026,SS,SSD,AFR,763210,1599479,2362689,1406078,690928,469316,441395,264932,156848,3429497,744156,1557729,2301885,1370839,668512,515733,503388,312778,211358,3582608,7012105,11676686,11676686
South Sudan,2027,SS,SSD,AFR,778282,1562161,2340443,1455640,749184,466589,445770,276894,164258,3558335,759082,1521600,2280682,1420637,723299,508287,508923,326807,219845,3707798,7266133,11887262,11887262
South Sudan,2028,SS,SSD,AFR,795001,1523992,2318993,1502316,813744,464323,448835,289205,171950,3690373,775622,1484749,2260371,1467128,785808,500418,512808,341300,228751,3836213,7526586,12105957,12105957
South Sudan,2029,SS,SSD,AFR,813025,1487509,2300534,1546263,881208,463267,451334,301608,180003,3823683,793364,1449681,2243045,1510595,852518,493048,515708,355973,238140,3965982,7789665,12333241,12333241
South Sudan,2030,SS,SSD,AFR,832883,1459722,2292605,1581783,949124,465425,452735,313921,188353,3951341,812825,1423174,2235999,1545539,920998,488381,516936,370615,247985,4090454,8041795,12570402,12570402
South Sudan,2031,SS,SSD,AFR,853754,1443240,2296994,1607723,1015888,473885,450555,326003,197017,4071071,833227,1407735,2240962,1571008,989351,489779,513917,385025,258309,4207389,8278460,12816418,12816418
South Sudan,2032,SS,SSD,AFR,874578,1439862,2314440,1621546,1081874,491927,442250,337537,206123,4181257,853582,1405083,2258665,1584637,1057593,500887,503991,398816,269273,4315197,8496454,13069562,13069562
South Sudan,2033,SS,SSD,AFR,894287,1454455,2348742,1615965,1147878,518204,430876,348210,215737,4276870,872864,1419875,2292739,1579409,1125935,520432,490671,411642,280967,4409056,8685926,13327397,13327397
South Sudan,2034,SS,SSD,AFR,912349,1481843,2394192,1595366,1209364,549622,424810,357715,225868,4362745,890572,1447073,2337645,1559589,1189591,545353,482567,423157,293411,4493668,8856413,13588252,13588252
South Sudan,2035,SS,SSD,AFR,927767,1514306,2442073,1568743,1264444,588291,423304,365702,236607,4447091,905703,1479201,2384904,1533909,1246647,578337,478384,432955,306695,4576927,9024018,13850995,13850995
South Sudan,2036,SS,SSD,AFR,939344,1548390,2487734,1538275,1316847,636681,421344,371854,247986,4532987,917109,1512922,2430031,1504469,1300508,622450,472857,440661,320827,4661772,9194759,14112524,14112524
South Sudan,2037,SS,SSD,AFR,946950,1584249,2531199,1503530,1366901,693421,420000,376032,259869,4619753,924653,1548429,2473082,1470834,1351405,676495,467043,446054,335668,4747499,9367252,14371522,14371522
South Sudan,2038,SS,SSD,AFR,951771,1620587,2572358,1467883,1413939,755940,419011,379103,272073,4707949,929472,1584430,2513902,1436327,1398840,737724,460773,450003,351045,4834712,9542661,14628915,14628915
South Sudan,2039,SS,SSD,AFR,953765,1656571,2610336,1433808,1458012,820959,419058,381699,284424,4797960,931523,1620052,2551575,1403400,1442967,802710,454880,453088,366744,4923789,9721749,14883663,14883663
South Sudan,2040,SS,SSD,AFR,952832,1691723,2644555,1408055,1493609,886115,421938,383324,296748,4889789,930732,1654801,2585533,1378667,1478415,869077,451387,454656,382549,5014751,9904540,15134633,15134633
South Sudan,2041,SS,SSD,AFR,951135,1724117,2675252,1393151,1519680,949898,430404,381774,308933,4983840,929171,1686835,2616006,1364593,1504276,935037,453371,452360,398312,5107949,10091789,15383050,15383050
South Sudan,2042,SS,SSD,AFR,949330,1752610,2701940,1390850,1533913,1012738,447404,374811,320853,5080569,927478,1715062,2642540,1362880,1518391,1000673,464215,443788,413863,5203810,10284379,15628860,15628860
South Sudan,2043,SS,SSD,AFR,946689,1777330,2724019,1405842,1529522,1075538,471845,365181,332336,5180264,924960,1739606,2664566,1378087,1514147,1066363,482855,432165,428986,5302603,10482867,15871459,15871459
South Sudan,2044,SS,SSD,AFR,943427,1797749,2741176,1433161,1510809,1134193,501232,360344,343178,5282917,921816,1759963,2681779,1405353,1495789,1127701,506680,425386,443464,5404373,10687290,16110244,16110244
South Sudan,2045,SS,SSD,AFR,939435,1812811,2752246,1465400,1486413,1186937,537497,359594,353182,5389023,917957,1775089,2693046,1437439,1471804,1182881,538209,422239,457018,5509590,10898613,16343904,16343904
South Sudan,2046,SS,SSD,AFR,934763,1823459,2758222,1499240,1458396,1237269,582717,358426,362158,5498206,913447,1785900,2699347,1471104,1444229,1235135,580179,417861,469407,5617915,11116121,16573684,16573684
South Sudan,2047,SS,SSD,AFR,929896,1830186,2760082,1534815,1426320,1285485,635633,357759,369902,5609914,908770,1792861,2701631,1506539,1412633,1284666,631480,413202,480331,5728851,11338765,16800487,16800487
South Sudan,2048,SS,SSD,AFR,924922,1833406,2758328,1570881,1393383,1330927,693836,357440,377002,5723469,903996,1796376,2700372,1542484,1380207,1330957,689518,408156,490395,5841717,11565186,17023893,17023893
South Sudan,2049,SS,SSD,AFR,920152,1833283,2753435,1606617,1361932,1373599,754290,358109,383859,5838406,899419,1796597,2696016,1578082,1349326,1374128,751073,403530,499957,5956096,11794502,17243955,17243955
South Sudan,2050,SS,SSD,AFR,916318,1829629,2745947,1641552,1338379,1408232,814821,361307,389950,5954241,895780,1793360,2689140,1612842,1326342,1408977,813921,401114,508320,6071516,12025757,17460846,17460846
Sao Tome and Principe,1970,ST,STP,AFR,7611,11262,18873,7339,4481,3342,2650,1905,1620,21337,6922,10011,16933,6730,4156,3032,2550,2003,1972,20443,41780,77583,77583
Sao Tome and Principe,1971,ST,STP,AFR,7507,11636,19143,7628,4476,3374,2701,1945,1650,21774,6945,10364,17309,7011,4241,3084,2602,2037,2023,20998,42772,79226,79226
Sao Tome and Principe,1972,ST,STP,AFR,7418,11969,19387,7813,4482,3474,2791,1989,1682,22231,6970,10704,17674,7215,4301,3173,2686,2077,2087,21539,43770,80835,80835
Sao Tome and Principe,1973,ST,STP,AFR,7314,12334,19648,7984,4480,3563,2888,2042,1718,22675,6981,11075,18056,7415,4366,3262,2774,2127,2149,22093,44768,82472,82472
Sao Tome and Principe,1974,ST,STP,AFR,7187,12741,19928,8170,4502,3637,2990,2098,1752,23149,6972,11478,18450,7623,4442,3341,2860,2174,2214,22654,45803,84189,84189
Sao Tome and Principe,1975,ST,STP,AFR,7220,13028,20248,8392,4572,3686,3085,2153,1784,23672,7066,11811,18877,7858,4547,3411,2937,2224,2270,23247,46919,86037,86037
Sao Tome and Principe,1976,ST,STP,AFR,7429,13185,20614,8649,4694,3716,3174,2212,1814,24259,7276,12060,19336,8118,4693,3464,3011,2272,2317,23875,48134,88078,88078
Sao Tome and Principe,1977,ST,STP,AFR,7653,13372,21025,8943,4867,3721,3257,2267,1842,24897,7506,12332,19838,8398,4874,3507,3077,2326,2356,24538,49435,90299,90299
Sao Tome and Principe,1978,ST,STP,AFR,7907,13559,21466,9246,5083,3720,3332,2330,1873,25584,7762,12612,20374,8683,5090,3549,3136,2383,2391,25232,50816,92659,92659
Sao Tome and Principe,1979,ST,STP,AFR,8188,13706,21894,9519,5286,3732,3426,2399,1908,26270,8039,12863,20902,8954,5301,3595,3213,2444,2443,25950,52220,95017,95017
Sao Tome and Principe,1980,ST,STP,AFR,8481,13787,22268,9724,5415,3767,3548,2478,1962,26894,8313,13077,21390,9190,5462,3671,3317,2516,2510,26666,53560,97210,97210
Sao Tome and Principe,1981,ST,STP,AFR,8761,13814,22575,9847,5442,3824,3701,2566,2023,27403,8559,13257,21816,9394,5546,3768,3459,2602,2600,27369,54772,99170,99170
Sao Tome and Principe,1982,ST,STP,AFR,8993,13898,22891,10026,5472,3813,3787,2645,2069,27812,8782,13484,22266,9624,5646,3823,3544,2663,2659,27959,55771,100931,100931
Sao Tome and Principe,1983,ST,STP,AFR,9164,14085,23249,10312,5567,3742,3781,2699,2102,28203,8969,13782,22751,9902,5799,3838,3556,2696,2657,28448,56651,102650,102650
Sao Tome and Principe,1984,ST,STP,AFR,9291,14294,23585,10658,5674,3690,3761,2759,2136,28678,9112,14108,23220,10227,5963,3870,3559,2734,2667,29020,57698,104497,104497
Sao Tome and Principe,1985,ST,STP,AFR,9409,14689,24098,10915,5826,3668,3728,2815,2177,29129,9243,14551,23794,10507,6151,3927,3554,2773,2675,29587,58716,106607,106607
Sao Tome and Principe,1986,ST,STP,AFR,9549,15223,24772,11078,6037,3687,3686,2872,2215,29575,9386,15077,24463,10737,6371,4004,3542,2818,2686,30158,59733,108966,108966
Sao Tome and Principe,1987,ST,STP,AFR,9740,15734,25474,11295,6296,3746,3629,2926,2261,30153,9571,15576,25147,11010,6622,4117,3528,2868,2696,30841,60994,111610,111610
Sao Tome and Principe,1988,ST,STP,AFR,9978,16238,26216,11531,6592,3846,3557,2979,2312,30817,9804,16064,25868,11305,6899,4257,3511,2911,2726,31609,62426,114513,114513
Sao Tome and Principe,1989,ST,STP,AFR,10243,16723,26966,11741,6903,3970,3487,3020,2364,31485,10063,16539,26602,11582,7185,4426,3491,2956,2760,32400,63885,117445,117445
Sao Tome and Principe,1990,ST,STP,AFR,10528,17177,27705,11924,7214,4105,3409,3054,2413,32119,10335,16997,27332,11848,7470,4609,3477,2991,2788,33183,65302,120343,120343
Sao Tome and Principe,1991,ST,STP,AFR,10770,17628,28398,12081,7543,4246,3334,3082,2478,32764,10551,17419,27970,12075,7774,4772,3467,3013,2841,33942,66706,123084,123084
Sao Tome and Principe,1992,ST,STP,AFR,10942,18071,29013,12253,7884,4400,3261,3090,2545,33433,10683,17813,28496,12282,8101,4926,3454,3032,2908,34703,68136,125648,125648
Sao Tome and Principe,1993,ST,STP,AFR,11081,18482,29563,12486,8211,4565,3198,3087,2615,34162,10785,18174,28959,12531,8418,5091,3447,3040,2973,35500,69662,128182,128182
Sao Tome and Principe,1994,ST,STP,AFR,11188,18864,30052,12787,8506,4744,3145,3069,2680,34931,10854,18502,29356,12829,8707,5274,3446,3042,3035,36333,71264,130666,130666
Sao Tome and Principe,1995,ST,STP,AFR,11263,19208,30471,13244,8662,4932,3115,3037,2740,35730,10895,18786,29681,13243,8898,5468,3463,3039,3087,37198,72928,133077,133077
Sao Tome and Principe,1996,ST,STP,AFR,11302,19537,30839,13827,8710,5122,3116,2988,2789,36552,10910,19028,29938,13759,8993,5681,3492,3021,3135,38081,74633,135412,135412
Sao Tome and Principe,1997,ST,STP,AFR,11306,19828,31134,14433,8759,5310,3140,2920,2825,37387,10899,19216,30115,14308,9066,5910,3541,3001,3181,39007,76394,137656,137656
Sao Tome and Principe,1998,ST,STP,AFR,11288,20047,31335,15077,8822,5489,3200,2846,2854,38288,10878,19326,30204,14898,9134,6136,3610,2977,3210,39965,78253,139790,139790
Sao Tome and Principe,1999,ST,STP,AFR,11258,20182,31440,15738,8915,5650,3279,2756,2874,39212,10855,19358,30213,15512,9203,6354,3701,2942,3232,40944,80156,141808,141808
Sao Tome and Principe,2000,ST,STP,AFR,11213,20253,31466,16385,9069,5789,3373,2654,2876,40146,10836,19337,30173,16107,9310,6551,3808,2892,3252,41920,82066,143714,143714
Sao Tome and Principe,2001,ST,STP,AFR,11460,20332,31792,16877,9340,5948,3504,2558,2883,41110,11107,19360,30467,16570,9532,6736,3946,2834,3267,42885,83995,146258,146258
Sao Tome and Principe,2002,ST,STP,AFR,12031,20424,32455,17201,9793,6176,3685,2492,2900,42247,11712,19470,31182,16878,9916,6927,4117,2801,3311,43950,86197,149841,149841
Sao Tome and Principe,2003,ST,STP,AFR,12612,20517,33129,17450,10366,6436,3898,2470,2932,43552,12348,19628,31976,17104,10406,7122,4315,2788,3373,45108,88660,153762,153762
Sao Tome and Principe,2004,ST,STP,AFR,13155,20665,33820,17637,10947,6701,4119,2469,2960,44833,12937,19845,32782,17266,10932,7302,4535,2781,3444,46260,91093,157697,157697
Sao Tome and Principe,2005,ST,STP,AFR,13649,20892,34541,17783,11528,6963,4349,2499,2987,46109,13464,20155,33619,17389,11480,7474,4773,2794,3508,47418,93527,161680,161680
Sao Tome and Principe,2006,ST,STP,AFR,14005,21300,35305,17892,12096,7235,4581,2560,3002,47366,13823,20666,34489,17474,12036,7639,5024,2824,3571,48568,95934,165725,165725
Sao Tome and Principe,2007,ST,STP,AFR,14270,21863,36133,17969,12640,7523,4807,2648,3006,48593,14063,21347,35410,17534,12590,7808,5279,2878,3620,49709,98302,169845,169845
Sao Tome and Principe,2008,ST,STP,AFR,14546,22449,36995,18027,13147,7832,5027,2766,3005,49804,14309,22052,36361,17590,13112,7999,5516,2964,3666,50847,100651,174004,174004
Sao Tome and Principe,2009,ST,STP,AFR,14786,23053,37839,18100,13595,8174,5249,2904,2999,51021,14522,22768,37290,17672,13578,8219,5735,3082,3691,51977,102998,178128,178128
Sao Tome and Principe,2010,ST,STP,AFR,14924,23683,38607,18236,13960,8544,5469,3045,2997,52251,14646,23488,38134,17819,13960,8498,5934,3224,3713,53148,105399,182138,182138
Sao Tome and Principe,2011,ST,STP,AFR,14983,24354,39337,18446,14224,8937,5694,3197,3000,53498,14657,24221,38878,18043,14247,8849,6118,3365,3713,54335,107833,186044,186044
Sao Tome and Principe,2012,ST,STP,AFR,15133,25047,40180,18552,14372,9364,5940,3376,3010,54614,14770,24973,39743,18198,14424,9223,6282,3521,3742,55390,110004,189924,189924
Sao Tome and Principe,2013,ST,STP,AFR,15374,25712,41086,18537,14435,9815,6214,3586,3052,55639,15021,25716,40737,18279,14504,9600,6436,3695,3792,56306,111945,193757,193757
Sao Tome and Principe,2014,ST,STP,AFR,15606,26308,41914,18572,14449,10252,6497,3807,3102,56679,15254,26374,41628,18425,14534,9982,6592,3885,3857,57275,113954,197497,197497
Sao Tome and Principe,2015,ST,STP,AFR,15844,26782,42626,18672,14415,10692,6790,4036,3175,57780,15484,26904,42388,18663,14509,10377,6748,4094,3934,58325,116105,201124,201124
Sao Tome and Principe,2016,ST,STP,AFR,16021,27184,43205,18852,14336,11145,7089,4268,3277,58967,15692,27300,42992,19006,14441,10792,6898,4307,4030,59474,118441,204632,204632
Sao Tome and Principe,2017,ST,STP,AFR,15955,27708,43663,19117,14206,11612,7395,4487,3390,60207,15663,27781,43444,19454,14326,11237,7042,4518,4153,60730,120937,208036,208036
Sao Tome and Principe,2018,ST,STP,AFR,15704,28307,44011,19459,14037,12067,7709,4699,3523,61494,15414,28361,43775,19989,14183,11680,7201,4718,4289,62060,123554,211344,211344
Sao Tome and Principe,2019,ST,STP,AFR,15460,28791,44251,19894,13875,12477,8051,4916,3657,62870,15174,28840,44014,20596,14048,12080,7392,4905,4439,63460,126330,214599,214599
Sao Tome and Principe,2020,ST,STP,AFR,15348,29197,44545,20667,13886,12783,8392,5103,3736,64567,15046,29206,44252,21454,14097,12435,7658,5085,4547,65276,129843,218641,218641
Sao Tome and Principe,2021,ST,STP,AFR,15353,29498,44851,21640,14046,12979,8744,5266,3775,66450,15027,29447,44474,22449,14295,12711,8005,5253,4613,67326,133776,223107,223107
Sao Tome and Principe,2022,ST,STP,AFR,15418,29683,45101,22604,14239,13060,9112,5444,3847,68306,15079,29567,44646,23407,14538,12886,8382,5414,4700,69327,137633,227380,227380
Sao Tome and Principe,2023,ST,STP,AFR,15571,29843,45414,23600,14523,13057,9452,5614,3941,70187,15215,29634,44849,24358,14882,12994,8768,5586,4815,71403,141590,231856,231856
Sao Tome and Principe,2024,ST,STP,AFR,15749,30029,45778,24488,14905,13026,9780,5791,4050,72040,15384,29728,45112,25190,15326,13061,9166,5760,4953,73456,145496,236381,236381
Sao Tome and Principe,2025,ST,STP,AFR,15954,30285,46239,25212,15378,12974,10109,5974,4178,73825,15581,29887,45468,25856,15875,13094,9569,5930,5115,75439,149264,240979,240979
Sao Tome and Principe,2026,ST,STP,AFR,16175,30570,46745,25837,15942,12911,10447,6166,4316,75619,15799,30117,45916,26355,16539,13096,9997,6093,5308,77388,153007,245664,245664
Sao Tome and Principe,2027,ST,STP,AFR,16400,30703,47103,26545,16604,12827,10790,6361,4448,77575,16019,30215,46234,26912,17305,13071,10449,6255,5505,79497,157072,250413,250413
Sao Tome and Principe,2028,ST,STP,AFR,16635,30726,47361,27300,17341,12748,11131,6563,4586,79669,16248,30175,46423,27545,18145,13040,10895,6423,5721,81769,161438,255223,255223
Sao Tome and Principe,2029,ST,STP,AFR,16873,30808,47681,27925,18158,12713,11424,6791,4723,81734,16483,30205,46688,28057,19047,13047,11298,6620,5933,84002,165736,260101,260101
Sao Tome and Principe,2030,ST,STP,AFR,17105,30967,48072,28390,19059,12740,11648,7047,4858,83742,16713,30320,47033,28431,19986,13121,11633,6873,6137,86181,169923,265036,265036
Sao Tome and Principe,1950,ST,STP,AFR,5107,5243,10350,6375,8478,3925,2397,1321,1049,23545,4934,5134,10068,4203,5008,3023,2116,1326,1330,17006,40551,60975,60975
Sao Tome and Principe,1951,ST,STP,AFR,5184,5817,11001,5849,8571,4189,2419,1379,1045,23452,5064,5545,10609,3980,5091,3105,2142,1370,1305,16993,40445,62050,62050
Sao Tome and Principe,1952,ST,STP,AFR,5155,6314,11469,5704,8499,4423,2432,1447,1045,23550,5072,5835,10907,3953,5112,3167,2155,1430,1279,17096,40646,63023,63023
Sao Tome and Principe,1953,ST,STP,AFR,5152,6528,11680,5818,8399,4625,2452,1509,1046,23849,5076,5960,11036,4063,5105,3217,2168,1484,1265,17302,41151,63864,63864
Sao Tome and Principe,1954,ST,STP,AFR,5204,6487,11691,6206,8248,4764,2479,1553,1053,24303,5102,5935,11037,4305,5036,3265,2182,1539,1259,17586,41889,64614,64614
Sao Tome and Principe,1955,ST,STP,AFR,5278,6299,11577,6773,8083,4834,2519,1587,1061,24857,5127,5839,10966,4622,4932,3302,2201,1584,1260,17901,42758,65300,65300
Sao Tome and Principe,1956,ST,STP,AFR,5343,6083,11426,7391,7970,4829,2562,1602,1070,25424,5138,5733,10871,4939,4827,3324,2220,1619,1268,18197,43621,65919,65919
Sao Tome and Principe,1957,ST,STP,AFR,5425,5880,11305,7929,7957,4752,2600,1608,1075,25921,5168,5614,10782,5191,4765,3328,2244,1635,1284,18447,44368,66463,66463
Sao Tome and Principe,1958,ST,STP,AFR,5526,5740,11266,8254,8120,4635,2638,1600,1086,26333,5221,5515,10736,5308,4796,3322,2270,1646,1312,18654,44987,66992,66992
Sao Tome and Principe,1959,ST,STP,AFR,5641,5699,11340,8274,8504,4501,2669,1590,1096,26634,5296,5469,10765,5252,4955,3305,2293,1651,1339,18795,45429,67532,67532
Sao Tome and Principe,1960,ST,STP,AFR,5736,5785,11521,7951,9098,4387,2673,1576,1105,26790,5362,5500,10862,5015,5233,3281,2308,1647,1378,18862,45652,68038,68038
Sao Tome and Principe,1961,ST,STP,AFR,5925,6249,12174,7159,9315,4435,2677,1602,1138,26326,5557,5872,11429,4673,5388,3302,2336,1653,1430,18782,45108,68705,68705
Sao Tome and Principe,1962,ST,STP,AFR,6186,6995,13181,6201,8992,4599,2696,1655,1185,25328,5839,6517,12356,4400,5344,3360,2374,1681,1491,18650,43978,69520,69520
Sao Tome and Principe,1963,ST,STP,AFR,6383,7702,14085,5526,8535,4718,2707,1706,1240,24432,6035,7127,13162,4285,5233,3399,2410,1714,1551,18592,43024,70272,70272
Sao Tome and Principe,1964,ST,STP,AFR,6551,8351,14902,5159,7946,4766,2716,1755,1292,23634,6179,7676,13855,4328,5058,3413,2438,1750,1606,18593,42227,70992,70992
Sao Tome and Principe,1965,ST,STP,AFR,6723,8934,15657,5097,7256,4723,2720,1793,1344,22933,6306,8163,14469,4529,4825,3401,2462,1792,1665,18674,41607,71730,71730
Sao Tome and Principe,1966,ST,STP,AFR,6878,9480,16358,5307,6513,4579,2721,1823,1396,22339,6393,8626,15019,4862,4575,3367,2490,1834,1721,18849,41188,72567,72567
Sao Tome and Principe,1967,ST,STP,AFR,7039,9995,17034,5720,5786,4347,2718,1849,1455,21875,6474,9054,15528,5297,4349,3307,2514,1881,1784,19132,41007,73564,73564
Sao Tome and Principe,1968,ST,STP,AFR,7254,10448,17702,6260,5160,4017,2707,1873,1512,21529,6612,9407,16019,5789,4184,3216,2530,1928,1846,19493,41022,74739,74739
Sao Tome and Principe,1969,ST,STP,AFR,7525,10853,18378,6847,4685,3596,2669,1884,1573,21254,6805,9692,16497,6299,4114,3093,2540,1968,1917,19931,41185,76059,76059
Sao Tome and Principe,2031,ST,STP,AFR,17328,31210,48538,28710,20027,12857,11780,7329,5009,85712,16933,30532,47465,28672,20963,13277,11875,7191,6336,88314,174026,270026,270026
Sao Tome and Principe,2032,ST,STP,AFR,17554,31536,49090,28920,21034,13061,11825,7627,5160,87627,17157,30828,47985,28797,21948,13528,12042,7545,6535,90395,178022,275089,275089
Sao Tome and Principe,2033,ST,STP,AFR,17782,31921,49703,29079,22014,13339,11819,7921,5338,89510,17381,31195,48576,28869,22888,13872,12145,7908,6750,92432,181942,280216,280216
Sao Tome and Principe,2034,ST,STP,AFR,18002,32337,50339,29264,22883,13712,11794,8210,5524,91387,17597,31598,49195,28965,23716,14313,12213,8271,6985,94463,185850,285383,285383
Sao Tome and Principe,2035,ST,STP,AFR,18213,32774,50987,29520,23595,14172,11752,8499,5728,93266,17803,32024,49827,29128,24375,14856,12249,8649,7241,96498,189764,290575,290575
Sao Tome and Principe,2036,ST,STP,AFR,18408,33218,51626,29803,24207,14727,11696,8788,5936,95157,17995,32463,50458,29360,24872,15506,12256,9043,7509,98546,193703,295789,295789
Sao Tome and Principe,2037,ST,STP,AFR,18580,33668,52248,29940,24907,15367,11626,9090,6147,97077,18166,32910,51076,29460,25427,16264,12238,9461,7783,100633,197710,301024,301024
Sao Tome and Principe,2038,ST,STP,AFR,18728,34128,52856,29966,25654,16086,11560,9385,6359,99010,18312,33364,51676,29424,26056,17091,12215,9874,8059,102719,201729,306261,306261
Sao Tome and Principe,2039,ST,STP,AFR,18854,34585,53439,30052,26270,16880,11535,9637,6586,100960,18435,33816,52251,29460,26569,17976,12226,10249,8360,104840,205800,311490,311490
Sao Tome and Principe,2040,ST,STP,AFR,18952,35028,53980,30212,26729,17754,11572,9831,6832,102930,18532,34255,52787,29581,26947,18900,12302,10557,8697,106984,209914,316692,316692
Sao Tome and Principe,2041,ST,STP,AFR,19026,35447,54473,30460,27050,18698,11691,9941,7104,104944,18603,34669,53272,29793,27189,19860,12462,10783,9079,109166,214110,321857,321857
Sao Tome and Principe,2042,ST,STP,AFR,19074,35844,54918,30784,27257,19680,11882,9978,7388,106969,18652,35061,53713,30094,27320,20834,12710,10934,9486,111378,218347,326985,326985
Sao Tome and Principe,2043,ST,STP,AFR,19101,36220,55321,31169,27417,20627,12154,9976,7682,109025,18681,35434,54115,30464,27396,21761,13046,11035,9911,113613,222638,332079,332079
Sao Tome and Principe,2044,ST,STP,AFR,19122,36565,55687,31585,27608,21476,12511,9954,7975,111109,18700,35773,54473,30870,27497,22574,13476,11100,10348,115865,226974,337139,337139
Sao Tome and Principe,2045,ST,STP,AFR,19138,36874,56012,32021,27865,22171,12950,9921,8279,113207,18719,36079,54798,31299,27665,23229,14002,11137,10804,118136,231343,342154,342154
Sao Tome and Principe,2046,ST,STP,AFR,19154,37142,56296,32466,28145,22766,13476,9880,8585,115318,18734,36345,55079,31738,27902,23720,14641,11150,11290,120441,235759,347130,347130
Sao Tome and Principe,2047,ST,STP,AFR,19169,37363,56532,32915,28285,23450,14088,9833,8896,117467,18748,36564,55312,32187,28006,24266,15376,11141,11783,122759,240226,352075,352075
Sao Tome and Principe,2048,ST,STP,AFR,19182,37542,56724,33376,28319,24178,14773,9791,9204,119641,18763,36740,55503,32644,27979,24892,16183,11130,12281,125109,244750,356975,356975
Sao Tome and Principe,2049,ST,STP,AFR,19196,37690,56886,33833,28413,24781,15526,9781,9487,121821,18776,36886,55662,33094,28022,25402,17041,11152,12750,127461,249282,361833,361833
Sao Tome and Principe,2050,ST,STP,AFR,19215,37807,57022,34274,28578,25235,16356,9833,9735,124011,18793,37002,55795,33534,28147,25779,17942,11235,13197,129834,253845,366663,366663
Suriname,1970,SR,SUR,AMR,34192,60525,94717,34013,20467,16828,10963,7880,7516,97667,32550,57926,90476,32491,21030,16472,10827,7744,8495,97059,194726,379918,379918
Suriname,1971,SR,SUR,AMR,34216,62805,97021,36880,20550,17198,11459,8025,7588,101700,32600,60001,92601,34972,21117,16928,11335,7754,8607,100713,202413,392026,392026
Suriname,1972,SR,SUR,AMR,33353,63596,96949,38939,20598,17395,11893,8016,7620,104461,31914,60708,92622,36935,21166,17240,11730,7711,8709,103491,207952,397529,397529
Suriname,1973,SR,SUR,AMR,31897,62885,94782,39902,20619,17414,12207,7907,7604,105653,30691,60086,90777,38085,21192,17407,11996,7634,8793,105107,210760,396331,396331
Suriname,1974,SR,SUR,AMR,30574,61993,92567,40593,20725,17364,12505,7801,7630,106618,29518,59299,88817,39021,21265,17515,12255,7574,8885,106515,213133,394519,394519
Suriname,1975,SR,SUR,AMR,29418,60855,90273,41071,20901,17238,12778,7731,7665,107384,28443,58310,86753,39759,21393,17562,12510,7564,8944,107732,215116,392137,392137
Suriname,1976,SR,SUR,AMR,28456,59407,87863,41426,21112,17032,13011,7715,7703,107999,27501,57061,84562,40337,21567,17541,12766,7609,8982,108802,216801,389231,389231
Suriname,1977,SR,SUR,AMR,27601,57718,85319,41726,21321,16754,13202,7755,7740,108498,26640,55602,82242,40814,21759,17465,13013,7713,8985,109749,218247,385810,385810
Suriname,1978,SR,SUR,AMR,26751,55920,82671,42029,21446,16421,13350,7842,7772,108860,25795,54016,79811,41232,21914,17332,13245,7864,8959,110546,219406,381885,381885
Suriname,1979,SR,SUR,AMR,25840,54092,79932,42341,21399,16050,13445,7961,7788,108984,24924,52361,77285,41618,21978,17146,13451,8044,8916,111153,220137,377362,377362
Suriname,1980,SR,SUR,AMR,25209,52529,77738,43265,21675,15724,13473,8086,7602,109825,24358,50889,75247,42487,22310,16938,13600,8237,8726,112298,222123,375112,375112
Suriname,1981,SR,SUR,AMR,25086,51260,76346,44650,22452,15494,13445,8220,7233,111494,24295,49646,73941,43711,23052,16751,13702,8440,8425,114081,225575,375859,375859
Suriname,1982,SR,SUR,AMR,25271,50047,75318,45731,23382,15346,13395,8376,6915,113145,24520,48449,72969,44669,23961,16602,13790,8654,8179,115855,229000,377288,377288
Suriname,1983,SR,SUR,AMR,25738,48879,74617,46516,24498,15294,13322,8550,6657,114837,25014,47293,72307,45353,25052,16520,13859,8873,7988,117645,232482,379409,379409
Suriname,1984,SR,SUR,AMR,26534,47762,74296,47042,25853,15360,13237,8737,6465,116694,25815,46201,72016,45809,26364,16538,13927,9109,7867,119614,236308,382617,382617
Suriname,1985,SR,SUR,AMR,27323,47050,74373,47342,27489,15560,13153,8938,6350,118832,26587,45519,72106,46068,27930,16684,13997,9359,7815,121853,240685,387171,387171
Suriname,1986,SR,SUR,AMR,27894,46797,74691,47342,29339,15884,13051,9129,6296,121041,27134,45312,72446,46067,29687,16951,14052,9607,7832,124196,245237,392372,392372
Suriname,1987,SR,SUR,AMR,28362,46625,74987,46949,31234,16276,12890,9280,6283,122912,27582,45183,72765,45700,31473,17284,14047,9827,7866,126197,249109,396867,396867
Suriname,1988,SR,SUR,AMR,28821,46710,75531,46449,33191,16797,12752,9425,6313,124927,28020,45312,73332,45228,33307,17760,14048,10052,7957,128352,253279,402139,402139
Suriname,1989,SR,SUR,AMR,29257,47105,76362,45937,35136,17455,12652,9567,6395,127142,28431,45744,74175,44734,35121,18385,14061,10286,8094,130681,257823,408360,408360
Suriname,1990,SR,SUR,AMR,29481,47478,76959,45168,36759,18134,12528,9637,6465,128691,28643,46153,74796,43966,36618,19040,14006,10462,8219,132311,261002,412756,412756
Suriname,1991,SR,SUR,AMR,29550,47913,77463,44264,38038,18858,12409,9656,6525,129750,28701,46612,75313,43067,37780,19757,13914,10589,8336,133443,263193,415981,415981
Suriname,1992,SR,SUR,AMR,29553,48584,78137,43400,39072,19714,12359,9661,6603,130809,28698,47298,75996,42196,38714,20628,13862,10704,8486,134590,265399,419521,419521
Suriname,1993,SR,SUR,AMR,29424,49355,78779,42451,39758,20685,12350,9624,6681,131549,28558,48069,76627,41249,39323,21606,13829,10780,8638,135425,266974,422375,422375
Suriname,1994,SR,SUR,AMR,29298,50455,79753,41594,40286,21890,12457,9591,6803,132621,28422,49147,77569,40400,39792,22809,13903,10867,8835,136606,269227,426548,426548
Suriname,1995,SR,SUR,AMR,29059,51695,80754,41474,40824,23618,12946,9813,7127,135802,28184,50232,78416,40201,40141,24477,14339,11140,9233,139531,275333,434490,434490
Suriname,1996,SR,SUR,AMR,28586,52552,81138,41974,41211,25677,13766,10235,7660,140523,27758,50842,78600,40524,40205,26411,15077,11556,9803,143576,284099,443834,443834
Suriname,1997,SR,SUR,AMR,28145,53028,81173,42628,41446,27727,14682,10662,8280,145425,27417,51149,78566,40979,40135,28264,15929,11976,10445,147728,293153,452887,452887
Suriname,1998,SR,SUR,AMR,27845,53065,80910,43446,41624,29709,15686,11086,8972,150523,27221,51113,78334,41588,40002,29947,16914,12391,11141,151983,302506,461749,461749
Suriname,1999,SR,SUR,AMR,27737,52688,80425,44441,41774,31559,16760,11500,9727,155761,27181,50782,77963,42357,39822,31419,18016,12822,11876,156312,312073,470458,470458
Suriname,2000,SR,SUR,AMR,27779,52055,79834,45573,41858,33210,17922,11916,10532,161011,27226,50299,77525,43234,39591,32655,19201,13317,12630,160628,321639,478998,478998
Suriname,2001,SR,SUR,AMR,27922,51345,79267,46752,41859,34641,19181,12359,11381,166173,27291,49805,77096,44145,39355,33632,20444,13904,13384,164864,331037,487394,487394
Suriname,2002,SR,SUR,AMR,28099,50710,78809,47860,41824,35829,20546,12837,12254,171150,27377,49381,76758,44952,39213,34344,21755,14567,14114,168945,340095,495666,495666
Suriname,2003,SR,SUR,AMR,28177,50275,78452,48760,41846,36781,21996,13367,13170,175920,27432,49104,76536,45535,39249,34836,23138,15221,14892,172871,348791,503780,503780
Suriname,2004,SR,SUR,AMR,28221,50421,78642,49230,41818,37515,23224,13728,13664,179179,27469,49362,76831,45859,39331,35295,24348,15595,15486,175914,355093,510572,510572
Suriname,2005,SR,SUR,AMR,28296,51018,79314,49332,41788,38092,24228,13947,13713,181100,27515,50078,77593,46010,39399,35776,25363,15762,15901,178211,359311,516220,516220
Suriname,2006,SR,SUR,AMR,28321,51657,79978,49254,41917,38579,25286,14267,13804,183107,27533,50815,78348,46084,39498,36222,26370,16035,16375,180584,363691,522023,522023
Suriname,2007,SR,SUR,AMR,28296,52383,80679,48979,42168,38995,26426,14665,13927,185160,27497,51590,79087,46057,39662,36635,27335,16484,16848,183021,368181,527946,527946
Suriname,2008,SR,SUR,AMR,28239,53127,81366,48556,42546,39326,27670,15119,14045,187262,27400,52356,79756,45954,39977,36936,28286,17100,17308,185561,372823,533938,533938
Suriname,2009,SR,SUR,AMR,28118,53869,81987,48124,43059,39521,28970,15626,14156,189456,27252,53042,80294,45901,40423,37073,29254,17794,17803,188248,377704,539987,539987
Suriname,2010,SR,SUR,AMR,27955,54576,82531,47836,43694,39514,30230,16215,14276,191765,27080,53589,80669,46007,40970,37039,30210,18519,18363,191108,382873,546080,546080
Suriname,2011,SR,SUR,AMR,27801,55181,82982,47775,44373,39310,31387,16895,14388,194128,26921,53976,80897,46306,41574,36924,31107,19273,18957,194141,388269,552146,552146
Suriname,2012,SR,SUR,AMR,27669,55613,83282,47994,45017,39040,32402,17660,14487,196600,26781,54217,80998,46780,42127,36853,31894,20084,19490,197228,393828,558111,558111
Suriname,2013,SR,SUR,AMR,27568,55814,83382,48487,45570,38808,33261,18486,14605,199217,26669,54308,80977,47395,42591,36889,32567,20971,19953,200366,399583,563947,563947
Suriname,2014,SR,SUR,AMR,27485,55830,83315,49123,45989,38714,33984,19344,14806,201960,26587,54267,80854,48112,42984,37000,33160,21906,20392,203554,405514,569682,569682
Suriname,2015,SR,SUR,AMR,27432,55762,83194,49771,46243,38807,34599,20246,15135,204801,26536,54162,80698,48879,43280,37167,33678,22863,20921,206788,411589,575475,575475
Suriname,2016,SR,SUR,AMR,27412,55656,83068,50438,46275,39035,35143,21213,15588,207692,26503,54037,80540,49689,43500,37365,34172,23826,21605,210157,417849,581453,581453
Suriname,2017,SR,SUR,AMR,27421,55518,82939,51155,46067,39364,35616,22266,16126,210594,26489,53884,80373,50537,43627,37634,34638,24760,22451,213647,424241,587559,587559
Suriname,2018,SR,SUR,AMR,27448,55382,82830,51898,45701,39806,36016,23405,16680,213506,26497,53697,80194,51377,43672,38037,34998,25688,23406,217178,430684,593715,593715
Suriname,2019,SR,SUR,AMR,27501,55221,82722,52755,45442,40426,36300,24585,17203,216711,26528,53499,80027,52189,43819,38599,35198,26632,24403,220840,437551,600301,600301
Suriname,2020,SR,SUR,AMR,27571,55040,82611,53619,45375,41184,36389,25719,17755,220041,26578,53310,79888,52872,44148,39271,35245,27556,25436,224528,444569,607065,607065
Suriname,2021,SR,SUR,AMR,27650,54892,82542,54286,45444,41931,36258,26718,18209,222846,26644,53144,79788,53334,44616,39964,35178,28386,26331,227809,450655,612985,612985
Suriname,2022,SR,SUR,AMR,27707,54783,82490,54705,45698,42587,36012,27541,18587,225130,26705,53008,79713,53598,45202,40580,35135,29085,27095,230695,455825,618040,618040
Suriname,2023,SR,SUR,AMR,27735,54723,82458,54838,46153,43125,35818,28288,19224,227446,26746,52912,79658,53676,45895,41113,35204,29722,28059,233669,461115,623236,623236
Suriname,2024,SR,SUR,AMR,27748,54700,82448,54793,46747,43536,35765,28979,20105,229925,26774,52862,79636,53619,46684,41572,35369,30317,29213,236774,466699,628785,628785
Suriname,2025,SR,SUR,AMR,27733,54717,82450,54673,47345,43779,35888,29571,21083,232339,26772,52861,79633,53497,47514,41938,35585,30848,30423,239805,472144,634221,634221
Suriname,2026,SR,SUR,AMR,27683,54771,82454,54517,47969,43821,36137,30088,22135,234667,26735,52898,79633,53356,48342,42204,35814,31343,31706,242765,477432,639523,639523
Suriname,2027,SR,SUR,AMR,27615,54840,82455,54342,48655,43647,36492,30546,23258,236940,26678,52952,79630,53183,49175,42354,36098,31809,33050,245669,482609,644697,644697
Suriname,2028,SR,SUR,AMR,27540,54904,82444,54173,49350,43315,36951,30938,24433,239160,26614,53007,79621,52979,49990,42414,36517,32172,34448,248520,487680,649746,649746
Suriname,2029,SR,SUR,AMR,27465,54964,82429,53975,50030,42962,37522,31212,25628,241329,26544,53055,79599,52762,50711,42509,37059,32383,35901,251325,492654,654678,654678
Suriname,2030,SR,SUR,AMR,27394,55008,82402,53768,50673,42725,38185,31296,26810,243457,26480,53096,79576,52554,51277,42748,37690,32445,37361,254075,497532,659508,659508
Suriname,1950,SR,SUR,AMR,16761,24852,41613,17922,11522,9447,8126,6380,3830,57227,16001,23864,39865,17936,12181,9647,7822,5310,4160,57056,114283,195765,195765
Suriname,1951,SR,SUR,AMR,17808,25609,43417,18637,11882,9450,8024,6235,3631,57859,17119,24592,41711,18488,12605,9676,7932,5289,4011,58001,115860,201001,201001
Suriname,1952,SR,SUR,AMR,18851,26316,45167,19266,12330,9522,7985,6244,3753,59100,18217,25292,43509,19008,13051,9728,8056,5395,4088,59326,118426,207111,207111
Suriname,1953,SR,SUR,AMR,19899,27121,47020,19893,12817,9592,7973,6247,3848,60370,19336,26072,45408,19521,13524,9798,8178,5500,4164,60685,121055,213482,213482
Suriname,1954,SR,SUR,AMR,20988,28010,48998,20491,13341,9670,7983,6241,3926,61652,20508,26915,47423,20023,14020,9902,8295,5603,4230,62073,123725,220148,220148
Suriname,1955,SR,SUR,AMR,21906,29202,51108,21050,13896,9778,8015,6228,4004,62971,21463,28093,49556,20512,14523,10053,8400,5715,4306,63509,126480,227145,227145
Suriname,1956,SR,SUR,AMR,22624,30714,53338,21578,14471,9936,8069,6224,4097,64375,22178,29619,51797,20997,15035,10248,8483,5846,4402,65011,129386,234523,234523
Suriname,1957,SR,SUR,AMR,23383,32275,55658,22093,15084,10137,8147,6221,4223,65905,22929,31185,54114,21498,15564,10490,8561,5995,4525,66633,132538,242316,242316
Suriname,1958,SR,SUR,AMR,24186,33862,58048,22608,15740,10373,8255,6238,4397,67611,23718,32783,56501,22020,16124,10767,8635,6161,4694,68401,136012,250559,250559
Suriname,1959,SR,SUR,AMR,25025,35485,60510,23128,16427,10669,8372,6282,4614,69492,24532,34423,58955,22565,16693,11093,8704,6350,4895,70300,139792,259255,259255
Suriname,1960,SR,SUR,AMR,25889,37134,63023,23675,17114,11039,8492,6353,4880,71553,25362,36101,61463,23148,17251,11468,8773,6551,5154,72345,143898,268396,268396
Suriname,1961,SR,SUR,AMR,26767,38800,65567,24277,17791,11483,8617,6449,5212,73829,26192,37815,64007,23796,17792,11887,8847,6767,5475,74564,148393,277969,277969
Suriname,1962,SR,SUR,AMR,28030,40223,68253,24601,18458,12020,8879,6542,5958,76458,27340,39057,66397,24373,18403,12283,9007,6907,6203,77176,153634,288291,288291
Suriname,1963,SR,SUR,AMR,29578,41594,71172,24602,19025,12700,9304,6583,7148,79362,28766,39932,68698,24803,19072,12695,9246,6919,7364,80099,159461,299332,299332
Suriname,1964,SR,SUR,AMR,30718,43680,74398,24845,19446,13424,9639,6603,7885,81842,29846,41604,71450,25217,19656,13211,9414,6966,8133,82597,164439,310288,310288
Suriname,1965,SR,SUR,AMR,31464,46487,77951,25520,19824,14053,9829,6687,7926,83839,30485,44264,74749,25751,20123,13750,9501,7110,8294,84529,168368,321069,321069
Suriname,1966,SR,SUR,AMR,32069,49570,81639,26504,20118,14645,9963,6852,7774,85856,30935,47284,78219,26495,20484,14274,9596,7284,8296,86429,172285,332142,332142
Suriname,1967,SR,SUR,AMR,32606,52673,85279,27770,20292,15273,10090,7093,7642,88160,31320,50317,81637,27473,20717,14845,9741,7454,8314,88544,176704,343620,343620
Suriname,1968,SR,SUR,AMR,33200,55538,88738,29410,20385,15881,10268,7374,7545,90863,31759,53124,84883,28752,20858,15433,9986,7603,8349,90981,181844,355468,355468
Suriname,1969,SR,SUR,AMR,33801,58113,91914,31497,20430,16393,10557,7649,7505,94031,32227,55631,87858,30413,20956,15974,10361,7700,8407,93811,187842,367618,367618
Suriname,2031,SR,SUR,AMR,27326,55026,82352,53605,51203,42690,38858,31210,27971,245537,26418,53117,79535,52380,51667,43161,38360,32422,38794,256784,502321,664205,664205
Suriname,2032,SR,SUR,AMR,27255,55011,82266,53495,51563,42904,39480,31058,29083,247583,26352,53118,79470,52244,51906,43730,38972,32438,40151,259441,507024,668761,668761
Suriname,2033,SR,SUR,AMR,27177,54967,82144,53434,51700,43370,40009,30932,30149,249594,26281,53094,79375,52155,51986,44422,39506,32549,41446,262064,511658,673183,673183
Suriname,2034,SR,SUR,AMR,27088,54903,81991,53418,51664,43962,40408,30928,31185,251565,26196,53055,79251,52109,51938,45209,39966,32731,42696,264649,516214,677458,677458
Suriname,2035,SR,SUR,AMR,26980,54821,81801,53436,51551,44560,40651,31089,32214,253501,26092,52992,79084,52108,51821,46033,40335,32962,43931,267190,520691,681584,681584
Suriname,2036,SR,SUR,AMR,26860,54705,81565,53494,51405,45185,40712,31371,33238,255405,25977,52895,78872,52150,51684,46857,40604,33217,45204,269716,525121,685561,685561
Suriname,2037,SR,SUR,AMR,26729,54566,81295,53567,51241,45868,40573,31756,34259,257264,25848,52775,78623,52206,51520,47692,40762,33521,46493,272194,529458,689374,689374
Suriname,2038,SR,SUR,AMR,26581,54415,80996,53632,51080,46558,40283,32237,35272,259062,25703,52639,78342,52262,51323,48500,40834,33952,47732,274603,533665,693015,693015
Suriname,2039,SR,SUR,AMR,26430,54255,80685,53694,50893,47235,39981,32814,36198,260815,25558,52487,78045,52314,51111,49215,40946,34502,48872,276960,537775,696508,696508
Suriname,2040,SR,SUR,AMR,26282,54081,80363,53739,50695,47870,39792,33457,36949,262502,25414,52322,77736,52352,50914,49781,41198,35126,49891,279262,541764,699860,699860
Suriname,2041,SR,SUR,AMR,26131,53891,80022,53759,50543,48400,39790,34100,37542,264134,25265,52141,77406,52377,50744,50172,41620,35779,50800,281492,545626,703054,703054
Suriname,2042,SR,SUR,AMR,25980,53687,79667,53746,50441,48768,40025,34680,38029,265689,25116,51948,77064,52382,50614,50416,42191,36381,51672,283656,549345,706082,706082
Suriname,2043,SR,SUR,AMR,25841,53470,79311,53705,50395,48912,40498,35170,38511,267191,24979,51738,76717,52360,50529,50507,42883,36907,52562,285748,552939,708977,708977
Suriname,2044,SR,SUR,AMR,25705,53232,78937,53649,50384,48893,41099,35553,39077,268655,24849,51505,76354,52324,50490,50467,43666,37367,53480,287794,556449,711736,711736
Suriname,2045,SR,SUR,AMR,25570,52976,78546,53570,50412,48797,41704,35808,39770,270061,24715,51257,75972,52262,50492,50360,44490,37739,54429,289772,559833,714358,714358
Suriname,2046,SR,SUR,AMR,25444,52706,78150,53452,50478,48673,42329,35909,40575,271416,24592,50998,75590,52164,50539,50236,45308,38023,55419,291689,563105,716841,716841
Suriname,2047,SR,SUR,AMR,25322,52427,77749,53318,50553,48529,43013,35832,41466,272711,24471,50725,75196,52045,50597,50080,46131,38197,56488,293538,566249,719188,719188
Suriname,2048,SR,SUR,AMR,25202,52146,77348,53175,50629,48386,43694,35633,42432,273949,24353,50446,74799,51914,50656,49895,46932,38300,57625,295322,569271,721418,721418
Suriname,2049,SR,SUR,AMR,25088,51858,76946,53014,50697,48219,44366,35426,43414,275136,24242,50166,74408,51763,50715,49696,47645,38440,58780,297039,572175,723527,723527
Suriname,2050,SR,SUR,AMR,24972,51577,76549,52845,50752,48039,44998,35323,44313,276270,24128,49889,74017,51602,50757,49507,48208,38717,59895,298686,574956,725519,725519
Slovakia,1970,SK,SVK,EUR,197983,439518,637501,418563,281030,283711,222744,213134,175978,1595160,188705,419735,608440,403152,287083,292118,235007,229617,234790,1681767,3276927,4522867,4522867
Slovakia,1971,SK,SVK,EUR,198981,432100,631081,433444,283577,280419,234134,205870,180215,1617659,189394,412101,601495,416899,289671,289340,247713,222646,240997,1707266,3324925,4557502,4557502
Slovakia,1972,SK,SVK,EUR,202075,423643,625718,444265,291648,276710,248630,195221,185160,1641634,192413,403736,596149,426909,296687,286150,263665,212206,248046,1733663,3375297,4597164,4597164
Slovakia,1973,SK,SVK,EUR,208301,415448,623749,450474,302863,273517,263412,183027,191094,1664387,199031,395763,594794,432379,306459,283315,280098,200199,255915,1758365,3422752,4641289,4641289
Slovakia,1974,SK,SVK,EUR,216611,409711,626322,453696,314419,270896,272533,175437,197239,1684220,207486,390407,597893,434910,316183,281134,290750,192802,264253,1780032,3464252,4688472,4688472
Slovakia,1975,SK,SVK,EUR,224389,406604,630993,453857,326943,269082,275332,174732,202618,1702564,215418,387838,603256,434417,326881,279746,294314,192820,272070,1800248,3502812,4737059,4737059
Slovakia,1976,SK,SVK,EUR,231892,404517,636409,451242,341553,267815,275631,177387,207029,1720657,222847,386042,608889,431347,339780,278730,294806,197120,278615,1820398,3541055,4786342,4786342
Slovakia,1977,SK,SVK,EUR,239288,404425,643713,446514,357291,266624,273915,181399,211187,1736930,229436,386224,615660,426353,353595,277992,292881,203334,284993,1839148,3576078,4835452,4835452
Slovakia,1978,SK,SVK,EUR,244230,406722,650952,441725,372940,266450,270895,185444,214883,1752337,233841,389001,622842,421411,367287,278131,289659,209255,291497,1857240,3609577,4883368,4883368
Slovakia,1979,SK,SVK,EUR,246470,410737,657207,437991,387436,268219,267263,189047,218385,1768341,236287,393365,629652,417361,379946,280291,286094,214186,297885,1875763,3644104,4930967,4930967
Slovakia,1980,SK,SVK,EUR,246288,416636,662924,433361,402019,270370,264466,194257,218127,1782600,236021,399423,635444,412317,392875,282896,283749,220961,300114,1892912,3675512,4973883,4973883
Slovakia,1981,SK,SVK,EUR,244008,424672,668680,426236,416468,273818,261179,203705,212598,1794004,233808,407070,640878,405524,406108,286017,281092,233290,296120,1908151,3702155,5011717,5011717
Slovakia,1982,SK,SVK,EUR,240671,434970,675641,417119,427161,281350,257596,214904,205186,1803316,231115,416560,647675,397633,415530,292820,278044,247937,289541,1921505,3724821,5048145,5048145
Slovakia,1983,SK,SVK,EUR,237315,446228,683543,408084,433517,291718,254401,225974,197029,1810723,227781,427468,655249,389956,420709,302102,275446,262676,282036,1932925,3743648,5082436,5082436
Slovakia,1984,SK,SVK,EUR,233605,456825,690430,401605,436885,302414,251528,231875,193824,1818131,223690,438193,661883,384725,423297,311311,273354,271721,280186,1944594,3762725,5115041,5115041
Slovakia,1985,SK,SVK,EUR,230384,465247,695631,397293,437296,314013,249473,233104,195602,1826781,220457,446579,667036,381517,423070,321461,271932,274637,284503,1957120,3783901,5146571,5146571
Slovakia,1986,SK,SVK,EUR,227820,471114,698934,394428,434650,327706,248088,232732,198564,1836168,217902,452495,670397,379083,420364,333606,270984,275003,290877,1969917,3806085,5175411,5175411
Slovakia,1987,SK,SVK,EUR,224087,474818,698905,394683,429441,342667,246773,230634,202983,1847181,214413,456044,670457,379496,415603,346708,270225,273145,299453,1984630,3831811,5201174,5201174
Slovakia,1988,SK,SVK,EUR,219369,476082,695451,397409,423815,357674,246337,227626,207492,1860353,210392,456692,667084,382610,410589,359903,270184,270370,308357,2002013,3862366,5224908,5224908
Slovakia,1989,SK,SVK,EUR,214042,474337,688379,401988,418866,371572,247685,223988,211155,1875254,205466,454820,660286,387198,406339,372172,272227,267134,316131,2021201,3896455,5245118,5245118
Slovakia,1990,SK,SVK,EUR,207974,470829,678803,408679,412841,385451,249139,220972,213553,1890635,199399,451256,650655,393579,400945,384713,274695,264916,322365,2041213,3931848,5261305,5261305
Slovakia,1991,SK,SVK,EUR,203305,466224,669529,417407,405815,399038,251969,217541,215570,1907340,194637,446702,641339,401597,394411,397695,277569,262369,328379,2062020,3969360,5280226,5280226
Slovakia,1992,SK,SVK,EUR,200011,459852,659863,428094,398414,408984,259030,213910,217531,1925963,191205,441082,632287,411333,387591,407030,284077,259352,334394,2083777,4009740,5301892,5301892
Slovakia,1993,SK,SVK,EUR,196338,452760,649098,439598,391252,414879,268953,210953,219377,1945012,187147,434506,621653,422431,381070,412211,293192,256781,340401,2106086,4051098,5321859,5321859
Slovakia,1994,SK,SVK,EUR,191214,445060,636274,450485,386485,418193,279464,208716,221562,1964905,182070,426646,608716,433343,376909,414910,302409,254787,346567,2128925,4093830,5338811,5338811
Slovakia,1995,SK,SVK,EUR,183492,437672,621164,459342,383805,418850,290790,207481,223989,1984257,175106,419087,594193,442109,374648,415039,312564,253516,352510,2150386,4134643,5349997,5349997
Slovakia,1996,SK,SVK,EUR,174555,431516,606071,465978,382251,416864,303981,206980,226274,2002328,166568,412940,579508,448557,373032,412907,324681,252794,358406,2170377,4172705,5358289,5358289
Slovakia,1997,SK,SVK,EUR,166367,424434,590801,470764,383187,412754,318429,206634,228490,2020258,158308,406359,564667,452788,373977,408863,337768,252431,364268,2190095,4210353,5365829,5365829
Slovakia,1998,SK,SVK,EUR,158573,416346,574919,473177,386328,408318,332832,206997,229816,2037468,150835,398737,549572,454359,377350,404744,350882,252803,368985,2209123,4246591,5371081,5371081
Slovakia,1999,SK,SVK,EUR,151951,406704,558655,472703,391142,404714,346198,208868,230368,2053993,144559,389369,533928,453729,381969,401513,363034,255164,372634,2228043,4282036,5374620,5374620
Slovakia,2000,SK,SVK,EUR,147409,394217,541626,470936,397750,400389,359609,211170,230757,2070611,140157,377447,517604,451910,388124,397193,375621,258073,375925,2246846,4317457,5376690,5376690
Slovakia,2001,SK,SVK,EUR,143218,380742,523960,467554,406830,394624,373014,214662,230933,2087617,136118,364353,500471,448262,395830,391073,388628,261491,379129,2264413,4352030,5376456,5376456
Slovakia,2002,SK,SVK,EUR,139091,367986,507077,461398,418377,387875,383201,221874,231318,2104043,132181,351588,483769,442399,405207,384022,397885,268311,382484,2280308,4384351,5375206,5375206
Slovakia,2003,SK,SVK,EUR,135945,355464,491409,454244,430699,381301,389431,231665,232097,2119437,129270,339061,468331,435440,415895,377257,403003,277454,386151,2295200,4414637,5374376,5374376
Slovakia,2004,SK,SVK,EUR,134279,343124,477403,446202,442393,377039,393251,241768,233449,2134102,127462,327094,454556,427142,426393,372765,405613,286632,390321,2308866,4442968,5374931,5374931
Slovakia,2005,SK,SVK,EUR,133939,330938,464877,438198,452110,374787,394603,252488,235632,2147818,126788,315583,442371,419178,434690,370102,405647,296655,394897,2321169,4468987,5376242,5376242
Slovakia,2006,SK,SVK,EUR,134618,318281,452899,431122,459506,373567,393396,264836,238320,2160747,127495,303218,430713,412527,440531,368049,403425,308403,399943,2332878,4493625,5377235,5377235
Slovakia,2007,SK,SVK,EUR,136227,306153,442380,423115,464659,374912,390194,278259,241167,2172306,129144,291100,420244,405402,444038,368439,399309,321011,405262,2343461,4515767,5378382,5378382
Slovakia,2008,SK,SVK,EUR,138686,295203,433889,414305,467111,378544,386814,291639,244448,2182861,131488,280542,412030,397397,444847,371267,395090,333584,410663,2352848,4535709,5381636,5381636
Slovakia,2009,SK,SVK,EUR,142057,287203,429260,404050,466379,383957,384356,304258,248888,2191888,134609,272600,407209,387758,443450,375356,391727,345190,417086,2360567,4552455,5388926,5388926
Slovakia,2010,SK,SVK,EUR,144938,282978,427916,391168,464118,391282,381105,317027,253204,2197904,137610,268058,405668,375610,440941,380812,387286,357222,423061,2364932,4562836,5396424,5396424
Slovakia,2011,SK,SVK,EUR,147103,280178,427281,377899,460332,400632,376312,329593,257847,2202615,140111,265316,405427,362651,437320,387775,381071,369769,428776,2367362,4569977,5402680,5402680
Slovakia,2012,SK,SVK,EUR,148947,277714,426661,365894,454444,412148,370684,339122,265319,2207611,141729,263145,404874,350467,432606,396739,374242,378724,437360,2370138,4577749,5409283,5409283
Slovakia,2013,SK,SVK,EUR,149248,276727,425975,354399,447508,424447,365288,345208,274975,2211825,141983,262267,404250,338784,426695,406942,368010,383674,448584,2372689,4584514,5414739,5414739
Slovakia,2014,SK,SVK,EUR,147869,277959,425828,342914,439665,435830,362016,349038,285540,2215003,141113,263088,404201,327430,419397,416637,363968,386181,460913,2374526,4589529,5419569,5419569
Slovakia,2015,SK,SVK,EUR,146835,279604,426439,331272,432699,445198,360579,350758,297338,2217844,139975,264700,404675,316177,413080,424244,361640,386136,474220,2375497,4593341,5424444,5424444
Slovakia,2016,SK,SVK,EUR,146431,282505,428936,319060,427033,452366,360133,350537,310836,2219965,139077,268172,407249,304037,407896,429764,359834,384201,489331,2375063,4595028,5431203,5431203
Slovakia,2017,SK,SVK,EUR,146820,286566,433386,306973,420371,457507,362077,348752,324998,2220678,139555,272121,411676,292050,401992,433356,360374,380546,505365,2373683,4594361,5439417,5439417
Slovakia,2018,SK,SVK,EUR,148604,289433,438037,295852,412660,460151,366119,346874,339017,2220673,141264,274701,415965,281441,395139,434472,363328,376768,520929,2372077,4592750,5446745,5446745
Slovakia,2019,SK,SVK,EUR,150301,291286,441587,287615,403289,459742,371870,345764,353196,2221476,142683,276770,419453,273309,386421,433552,367509,373933,536687,2371411,4592887,5453924,5453924
Slovakia,2020,SK,SVK,EUR,150353,292831,443184,283125,391151,457932,379383,343671,366226,2221488,142850,278415,421265,268609,375230,431883,373106,370107,551816,2370751,4592239,5456681,5456681
Slovakia,2021,SK,SVK,EUR,148338,295097,443435,280060,378474,454658,388448,339422,375394,2216456,141015,280691,421706,265672,363225,429530,380170,364283,563150,2366030,4582486,5447622,5447622
Slovakia,2022,SK,SVK,EUR,151550,303325,454875,308183,400456,465724,406370,337127,384806,2302666,144280,289101,433381,296623,385836,441473,395169,360119,573313,2452533,4755199,5643453,5643453
Slovakia,2023,SK,SVK,EUR,154273,309339,463612,326356,415039,472991,423853,335082,396418,2369739,147139,294960,442099,316639,401208,449745,410394,356355,585416,2519757,4889496,5795199,5795199
Slovakia,2024,SK,SVK,EUR,150602,307237,457839,307261,390083,460551,432672,331833,406909,2329309,143414,292853,436267,295687,376948,439205,418425,352131,597013,2479409,4808718,5702832,5702832
Slovakia,2025,SK,SVK,EUR,147208,305401,452609,294156,368485,450121,440325,330552,416992,2300631,139881,290899,430780,281345,356177,430670,425129,349835,607868,2451024,4751655,5635034,5635034
Slovakia,2026,SK,SVK,EUR,144264,303479,447743,288199,350313,442972,446676,330537,427169,2285866,136913,288639,425552,275127,338445,425103,430633,348394,618932,2436634,4722500,5595797,5595797
Slovakia,2027,SK,SVK,EUR,141510,301769,443279,288025,335412,436642,451905,333068,436720,2281772,134158,287183,421341,274349,323860,420414,434932,349525,629199,2432279,4714051,5578672,5578672
Slovakia,2028,SK,SVK,EUR,138065,301824,439889,289029,322478,430130,455227,337798,446241,2280903,130856,287360,418216,274762,311540,415413,437191,353144,639070,2431120,4712023,5570123,5570123
Slovakia,2029,SK,SVK,EUR,134305,301945,436250,290220,312338,422296,455866,344189,456318,2281227,127332,287162,414494,275954,301585,408755,437732,358010,649418,2431454,4712681,5563418,5563418
Slovakia,2030,SK,SVK,EUR,131148,300452,431600,291735,305289,411693,455269,352214,465589,2281789,124355,285653,410008,277407,294306,399352,437393,364235,659018,2431711,4713500,5555114,5555114
Slovakia,1950,SK,SVK,EUR,194186,311096,505282,299823,238622,236827,192878,109416,99217,1176783,187130,308496,495626,306039,248520,252101,212671,137914,130682,1287927,2464710,3465617,3465617
Slovakia,1951,SK,SVK,EUR,204313,315228,519541,299208,251629,230283,198376,114073,100887,1194456,195922,312078,508000,304187,261204,245001,216639,142518,133389,1302938,2497394,3524943,3524943
Slovakia,1952,SK,SVK,EUR,214680,322712,537392,298237,267538,220830,204484,119179,102586,1212854,205333,318010,523343,301912,277190,234061,220700,147705,136032,1317600,2530454,3591182,3591182
Slovakia,1953,SK,SVK,EUR,223347,332894,556241,297428,283245,210488,211258,124559,104317,1231295,213031,326278,539309,299823,293032,222442,225489,152749,139041,1332576,2563871,3659422,3659422
Slovakia,1954,SK,SVK,EUR,230627,343832,574459,297121,293862,204529,217962,131013,105718,1250205,219304,335361,554665,298165,303573,215568,230572,158368,141811,1348057,2598262,3727388,3727388
Slovakia,1955,SK,SVK,EUR,236621,355099,591720,297387,299074,204751,223009,139300,106936,1270457,224673,345281,569954,296957,308108,215083,234491,165623,144230,1364492,2634949,3796626,3796626
Slovakia,1956,SK,SVK,EUR,239950,368595,608545,297990,301028,209149,226636,148251,108523,1291577,227994,357693,585687,296060,309062,219031,237278,173285,147135,1381851,2673428,3867651,3867651
Slovakia,1957,SK,SVK,EUR,240625,384382,625007,298800,300678,215323,230416,156652,110016,1311885,228713,371953,600666,295453,307660,224930,240339,180359,150013,1398754,2710639,3936315,3936315
Slovakia,1958,SK,SVK,EUR,239324,400509,639833,300579,298984,221644,234475,164415,112139,1332236,227985,386346,614331,295783,305070,230739,243610,186834,153780,1415816,2748052,4002213,4002213
Slovakia,1959,SK,SVK,EUR,235943,415714,651657,304014,296877,227426,238282,171438,115318,1353355,225423,400058,625481,298398,301868,235723,246566,192581,158753,1433889,2787244,4064383,4064383
Slovakia,1960,SK,SVK,EUR,231544,430810,662354,307997,295553,235420,238399,177738,119443,1374550,221103,414172,635275,301838,299436,243163,245742,197506,164376,1452061,2826611,4124239,4124239
Slovakia,1961,SK,SVK,EUR,226810,445629,672439,313327,293620,249044,232387,183514,124807,1396699,216298,428689,644987,305961,296749,256880,238568,201665,171123,1470946,2867645,4185077,4185077
Slovakia,1962,SK,SVK,EUR,221320,455876,677196,321112,290989,265146,221946,188820,129753,1417766,210958,438393,649351,313159,293605,273342,227649,205699,177571,1491025,2908791,4235337,4235337
Slovakia,1963,SK,SVK,EUR,217188,461047,678235,330180,288410,281267,208904,194427,134448,1437636,206764,442786,649550,322131,290911,290070,215059,210298,183767,1512236,2949872,4277652,4277652
Slovakia,1964,SK,SVK,EUR,215713,463754,679467,339140,286182,291052,201140,200484,140300,1458298,205275,444869,650144,330794,288646,300580,207788,215540,190847,1534195,2992493,4322111,4322111
Slovakia,1965,SK,SVK,EUR,214528,463737,678265,348757,284842,294372,200566,204530,147077,1480144,203708,444280,647988,340236,287109,303914,207833,219379,198651,1557122,3037266,4363511,4363511
Slovakia,1966,SK,SVK,EUR,211993,460652,672645,360965,283553,295260,203443,206809,153724,1503754,200976,441032,642008,351936,285847,304341,211897,221690,206227,1581938,3085692,4400352,4400352
Slovakia,1967,SK,SVK,EUR,208606,455410,664016,375085,281643,293721,208093,209426,160202,1528170,198098,435858,633956,364693,284616,302234,218025,224484,213761,1607813,3135983,4433961,4433961
Slovakia,1968,SK,SVK,EUR,204202,449947,654149,389870,280277,290698,212809,212069,166292,1552015,194133,430563,624696,377692,284062,298861,223740,227566,221154,1633075,3185090,4463936,4463936
Slovakia,1969,SK,SVK,EUR,199617,445208,644825,403974,280576,286756,217002,214357,171390,1574055,190107,425787,615894,390122,285417,294915,228484,230317,228188,1657443,3231498,4492219,4492219
Slovakia,2031,SK,SVK,EUR,128525,297183,425708,294558,299100,400471,453398,361923,473409,2282859,121862,282549,404411,280164,288085,388846,436201,371925,667073,2432294,4715153,5545269,5545269
Slovakia,2032,SK,SVK,EUR,126317,292584,418901,298384,293084,390039,449377,373262,480036,2284182,119754,278026,397780,283992,282143,378612,433749,381208,673390,2433094,4717276,5533949,5533949
Slovakia,2033,SK,SVK,EUR,124378,287284,411662,301749,288534,379417,444644,385143,485773,2285260,117900,273018,390918,287228,277395,368212,430445,391670,678393,2433343,4718603,5521189,5521189
Slovakia,2034,SK,SVK,EUR,122633,281932,404565,303278,286342,368519,439159,396432,491853,2285583,116235,267837,384072,289031,274432,357828,426073,401984,683495,2432843,4718426,5507060,5507060
Slovakia,2035,SK,SVK,EUR,121071,276979,398050,303768,285041,357323,433976,405933,498694,2284735,114743,262917,377660,289563,272684,347317,422152,410398,689042,2431156,4715891,5491597,5491597
Slovakia,2036,SK,SVK,EUR,119741,272342,392083,303050,285469,345088,429915,413323,506019,2282864,113472,258382,371854,288573,273285,335401,419235,416868,694869,2428231,4711095,5475035,5475035
Slovakia,2037,SK,SVK,EUR,118678,267735,386413,301768,287601,332498,424959,418986,514505,2280317,112460,253867,366327,287563,274962,323011,415606,421558,701815,2424515,4704832,5457575,5457575
Slovakia,2038,SK,SVK,EUR,117849,262452,380301,301934,289187,320305,419088,422640,524737,2277891,111666,248808,360474,287850,275983,311308,410975,424018,710447,2420581,4698472,5439248,5439248
Slovakia,2039,SK,SVK,EUR,117252,256956,374208,302067,290409,310342,411663,423771,536895,2275147,111092,243627,354719,287657,277189,301421,404461,424744,720616,2416088,4691235,5420159,5420159
Slovakia,2040,SK,SVK,EUR,116942,252250,369192,300590,291950,303433,401519,423782,549852,2271126,110789,239167,349956,286157,278645,294195,395231,424627,731360,2410215,4681341,5400488,5400488
Slovakia,2041,SK,SVK,EUR,116794,248304,365098,297341,294794,297371,390760,422612,563107,2265985,110639,235411,346050,283063,281411,288017,384899,423681,742069,2403140,4669125,5380279,5380279
Slovakia,2042,SK,SVK,EUR,116722,245042,361764,292765,298634,291473,380760,419434,576879,2259945,110564,232293,342857,278551,285239,282125,374834,421511,752805,2395065,4655010,5359631,5359631
Slovakia,2043,SK,SVK,EUR,116823,242278,359101,287489,302018,287031,370567,415586,590483,2253174,110656,229651,340307,273556,288478,277416,364612,418509,763606,2386177,4639351,5338769,5338769
Slovakia,2044,SK,SVK,EUR,117015,239945,356960,282160,303571,284930,360096,411028,603990,2245775,110834,227417,338251,268389,290288,274487,354393,414471,774598,2376626,4622401,5317613,5317613
Slovakia,2045,SK,SVK,EUR,117193,238077,355270,277230,304092,283705,349333,406732,616731,2237823,110998,225627,336625,263476,290827,272772,344059,410859,784464,2366457,4604280,5296171,5296171
Slovakia,2046,SK,SVK,EUR,117376,236608,353984,272613,303406,284192,337557,403443,628152,2229363,111163,224216,335379,258952,289847,273393,332334,408202,793077,2355805,4585168,5274528,5274528
Slovakia,2047,SK,SVK,EUR,117571,235473,353044,268025,302158,286364,325421,399289,639251,2220508,111344,223126,334470,254450,288848,275080,320130,404845,801392,2344745,4565253,5252775,5252775
Slovakia,2048,SK,SVK,EUR,117694,234752,352446,262767,302358,287985,313670,394258,650250,2211288,111456,222428,333884,249400,289143,276115,308610,400503,809581,2333352,4544640,5230974,5230974
Slovakia,2049,SK,SVK,EUR,117755,234353,352108,257294,302518,289242,304095,387719,660853,2201721,111511,222036,333547,244233,288962,277330,298888,394317,817979,2321709,4523430,5209078,5209078
Slovakia,2050,SK,SVK,EUR,117712,234228,351940,252605,301072,290819,297477,378559,671304,2191836,111472,221897,333369,239779,287474,278801,291789,385463,826517,2309823,4501659,5186967,5186967
Slovenia,1970,SI,SVN,EUR,72726,141808,214534,154127,131745,123584,69156,77652,66813,623077,70259,138202,208461,144599,122737,130461,94177,97885,105350,695209,1318286,1741286,1741286
Slovenia,1971,SI,SVN,EUR,71864,141923,213787,157819,130558,126414,73225,74331,68663,631010,69177,138598,207775,148330,121231,129651,100131,94540,108421,702304,1333314,1754881,1754881
Slovenia,1972,SI,SVN,EUR,71224,142729,213953,159236,131410,128234,78903,70031,70460,638274,68267,139677,207944,150315,121957,128802,107086,89867,111513,709540,1347814,1769709,1769709
Slovenia,1973,SI,SVN,EUR,71324,143386,214710,159624,133385,128810,85501,65610,72305,645235,68073,140582,208655,151392,123711,127829,113855,85254,114580,716621,1361856,1785222,1785222
Slovenia,1974,SI,SVN,EUR,71984,143725,215709,159407,135848,128920,91493,62135,74329,652132,68551,140922,209473,151984,125900,126957,118913,82113,117791,723658,1375790,1800974,1800974
Slovenia,1975,SI,SVN,EUR,73024,143865,216889,158197,139081,128670,96665,60088,76308,659009,69436,140727,210163,152026,128913,125846,122326,80860,121016,730987,1389996,1817044,1817044
Slovenia,1976,SI,SVN,EUR,74189,143937,218126,156737,142605,128340,101359,59006,77951,665998,70530,140312,210842,151882,132387,124641,124689,81035,123935,738569,1404567,1833543,1833543
Slovenia,1977,SI,SVN,EUR,75237,144092,219329,155522,146085,128571,105239,58437,79376,673230,71509,140038,211547,151815,135634,124061,125965,81973,126821,746269,1419499,1850369,1850369
Slovenia,1978,SI,SVN,EUR,76240,144425,220665,154092,149864,129096,108543,58287,80568,680450,72362,140000,212362,151466,138922,123983,126563,83310,129663,753907,1434357,1867379,1867379
Slovenia,1979,SI,SVN,EUR,77288,144999,222287,152525,154465,129072,111440,58583,81391,687476,73232,140059,213291,150967,143321,123274,126758,85073,132149,761542,1449018,1884595,1884595
Slovenia,1980,SI,SVN,EUR,78041,145619,223660,151099,160759,127435,114170,60133,81018,694614,73839,140182,214021,150557,149574,121266,126466,88469,132946,769278,1463892,1901570,1901570
Slovenia,1981,SI,SVN,EUR,78053,146131,224184,150070,165951,126094,116648,63506,79112,701381,73777,140615,214392,149989,154990,120035,125787,94081,131487,776369,1477750,1916320,1916320
Slovenia,1982,SI,SVN,EUR,77261,146893,224154,149454,167866,126852,118262,68121,76467,707022,73149,141301,214450,149234,157913,120713,124965,100528,128970,782323,1489345,1927956,1927956
Slovenia,1983,SI,SVN,EUR,75832,148080,223912,149161,168136,128679,118669,73443,73502,711590,72114,142229,214343,148663,159444,122327,123938,106725,126287,787384,1498974,1937234,1937234
Slovenia,1984,SI,SVN,EUR,73868,149561,223429,148973,167504,130987,118591,78186,71443,715684,70649,143487,214136,148179,160022,124408,122979,111306,124993,791887,1507571,1945141,1945141
Slovenia,1985,SI,SVN,EUR,71643,150984,222627,148823,165750,134063,118211,82269,70767,719883,68788,144749,213537,147694,159712,127310,121801,114347,125604,796468,1516351,1952518,1952518
Slovenia,1986,SI,SVN,EUR,69408,151824,221232,148755,163784,137427,117789,85994,70805,724554,66736,145598,212334,147375,159037,130633,120561,116400,127422,801428,1525982,1959550,1959550
Slovenia,1987,SI,SVN,EUR,67450,151777,219227,148754,162226,140757,117876,88983,71168,729764,65043,145683,210726,147355,158380,133704,119887,117468,129985,806779,1536543,1966495,1966495
Slovenia,1988,SI,SVN,EUR,65946,150970,216916,148749,160785,144272,118166,91481,71806,735259,63731,145080,208811,147427,157619,136751,119682,117957,133061,812497,1547756,1973494,1973494
Slovenia,1989,SI,SVN,EUR,64566,149597,214163,148773,159597,148360,117873,93743,72703,741049,62270,144065,206335,147334,157064,140728,118873,118131,136504,818634,1559683,1980180,1980180
Slovenia,1990,SI,SVN,EUR,63021,147690,210711,148619,158856,153854,116089,95906,73771,747095,60662,142447,203109,146934,157095,146340,116796,117846,140093,825104,1572199,1986024,1986024
Slovenia,1991,SI,SVN,EUR,61296,145428,206724,148170,158206,158829,114848,97968,75159,753180,58948,140234,199182,146048,157188,151128,115500,117259,143587,830710,1583890,1989797,1989797
Slovenia,1992,SI,SVN,EUR,59232,143125,202357,148093,157240,161486,115814,99563,76957,759153,56743,138076,194819,144932,156695,153716,116065,116716,146887,835011,1594164,1991340,1991340
Slovenia,1993,SI,SVN,EUR,56912,140607,197519,148823,156078,162918,117781,100310,79192,765102,54327,135864,190191,144379,155765,155206,117417,116004,150102,838873,1603975,1991685,1991685
Slovenia,1994,SI,SVN,EUR,54807,137446,192253,150174,154678,163569,120219,100732,81830,771202,52370,132896,185266,144638,154390,155946,119129,115344,153285,842732,1613934,1991449,1991449
Slovenia,1995,SI,SVN,EUR,53111,133673,186784,151761,153211,163009,123420,100958,85107,777466,50787,129202,179989,145379,152616,155933,121566,114457,156920,846871,1624337,1991106,1991106
Slovenia,1996,SI,SVN,EUR,51716,129651,181367,152931,151849,162084,126911,101171,88647,783593,49345,125263,174608,146021,150760,155652,124312,113434,160922,851101,1634694,1990667,1990667
Slovenia,1997,SI,SVN,EUR,50462,125699,176161,153224,150756,161185,130472,101792,91850,789279,48139,121425,169564,145954,149132,155336,126786,112853,164765,854826,1644105,1989828,1989828
Slovenia,1998,SI,SVN,EUR,49336,121936,171272,152682,150029,159938,134358,102506,94820,794333,47013,117738,164751,145287,147710,154694,129299,112577,168361,857928,1652261,1988279,1988279
Slovenia,1999,SI,SVN,EUR,48331,118305,166636,151464,149700,158523,138879,102535,97771,798872,45864,114128,159992,144322,146335,153930,132760,111623,171786,860756,1659628,1986261,1986261
Slovenia,2000,SI,SVN,EUR,47524,114809,162333,149622,149553,157219,144753,101113,100793,803053,44980,110618,155598,142773,144974,153371,137850,109375,175023,863366,1666419,1984339,1984339
Slovenia,2001,SI,SVN,EUR,46821,111471,158292,147177,149436,156134,150147,100112,103893,806899,44257,107247,151504,140536,143814,152952,142417,107811,178269,865799,1672698,1982487,1982487
Slovenia,2002,SI,SVN,EUR,46257,108276,154533,145070,150114,155473,153513,101210,106875,812255,43654,103913,147567,138546,143208,152588,145436,108243,181391,869412,1681667,1983767,1983767
Slovenia,2003,SI,SVN,EUR,46081,105231,151312,143648,151945,155229,155843,103434,109522,819621,43525,100667,144192,136867,143522,152275,147804,109720,184089,874277,1693898,1989411,1989411
Slovenia,2004,SI,SVN,EUR,46299,102465,148764,141865,154443,154958,157462,106186,112329,827243,43853,97911,141764,134582,144658,151680,149518,111620,186888,878946,1706189,1996722,1996722
Slovenia,2005,SI,SVN,EUR,46681,100288,146969,139484,157190,154630,157967,109743,115610,834624,44288,95800,140088,131604,146261,150691,150508,114240,189783,883087,1717711,2004778,2004778
Slovenia,2006,SI,SVN,EUR,47327,98608,145935,136630,159646,154447,158207,113663,119092,841685,44936,94020,138956,128404,147735,149556,151239,117316,192740,886990,1728675,2013570,2013570
Slovenia,2007,SI,SVN,EUR,48445,97313,145758,133352,161385,154588,158530,117730,122679,848264,46061,92695,138756,125088,148472,148717,151785,120280,196109,890451,1738715,2023229,2023229
Slovenia,2008,SI,SVN,EUR,50144,96376,146520,129964,162475,155061,158377,122301,126341,854519,47823,91761,139584,121732,148637,148143,151910,123367,199627,893416,1747935,2034033,2034033
Slovenia,2009,SI,SVN,EUR,52255,95685,147940,126549,163127,155858,158201,127387,129529,860651,49779,91048,140827,118556,148568,147495,151983,127306,202252,896160,1756811,2045578,2045578
Slovenia,2010,SI,SVN,EUR,54387,95345,149732,122919,163508,156722,158318,133782,131331,866580,51654,90692,142346,115380,148025,146797,152322,133009,203101,898634,1765214,2057287,2057287
Slovenia,2011,SI,SVN,EUR,56185,95409,151594,119210,162156,157011,158234,139778,133552,869941,53374,90683,144057,112252,146222,146225,152517,138195,204452,899863,1769804,2065453,2065453
Slovenia,2012,SI,SVN,EUR,57390,96112,153502,115284,159399,157229,157830,143202,137548,870492,54449,91261,145710,108990,144007,145640,152303,141258,207457,899655,1770147,2069354,2069354
Slovenia,2013,SI,SVN,EUR,57689,97665,155354,111146,156642,158036,157420,145243,142146,870633,54574,92821,147395,105459,142090,145472,151879,143174,210914,898988,1769621,2072374,2072374
Slovenia,2014,SI,SVN,EUR,57256,99836,157092,107585,153054,159276,156754,146732,147250,870651,54119,94927,149046,102343,139555,146016,151111,144295,214807,898127,1768778,2074917,2074917
Slovenia,2015,SI,SVN,EUR,56603,102217,158820,106175,149333,161463,155895,147405,153147,873418,53546,97073,150619,100186,136223,147238,149994,145146,219222,898009,1771427,2080862,2080862
Slovenia,2016,SI,SVN,EUR,55835,104598,160433,106269,146049,163983,155388,147977,159161,878827,52825,99400,152225,98626,132645,148611,148700,146089,223871,898542,1777369,2090020,2090020
Slovenia,2017,SI,SVN,EUR,55019,106999,162018,106378,142764,165714,155361,148515,165130,883862,52053,101710,153763,97531,128950,149233,147750,146732,228549,898745,1782607,2098392,2098392
Slovenia,2018,SI,SVN,EUR,54332,109198,163530,106439,139961,166635,155698,148419,171415,888567,51293,103857,155150,96783,125313,149147,147165,146836,233435,898679,1787246,2105924,2105924
Slovenia,2019,SI,SVN,EUR,53673,111067,164740,106273,137842,166929,156383,148267,177642,893336,50550,105579,156129,96240,122005,148745,146499,146808,238405,898702,1792038,2112901,2112901
Slovenia,2020,SI,SVN,EUR,52795,112588,165383,106008,136178,166811,157113,148433,183070,897613,49706,106848,156554,96051,118889,147820,145793,146941,242598,898092,1795705,2117641,2117641
Slovenia,2021,SI,SVN,EUR,51988,113403,165391,105197,134470,165656,157688,148795,187975,899781,48807,107704,156511,96138,116325,146010,145520,147211,246526,897730,1797511,2119410,2119410
Slovenia,2022,SI,SVN,EUR,51104,113591,164695,104210,131894,163830,158567,149218,193203,900922,47903,107852,155755,96526,113792,144179,145443,147437,251098,898475,1799397,2119844,2119844
Slovenia,2023,SI,SVN,EUR,50074,113062,163136,104127,128547,161941,160045,149610,198566,902836,47016,106992,154008,97671,110791,142559,145706,147510,255451,899688,1802524,2119675,2119675
Slovenia,2024,SI,SVN,EUR,49120,111836,160956,104966,125335,159172,162033,149761,203818,905085,46168,105620,151788,99366,108193,140226,146670,147241,259440,901136,1806221,2118965,2118965
Slovenia,2025,SI,SVN,EUR,48282,110177,158459,106179,122771,155674,164352,149427,208990,907393,45414,104025,149439,100922,106379,137052,148073,146476,263564,902466,1809859,2117762,2117762
Slovenia,2026,SI,SVN,EUR,47537,108374,155911,107723,120128,152139,166233,149111,214176,909510,44728,102225,146953,102663,104737,133747,149282,145407,267926,903762,1813272,2116129,2116129
Slovenia,2027,SI,SVN,EUR,46839,106560,153399,109653,117375,148497,167236,149144,219436,911341,44090,100464,144554,104581,103266,130403,149669,144631,272261,904811,1816152,2114109,2114109
Slovenia,2028,SI,SVN,EUR,46223,104849,151072,111481,114885,145015,167414,149387,224591,912773,43534,98783,142317,106361,102044,127108,149387,144182,276475,905557,1818330,2111727,2111727
Slovenia,2029,SI,SVN,EUR,45686,103235,148921,113025,112516,141937,166950,149831,229580,913839,43044,97182,140226,107734,101003,124086,148860,143625,280705,906013,1819852,2108994,2108994
Slovenia,2030,SI,SVN,EUR,45243,101559,146802,114270,110462,138981,166082,150237,234628,914660,42641,95610,138251,108702,100306,121171,147903,142990,285167,906239,1820899,2105945,2105945
Slovenia,1950,SI,SVN,EUR,72238,130249,202487,134015,76692,93622,77910,46863,46687,475789,70676,128828,199504,139664,99554,107707,92622,65786,61919,567252,1043041,1445033,1445033
Slovenia,1951,SI,SVN,EUR,76043,127926,203969,136166,81611,89792,79880,47527,46001,480977,74102,126784,200886,138989,105999,103937,94084,66621,63177,572807,1053784,1458637,1458637
Slovenia,1952,SI,SVN,EUR,77934,127749,205683,137229,88457,84848,81602,48569,45548,486253,75916,126683,202599,138299,113531,98915,95326,67692,64594,578357,1064610,1472894,1472894
Slovenia,1953,SI,SVN,EUR,79276,128848,208124,137003,96196,79848,83390,50011,45365,491813,77064,127594,204658,137239,120855,94030,96760,69038,66086,584008,1075821,1488604,1488604
Slovenia,1954,SI,SVN,EUR,80022,130767,210789,136178,103038,75994,85454,52001,45269,497934,77456,129226,206682,135745,126375,90743,98717,70748,67506,589834,1087768,1505245,1505245
Slovenia,1955,SI,SVN,EUR,79617,133504,213121,134891,108854,73665,87272,54548,45185,504415,76823,131737,208560,133814,130093,89395,100607,73094,68676,595679,1100094,1521772,1521772
Slovenia,1956,SI,SVN,EUR,78829,136213,215042,133636,114058,72400,88377,57507,45211,511189,75846,134415,210261,131855,132623,89515,101849,76045,69710,601597,1112786,1538081,1538081
Slovenia,1957,SI,SVN,EUR,77927,138399,216326,133221,118358,71658,89152,60603,45470,518462,74981,136474,211455,130611,133975,90357,102964,79029,70978,607914,1126376,1554148,1554148
Slovenia,1958,SI,SVN,EUR,76576,140372,216948,133359,122066,71283,89920,63614,45923,526165,73759,138141,211900,130057,134578,91544,104313,81832,72393,614717,1140882,1569730,1569730
Slovenia,1959,SI,SVN,EUR,75090,142869,217959,132952,125343,71492,90377,66513,46596,533273,72336,140578,212914,129119,134566,93189,105366,84503,74021,620764,1154037,1584908,1584908
Slovenia,1960,SI,SVN,EUR,73417,146922,220339,130811,128390,73411,89250,69259,47470,538591,71035,144633,215668,126974,133836,96671,104511,87022,75963,624977,1163568,1599571,1599571
Slovenia,1961,SI,SVN,EUR,71718,150860,222578,128968,131106,77873,85713,71694,48528,543882,69725,148012,217737,125488,132808,102772,100987,89208,78164,629427,1173309,1613624,1613624
Slovenia,1962,SI,SVN,EUR,70661,152829,223490,129434,132783,84164,80939,73567,49806,550693,68602,149243,217845,125821,131889,110019,96169,90905,80558,635361,1186054,1627384,1627384
Slovenia,1963,SI,SVN,EUR,70358,153361,223719,131289,133089,91425,76048,75121,51321,558293,68220,149064,217284,127040,130831,117136,91379,92468,83008,641862,1200155,1641161,1641161
Slovenia,1964,SI,SVN,EUR,70495,152798,223293,133776,132896,97994,72166,76545,53201,566578,68427,147993,216420,128629,129847,122488,88051,94087,85713,648815,1215393,1655107,1655107
Slovenia,1965,SI,SVN,EUR,71061,150826,221887,137007,132448,103660,69744,77523,55565,575947,68912,146114,215026,130939,128595,126103,86659,95214,89083,656593,1232540,1669453,1669453
Slovenia,1966,SI,SVN,EUR,71940,148386,220326,140398,132063,108816,68367,77918,58236,585798,69676,143871,213547,133580,127221,128633,86779,95746,92865,664824,1250622,1684505,1684505
Slovenia,1967,SI,SVN,EUR,72649,146303,218952,143440,132373,113193,67562,78261,60783,595612,70484,141953,212437,135726,126429,130053,87665,96566,96383,672822,1268434,1699820,1699820
Slovenia,1968,SI,SVN,EUR,73009,144315,217324,146385,133050,117015,67218,78680,63009,605357,70966,140214,211180,137619,126128,130745,88931,97763,99416,680602,1285959,1714458,1714458
Slovenia,1969,SI,SVN,EUR,73091,142725,215816,149676,133186,120403,67410,78873,64964,614512,70911,138851,209762,140343,125142,130896,90665,98685,102335,688066,1302578,1728167,1728167
Slovenia,2031,SI,SVN,EUR,44909,100007,144916,114928,108671,136376,164541,150738,239836,915090,42336,94021,136357,109392,99911,118501,146045,142758,289675,906282,1821372,2102637,2102637
Slovenia,2032,SI,SVN,EUR,44687,98389,143076,115083,107499,133653,162729,151776,244584,915324,42131,92446,134577,109509,100081,115785,144177,142734,293862,906148,1821472,2099124,2099124
Slovenia,2033,SI,SVN,EUR,44579,96746,141325,114559,107427,130336,160918,153375,248731,915346,42039,91003,133042,108649,101225,112794,142588,143060,297405,905721,1821067,2095434,2095434
Slovenia,2034,SI,SVN,EUR,44585,95260,139845,113337,108271,127152,158236,155441,252516,914953,42055,89665,131720,107281,102923,110208,140285,144066,300262,905025,1819978,2091539,2091539
Slovenia,2035,SI,SVN,EUR,44694,93985,138679,111680,109488,124608,154821,157792,255738,914127,42166,88510,130676,105688,104483,108403,137155,145500,302766,903995,1818122,2087470,2087470
Slovenia,2036,SI,SVN,EUR,44883,92903,137786,109876,111035,121983,151372,159709,258948,912923,42350,87520,129870,103889,106222,106770,133885,146732,305170,902668,1815591,2083249,2083249
Slovenia,2037,SI,SVN,EUR,45135,91979,137114,108065,112970,119250,147817,160782,262526,911410,42596,86684,129280,102130,108143,105307,130579,147159,307761,901079,1812489,2078881,2078881
Slovenia,2038,SI,SVN,EUR,45433,91262,136695,106357,114800,116776,144412,161052,266151,909548,42883,86032,128915,100445,109923,104091,127320,146932,310491,899202,1808750,2074358,2074358
Slovenia,2039,SI,SVN,EUR,45749,90734,136483,104747,116341,114422,141393,160690,269762,907355,43183,85561,128744,98848,111295,103057,124327,146450,313086,897063,1804418,2069646,2069646
Slovenia,2040,SI,SVN,EUR,46064,90400,136464,103071,117588,112383,138498,159939,273396,904875,43481,85265,128746,97277,112265,102364,121443,145550,315769,894668,1799543,2064752,2064752
Slovenia,2041,SI,SVN,EUR,46362,90250,136612,101519,118249,110610,135954,158538,277263,902133,43765,85147,128912,95689,112954,101975,118799,143771,318831,892019,1794152,2059689,2059689
Slovenia,2042,SI,SVN,EUR,46611,90281,136892,99907,118406,109449,133287,156892,281205,899146,44000,85194,129194,94117,113074,102148,116113,141986,321750,889188,1788334,2054419,2054419
Slovenia,2043,SI,SVN,EUR,46800,90474,137274,98264,117886,109383,130039,155250,285126,895948,44181,85388,129569,92672,112218,103295,113156,140471,324331,886143,1782091,2048934,2048934
Slovenia,2044,SI,SVN,EUR,46930,90799,137729,96780,116667,110240,126910,152770,289200,892567,44304,85701,130005,91339,110849,104996,110595,138249,326873,882901,1775468,2043204,2043204
Slovenia,2045,SI,SVN,EUR,46966,91222,138188,95506,115014,111463,124417,149575,293050,889025,44338,86109,130447,90183,109262,106558,108816,135216,329466,879501,1768526,2037161,2037161
Slovenia,2046,SI,SVN,EUR,46908,91709,138617,94424,113216,113013,121843,146343,296553,885392,44288,86581,130869,89196,107462,108300,107202,132041,331777,875978,1761370,2030851,2030851
Slovenia,2047,SI,SVN,EUR,46781,92209,138990,93505,111409,114949,119154,143002,299671,881690,44171,87063,131234,88358,105705,110217,105753,128827,333534,872394,1754084,2024309,2024309
Slovenia,2048,SI,SVN,EUR,46600,92696,139296,92784,109709,116777,116716,139787,302169,877942,44003,87527,131530,87710,104025,111999,104554,125656,334837,868781,1746723,2017553,2017553
Slovenia,2049,SI,SVN,EUR,46353,93143,139496,92258,108099,118318,114403,136949,304161,874188,43771,87951,131722,87236,102429,113375,103538,122748,335829,865155,1739343,2010553,2010553
Slovenia,2050,SI,SVN,EUR,46041,93494,139535,91926,106431,119567,112400,134226,305892,870442,43475,88285,131760,86943,100860,114344,102858,119947,336579,861531,1731973,2003258,2003258
Sweden,1970,SE,SWE,EUR,298760,560439,859199,617607,565125,464314,525769,485352,490334,3148501,282795,531011,813806,590601,527399,455871,523182,499744,609401,3206198,6354699,8027702,8027702
Sweden,1971,SE,SWE,EUR,293072,568929,862001,605558,591220,460178,522824,486268,501078,3167126,277539,539497,817036,579522,550712,450474,520931,500015,626008,3227662,6394788,8073819,8073819
Sweden,1972,SE,SWE,EUR,288279,576955,865234,594046,614688,459051,517879,485978,511990,3183632,273164,547366,820530,568837,572270,448053,516900,499622,642631,3248313,6431945,8117716,8117716
Sweden,1973,SE,SWE,EUR,285059,582988,868047,583217,634545,460071,512834,484231,522911,3197809,270254,553188,823442,558556,591535,447358,512679,498141,659369,3267638,6465447,8156939,8156939
Sweden,1974,SE,SWE,EUR,284913,585995,870908,573935,649846,463768,507524,480769,534133,3209975,270197,556374,826571,549222,607167,449168,508573,494969,676596,3285695,6495670,8193154,8193154
Sweden,1975,SE,SWE,EUR,284200,588864,873064,566400,661336,468823,496570,481964,545082,3220175,269638,559306,828944,541971,619579,451951,498837,496841,693048,3302227,6522402,8224408,8224408
Sweden,1976,SE,SWE,EUR,279019,593173,872192,561622,668835,474910,482452,486437,554610,3228866,264925,563451,828376,537610,628479,455533,485431,502618,707888,3317559,6546425,8246995,8246995
Sweden,1977,SE,SWE,EUR,271180,596744,867924,559887,669925,486202,471745,486631,564117,3238507,257732,566959,824691,535871,631668,464179,474974,504196,723227,3334115,6572622,8265242,8265242
Sweden,1978,SE,SWE,EUR,262912,597108,860020,560456,664879,504588,462421,484590,573637,3250571,250124,567581,817705,536194,629060,479959,465747,503320,738717,3352997,6603568,8281299,8281299
Sweden,1979,SE,SWE,EUR,254983,593324,848307,565944,654153,528382,453546,482084,581785,3265894,242809,564220,807029,541129,621042,501146,456744,501641,753095,3374797,6640691,8296033,8296033
Sweden,1980,SE,SWE,EUR,249311,585726,835037,574672,640707,553838,446672,479540,588290,3283719,237524,557174,794698,549014,610351,524257,449092,499775,765823,3398312,6682031,8311763,8311763
Sweden,1981,SE,SWE,EUR,246171,574938,821109,582984,628224,578303,442525,476510,593767,3302313,234586,547205,781791,556403,599681,547090,443935,497688,776673,3421470,6723783,8326687,8326687
Sweden,1982,SE,SWE,EUR,244130,562584,806714,591036,616863,600643,441445,471878,599391,3321256,232644,535719,768363,563237,589462,568447,441703,494000,787540,3444389,6765645,8340723,8340723
Sweden,1983,SE,SWE,EUR,243179,551441,794620,597337,606535,619905,442586,467281,604688,3338332,231501,525284,756785,568338,579574,587692,441110,490335,798332,3465381,6803713,8355107,8355107
Sweden,1984,SE,SWE,EUR,242900,543675,786575,600819,597904,635218,446501,462567,609553,3352562,230827,517976,748803,571181,570610,603472,443001,486786,808299,3483349,6835911,8371290,8371290
Sweden,1985,SE,SWE,EUR,243505,537841,781346,604080,591255,647340,451878,453007,618037,3365597,230971,512392,743363,573889,563799,616202,445908,477913,821893,3499604,6865201,8389913,8389913
Sweden,1986,SE,SWE,EUR,246572,530337,776909,608602,587526,655938,458261,440927,628466,3379720,233533,505261,738794,577774,559888,625610,449664,465677,837754,3516367,6896087,8411791,8411791
Sweden,1987,SE,SWE,EUR,252170,521400,773570,612228,586799,658586,469722,432084,635581,3395000,238815,496730,735545,581072,558524,629580,458400,456180,850129,3533885,6928885,8437994,8437994
Sweden,1988,SE,SWE,EUR,260642,513260,773902,612385,588334,655527,488185,424312,640287,3409030,246968,488620,735588,581561,559141,628002,474079,447822,859015,3549620,6958650,8468137,8468137
Sweden,1989,SE,SWE,EUR,271386,506210,777596,608200,594636,647043,512029,416944,644672,3423524,257229,481399,738628,578094,564350,621222,495092,439760,866713,3565231,6988755,8504982,8504982
Sweden,1990,SE,SWE,EUR,282981,502481,785462,599915,604029,635851,537482,411599,648410,3437286,268401,477275,745676,570932,572485,611929,518106,432993,873537,3579982,7017268,8548406,8548406
Sweden,1991,SE,SWE,EUR,294183,503900,798083,588291,612751,625503,561827,408720,650377,3447469,279072,478152,757224,560890,580083,602675,540851,428522,878367,3591388,7038857,8594171,8594171
Sweden,1992,SE,SWE,EUR,303477,508994,812471,575210,620870,616228,584086,408610,651075,3456079,287691,482841,770532,549450,587247,593900,562121,426834,881634,3601186,7057265,8640272,8640272
Sweden,1993,SE,SWE,EUR,308554,518083,826637,563555,627039,607811,603339,410666,651142,3463552,292676,491173,783849,539158,592986,585504,581363,426761,883597,3609369,7072921,8683405,8683405
Sweden,1994,SE,SWE,EUR,307857,530074,837931,555581,630204,600841,618785,415358,651427,3472196,292554,501961,794515,532185,596714,578085,597253,429016,885564,3618817,7091013,8723460,8723460
Sweden,1995,SE,SWE,EUR,300809,543535,844344,550152,632799,595774,631075,421394,651826,3483020,286187,514286,800473,527372,600241,572967,610199,432155,887720,3630654,7113674,8758496,8758496
Sweden,1996,SE,SWE,EUR,288126,558719,846845,543760,636465,593603,639886,428393,651767,3493874,274444,528317,802761,521414,604953,570855,619912,436173,888708,3642015,7135889,8785494,8785494
Sweden,1997,SE,SWE,EUR,272871,573985,846856,536460,639373,594374,643038,440200,651662,3505107,260244,542682,802926,514324,609214,571297,624400,445042,888706,3652983,7158090,8807869,8807869
Sweden,1998,SE,SWE,EUR,258020,587342,845362,530387,639090,597400,640908,458586,650878,3517249,245913,555940,801853,507925,610733,573685,623680,460570,887579,3664172,7181421,8828633,8828633
Sweden,1999,SE,SWE,EUR,245717,596898,842615,525722,634946,605002,633748,481974,649514,3530906,233680,566059,799739,502645,608374,580480,618040,481159,884917,3675615,7206521,8848876,8848876
Sweden,2000,SE,SWE,EUR,237554,600805,838359,524388,627416,615596,623932,506927,649434,3547693,225470,570791,796261,500502,602530,590080,609963,503547,882113,3688735,7236428,8871043,8871043
Sweden,2001,SE,SWE,EUR,234337,598625,832962,527974,617380,625506,614956,530830,651324,3567970,221934,569620,791554,503271,594125,599121,601896,525649,880203,3704265,7272235,8896748,8896748
Sweden,2002,SE,SWE,EUR,235528,592048,827576,534874,606716,634708,607101,552646,654465,3590510,222671,563938,786609,509670,584667,607639,594250,546464,878623,3721313,7311823,8926012,8926012
Sweden,2003,SE,SWE,EUR,239912,581978,821890,545429,598160,642032,600042,571631,659136,3616430,226803,554547,781350,519511,576674,614683,586955,565310,878698,3741831,7358261,8961506,8961506
Sweden,2004,SE,SWE,EUR,245923,569395,815318,558512,593792,646581,594339,587083,666574,3646881,232665,542436,775101,531657,572217,619728,580698,580905,881757,3766962,7413843,9004263,9004263
Sweden,2005,SE,SWE,EUR,252256,555089,807345,572878,592537,650712,590539,599472,675085,3681223,238922,528447,767369,545137,570443,624467,576723,593594,885440,3795804,7477027,9051738,9051738
Sweden,2006,SE,SWE,EUR,259181,540168,799349,589107,590878,656128,589601,608457,684400,3718571,245707,514058,759765,560199,568051,630410,575598,603203,889565,3827026,7545597,9104719,9104719
Sweden,2007,SE,SWE,EUR,266417,527461,793878,605526,588599,661213,591549,612155,698332,3757374,252531,501910,754441,575548,564846,636165,576999,607997,897020,3858575,7615949,9164272,9164272
Sweden,2008,SE,SWE,EUR,272728,518931,791659,620401,587715,663443,595827,611027,717655,3796068,258271,493374,751645,589896,562723,639430,580458,607867,909531,3889905,7685973,9229271,9229271
Sweden,2009,SE,SWE,EUR,278737,515031,793768,632370,588259,662294,604650,605319,741198,3834090,263715,488813,752528,601583,561937,639231,588309,603060,926905,3921025,7755115,9301413,9301413
Sweden,2010,SE,SWE,EUR,285484,515811,801295,639869,591996,658348,616599,597084,767088,3870984,269915,488818,758733,608508,564329,636072,599062,596002,946749,3950722,7821706,9381729,9381729
Sweden,2011,SE,SWE,EUR,291041,522235,813276,642459,600468,652258,628175,589699,793238,3906297,275142,494192,769334,610092,571639,630745,609467,589079,967468,3978490,7884787,9467388,9467388
Sweden,2012,SE,SWE,EUR,294647,533449,828096,641686,612086,645676,639175,583538,818478,3940639,278619,504055,782674,607581,582566,624661,619445,582591,987736,4004580,7945219,9555987,9555987
Sweden,2013,SE,SWE,EUR,297766,546742,844508,638466,627074,641131,648579,578079,842597,3975926,281628,516464,798092,601541,596894,620161,628112,576395,1007309,4030412,8006338,9648932,9648932
Sweden,2014,SE,SWE,EUR,300378,560753,861131,633731,644395,640680,655483,573913,865657,4013859,284158,530362,814520,592747,613506,619128,634914,571235,1026465,4057995,8071854,9747508,9747508
Sweden,2015,SE,SWE,EUR,302179,575815,877994,627003,663010,643337,662015,571641,886373,4053379,285594,545341,830935,581866,631243,620859,641460,568328,1043284,4087040,8140419,9849349,9849349
Sweden,2016,SE,SWE,EUR,304439,590888,895327,618272,683734,645527,669806,572075,904265,4093679,287334,559834,847168,570130,650406,621962,649243,568124,1057276,4117141,8210820,9953317,9953317
Sweden,2017,SE,SWE,EUR,306978,604594,911572,610534,704755,646877,677324,575282,920875,4135647,289593,572499,862092,560180,669649,621893,656831,570319,1070002,4148874,8284521,10058190,10058190
Sweden,2018,SE,SWE,EUR,308424,616893,925317,606079,723994,649437,681930,580799,937449,4179688,290998,583383,874381,553483,687369,622627,661821,574628,1082982,4182910,8362598,10162298,10162298
Sweden,2019,SE,SWE,EUR,308895,628121,937016,605709,739850,653163,683041,590729,953855,4226347,291568,593197,884765,550398,701867,624280,663314,583328,1096599,4219786,8446133,10267922,10267922
Sweden,2020,SE,SWE,EUR,307909,638761,946670,609415,750394,659723,681162,603531,968151,4272376,290969,602342,893311,551568,710833,628649,661651,594884,1109028,4256613,8528989,10368969,10368969
Sweden,2021,SE,SWE,EUR,306036,648172,954208,618133,754834,670730,676640,615753,982214,4318304,289439,610495,899934,557983,713364,637745,657377,606057,1122117,4294643,8612947,10467097,10467097
Sweden,2022,SE,SWE,EUR,303231,652206,955437,628646,751846,683587,670775,627347,998981,4361182,286820,614407,901227,568151,708726,649398,651479,616593,1137163,4331510,8692692,10549347,10549347
Sweden,2023,SE,SWE,EUR,299880,650995,950875,637903,743234,698291,666166,637282,1016119,4398995,283720,614021,897741,579918,697999,663168,646377,625456,1151560,4364478,8763473,10612086,10612086
Sweden,2024,SE,SWE,EUR,297224,648131,945355,646265,733743,714660,665279,644581,1032491,4437019,281316,612088,893404,592613,684373,678778,644533,632243,1165356,4397896,8834915,10673669,10673669
Sweden,2025,SE,SWE,EUR,295710,643077,938787,654061,722693,731755,667207,651364,1048157,4475237,280060,607645,887705,605698,668767,695044,645293,638596,1178733,4432131,8907368,10733867,10733867
Sweden,2026,SE,SWE,EUR,294742,637870,932612,660171,710194,750337,668463,659323,1063490,4511978,279315,602428,881743,617548,652800,712177,645202,646071,1192082,4465880,8977858,10792212,10792212
Sweden,2027,SE,SWE,EUR,293624,633418,927042,665050,698490,768261,668590,666921,1079735,4547047,278393,598033,876426,626733,639376,728772,643676,653332,1206350,4498239,9045286,10848755,10848755
Sweden,2028,SE,SWE,EUR,292438,628572,921010,670024,689282,783435,669474,671503,1097818,4581536,277356,593801,871157,633463,630161,743238,642667,657860,1222437,4529826,9111362,10903539,10903539
Sweden,2029,SE,SWE,EUR,291188,623349,914537,674349,684125,794307,671365,672488,1118740,4615374,276242,589344,865586,638732,625311,753944,642509,658820,1241551,4560867,9176241,10956367,10956367
Sweden,2030,SE,SWE,EUR,289934,617759,907693,678380,682907,799275,676028,670466,1141421,4648477,275112,584708,859820,643076,625001,758797,645221,656576,1262562,4591233,9239710,11007228,11007228
Sweden,1950,SE,SWE,EUR,317674,518610,836284,444808,545277,547323,452271,337153,332288,2659120,301756,497350,799106,436185,532436,537306,464921,367025,382229,2720102,5379222,7014610,7014610
Sweden,1951,SE,SWE,EUR,308277,542596,850873,439211,542155,548302,460681,343098,338942,2672389,292624,519414,812038,431017,529897,537159,472303,372946,389813,2733135,5405524,7068426,7068426
Sweden,1952,SE,SWE,EUR,298397,564195,862592,436687,536940,547979,469900,349021,346359,2686886,282805,539202,822007,428864,525568,536306,480261,378262,398703,2747964,5434850,7119452,7119452
Sweden,1953,SE,SWE,EUR,290029,582760,872789,436241,531467,546087,479480,355344,353943,2702562,274198,556405,830603,428511,520935,534218,488420,384006,407933,2764023,5466585,7169975,7169975
Sweden,1954,SE,SWE,EUR,282340,597667,880007,438550,525704,542188,490091,362534,360604,2719671,266287,569875,836162,430847,516254,530275,497226,390533,416617,2781752,5501423,7217595,7217595
Sweden,1955,SE,SWE,EUR,276339,609562,885901,442517,513900,543276,499934,370740,367058,2737425,260443,580263,840706,434272,505816,531660,504677,398013,425874,2800312,5537737,7264351,7264351
Sweden,1956,SE,SWE,EUR,273724,618061,891785,447680,498675,548125,507433,379416,374185,2755514,257903,587469,845372,438451,491790,537227,509863,405993,436116,2819440,5574954,7312105,7312105
Sweden,1957,SE,SWE,EUR,272574,620411,892985,458409,487211,548416,514249,388259,380824,2777368,256828,588975,845803,447804,480970,538343,514882,414231,445747,2841977,5619345,7358120,7358120
Sweden,1958,SE,SWE,EUR,270882,616601,887483,476760,477375,546268,521051,396705,387558,2805717,255350,584668,840018,464355,471475,536837,519761,422208,455441,2870077,5675794,7403292,7403292
Sweden,1959,SE,SWE,EUR,269817,607021,876838,500935,468226,543727,526684,405158,395110,2839840,254376,575215,829591,486144,462292,534581,524032,429665,466336,2903050,5742890,7449323,7449323
Sweden,1960,SE,SWE,EUR,268481,594665,863146,527200,461282,541450,529876,413300,402596,2875704,253220,563583,816803,509631,454506,532343,526159,437192,477412,2937243,5812947,7492895,7492895
Sweden,1961,SE,SWE,EUR,266283,583275,849558,552640,457356,538761,530930,421143,410611,2911441,251480,552518,803998,532399,449238,530022,526097,444835,488710,2971301,5882742,7536310,7536310
Sweden,1962,SE,SWE,EUR,265521,572935,838456,576109,456824,534136,530771,429766,418551,2946157,251031,542311,793342,553319,447032,525932,525386,452994,500014,3004677,5950834,7582635,7582635
Sweden,1963,SE,SWE,EUR,267722,563522,831244,596760,458704,529422,529157,438607,426304,2978954,253231,532901,786132,572001,446587,521560,523464,461264,511729,3036605,6015559,7632931,7632931
Sweden,1964,SE,SWE,EUR,274444,555535,829979,613626,463564,524526,525632,448395,434444,3010187,259796,524703,784499,587208,448746,517185,519692,470052,524272,3067155,6077342,7691823,7691823
Sweden,1965,SE,SWE,EUR,284756,549071,833827,627299,470155,513710,526965,457616,442988,3038733,269637,518575,788212,599463,451997,507026,521233,477563,537697,3094979,6133712,7755752,7755752
Sweden,1966,SE,SWE,EUR,295571,545138,840709,637465,478047,499495,531999,464774,452494,3064274,279807,515219,795026,608589,456087,493206,527002,482951,552128,3119963,6184237,7819971,7819971
Sweden,1967,SE,SWE,EUR,304672,544072,848744,641389,491297,488846,532555,471219,462433,3087739,288346,514494,802840,612109,465286,482505,528451,488138,566829,3143318,6231057,7882644,7882644
Sweden,1968,SE,SWE,EUR,308820,545234,854054,638835,511753,479668,530625,477473,471664,3110018,292272,515906,808178,609635,481720,473051,527243,493190,580696,3165535,6275553,7937776,7937776
Sweden,1969,SE,SWE,EUR,305536,551305,856841,629926,537664,471025,528165,482505,480439,3129724,289179,522000,811179,601541,503606,463777,525232,497491,594153,3185800,6315524,7983535,7983535
Sweden,2031,SE,SWE,EUR,288827,611799,900626,681400,686542,798031,685065,665877,1163802,4680717,274114,579620,853734,646279,629951,757220,652652,651741,1283194,4621037,9301754,11056111,11056111
Sweden,2032,SE,SWE,EUR,288086,606282,894368,682292,694496,792224,696979,660297,1185072,4711360,273456,574647,848103,647709,639363,750592,663440,645774,1302847,4649725,9361085,11103547,11103547
Sweden,2033,SE,SWE,EUR,287656,601755,889411,681102,703763,783748,711688,656181,1203503,4739985,273091,570516,843607,647334,651117,739929,677205,640989,1320056,4676630,9416615,11149630,11149630
Sweden,2034,SE,SWE,EUR,287616,597857,885473,678256,712139,774392,728039,655635,1218461,4766922,273092,567007,840099,645414,663807,726373,692806,639369,1334201,4701970,9468892,11194469,11194469
Sweden,2035,SE,SWE,EUR,288256,595094,883350,673230,719945,763489,745123,657824,1232157,4791768,273731,564628,838359,640982,676885,710856,709067,640317,1347170,4725277,9517045,11238752,11238752
Sweden,2036,SE,SWE,EUR,289598,593024,882622,668046,726082,751143,763682,659380,1246760,4815093,275029,562891,837920,635783,688730,694977,726185,640449,1360973,4747097,9562190,11282736,11282736
Sweden,2037,SE,SWE,EUR,291362,591173,882535,663614,730984,739584,781575,659861,1262169,4837787,276728,561318,838046,631400,697914,681636,742760,639189,1375343,4768242,9606029,11326611,11326611
Sweden,2038,SE,SWE,EUR,293425,589564,882989,658790,735984,730506,796729,661071,1276829,4859909,278712,559921,838633,627184,704649,672489,757209,638435,1388816,4788782,9648691,11370307,11370307
Sweden,2039,SE,SWE,EUR,295769,588284,884053,653587,740334,725450,807601,663265,1291209,4881446,280958,558813,839771,622739,709927,667693,767911,638531,1401942,4808743,9690189,11414013,11414013
Sweden,2040,SE,SWE,EUR,298172,587672,885844,648023,744395,724305,812616,668180,1304998,4902517,283260,558327,841587,618116,714280,667423,772783,641448,1414120,4828170,9730687,11458122,11458122
Sweden,2041,SE,SWE,EUR,300528,587911,888439,642092,747448,727989,811465,677342,1316740,4923076,285509,558631,844140,613039,717495,672395,771263,648990,1423853,4847035,9770111,11502693,11502693
Sweden,2042,SE,SWE,EUR,302699,588938,891637,636601,748384,735963,805786,689291,1327131,4943156,287577,559675,847252,608077,718942,681814,764714,659828,1432114,4865489,9808645,11547531,11547531
Sweden,2043,SE,SWE,EUR,304718,590575,895293,632093,747244,745243,797464,703952,1336859,4962855,289489,561299,850788,603963,718591,693572,754159,673587,1439766,4883638,9846493,11592573,11592573
Sweden,2044,SE,SWE,EUR,306543,592886,899429,628220,744457,753634,788283,720233,1347375,4982202,291215,563556,854771,600468,716690,706256,740743,689161,1448208,4901526,9883728,11637925,11637925
Sweden,2045,SE,SWE,EUR,308030,595928,903958,625476,739500,761465,777583,737263,1359902,5001189,292626,566496,859122,598096,712290,719329,725387,705406,1458708,4919216,9920405,11683489,11683489
Sweden,2046,SE,SWE,EUR,309075,599629,908704,623420,734379,767631,765471,755739,1373123,5019763,293627,570049,863676,596370,707117,731177,709686,722501,1469871,4936722,9956485,11728859,11728859
Sweden,2047,SE,SWE,EUR,309637,603568,913205,621586,730011,772571,754142,773527,1386327,5038164,294179,573815,867994,594806,702760,740365,696517,739032,1480775,4954255,9992419,11773615,11773615
Sweden,2048,SE,SWE,EUR,309693,607654,917347,619991,725247,777604,745270,788586,1399664,5056362,294254,577717,871971,593418,698570,747115,687522,753436,1491785,4971846,10028208,11817527,11817527
Sweden,2049,SE,SWE,EUR,309208,611825,921033,618722,720110,781996,740383,799415,1413771,5074397,293808,581693,875501,592321,694152,752413,682852,764119,1503613,4989470,10063867,11860397,11860397
Sweden,2050,SE,SWE,EUR,308202,615716,923918,618126,714616,786095,739370,804484,1429824,5092515,292865,585410,878275,591843,689557,756788,682678,769039,1517417,5007322,10099837,11902033,11902033
Eswatini,1970,SZ,SWZ,AFR,42947,62573,105520,41809,24432,15868,11288,7598,5412,106407,42422,63585,106007,46471,27995,19248,14258,9769,7181,124922,231329,442865,442865
Eswatini,1971,SZ,SWZ,AFR,44465,64063,108528,42373,25354,16358,11351,7691,5564,108691,43920,65271,109191,48048,29011,19554,14482,9998,7414,128507,237198,454913,454913
Eswatini,1972,SZ,SWZ,AFR,46101,65702,111803,42857,26269,16913,11421,7780,5704,110944,45533,67050,112583,49548,30155,19883,14705,10226,7656,132173,243117,467512,467512
Eswatini,1973,SZ,SWZ,AFR,47789,67524,115313,43359,27133,17540,11507,7870,5859,113268,47191,68963,116154,51016,31402,20232,14930,10447,7900,135927,249195,480668,480668
Eswatini,1974,SZ,SWZ,AFR,49572,69580,119152,43748,28124,18210,11623,7961,6003,115669,48941,71061,120002,52357,32873,20599,15158,10665,8148,139800,255469,494624,494624
Eswatini,1975,SZ,SWZ,AFR,51482,71869,123351,44040,29285,18911,11782,8043,6149,118210,50812,73357,124169,53546,34597,20987,15397,10880,8402,143809,262019,509535,509535
Eswatini,1976,SZ,SWZ,AFR,53458,74410,127868,44531,30382,19653,11990,8128,6294,120978,52745,75853,128598,54758,36402,21437,15651,11092,8678,148018,268996,525457,525457
Eswatini,1977,SZ,SWZ,AFR,55412,77189,132601,45443,31424,20497,12263,8178,6437,124242,54687,78539,133226,56133,38130,21942,15818,11267,8966,152256,276498,542328,542328
Eswatini,1978,SZ,SWZ,AFR,57379,80118,137497,46877,32407,21428,12611,8205,6571,128099,56657,81338,137995,57728,39776,22539,15919,11409,9279,156650,284749,560236,560236
Eswatini,1979,SZ,SWZ,AFR,59354,83205,142559,48614,33292,22386,13038,8237,6710,132277,58613,84312,142925,59472,41384,23275,16058,11542,9598,161329,293606,579091,579091
Eswatini,1980,SZ,SWZ,AFR,61279,86448,147727,50512,34109,23385,13524,8266,6851,136647,60509,87513,148022,61343,42897,24143,16197,11659,9927,166166,302813,598564,598564
Eswatini,1981,SZ,SWZ,AFR,62951,89328,152279,51852,34879,24525,13998,8188,6981,140423,62197,90786,152983,63411,44024,25000,16135,11703,10259,170532,310955,616210,616210
Eswatini,1982,SZ,SWZ,AFR,64603,92357,156960,53320,35579,25670,14567,8111,7103,144350,63846,94163,158009,65628,45099,25975,16118,11709,10594,175123,319473,634439,634439
Eswatini,1983,SZ,SWZ,AFR,66432,95930,162362,55678,36267,26652,15315,8147,7217,149276,65594,97640,163234,67929,46498,27184,16374,11733,10911,180629,329905,655505,655505
Eswatini,1984,SZ,SWZ,AFR,68291,99529,167820,58250,36886,27751,16107,8216,7323,154533,67375,101164,168539,70367,47834,28580,16675,11749,11215,186420,340953,677303,677303
Eswatini,1985,SZ,SWZ,AFR,70440,103645,174085,61688,37429,28901,17024,8436,7423,160901,69392,104868,174260,72862,49391,30334,17232,11825,11509,193153,354054,702400,702400
Eswatini,1986,SZ,SWZ,AFR,72526,108167,180693,65818,38303,29956,18036,8799,7530,168442,71338,108802,180140,75505,51335,32268,18009,11974,11788,200879,369321,730150,730150
Eswatini,1987,SZ,SWZ,AFR,74338,112620,186958,69947,39725,31019,19056,9217,7624,176588,73075,112878,185953,78383,53517,34225,18818,12177,12044,209164,385752,758669,758669
Eswatini,1988,SZ,SWZ,AFR,76190,117327,193517,75033,42638,32516,20323,9817,7733,188060,74871,117259,192130,82323,56985,36682,19920,12514,12291,220715,408775,794434,794434
Eswatini,1989,SZ,SWZ,AFR,77802,121993,199795,79296,45145,33554,21434,10415,7850,197694,76449,121613,198062,85444,59806,38783,20992,12840,12535,230400,428094,825952,825952
Eswatini,1990,SZ,SWZ,AFR,79128,126526,205654,83023,47364,34211,22417,11013,7976,206004,77748,125855,203603,88087,62077,40586,22073,13164,12761,238748,444752,854011,854011
Eswatini,1991,SZ,SWZ,AFR,80535,131098,211633,87912,51111,35406,23645,11784,8115,217973,79124,130163,209287,92110,65643,42948,23496,13631,12983,250811,468784,889712,889712
Eswatini,1992,SZ,SWZ,AFR,81994,135455,217449,92658,55049,36563,24807,12600,8270,229947,80561,134274,214835,96123,69155,45286,25014,14150,13204,262932,492879,925165,925165
Eswatini,1993,SZ,SWZ,AFR,83191,139425,222616,96266,58067,37222,25621,13331,8435,238942,81744,138026,219770,99033,71525,47146,26382,14627,13413,272126,511068,953451,953451
Eswatini,1994,SZ,SWZ,AFR,83101,142611,225712,95856,56811,35609,25503,13619,8586,235984,81657,141002,222659,97715,69381,46867,27065,14776,13579,269383,505367,953737,953737
Eswatini,1995,SZ,SWZ,AFR,82015,145582,227597,96245,55774,33914,25438,13877,8716,233964,80599,143806,224405,97338,67272,46445,27893,14940,13716,267604,501568,953573,953573
Eswatini,1996,SZ,SWZ,AFR,80789,148624,229413,100540,58274,34032,25945,14420,8860,242071,79416,146763,226179,101224,68604,47559,29319,15381,13834,275921,517992,973587,973587
Eswatini,1997,SZ,SWZ,AFR,78919,150891,229810,103655,60458,34773,26302,14847,9027,249062,77915,149902,227817,105375,69447,48635,30611,16018,13965,284051,533113,990734,990734
Eswatini,1998,SZ,SWZ,AFR,76801,152346,229147,106154,62276,35926,26658,15330,9213,255557,76177,152533,228710,109532,69820,49606,31784,16873,14134,291749,547306,1005158,1005158
Eswatini,1999,SZ,SWZ,AFR,75193,153105,228298,109259,63990,36998,26973,15920,9434,262574,74614,153872,228486,113543,70177,50375,32826,17766,14326,299013,561587,1018370,1018370
Eswatini,2000,SZ,SWZ,AFR,74518,152685,227203,112224,65634,38203,27158,16469,9679,269367,73915,154057,227972,117483,70656,50937,33685,18667,14531,305959,575326,1030496,1030496
Eswatini,2001,SZ,SWZ,AFR,74528,151363,225891,114978,67190,39491,27218,16948,9948,275773,73845,153340,227185,121209,71333,51313,34388,19543,14761,312547,588320,1041396,1041396
Eswatini,2002,SZ,SWZ,AFR,74605,149748,224353,117450,68674,40746,27169,17337,10243,281619,73864,152268,226132,124638,72281,51441,34938,20380,15022,318700,600319,1050809,1050809
Eswatini,2003,SZ,SWZ,AFR,74773,147928,222701,119603,70127,41961,27087,17609,10548,286935,74018,150918,224936,127724,73448,51284,35341,21129,15312,324238,611173,1058797,1058797
Eswatini,2004,SZ,SWZ,AFR,74999,145935,220934,121553,71572,43162,26933,17894,10846,291960,74228,149371,223599,130567,74808,50877,35537,21874,15602,329265,621225,1065764,1065764
Eswatini,2005,SZ,SWZ,AFR,75228,143963,219191,123134,73073,44306,26728,18233,11139,296613,74433,147813,222246,133022,76429,50271,35541,22656,15911,333830,630443,1071886,1071886
Eswatini,2006,SZ,SWZ,AFR,75552,142042,217594,124251,74734,45378,26650,18486,11437,300936,74715,146252,220967,135004,78457,49640,35525,23370,16249,338245,639181,1077735,1077735
Eswatini,2007,SZ,SWZ,AFR,76090,140025,216115,125252,76569,46360,26743,18638,11743,305305,75176,144498,219674,136823,80889,49060,35550,23983,16608,342913,648218,1084008,1084008
Eswatini,2008,SZ,SWZ,AFR,76642,138068,214710,126349,78836,47218,27065,18832,12053,310353,75621,142218,217839,137676,83350,48540,35831,24553,17026,346976,657329,1089870,1089870
Eswatini,2009,SZ,SWZ,AFR,76968,136446,213414,127192,81551,48086,27590,19086,12395,315900,75855,139790,215645,137220,85641,48117,36296,25126,17531,349931,665831,1094886,1094886
Eswatini,2010,SZ,SWZ,AFR,77041,135700,212741,127029,84362,49107,28251,19306,12766,320821,75874,138309,214183,135712,87962,47938,36742,25696,18118,352168,672989,1099920,1099920
Eswatini,2011,SZ,SWZ,AFR,76995,135671,212666,126092,87136,50258,29032,19510,13173,325201,75807,137598,213405,133411,90271,48112,37214,26298,18787,354093,679294,1105371,1105371
Eswatini,2012,SZ,SWZ,AFR,76938,135833,212771,124952,89832,51605,29909,19721,13615,329634,75747,137192,212939,130865,92432,48636,37657,26960,19549,356099,685733,1111444,1111444
Eswatini,2013,SZ,SWZ,AFR,76712,136267,212979,123690,92440,53200,30903,19984,14070,334287,75524,137187,212711,128187,94434,49541,38081,27699,20392,358334,692621,1118319,1118319
Eswatini,2014,SZ,SWZ,AFR,76254,136770,213024,122323,95063,55076,32025,20261,14600,339348,75073,137352,212425,125493,96400,50861,38511,28466,21340,361071,700419,1125865,1125865
Eswatini,2015,SZ,SWZ,AFR,75726,137076,212802,121010,97536,57291,33234,20554,15222,344847,74546,137397,211943,122968,98158,52626,38926,29244,22420,364342,709189,1133936,1133936
Eswatini,2016,SZ,SWZ,AFR,75152,137340,212492,119707,99716,59869,34519,20952,15864,350627,73971,137441,211412,120585,99567,54844,39339,30098,23567,368000,718627,1142524,1142524
Eswatini,2017,SZ,SWZ,AFR,74356,137724,212080,118183,101808,62745,35854,21486,16502,356578,73174,137634,210808,118122,100850,57444,39753,31018,24744,371931,728509,1151390,1151390
Eswatini,2018,SZ,SWZ,AFR,73340,138141,211481,116625,103738,65868,37211,22153,17130,362725,72166,137895,210061,115743,101932,60358,40164,32009,25961,376167,738892,1160428,1160428
Eswatini,2019,SZ,SWZ,AFR,72260,138387,210647,115386,105206,69219,38650,22939,17761,369161,71074,138008,209082,113781,102500,63532,40676,33024,27215,380728,749889,1169613,1169613
Eswatini,2020,SZ,SWZ,AFR,71392,138666,210058,115533,105812,72585,40079,23620,18231,375860,70147,138217,208364,113442,102587,66892,41269,33806,28381,386377,762237,1180655,1180655
Eswatini,2021,SZ,SWZ,AFR,70695,139028,209723,116832,105718,75715,41380,24097,18360,382102,69374,138545,207919,114479,102362,70242,41910,34276,29248,392517,774619,1192271,1192271
Eswatini,2022,SZ,SWZ,AFR,70046,139372,209418,118318,105023,78315,42519,24356,18222,386753,68640,138851,207491,115954,101889,73319,42587,34406,29859,398014,784767,1201670,1201670
Eswatini,2023,SZ,SWZ,AFR,69485,139581,209066,120173,103932,80488,43668,24581,18143,390985,67997,138988,206985,118031,101350,76169,43406,34327,30494,403777,794762,1210822,1210822
Eswatini,2024,SZ,SWZ,AFR,68981,139510,208491,122190,102997,82764,45195,25085,18418,396649,67464,138741,206205,120314,100862,79091,44635,34361,31463,410726,807375,1222075,1222075
Eswatini,2025,SZ,SWZ,AFR,68592,139385,207977,124064,102371,84960,47071,25767,18900,403133,67071,138362,205433,122485,100585,81900,46290,34428,32628,418316,821449,1234858,1234858
Eswatini,2026,SZ,SWZ,AFR,68309,139172,207481,125879,101941,86829,49198,26486,19388,409721,66803,137865,204668,124605,100444,84418,48327,34459,33768,426021,835742,1247889,1247889
Eswatini,2027,SZ,SWZ,AFR,68203,138722,206925,127790,101521,88590,51526,27221,19891,416539,66719,137118,203837,126818,100252,86859,50698,34474,34873,433974,850513,1261280,1261280
Eswatini,2028,SZ,SWZ,AFR,68252,138077,206329,129731,101308,90212,54026,27976,20419,423672,66775,136197,202972,129043,100209,89183,53370,34470,35946,442221,865893,1275188,1275188
Eswatini,2029,SZ,SWZ,AFR,68374,137399,205773,131547,101680,91472,56707,28805,20977,431188,66906,135269,202175,131108,100707,91137,56337,34570,36970,450829,882017,1289962,1289962
Eswatini,2030,SZ,SWZ,AFR,68578,136810,205388,133182,103190,91989,59477,29759,21563,439160,67120,134466,201586,132948,102327,92301,59494,34856,37923,459849,899009,1305985,1305985
Eswatini,1950,SZ,SWZ,AFR,24482,33492,57974,25204,18675,13241,8783,5300,3029,74232,24717,34574,59291,26198,19555,14103,9588,6457,4246,80147,154379,271642,271642
Eswatini,1951,SZ,SWZ,AFR,25726,34441,60167,25567,18828,13444,8957,5419,3147,75362,25825,35553,61378,26673,19855,14383,9812,6540,4392,81655,157017,278562,278562
Eswatini,1952,SZ,SWZ,AFR,26873,35485,62358,25975,18965,13643,9132,5543,3262,76520,26837,36627,63464,27183,20158,14671,10051,6622,4538,83223,159743,285562,285562
Eswatini,1953,SZ,SWZ,AFR,27976,36588,64564,26415,19089,13828,9310,5669,3376,77687,27790,37773,65563,27718,20460,14959,10298,6702,4686,84823,162510,292637,292637
Eswatini,1954,SZ,SWZ,AFR,28846,37975,66821,26869,19207,14006,9486,5791,3488,78847,28574,39136,67710,28260,20765,15241,10544,6792,4826,86428,165275,299805,299805
Eswatini,1955,SZ,SWZ,AFR,29443,39692,69135,27333,19328,14163,9660,5904,3604,79992,29157,40752,69909,28801,21073,15511,10797,6899,4964,88045,168037,307078,307078
Eswatini,1956,SZ,SWZ,AFR,30007,41480,71487,27817,19447,14302,9821,6021,3719,81127,29704,42441,72145,29365,21384,15773,11040,7024,5099,89685,170812,314445,314445
Eswatini,1957,SZ,SWZ,AFR,30602,43283,73885,28327,19575,14419,9971,6135,3835,82262,30286,44132,74418,29959,21703,16026,11275,7164,5229,91356,173618,321925,321925
Eswatini,1958,SZ,SWZ,AFR,31240,45077,76317,28889,19710,14512,10110,6244,3951,83416,30908,45813,76721,30597,22033,16265,11505,7323,5364,93087,176503,329538,329538
Eswatini,1959,SZ,SWZ,AFR,31917,46852,78769,29511,19829,14575,10239,6356,4072,84582,31570,47468,79038,31299,22359,16497,11739,7491,5486,94871,179453,337262,337262
Eswatini,1960,SZ,SWZ,AFR,32637,48590,81227,30208,19921,14608,10362,6469,4184,85752,32275,49090,81365,32084,22678,16717,11971,7663,5608,96721,182473,345065,345065
Eswatini,1961,SZ,SWZ,AFR,33398,50287,83685,30989,20007,14597,10472,6583,4301,86949,33020,50666,83686,32951,22999,16927,12200,7844,5730,98651,185600,352971,352971
Eswatini,1962,SZ,SWZ,AFR,34209,51949,86158,31851,20107,14558,10572,6696,4421,88205,33814,52196,86010,33913,23342,17130,12429,8034,5847,100695,188900,361070,361070
Eswatini,1963,SZ,SWZ,AFR,35099,53618,88717,32796,20241,14504,10666,6805,4538,89550,34687,53721,88408,34960,23709,17334,12654,8225,5974,102856,192406,369527,369527
Eswatini,1964,SZ,SWZ,AFR,36046,55123,91169,34069,20443,14468,10756,6922,4658,91316,35618,55132,90750,36246,24102,17544,12877,8423,6097,105289,196605,378531,378531
Eswatini,1965,SZ,SWZ,AFR,37042,56428,93470,35760,20760,14487,10858,7048,4773,93686,36594,56409,93003,37831,24562,17789,13110,8632,6235,108159,201845,388317,388317
Eswatini,1966,SZ,SWZ,AFR,38121,57760,95881,37584,21190,14555,10961,7177,4892,96359,37656,57715,95371,39523,25088,18066,13345,8847,6382,111251,207610,398861,398861
Eswatini,1967,SZ,SWZ,AFR,39218,58969,98187,39150,21830,14743,11060,7298,5012,99093,38739,59068,97807,41290,25688,18363,13579,9072,6555,114547,213640,409638,409638
Eswatini,1968,SZ,SWZ,AFR,40330,60062,100392,40269,22662,15064,11147,7406,5142,101690,39836,60498,100334,43081,26354,18661,13806,9303,6748,117953,219643,420373,420373
Eswatini,1969,SZ,SWZ,AFR,41564,61249,102813,41117,23529,15444,11221,7504,5271,104086,41056,62004,103060,44812,27113,18955,14034,9535,6964,121413,225499,431366,431366
Eswatini,2031,SZ,SWZ,AFR,68856,136310,205166,134705,105659,91988,62222,30828,22181,447583,67409,133795,201204,134628,104911,92891,62705,35346,38818,469299,916882,1323254,1323254
Eswatini,2032,SZ,SWZ,AFR,69191,135928,205119,136039,108528,91982,64899,32048,22835,456331,67751,133297,201048,136036,107955,93384,65904,36097,39635,479011,935342,1341503,1341503
Eswatini,2033,SZ,SWZ,AFR,69575,135678,205253,136949,111746,92023,67455,33415,23512,465100,68146,132976,201122,136933,111438,93805,69041,37123,40392,488732,953832,1360216,1360216
Eswatini,2034,SZ,SWZ,AFR,69992,135524,205516,137472,115037,92136,69970,34935,24232,473782,68574,132813,201387,137331,115051,94219,72177,38437,41094,498309,972091,1378991,1378991
Eswatini,2035,SZ,SWZ,AFR,70395,135519,205914,137822,118089,92459,72310,36631,24968,482279,68988,132826,201814,137471,118468,94791,75165,40076,41722,507693,989972,1397706,1397706
Eswatini,2036,SZ,SWZ,AFR,70799,135668,206467,137992,120994,92954,74374,38533,25733,490580,69398,133011,202409,137397,121758,95488,77883,42052,42314,516892,1007472,1416343,1416343
Eswatini,2037,SZ,SWZ,AFR,71201,136023,207224,137855,123904,93436,76344,40584,26511,498634,69805,133410,203215,136987,125041,96118,80533,44313,42861,525853,1024487,1434924,1434924
Eswatini,2038,SZ,SWZ,AFR,71546,136573,208119,137454,126715,94065,78174,42760,27311,506479,70154,133983,204137,136331,128214,96850,83054,46831,43372,534652,1041131,1453393,1453393
Eswatini,2039,SZ,SWZ,AFR,71808,137211,209019,136964,129232,95133,79651,45069,28172,514221,70422,134654,205076,135600,131042,98001,85198,49593,43932,543366,1057587,1471679,1471679
Eswatini,2040,SZ,SWZ,AFR,71995,137898,209893,136503,131351,97078,80406,47423,29112,521873,70617,135367,205984,134931,133411,100061,86539,52494,44583,552019,1073892,1489771,1489771
Eswatini,2041,SZ,SWZ,AFR,72096,138627,210723,136081,133142,99719,80619,49726,30146,529433,70725,136129,206854,134343,135380,102854,87260,55412,45351,560600,1090033,1507612,1507612
Eswatini,2042,SZ,SWZ,AFR,72102,139386,211488,135750,134578,102580,80770,51945,31283,536906,70738,136912,207650,133892,136906,105949,87823,58300,46272,569142,1106048,1525184,1525184
Eswatini,2043,SZ,SWZ,AFR,72024,140130,212154,135527,135547,105710,80939,54059,32545,544327,70669,137681,208350,133606,137854,109400,88300,61119,47377,577656,1121983,1542481,1542481
Eswatini,2044,SZ,SWZ,AFR,71913,140818,212731,135406,136130,108900,81183,56147,33925,551691,70568,138392,208960,133467,138299,112971,88778,63942,48687,586144,1137835,1559524,1559524
Eswatini,2045,SZ,SWZ,AFR,71775,141419,213194,135428,136548,111872,81620,58097,35447,559012,70442,139020,209462,133507,138502,116351,89412,66640,50216,594628,1153640,1576301,1576301
Eswatini,2046,SZ,SWZ,AFR,71610,141940,213550,135600,136789,114712,82213,59831,37120,566265,70291,139565,209856,133717,138487,119615,90163,69108,52000,603090,1169355,1592766,1592766
Eswatini,2047,SZ,SWZ,AFR,71413,142356,213769,135981,136730,117546,82807,61501,38918,573483,70109,140007,210116,134137,138145,122869,90864,71520,53990,611525,1185008,1608885,1608885
Eswatini,2048,SZ,SWZ,AFR,71202,142638,213840,136546,136415,120294,83536,63066,40798,580655,69912,140315,210227,134734,137556,126021,91663,73825,56164,619963,1200618,1624681,1624681
Eswatini,2049,SZ,SWZ,AFR,70943,142803,213746,137201,136015,122768,84656,64354,42796,587790,69671,140504,210175,135420,136896,128840,92867,75803,58583,628409,1216199,1640120,1640120
Eswatini,2050,SZ,SWZ,AFR,70603,142868,213471,137899,135643,124876,86539,65045,44878,594880,69353,140596,209949,136152,136298,131214,94916,77056,61187,636823,1231703,1655121,1655121
Sint Maarten (Dutch part),2010,SX,SXM,AMR,1143,2418,3561,2098,2129,2805,2562,1704,788,12086,1257,2632,3889,2218,2524,3299,2891,1712,859,13503,25589,33034,33034
Sint Maarten (Dutch part),2011,SX,SXM,AMR,1134,2390,3524,2132,2098,2755,2608,1770,865,12228,1220,2650,3870,2230,2491,3267,2952,1809,945,13694,25922,33309,33309
Sint Maarten (Dutch part),2012,SX,SXM,AMR,1244,2897,4141,2523,1424,3174,3340,1965,885,13311,961,2966,3927,2329,1331,3453,3610,2045,992,13760,27071,35139,35139
Sint Maarten (Dutch part),2013,SX,SXM,AMR,1282,3497,4779,3166,632,3610,4266,2259,910,14843,618,3236,3854,2684,139,3521,4465,2374,1042,14225,29068,37697,37697
Sint Maarten (Dutch part),2014,SX,SXM,AMR,1133,3582,4715,3692,417,3512,4646,2513,975,15755,472,3064,3536,3214,48,3189,4838,2636,1161,15086,30841,39100,39100
Sint Maarten (Dutch part),2015,SX,SXM,AMR,980,3580,4560,4185,297,3317,4974,2769,1054,16596,411,2765,3176,3699,52,2790,5125,2895,1313,15874,32470,40205,40205
Sint Maarten (Dutch part),2016,SX,SXM,AMR,818,3594,4412,4656,250,3088,5259,3044,1150,17447,390,2420,2810,4191,74,2368,5413,3155,1477,16678,34125,41346,41346
Sint Maarten (Dutch part),2017,SX,SXM,AMR,645,3507,4152,4975,372,2715,5355,3308,1269,17994,378,2057,2435,4624,170,1896,5532,3432,1642,17296,35290,41883,41883
Sint Maarten (Dutch part),2018,SX,SXM,AMR,585,3342,3927,5132,628,2302,5401,3562,1406,18431,388,1743,2131,4872,332,1466,5526,3749,1807,17752,36183,42246,42246
Sint Maarten (Dutch part),2019,SX,SXM,AMR,631,3198,3829,5210,946,1987,5483,3844,1547,19017,424,1482,1906,4974,505,1137,5540,4069,2002,18227,37244,42980,42980
Sint Maarten (Dutch part),2020,SX,SXM,AMR,685,3040,3725,5223,1321,1698,5481,4140,1691,19554,470,1248,1718,4976,742,832,5497,4364,2205,18616,38170,43621,43621
Sint Maarten (Dutch part),2021,SX,SXM,AMR,742,2841,3583,5185,1740,1395,5404,4423,1844,19991,532,1040,1572,4885,1044,558,5351,4644,2415,18897,38888,44042,44042
Sint Maarten (Dutch part),2022,SX,SXM,AMR,791,2594,3385,5084,2225,1074,5197,4664,2019,20263,628,845,1473,4704,1453,326,5039,4886,2641,19049,39312,44175,44175
Sint Maarten (Dutch part),2023,SX,SXM,AMR,836,2336,3172,4943,2749,776,4889,4865,2249,20471,737,695,1432,4431,1940,171,4572,5119,2917,19150,39621,44222,44222
Sint Maarten (Dutch part),2024,SX,SXM,AMR,888,2106,2994,4767,3277,543,4517,5052,2498,20654,831,629,1460,4067,2463,97,4025,5330,3217,19199,39853,44309,44309
Sint Maarten (Dutch part),2025,SX,SXM,AMR,951,1906,2857,4542,3821,358,4102,5229,2756,20808,915,663,1578,3599,3003,86,3449,5495,3525,19157,39965,44404,44404
Sint Maarten (Dutch part),2026,SX,SXM,AMR,1021,1718,2739,4316,4354,245,3662,5338,3024,20939,990,770,1760,3068,3554,89,2862,5637,3862,19072,40011,44513,44513
Sint Maarten (Dutch part),2027,SX,SXM,AMR,1095,1560,2655,4100,4785,286,3180,5385,3315,21051,1061,856,1917,2593,4043,140,2290,5716,4222,19004,40055,44627,44627
Sint Maarten (Dutch part),2028,SX,SXM,AMR,1165,1521,2686,3818,5066,487,2675,5390,3610,21046,1128,966,2094,2157,4439,241,1773,5680,4623,18913,39959,44740,44740
Sint Maarten (Dutch part),2029,SX,SXM,AMR,1228,1579,2807,3482,5192,823,2200,5323,3925,20945,1188,1143,2331,1728,4743,382,1317,5569,5027,18766,39711,44850,44850
Sint Maarten (Dutch part),2030,SX,SXM,AMR,1279,1662,2941,3164,5211,1234,1772,5188,4248,20817,1239,1325,2564,1360,4876,642,912,5411,5429,18630,39447,44946,44946
Sint Maarten (Dutch part),2031,SX,SXM,AMR,1318,1766,3084,2862,5153,1702,1382,5014,4566,20679,1276,1504,2780,1065,4848,1006,571,5175,5813,18478,39157,45022,45022
Sint Maarten (Dutch part),2032,SX,SXM,AMR,1342,1882,3224,2581,5046,2206,1039,4792,4876,20540,1299,1687,2986,841,4682,1446,320,4845,6195,18329,38869,45078,45078
Sint Maarten (Dutch part),2033,SX,SXM,AMR,1352,1997,3349,2324,4906,2726,750,4508,5180,20394,1306,1863,3169,691,4411,1929,167,4397,6593,18188,38582,45099,45099
Sint Maarten (Dutch part),2034,SX,SXM,AMR,1344,2111,3455,2096,4730,3248,527,4166,5480,20247,1298,2017,3315,626,4049,2447,95,3867,6982,18066,38313,45081,45081
Sint Maarten (Dutch part),2035,SX,SXM,AMR,1320,2227,3547,1899,4509,3786,349,3783,5765,20091,1276,2149,3425,661,3580,2983,84,3313,7337,17958,38049,45023,45023
Sint Maarten (Dutch part),2036,SX,SXM,AMR,1279,2336,3615,1715,4284,4314,240,3378,6011,19942,1236,2261,3497,769,3051,3532,87,2747,7673,17859,37801,44917,44917
Sint Maarten (Dutch part),2037,SX,SXM,AMR,1225,2434,3659,1558,4071,4740,281,2932,6212,19794,1186,2355,3541,856,2577,4018,137,2200,7977,17765,37559,44761,44761
Sint Maarten (Dutch part),2038,SX,SXM,AMR,1160,2512,3672,1519,3790,5015,478,2459,6382,19643,1123,2431,3554,966,2144,4414,236,1704,8218,17682,37325,44551,44551
Sint Maarten (Dutch part),2039,SX,SXM,AMR,1086,2566,3652,1575,3460,5141,810,2021,6506,19513,1051,2483,3534,1143,1717,4712,376,1260,8382,17590,37103,44282,44282
Sint Maarten (Dutch part),2040,SX,SXM,AMR,1004,2594,3598,1657,3146,5163,1214,1629,6573,19382,972,2510,3482,1324,1351,4841,633,869,8485,17503,36885,43963,43963
Sint Maarten (Dutch part),2041,SX,SXM,AMR,920,2593,3513,1760,2846,5107,1674,1268,6604,19259,890,2509,3399,1504,1057,4817,994,543,8515,17430,36689,43592,43592
Sint Maarten (Dutch part),2042,SX,SXM,AMR,837,2563,3400,1876,2566,4999,2170,951,6581,19143,808,2479,3287,1687,836,4651,1431,306,8439,17350,36493,43175,43175
Sint Maarten (Dutch part),2043,SX,SXM,AMR,756,2507,3263,1991,2311,4859,2681,687,6514,19043,730,2424,3154,1862,688,4382,1909,159,8267,17267,36310,42719,42719
Sint Maarten (Dutch part),2044,SX,SXM,AMR,684,2424,3108,2106,2082,4689,3189,485,6381,18932,660,2344,3004,2015,624,4023,2424,89,8009,17184,36116,42224,42224
Sint Maarten (Dutch part),2045,SX,SXM,AMR,622,2319,2941,2218,1888,4472,3717,320,6213,18828,600,2242,2842,2147,658,3559,2954,80,7698,17096,35924,41703,41703
Sint Maarten (Dutch part),2046,SX,SXM,AMR,572,2197,2769,2327,1704,4246,4232,220,5984,18713,552,2122,2674,2258,765,3034,3492,84,7363,16996,35709,41159,41159
Sint Maarten (Dutch part),2047,SX,SXM,AMR,536,2059,2595,2424,1549,4033,4647,263,5690,18606,516,1990,2506,2351,853,2560,3973,135,7023,16895,35501,40608,40608
Sint Maarten (Dutch part),2048,SX,SXM,AMR,513,1914,2427,2501,1512,3758,4916,455,5357,18499,493,1850,2343,2427,964,2130,4363,232,6670,16786,35285,40056,40056
Sint Maarten (Dutch part),2049,SX,SXM,AMR,503,1768,2271,2556,1570,3432,5037,774,5013,18382,483,1707,2190,2479,1141,1705,4660,368,6306,16659,35041,39498,39498
Sint Maarten (Dutch part),2050,SX,SXM,AMR,507,1625,2132,2583,1649,3120,5060,1163,4676,18251,487,1568,2055,2505,1322,1341,4786,619,5936,16509,34760,38947,38947
Seychelles,1970,SC,SYC,AFR,4370,7751,12121,4612,3024,2675,2085,1548,1319,15263,4253,7400,11653,3984,2939,2661,2132,1730,1897,15343,30606,54379,54379
Seychelles,1971,SC,SYC,AFR,4353,8021,12374,4866,3076,2707,2121,1572,1369,15711,4238,7684,11922,4203,2913,2694,2165,1753,1958,15686,31397,55694,55694
Seychelles,1972,SC,SYC,AFR,4335,8227,12562,5176,3174,2743,2167,1601,1388,16249,4205,7905,12110,4472,2928,2730,2208,1788,1999,16125,32374,57052,57052
Seychelles,1973,SC,SYC,AFR,4336,8366,12702,5526,3280,2772,2206,1617,1393,16794,4189,8079,12268,4783,2953,2765,2248,1814,2032,16595,33389,58359,58359
Seychelles,1974,SC,SYC,AFR,4365,8448,12813,5892,3388,2784,2233,1620,1398,17315,4213,8204,12417,5128,2984,2789,2281,1824,2061,17067,34382,59621,59621
Seychelles,1975,SC,SYC,AFR,4424,8499,12923,6260,3518,2800,2262,1630,1399,17869,4273,8282,12555,5489,3047,2804,2323,1838,2093,17594,35463,60943,60943
Seychelles,1976,SC,SYC,AFR,4444,8533,12977,6615,3670,2815,2293,1638,1397,18428,4303,8320,12623,5864,3135,2815,2362,1858,2122,18156,36584,62181,62181
Seychelles,1977,SC,SYC,AFR,4387,8554,12941,6950,3834,2816,2314,1632,1366,18912,4263,8327,12590,6277,3246,2815,2388,1866,2131,18723,37635,63166,63166
Seychelles,1978,SC,SYC,AFR,4353,8542,12895,7186,3975,2806,2329,1643,1371,19310,4237,8304,12541,6627,3352,2803,2412,1882,2157,19233,38543,63978,63978
Seychelles,1979,SC,SYC,AFR,4340,8502,12842,7306,4093,2801,2352,1689,1447,19688,4212,8260,12472,6861,3450,2775,2445,1908,2221,19660,39348,64662,64662
Seychelles,1980,SC,SYC,AFR,4308,8477,12785,7384,4214,2804,2367,1734,1524,20027,4176,8226,12402,7048,3575,2734,2485,1938,2287,20067,40094,65290,65290
Seychelles,1981,SC,SYC,AFR,4322,8423,12745,7428,4358,2821,2377,1776,1600,20360,4184,8170,12354,7192,3739,2697,2523,1970,2352,20473,40833,65930,65930
Seychelles,1982,SC,SYC,AFR,4328,8319,12647,7431,4528,2849,2375,1819,1667,20669,4184,8067,12251,7289,3943,2664,2548,2002,2422,20868,41537,66435,66435
Seychelles,1983,SC,SYC,AFR,4262,8265,12527,7395,4718,2887,2370,1860,1736,20966,4115,8011,12126,7341,4173,2634,2569,2032,2489,21238,42204,66859,66859
Seychelles,1984,SC,SYC,AFR,4202,8256,12458,7330,4914,2939,2358,1895,1803,21239,4057,8000,12057,7353,4420,2617,2584,2064,2559,21597,42836,67346,67346
Seychelles,1985,SC,SYC,AFR,4143,8264,12407,7249,5100,3000,2344,1928,1869,21490,3995,8006,12001,7325,4666,2622,2583,2102,2632,21930,43420,67833,67833
Seychelles,1986,SC,SYC,AFR,4076,8285,12361,7166,5267,3078,2331,1965,1937,21744,3929,8030,11959,7270,4926,2656,2570,2141,2705,22268,44012,68325,68325
Seychelles,1987,SC,SYC,AFR,4081,8242,12323,7120,5432,3170,2317,1994,1983,22016,3935,7986,11921,7221,5197,2704,2555,2178,2778,22633,44649,68897,68897
Seychelles,1988,SC,SYC,AFR,4102,8162,12264,7119,5635,3301,2317,2024,2035,22431,3955,7900,11855,7192,5473,2789,2536,2216,2824,23030,45461,69585,69585
Seychelles,1989,SC,SYC,AFR,4071,8106,12177,7153,5863,3469,2339,2054,2083,22961,3923,7825,11748,7184,5729,2916,2521,2259,2856,23465,46426,70343,70343
Seychelles,1990,SC,SYC,AFR,4028,8017,12045,7207,6065,3647,2376,2073,2116,23484,3877,7725,11602,7196,5951,3075,2505,2304,2887,23918,47402,71057,71057
Seychelles,1991,SC,SYC,AFR,4001,7951,11952,7223,6237,3852,2427,2084,2156,23979,3843,7647,11490,7174,6126,3275,2490,2349,2932,24346,48325,71754,71754
Seychelles,1992,SC,SYC,AFR,3977,7923,11900,7172,6358,4091,2489,2087,2188,24385,3815,7612,11427,7091,6250,3507,2482,2388,2991,24709,49094,72417,72417
Seychelles,1993,SC,SYC,AFR,3954,7841,11795,7160,6435,4356,2567,2086,2215,24819,3791,7526,11317,7054,6328,3763,2480,2422,3068,25115,49934,73040,73040
Seychelles,1994,SC,SYC,AFR,3976,7758,11734,7243,6473,4618,2649,2066,2204,25253,3815,7442,11257,7111,6393,4030,2485,2438,3137,25594,50847,73846,73846
Seychelles,1995,SC,SYC,AFR,3997,7700,11697,7382,6464,4842,2724,2032,2199,25643,3841,7384,11225,7235,6453,4305,2520,2445,3212,26170,51813,74735,74735
Seychelles,1996,SC,SYC,AFR,3958,7642,11600,7525,6446,5023,2801,2013,2236,26044,3804,7347,11151,7363,6498,4587,2580,2449,3284,26761,52805,75550,75550
Seychelles,1997,SC,SYC,AFR,3996,7678,11674,7678,6559,5419,2990,1921,1957,26524,3869,7315,11184,7482,6532,4890,2625,2373,3240,27142,53666,76531,76531
Seychelles,1998,SC,SYC,AFR,4015,7763,11778,7790,6718,5871,3196,1866,1684,27125,3909,7333,11242,7528,6587,5203,2692,2297,3199,27506,54631,77664,77664
Seychelles,1999,SC,SYC,AFR,3900,7834,11734,7831,6855,6153,3331,1912,1739,27821,3787,7418,11205,7499,6699,5502,2813,2293,3272,28078,55899,78833,78833
Seychelles,2000,SC,SYC,AFR,3795,7902,11697,7814,7098,6388,3488,1975,1785,28548,3674,7506,11180,7421,6858,5764,2968,2280,3332,28623,57171,80060,80060
Seychelles,2001,SC,SYC,AFR,3689,7974,11663,7790,7339,6575,3691,2051,1824,29270,3565,7611,11176,7336,7002,5990,3167,2258,3396,29149,58419,81262,81262
Seychelles,2002,SC,SYC,AFR,3625,8002,11627,7794,7510,6730,3944,2127,1854,29959,3503,7662,11165,7292,7109,6175,3410,2239,3461,29686,59645,82433,82433
Seychelles,2003,SC,SYC,AFR,3641,7949,11590,7796,7704,6851,4222,2215,1878,30666,3522,7613,11135,7214,7253,6319,3667,2233,3511,30197,60863,83592,83592
Seychelles,2004,SC,SYC,AFR,3663,7860,11523,7830,7916,6943,4518,2311,1903,31421,3546,7548,11094,7115,7387,6440,3923,2256,3554,30675,62096,84715,84715
Seychelles,2005,SC,SYC,AFR,3704,7776,11480,7866,8123,7007,4826,2413,1932,32167,3586,7503,11089,7012,7523,6523,4192,2309,3585,31144,63311,85883,85883
Seychelles,2006,SC,SYC,AFR,3766,7680,11446,7901,8333,7066,5140,2528,1969,32937,3645,7441,11086,6940,7636,6567,4490,2379,3611,31623,64560,87093,87093
Seychelles,2007,SC,SYC,AFR,3833,7587,11420,7992,8465,7135,5443,2658,2020,33713,3714,7375,11089,6970,7626,6613,4801,2457,3643,32110,65823,88325,88325
Seychelles,2008,SC,SYC,AFR,3924,7511,11435,8118,8557,7221,5736,2780,2081,34493,3801,7300,11101,7049,7551,6669,5108,2554,3681,32612,67105,89644,89644
Seychelles,2009,SC,SYC,AFR,4036,7390,11426,8243,8670,7353,6007,2912,2160,35345,3911,7174,11085,7131,7498,6743,5390,2679,3727,33168,68513,91030,91030
Seychelles,2010,SC,SYC,AFR,4100,7289,11389,8368,8753,7579,6229,3078,2253,36260,3971,7067,11038,7210,7412,6863,5637,2833,3775,33730,69990,92409,92409
Seychelles,2011,SC,SYC,AFR,4149,7207,11356,8487,8850,7814,6405,3286,2355,37197,4018,6979,10997,7289,7323,6962,5853,3030,3826,34283,71480,93827,93827
Seychelles,2012,SC,SYC,AFR,4232,7179,11411,8544,8991,7990,6556,3538,2460,38079,4097,6958,11055,7307,7279,7028,6027,3267,3863,34771,72850,95309,95309
Seychelles,2013,SC,SYC,AFR,4262,7269,11531,8499,9081,8203,6684,3809,2561,38837,4122,7054,11176,7239,7207,7149,6163,3513,3905,35176,74013,96714,96714
Seychelles,2014,SC,SYC,AFR,4238,7403,11641,8393,9146,8432,6789,4087,2665,39512,4096,7189,11285,7166,7106,7285,6284,3760,3967,35568,75080,98001,98001
Seychelles,2015,SC,SYC,AFR,4241,7513,11754,8273,9199,8656,6871,4366,2768,40133,4098,7293,11391,7112,7002,7421,6364,4024,4031,35954,76087,99240,99240
Seychelles,2016,SC,SYC,AFR,4271,7633,11904,8140,9241,8878,6938,4646,2882,40725,4127,7416,11543,7051,6927,7536,6407,4307,4106,36334,77059,100508,100508
Seychelles,2017,SC,SYC,AFR,4285,7797,12082,8017,9333,9021,7017,4915,3009,41312,4138,7570,11708,6979,6952,7530,6456,4605,4181,36703,78015,101811,101811
Seychelles,2018,SC,SYC,AFR,4311,7924,12235,7916,9450,9122,7106,5176,3151,41921,4163,7690,11853,6906,7028,7461,6514,4898,4286,37093,79014,103101,103101
Seychelles,2019,SC,SYC,AFR,4349,8018,12367,7787,9564,9235,7242,5412,3310,42550,4202,7774,11976,6780,7104,7413,6595,5169,4417,37478,80028,104373,104373
Seychelles,2020,SC,SYC,AFR,4361,8097,12458,7662,9632,9294,7452,5604,3483,43127,4214,7852,12066,6686,7173,7328,6711,5401,4581,37880,81007,105530,105530
Seychelles,2021,SC,SYC,AFR,4329,8198,12527,7531,9639,9340,7658,5742,3660,43570,4182,7946,12128,6622,7247,7238,6801,5592,4741,38241,81811,106471,106471
Seychelles,2022,SC,SYC,AFR,4258,8314,12572,7414,9531,9400,7800,5842,3833,43820,4114,8064,12178,6620,7245,7186,6861,5739,4902,38553,82373,107118,107118
Seychelles,2023,SC,SYC,AFR,4170,8401,12571,7379,9293,9389,7961,5937,4042,44001,4031,8147,12178,6732,7150,7102,6970,5857,5100,38911,82912,107660,107660
Seychelles,2024,SC,SYC,AFR,4093,8441,12534,7404,9022,9366,8149,6027,4289,44257,3952,8183,12135,6878,7050,6996,7104,5964,5352,39344,83601,108263,108263
Seychelles,2025,SC,SYC,AFR,4017,8480,12497,7423,8744,9336,8327,6095,4555,44480,3882,8221,12103,7003,6968,6885,7230,6037,5637,39760,84240,108844,108844
Seychelles,2026,SC,SYC,AFR,3956,8502,12458,7474,8444,9294,8505,6161,4828,44706,3824,8232,12056,7140,6875,6801,7338,6080,5953,40187,84893,109397,109397
Seychelles,2027,SC,SYC,AFR,3899,8462,12361,7590,8153,9288,8597,6236,5096,44960,3768,8189,11957,7313,6781,6812,7324,6126,6280,40636,85596,109913,109913
Seychelles,2028,SC,SYC,AFR,3853,8420,12273,7692,7876,9298,8646,6326,5364,45202,3723,8144,11867,7461,6683,6872,7254,6180,6619,41069,86271,110404,110404
Seychelles,2029,SC,SYC,AFR,3808,8389,12197,7780,7561,9289,8706,6450,5620,45406,3678,8110,11788,7586,6539,6932,7204,6259,6963,41483,86889,110877,110877
Seychelles,2030,SC,SYC,AFR,3770,8332,12102,7865,7289,9250,8720,6642,5856,45622,3641,8051,11692,7688,6434,6987,7116,6372,7307,41904,87526,111317,111317
Seychelles,1950,SC,SYC,AFR,2402,3576,5978,2940,2477,2339,1905,1602,2078,13341,2302,3659,5961,3050,2460,2162,1780,1384,1985,12821,26162,38106,38106
Seychelles,1951,SC,SYC,AFR,2542,3674,6216,2977,2500,2313,1902,1547,1871,13110,2437,3710,6147,3117,2497,2163,1793,1386,1878,12834,25944,38300,38300
Seychelles,1952,SC,SYC,AFR,2664,3780,6444,3018,2526,2286,1902,1502,1709,12943,2552,3767,6319,3184,2534,2163,1809,1392,1788,12870,25813,38581,38581
Seychelles,1953,SC,SYC,AFR,2773,3891,6664,3064,2552,2263,1902,1460,1571,12812,2656,3838,6494,3251,2572,2169,1823,1399,1730,12944,25756,38918,38918
Seychelles,1954,SC,SYC,AFR,2873,4021,6894,3107,2585,2246,1898,1424,1460,12720,2757,3915,6672,3310,2621,2178,1843,1404,1680,13036,25756,39318,39318
Seychelles,1955,SC,SYC,AFR,2967,4165,7132,3161,2620,2228,1897,1387,1365,12658,2851,4012,6863,3365,2670,2189,1858,1409,1644,13135,25793,39788,39788
Seychelles,1956,SC,SYC,AFR,3073,4315,7388,3217,2656,2220,1892,1357,1275,12617,2950,4125,7075,3420,2725,2202,1880,1415,1615,13257,25874,40331,40331
Seychelles,1957,SC,SYC,AFR,3202,4466,7668,3280,2692,2208,1882,1330,1198,12590,3063,4238,7301,3466,2778,2223,1894,1421,1594,13376,25966,40943,40943
Seychelles,1958,SC,SYC,AFR,3343,4616,7959,3354,2730,2207,1868,1315,1134,12608,3173,4363,7536,3505,2839,2253,1902,1432,1582,13513,26121,41608,41608
Seychelles,1959,SC,SYC,AFR,3505,4772,8277,3428,2766,2217,1856,1308,1086,12661,3258,4505,7763,3540,2899,2283,1910,1445,1567,13644,26305,42344,42344
Seychelles,1960,SC,SYC,AFR,3658,4953,8611,3502,2811,2247,1853,1322,1061,12796,3346,4655,8001,3554,2959,2317,1917,1466,1552,13765,26561,43167,43167
Seychelles,1961,SC,SYC,AFR,3763,5161,8924,3564,2856,2291,1859,1353,1032,12955,3454,4822,8276,3556,3010,2356,1933,1498,1532,13885,26840,44041,44041
Seychelles,1962,SC,SYC,AFR,3845,5403,9248,3625,2896,2336,1869,1388,1020,13134,3573,5010,8583,3544,3051,2392,1955,1532,1526,14000,27134,44969,44969
Seychelles,1963,SC,SYC,AFR,3926,5667,9593,3690,2935,2381,1888,1420,1022,13336,3705,5218,8923,3534,3083,2424,1971,1571,1535,14118,27454,45964,45964
Seychelles,1964,SC,SYC,AFR,4000,5954,9954,3763,2959,2426,1906,1450,1025,13529,3847,5455,9302,3529,3097,2460,1991,1606,1553,14236,27765,47023,47023
Seychelles,1965,SC,SYC,AFR,4073,6253,10326,3853,2978,2471,1932,1473,1042,13749,3971,5726,9697,3535,3096,2496,2009,1641,1579,14356,28105,48123,48123
Seychelles,1966,SC,SYC,AFR,4160,6546,10706,3961,2990,2514,1955,1491,1070,13981,4069,6032,10101,3564,3083,2533,2029,1669,1615,14493,28474,49284,49284
Seychelles,1967,SC,SYC,AFR,4246,6843,11089,4085,2998,2559,1985,1511,1117,14255,4146,6370,10516,3614,3061,2568,2054,1689,1673,14659,28914,50523,50523
Seychelles,1968,SC,SYC,AFR,4316,7147,11463,4236,3002,2604,2020,1525,1181,14568,4206,6721,10927,3693,3027,2598,2083,1706,1741,14848,29416,51808,51808
Seychelles,1969,SC,SYC,AFR,4361,7455,11816,4410,3010,2645,2052,1536,1244,14897,4245,7067,11312,3819,2987,2627,2110,1718,1820,15081,29978,53098,53098
Seychelles,2031,SC,SYC,AFR,3735,8233,11968,7970,7048,9179,8732,6835,6088,45852,3609,7955,11564,7807,6359,7042,7024,6469,7644,42345,88197,111734,111734
Seychelles,2032,SC,SYC,AFR,3709,8106,11815,8098,6886,9043,8778,6976,6330,46111,3585,7829,11414,7933,6353,7034,6978,6534,7969,42801,88912,112144,112144
Seychelles,2033,SC,SYC,AFR,3694,7971,11665,8181,6855,8818,8780,7142,6574,46350,3567,7700,11267,8014,6466,6941,6899,6651,8276,43247,89597,112531,112531
Seychelles,2034,SC,SYC,AFR,3680,7849,11529,8222,6882,8550,8768,7325,6816,46563,3559,7579,11138,8055,6613,6844,6799,6781,8575,43667,90230,112902,112902
Seychelles,2035,SC,SYC,AFR,3678,7736,11414,8265,6903,8279,8750,7502,7056,46755,3555,7474,11029,8093,6735,6767,6694,6911,8864,44064,90819,113262,113262
Seychelles,2036,SC,SYC,AFR,3683,7640,11323,8284,6954,7989,8720,7677,7295,46919,3561,7381,10942,8104,6868,6673,6615,7016,9148,44424,91343,113606,113606
Seychelles,2037,SC,SYC,AFR,3695,7561,11256,8242,7071,7705,8724,7775,7533,47050,3570,7306,10876,8063,7044,6578,6627,7006,9444,44762,91812,113944,113944
Seychelles,2038,SC,SYC,AFR,3708,7495,11203,8203,7173,7434,8738,7831,7783,47162,3584,7242,10826,8016,7194,6482,6684,6940,9758,45074,92236,114267,114267
Seychelles,2039,SC,SYC,AFR,3725,7443,11168,8169,7262,7128,8737,7893,8052,47241,3599,7189,10788,7980,7318,6340,6744,6896,10091,45369,92610,114569,114569
Seychelles,2040,SC,SYC,AFR,3740,7402,11142,8112,7347,6861,8706,7922,8362,47310,3613,7148,10761,7926,7420,6236,6803,6819,10441,45645,92955,114862,114862
Seychelles,2041,SC,SYC,AFR,3756,7370,11126,8019,7453,6631,8646,7948,8664,47361,3628,7124,10752,7827,7537,6165,6861,6735,10777,45902,93263,115143,115143
Seychelles,2042,SC,SYC,AFR,3765,7356,11121,7890,7579,6472,8522,8004,8936,47403,3640,7110,10750,7702,7665,6158,6854,6694,11061,46134,93537,115406,115406
Seychelles,2043,SC,SYC,AFR,3774,7354,11128,7759,7664,6447,8310,8020,9226,47426,3644,7106,10750,7571,7747,6268,6764,6622,11367,46339,93765,115647,115647
Seychelles,2044,SC,SYC,AFR,3777,7362,11139,7632,7705,6475,8062,8025,9525,47424,3648,7110,10758,7457,7785,6417,6669,6530,11682,46540,93964,115864,115864
Seychelles,2045,SC,SYC,AFR,3773,7375,11148,7525,7748,6497,7811,8024,9825,47430,3644,7124,10768,7347,7820,6542,6592,6434,11981,46716,94146,116059,116059
Seychelles,2046,SC,SYC,AFR,3768,7395,11163,7424,7767,6552,7536,8009,10114,47402,3639,7144,10783,7257,7837,6675,6500,6364,12245,46878,94280,116231,116231
Seychelles,2047,SC,SYC,AFR,3757,7415,11172,7345,7731,6668,7266,8026,10348,47384,3629,7167,10796,7178,7795,6851,6407,6380,12412,47023,94407,116377,116377
Seychelles,2048,SC,SYC,AFR,3741,7435,11176,7281,7686,6770,7011,8051,10557,47356,3612,7183,10795,7116,7749,7000,6319,6438,12543,47165,94521,116496,116496
Seychelles,2049,SC,SYC,AFR,3718,7455,11173,7226,7660,6864,6729,8066,10787,47332,3591,7199,10790,7065,7712,7122,6183,6502,12711,47295,94627,116585,116585
Seychelles,2050,SC,SYC,AFR,3688,7470,11158,7188,7601,6949,6481,8051,11024,47294,3563,7215,10778,7027,7657,7224,6080,6563,12868,47419,94713,116644,116644
Syrian Arab Republic,1970,SY,SYR,EMR,630173,923480,1553653,586570,362295,296020,195328,122369,109823,1672405,600688,877585,1478273,563996,359424,275685,172655,122335,120767,1614862,3287267,6319199,6319199
Syrian Arab Republic,1971,SY,SYR,EMR,655636,957572,1613208,611378,371890,300936,203156,125979,110312,1723651,625037,910387,1535424,590477,367294,282550,179690,123609,122627,1666247,3389898,6538526,6538526
Syrian Arab Republic,1972,SY,SYR,EMR,680775,993374,1674149,636303,383844,306028,212549,129411,111085,1779220,649052,944951,1594003,616669,376636,289951,188247,124969,124700,1721172,3500392,6768544,6768544
Syrian Arab Republic,1973,SY,SYR,EMR,705455,1030949,1736404,657939,399433,310239,222101,133001,112020,1834733,672606,981248,1653854,641498,389134,296685,197335,126600,126875,1778127,3612860,7003114,7003114
Syrian Arab Republic,1974,SY,SYR,EMR,729264,1070958,1800222,681037,415085,314126,231785,137004,113264,1892301,695389,1019814,1715203,666040,403662,302807,206825,128729,129113,1837176,3729477,7244901,7244901
Syrian Arab Republic,1975,SY,SYR,EMR,752451,1113725,1866176,708398,429327,318242,241562,141584,115043,1954156,717655,1060863,1778518,691788,418694,308391,216539,131506,131363,1898281,3852437,7497126,7497126
Syrian Arab Republic,1976,SY,SYR,EMR,776464,1158498,1934962,736351,444441,322340,250945,146696,117155,2017928,740705,1103753,1844458,718154,434540,313716,226282,135074,133554,1961320,3979248,7758673,7758673
Syrian Arab Republic,1977,SY,SYR,EMR,802266,1204507,2006773,764660,460452,326540,259740,152433,119408,2083233,765427,1147793,1913220,744972,450958,319147,235890,139481,135645,2026093,4109326,8029313,8029313
Syrian Arab Republic,1978,SY,SYR,EMR,829353,1251597,2080950,793284,477658,331152,268040,158917,121994,2151045,791300,1193012,1984312,772467,468616,324697,245403,144831,137897,2093911,4244956,8310217,8310217
Syrian Arab Republic,1979,SY,SYR,EMR,856794,1299662,2156456,822243,496354,336392,275794,166166,124937,2221886,817383,1239397,2056780,800854,488287,330164,254746,151141,140436,2165628,4387514,8600747,8600747
Syrian Arab Republic,1980,SY,SYR,EMR,883838,1348567,2232405,852053,516358,342735,282728,174012,127960,2295846,842942,1286709,2129651,830477,509619,336077,263608,158241,143029,2241051,4536897,8898954,8898954
Syrian Arab Republic,1981,SY,SYR,EMR,908839,1398372,2307211,884209,537320,350647,288467,182189,130841,2373673,866467,1334928,2201395,862630,532664,342972,271669,165937,145488,2321360,4695033,9203635,9203635
Syrian Arab Republic,1982,SY,SYR,EMR,930218,1449002,2379220,919187,556972,361079,292851,190268,133355,2453712,886557,1383854,2270411,898917,557094,351909,278410,173465,147611,2407406,4861118,9510754,9510754
Syrian Arab Republic,1983,SY,SYR,EMR,951313,1500747,2452060,958548,575102,376512,297095,198854,136536,2542647,906436,1433695,2340131,938868,581344,364700,284350,181031,150332,2500625,5043272,9835461,9835461
Syrian Arab Republic,1984,SY,SYR,EMR,974176,1552698,2526874,1002659,596848,393019,301838,208155,140989,2643508,928063,1483622,2411685,981402,606235,379972,290134,189133,154201,2601077,5244585,10183138,10183138
Syrian Arab Republic,1985,SY,SYR,EMR,997679,1603546,2601225,1049630,622794,407700,306553,217322,146058,2750057,950430,1532440,2482870,1026335,632948,396011,295557,197298,158621,2706770,5456827,10540926,10540926
Syrian Arab Republic,1986,SY,SYR,EMR,1022282,1653467,2675749,1098592,650056,423255,311319,226066,151706,2860994,973985,1580297,2554282,1072927,660830,413014,300905,205352,163575,2816603,5677597,10907619,10907619
Syrian Arab Republic,1987,SY,SYR,EMR,1046834,1702979,2749813,1148558,678662,439840,316342,234278,157963,2975643,997630,1627636,2625266,1120524,689903,430888,306647,213327,169104,2930393,5906036,11281107,11281107
Syrian Arab Republic,1988,SY,SYR,EMR,1068331,1753099,2821430,1199184,708832,457706,321764,241891,164772,3094149,1018468,1675397,2693865,1168846,720345,450144,312657,221221,175122,3048335,6142484,11657772,11657772
Syrian Arab Republic,1989,SY,SYR,EMR,1084641,1803925,2888566,1250214,740711,477114,327767,248871,172132,3216809,1034362,1723733,2758095,1217659,752311,471445,318670,228920,181620,3170625,6387434,12034097,12034097
Syrian Arab Republic,1990,SY,SYR,EMR,1095593,1854790,2950383,1301481,774576,497859,334897,255142,179943,3343898,1045071,1772119,2817190,1266833,786081,494471,325315,236284,188543,3297527,6641425,12408996,12408996
Syrian Arab Republic,1991,SY,SYR,EMR,1101202,1904983,3006185,1353044,810653,519422,343853,260706,188155,3475833,1050592,1820027,2870619,1316468,821989,518819,333124,243259,195985,3429644,6905477,12782281,12782281
Syrian Arab Republic,1992,SY,SYR,EMR,1103606,1953025,3056631,1405314,849434,540699,355505,265686,196773,3613411,1052992,1866013,2919005,1366730,860294,543864,342699,249806,203954,3567347,7180758,13156406,13156406
Syrian Arab Republic,1993,SY,SYR,EMR,1108051,1997397,3105448,1458015,890841,560037,371208,270213,205658,3755972,1057306,1908557,2965863,1417289,900704,568140,355489,255858,212295,3709775,7465747,13537060,13537060
Syrian Arab Republic,1994,SY,SYR,EMR,1117660,2036850,3154510,1508351,934030,581650,387226,274470,214586,3900313,1066600,1946479,3013079,1466613,942738,592883,370368,261196,220925,3854723,7755036,13922626,13922626
Syrian Arab Republic,1995,SY,SYR,EMR,1131436,2071542,3202978,1557887,979943,606856,401256,278557,223537,4048036,1079845,1979883,3059728,1514364,986958,619104,386023,266341,229925,4002715,8050751,14313450,14313450
Syrian Arab Republic,1996,SY,SYR,EMR,1148367,2101974,3250341,1607899,1028326,632556,415825,282540,232393,4199539,1096007,2009247,3105254,1561058,1032935,646007,402721,271784,239244,4153749,8353288,14708879,14708879
Syrian Arab Republic,1997,SY,SYR,EMR,1166570,2129089,3295659,1656707,1077491,659564,431335,286661,240988,4352746,1113364,2035499,3148863,1606889,1079497,674020,420151,277481,248684,4306722,8659468,15103996,15103996
Syrian Arab Republic,1998,SY,SYR,EMR,1183157,2155156,3338313,1705781,1127111,688047,447978,291062,249250,4509229,1129170,2060788,3189958,1653096,1126399,703318,438796,283319,258124,4463052,8972281,15500542,15500542
Syrian Arab Republic,1999,SY,SYR,EMR,1197766,2181279,3379045,1755293,1176821,718133,466006,295932,257155,4669340,1143063,2086153,3229216,1699975,1173445,734102,459332,289169,267574,4623597,9292937,15901201,15901201
Syrian Arab Republic,2000,SY,SYR,EMR,1211958,2206252,3418210,1804812,1226530,750187,485300,301883,264795,4833507,1156575,2110353,3266928,1747156,1220624,766766,481541,295681,277236,4789004,9622511,16307654,16307654
Syrian Arab Republic,2001,SY,SYR,EMR,1230022,2229142,3459164,1853979,1276537,784595,505517,309743,272463,5002834,1173854,2132369,3306223,1794172,1268111,801633,505057,303335,287423,4959731,9962565,16727948,16727948
Syrian Arab Republic,2002,SY,SYR,EMR,1253622,2250284,3503906,1901396,1327180,821771,525585,320292,280174,5176398,1196442,2152556,3348998,1839605,1316109,838917,529277,312750,298060,5134718,10311116,17164021,17164021
Syrian Arab Republic,2003,SY,SYR,EMR,1280508,2271885,3552393,1945507,1378313,861605,543863,334701,287781,5351770,1222114,2173120,3395234,1881947,1364498,878356,552818,325339,309007,5311965,10663735,17611356,17611356
Syrian Arab Republic,2004,SY,SYR,EMR,1310388,2297058,3607446,1989104,1431668,904590,563880,349359,295429,5534030,1250572,2197036,3447608,1922716,1414643,920483,576836,340317,319931,5494926,11028956,18084007,18084007
Syrian Arab Republic,2005,SY,SYR,EMR,1343606,2326296,3669902,2031803,1487208,951056,587592,362392,303124,5723175,1282134,2224806,3506940,1961717,1466457,965566,602706,356317,330773,5683536,11406711,18583557,18583557
Syrian Arab Republic,2006,SY,SYR,EMR,1386716,2371188,3757904,2118352,1596447,1026459,624200,381386,314118,6060962,1323467,2268197,3591664,2048940,1572739,1037484,639848,377616,344850,6021477,12082439,19432009,19432009
Syrian Arab Republic,2007,SY,SYR,EMR,1447375,2433173,3880548,2252915,1771661,1136761,676798,407664,329283,6575082,1381958,2328528,3710486,2188947,1746388,1142161,691034,405149,363210,6536889,13111971,20703005,20703005
Syrian Arab Republic,2008,SY,SYR,EMR,1506379,2483633,3990012,2294674,1866387,1209921,714295,427501,339803,6852581,1438069,2376487,3814556,2229426,1839281,1212295,729379,428099,378428,6816908,13669489,21474059,21474059
Syrian Arab Republic,2009,SY,SYR,EMR,1550861,2525841,4076702,2269577,1894180,1251633,739535,442388,346622,6943935,1479746,2415855,3895601,2197684,1864506,1252959,757238,447882,390716,6910985,13854920,21827220,21827220
Syrian Arab Republic,2010,SY,SYR,EMR,1585720,2577071,4162791,2271412,1946764,1306756,772578,460982,355751,7114243,1512524,2464520,3977044,2194894,1914544,1306092,791935,471180,404838,7083483,14197726,22337563,22337563
Syrian Arab Republic,2011,SY,SYR,EMR,1604663,2630416,4235079,2257227,1979589,1354207,804367,478653,364978,7239021,1529993,2515138,4045131,2175344,1944894,1352261,825841,494257,418900,7211497,14450518,22730733,22730733
Syrian Arab Republic,2012,SY,SYR,EMR,1587649,2680640,4268289,2172498,1926050,1361409,820434,487363,369707,7137461,1512724,2561828,4074552,2083311,1891719,1362732,847126,511241,429149,7125278,14262739,22605577,22605577
Syrian Arab Republic,2013,SY,SYR,EMR,1509406,2719487,4228893,1963119,1708684,1288987,803346,478040,365859,6608035,1436405,2595692,4032097,1860286,1677160,1301115,840715,514715,432803,6626794,13234829,21495821,21495821
Syrian Arab Republic,2014,SY,SYR,EMR,1389522,2749464,4138986,1751211,1434306,1186738,775811,464512,358022,5970600,1320610,2620812,3941422,1633209,1403661,1211510,825092,513545,434202,6021219,11991819,20072232,20072232
Syrian Arab Republic,2015,SY,SYR,EMR,1263630,2779889,4043519,1669602,1243860,1122191,768086,462204,354140,5620083,1200245,2647791,3848036,1543143,1210465,1155164,825628,519724,439422,5693546,11313629,19205178,19205178
Syrian Arab Republic,2016,SY,SYR,EMR,1147219,2807475,3954694,1716244,1151279,1101759,782101,470126,357267,5578776,1090036,2673003,3763039,1588761,1112411,1138178,844112,533897,450384,5667743,11246519,18964252,18964252
Syrian Arab Republic,2017,SY,SYR,EMR,1044529,2820356,3864885,1818437,1100645,1096954,804436,482844,364166,5667482,993311,2684250,3677561,1694578,1055913,1135309,869716,552188,465745,5773449,11440931,18983373,18983373
Syrian Arab Republic,2018,SY,SYR,EMR,967061,2818752,3785813,1971859,1109478,1115082,837511,501796,375826,5911552,920913,2682133,3603046,1855726,1058587,1152945,904309,575585,485907,6033059,11944611,19333463,19333463
Syrian Arab Republic,2019,SY,SYR,EMR,934018,2792508,3726526,2178308,1198041,1164851,884706,528512,392984,6347402,890942,2657388,3548330,2072432,1139990,1198226,950182,604884,510270,6475984,12823386,20098251,20098251
Syrian Arab Republic,2020,SY,SYR,EMR,939246,2728005,3667251,2352866,1287085,1206529,928572,555307,410059,6740418,896727,2596147,3492874,2253662,1221639,1234523,992622,634275,535341,6872062,13612480,20772595,20772595
Syrian Arab Republic,2021,SY,SYR,EMR,968036,2638471,3606507,2490911,1372053,1236594,967586,581529,425956,7074629,924413,2511131,3435544,2394891,1300008,1258851,1030590,663445,559900,7207685,14282314,21324367,21324367
Syrian Arab Republic,2022,SY,SYR,EMR,1018120,2540740,3558860,2651673,1511206,1282039,1014306,613528,447016,7519768,972560,2419230,3391790,2560803,1435849,1297013,1075168,697496,588502,7654831,15174599,22125249,22125249
Syrian Arab Republic,2023,SY,SYR,EMR,1090405,2436802,3527207,2841399,1713437,1346689,1070604,652131,473900,8098160,1042101,2322455,3364556,2757711,1639209,1352749,1128041,737045,622338,8237093,16335253,23227014,23227014
Syrian Arab Republic,2024,SY,SYR,EMR,1174995,2338828,3513823,3001604,1935043,1410095,1126513,692991,501373,8667619,1123218,2231526,3354744,2923194,1865562,1406581,1180393,778592,657538,8811860,17479479,24348053,24348053
Syrian Arab Republic,2025,SY,SYR,EMR,1262629,2263684,3526313,3115189,2161999,1469177,1179497,735297,528796,9189955,1207138,2162162,3369300,3040003,2100506,1456111,1229883,821521,693597,9341621,18531576,25427191,25427191
Syrian Arab Republic,2026,SY,SYR,EMR,1352269,2209550,3561819,3180850,2386554,1524257,1228645,777789,555822,9653917,1292804,2112741,3405545,3106589,2335615,1502114,1275707,864718,730154,9814897,19468814,26436176,26436176
Syrian Arab Republic,2027,SY,SYR,EMR,1442202,2176572,3618774,3202225,2601057,1578743,1274099,819670,582670,10058464,1378513,2083435,3461948,3127071,2562435,1548238,1318016,907450,767332,10230542,20289006,27369725,27369725
Syrian Arab Republic,2028,SY,SYR,EMR,1526736,2173200,3699936,3185785,2796565,1639057,1317287,860819,609970,10409483,1458930,2082181,3541111,3108905,2771075,1601268,1358040,949596,805607,10594491,21003974,28245013,28245013
Syrian Arab Republic,2029,SY,SYR,EMR,1601129,2214011,3815140,3125567,2967104,1709644,1358464,901056,638159,10699994,1529658,2122523,3652181,3047382,2954532,1666101,1395980,990960,845333,10900288,21600282,29067596,29067596
Syrian Arab Republic,2030,SY,SYR,EMR,1663470,2298561,3962031,3022852,3107829,1790836,1396768,940125,667562,10925972,1588882,2203947,3792829,2944167,3106960,1743668,1430943,1031327,886843,11143908,22069880,29824735,29824735
Syrian Arab Republic,1950,SY,SYR,EMR,313072,402175,715247,329588,240309,163147,129827,114088,137401,1114360,284976,391868,676844,314239,209374,154614,127300,97676,133891,1037094,2151454,3543537,3543537
Syrian Arab Republic,1951,SY,SYR,EMR,325531,416110,741641,333645,249007,167052,129481,112207,134647,1126039,299006,401343,700349,321436,217895,156066,128633,97411,131254,1052695,2178734,3620726,3620726
Syrian Arab Republic,1952,SY,SYR,EMR,336270,433714,769984,337440,257797,171281,129374,110668,131968,1138528,312578,413070,725648,328041,226908,157663,129781,97788,128669,1068850,2207378,3703006,3703006
Syrian Arab Republic,1953,SY,SYR,EMR,344074,456268,800342,341250,266482,175923,129640,109365,129380,1152040,324303,428653,752956,334160,236244,159633,131001,98515,126196,1085749,2237789,3791081,3791081
Syrian Arab Republic,1954,SY,SYR,EMR,353629,479390,833019,345369,274870,181063,130381,108282,126939,1166904,335770,446915,782685,339903,245749,162196,132295,99525,123827,1103495,2270399,3886093,3886093
Syrian Arab Republic,1955,SY,SYR,EMR,367487,500841,868328,350075,282761,186792,131674,107380,124665,1183347,348938,466250,815188,345427,255261,165561,133666,100756,121571,1122242,2305589,3989101,3989101
Syrian Arab Republic,1956,SY,SYR,EMR,382280,523634,905914,355558,290008,193142,133544,106628,122518,1201398,362993,486906,849899,351099,264628,169865,135108,102164,119408,1142272,2343670,4099489,4099489
Syrian Arab Republic,1957,SY,SYR,EMR,397599,547822,945421,362030,296572,200106,135964,106039,120484,1221195,377536,508695,886231,357408,273742,175139,136609,103732,117369,1163999,2385194,4216847,4216847
Syrian Arab Republic,1958,SY,SYR,EMR,413183,573545,986728,369673,302506,207617,138870,105638,118565,1242869,392339,532148,924487,364224,282521,181311,138150,105408,115578,1187192,2430061,4341276,4341276
Syrian Arab Republic,1959,SY,SYR,EMR,428676,600841,1029517,378695,307866,215603,142182,105438,116793,1266577,407101,557915,965016,371278,290889,188310,139712,107139,114130,1211458,2478035,4472564,4472564
Syrian Arab Republic,1960,SY,SYR,EMR,443878,629175,1073053,389790,312732,224004,145859,105443,115245,1293073,421630,585511,1007141,379334,298774,196055,141291,108813,113181,1237448,2530521,4610712,4610712
Syrian Arab Republic,1961,SY,SYR,EMR,458653,657428,1116081,402430,317047,232513,149519,105638,114015,1321162,435816,614127,1049943,388599,305927,204021,142643,110254,112902,1264346,2585508,4751534,4751534
Syrian Arab Republic,1962,SY,SYR,EMR,473310,684610,1157920,417351,320895,241015,153113,106062,113048,1351484,449964,642990,1092954,399699,312344,212086,143836,111562,113109,1292636,2644120,4894995,4894995
Syrian Arab Republic,1963,SY,SYR,EMR,488314,709387,1197701,437163,324569,249555,156979,106790,112212,1387268,464466,670625,1135091,414593,318293,220519,145298,112917,113568,1325188,2712456,5045245,5045245
Syrian Arab Republic,1964,SY,SYR,EMR,503985,735842,1239827,457588,328334,257932,161221,107884,111516,1424475,479605,698084,1177689,432116,323845,229155,147215,114308,114218,1360857,2785332,5202846,5202846
Syrian Arab Republic,1965,SY,SYR,EMR,520845,765993,1286838,476372,332400,265929,165920,109382,110937,1460940,495876,726783,1222659,450663,329105,237801,149757,115707,114981,1398014,2858954,5368451,5368451
Syrian Arab Republic,1966,SY,SYR,EMR,539402,796568,1335970,496305,336881,273303,171088,111279,110417,1499273,513740,755941,1269681,470440,334403,246277,153046,117099,115811,1437076,2936349,5542003,5542003
Syrian Arab Republic,1967,SY,SYR,EMR,559697,827500,1387197,517234,341856,279928,176656,113527,109960,1539161,533227,785514,1318741,491245,340200,254437,157075,118473,116772,1478202,3017363,5723306,5723306
Syrian Arab Republic,1968,SY,SYR,EMR,581503,858861,1440364,539318,347558,285876,182587,116087,109653,1581079,554155,815583,1369738,513557,346346,262144,161759,119814,117911,1521531,3102610,5912715,5912715
Syrian Arab Republic,1969,SY,SYR,EMR,605078,890746,1495824,562692,354224,291260,188864,118935,109602,1625577,576711,846178,1422889,537977,352531,269279,166998,121081,119222,1567088,3192665,6111364,6111364
Syrian Arab Republic,2031,SY,SYR,EMR,1712198,2413257,4125455,2893431,3216233,1882862,1431704,978119,698487,11100836,1635116,2313664,3948780,2814631,3224995,1834769,1462353,1070743,930314,11337805,22438641,30512875,30512875
Syrian Arab Republic,2032,SY,SYR,EMR,1748154,2544143,4292297,2748577,3298492,1987008,1462715,1015460,731175,11243427,1669126,2438570,4107696,2670059,3313923,1941124,1489432,1109473,975978,11499989,22743416,31143413,31143413
Syrian Arab Republic,2033,SY,SYR,EMR,1770494,2684294,4454788,2594707,3363036,2105699,1489950,1052360,765691,11371443,1690136,2572106,4262242,2517433,3381470,2065338,1512044,1147593,1023808,11647686,23019129,31736160,31736160
Syrian Arab Republic,2034,SY,SYR,EMR,1778864,2826418,4605282,2453721,3400369,2239451,1513949,1088232,802309,11498031,1697884,2707361,4405245,2378076,3418587,2207908,1530631,1184462,1074001,11793665,23291696,32302224,32302224
Syrian Arab Republic,2035,SY,SYR,EMR,1774511,2961225,4735736,2342862,3403712,2383961,1536173,1122588,841103,11630399,1693550,2835598,4529148,2268322,3419094,2364127,1547028,1219477,1126624,11944672,23575071,32839952,32839952
Syrian Arab Republic,2036,SY,SYR,EMR,1758348,3087071,4845419,2259894,3375979,2536234,1559094,1155423,881312,11767936,1677945,2955195,4633140,2186085,3386166,2530336,1564097,1252662,1180849,12100195,23868131,33346683,33346683
Syrian Arab Republic,2037,SY,SYR,EMR,1732551,3203080,4935631,2204249,3321026,2689675,1586452,1187019,922479,11910900,1653170,3065232,4718402,2130793,3324345,2699096,1585860,1284310,1236196,12260600,24171500,33825539,33825539
Syrian Arab Republic,2038,SY,SYR,EMR,1699781,3301836,5001617,2183455,3242615,2833317,1623402,1218257,964630,12065676,1621800,3158690,4780490,2109493,3238310,2858307,1618003,1315211,1292677,12432001,24497677,34279788,34279788
Syrian Arab Republic,2039,SY,SYR,EMR,1662507,3377798,5040305,2211125,3133860,2960649,1673919,1249223,1007797,12236573,1586157,3230469,4816626,2134940,3122352,3000357,1665052,1345425,1350321,12618447,24855020,34711951,34711951
Syrian Arab Republic,2040,SY,SYR,EMR,1621498,3430673,5052171,2286141,2997015,3068687,1739196,1279502,1052250,12422791,1546933,3280293,4827226,2205922,2979327,3121323,1728768,1374451,1409439,12819230,25242021,35121421,35121421
Syrian Arab Republic,2041,SY,SYR,EMR,1579047,3459997,5039044,2394323,2846824,3155303,1819660,1308740,1098268,12623118,1506350,3307669,4814019,2308845,2823857,3218288,1810173,1401827,1470260,13033250,25656368,35509433,35509433
Syrian Arab Republic,2042,SY,SYR,EMR,1536096,3468470,5004566,2520944,2691383,3224589,1915663,1336079,1146041,12834699,1465289,3315167,4780456,2429590,2664038,3294596,1910148,1426500,1532953,13257825,26092524,35877547,35877547
Syrian Arab Republic,2043,SY,SYR,EMR,1493658,3457185,4950843,2658091,2532478,3280933,2027703,1360855,1195166,13055226,1424663,3303860,4728523,2560470,2501992,3354051,2029534,1447657,1597087,13490791,26546017,36225380,36225380
Syrian Arab Republic,2044,SY,SYR,EMR,1454067,3427756,4881823,2797904,2388797,3312658,2155098,1383058,1245019,13282534,1386750,3275317,4662067,2693895,2356000,3385219,2167713,1465264,1661929,13730020,27012554,36556446,36556446
Syrian Arab Republic,2045,SY,SYR,EMR,1419243,3382191,4801434,2931043,2276959,3313086,2293665,1404054,1295251,13514058,1353400,3231396,4584796,2820960,2242093,3381934,2320041,1481098,1726968,13973094,27487152,36873389,36873389
Syrian Arab Republic,2046,SY,SYR,EMR,1388702,3323707,4712409,3055722,2194553,3285038,2440524,1426125,1345180,13747142,1324126,3175146,4499272,2939900,2157962,3347367,2482940,1497929,1791474,14217572,27964714,37176391,37176391
Syrian Arab Republic,2047,SY,SYR,EMR,1362911,3255331,4618242,3170910,2140387,3231812,2589139,1452708,1394648,13979604,1299395,3109485,4408880,3049616,2102369,3285591,2648919,1519585,1855235,14461315,28440919,37468039,37468039
Syrian Arab Republic,2048,SY,SYR,EMR,1343986,3180617,4524603,3269081,2120940,3156248,2728592,1488578,1444365,14207804,1281235,3037775,4319010,3142929,2081327,3200422,2805763,1551492,1918929,14700862,28908666,37752283,37752283
Syrian Arab Republic,2049,SY,SYR,EMR,1331145,3104252,4435397,3344670,2148986,3051042,2852393,1537363,1494404,14428858,1268843,2964513,4233356,3214623,2106877,3085614,2945769,1597943,1982634,14933460,29362318,38031069,38031069
Syrian Arab Republic,2050,SY,SYR,EMR,1323978,3028906,4352884,3397364,2223386,2918281,2957635,1600140,1544688,14641494,1261883,2892218,4154101,3264417,2177725,2943914,3065055,1660621,2046167,15157899,29799393,38306374,38306374
Turks and Caicos Islands,1970,TC,TCA,AMR,461,912,1373,448,206,219,201,174,96,1344,451,833,1284,446,257,324,236,189,214,1666,3010,5665,5665
Turks and Caicos Islands,1971,TC,TCA,AMR,452,925,1377,474,213,225,198,178,97,1385,450,842,1292,472,257,321,239,185,215,1689,3074,5742,5742
Turks and Caicos Islands,1972,TC,TCA,AMR,452,930,1382,511,233,234,202,181,103,1464,452,848,1300,511,264,321,244,182,220,1742,3206,5896,5896
Turks and Caicos Islands,1973,TC,TCA,AMR,460,940,1400,548,259,236,204,180,111,1538,456,860,1316,548,276,321,252,183,225,1805,3343,6068,6068
Turks and Caicos Islands,1974,TC,TCA,AMR,471,953,1424,584,282,242,214,181,114,1617,462,882,1344,581,289,316,265,182,232,1865,3482,6249,6249
Turks and Caicos Islands,1975,TC,TCA,AMR,482,970,1452,612,301,245,225,184,122,1689,470,910,1380,611,303,310,283,182,236,1925,3614,6451,6451
Turks and Caicos Islands,1976,TC,TCA,AMR,494,992,1486,642,328,250,236,191,125,1772,478,938,1416,640,314,304,309,181,239,1987,3759,6668,6668
Turks and Caicos Islands,1977,TC,TCA,AMR,498,1018,1516,671,354,253,254,196,130,1858,488,966,1454,662,334,305,322,187,246,2056,3914,6885,6885
Turks and Caicos Islands,1978,TC,TCA,AMR,495,1046,1541,696,382,265,269,196,141,1949,498,994,1492,683,355,309,329,205,247,2128,4077,7110,7110
Turks and Caicos Islands,1979,TC,TCA,AMR,492,1068,1560,723,407,272,284,202,154,2042,508,1017,1525,709,380,312,330,222,249,2202,4244,7332,7332
Turks and Caicos Islands,1980,TC,TCA,AMR,489,1082,1571,783,440,290,289,215,158,2175,513,1037,1550,752,415,321,326,239,246,2299,4474,7598,7598
Turks and Caicos Islands,1981,TC,TCA,AMR,500,1088,1588,853,497,330,293,221,163,2357,520,1056,1576,813,465,337,315,253,253,2436,4793,7957,7957
Turks and Caicos Islands,1982,TC,TCA,AMR,522,1084,1606,935,559,384,291,225,170,2564,533,1062,1595,876,525,360,316,261,256,2594,5158,8355,8355
Turks and Caicos Islands,1983,TC,TCA,AMR,545,1081,1626,1007,629,438,297,225,171,2767,544,1065,1609,937,587,385,322,261,258,2750,5517,8758,8758
Turks and Caicos Islands,1984,TC,TCA,AMR,570,1078,1648,1068,706,496,314,229,180,2993,557,1064,1621,996,641,420,336,256,262,2911,5904,9166,9166
Turks and Caicos Islands,1985,TC,TCA,AMR,592,1070,1662,1116,781,554,336,228,190,3205,572,1058,1630,1047,704,456,351,256,265,3079,6284,9577,9577
Turks and Caicos Islands,1986,TC,TCA,AMR,610,1074,1684,1151,860,620,370,219,200,3420,587,1058,1645,1089,769,495,372,250,268,3243,6663,9986,9986
Turks and Caicos Islands,1987,TC,TCA,AMR,622,1077,1699,1175,934,686,410,210,220,3635,601,1061,1662,1118,826,538,403,240,276,3401,7036,10400,10400
Turks and Caicos Islands,1988,TC,TCA,AMR,634,1088,1722,1192,998,762,461,202,235,3850,613,1064,1677,1140,879,587,441,227,292,3566,7416,10816,10816
Turks and Caicos Islands,1989,TC,TCA,AMR,646,1100,1746,1200,1065,838,519,199,245,4066,623,1072,1695,1152,938,639,471,221,303,3724,7790,11227,11227
Turks and Caicos Islands,1990,TC,TCA,AMR,668,1120,1788,1221,1137,897,567,206,250,4278,647,1087,1734,1184,1005,693,501,225,304,3912,8190,11709,11709
Turks and Caicos Islands,1991,TC,TCA,AMR,718,1149,1867,1279,1215,935,601,230,252,4512,692,1121,1813,1251,1086,745,514,241,306,4143,8655,12329,12329
Turks and Caicos Islands,1992,TC,TCA,AMR,776,1182,1958,1340,1312,968,637,254,246,4757,741,1162,1903,1315,1182,803,519,263,308,4390,9147,13014,13014
Turks and Caicos Islands,1993,TC,TCA,AMR,830,1217,2047,1392,1419,1018,666,280,245,5020,787,1209,1996,1365,1298,860,524,295,302,4644,9664,13704,13704
Turks and Caicos Islands,1994,TC,TCA,AMR,871,1259,2130,1431,1525,1080,690,307,251,5284,829,1253,2082,1406,1415,928,538,316,306,4909,10193,14402,14402
Turks and Caicos Islands,1995,TC,TCA,AMR,898,1315,2213,1445,1643,1153,719,331,261,5552,858,1304,2162,1435,1535,1010,557,325,308,5170,10722,15101,15101
Turks and Caicos Islands,1996,TC,TCA,AMR,911,1382,2293,1445,1767,1235,756,350,277,5830,878,1361,2239,1449,1662,1099,582,339,321,5452,11282,15806,15806
Turks and Caicos Islands,1997,TC,TCA,AMR,920,1455,2375,1423,1880,1331,804,366,297,6101,900,1418,2318,1449,1785,1187,618,353,329,5721,11822,16515,16515
Turks and Caicos Islands,1998,TC,TCA,AMR,936,1529,2465,1397,1985,1438,856,381,318,6375,917,1474,2391,1440,1899,1286,670,366,351,6012,12387,17239,17239
Turks and Caicos Islands,1999,TC,TCA,AMR,962,1595,2557,1371,2073,1564,916,398,340,6662,932,1529,2461,1431,1997,1402,733,367,372,6302,12964,17984,17984
Turks and Caicos Islands,2000,TC,TCA,AMR,1004,1656,2660,1345,2137,1709,975,422,361,6949,951,1582,2533,1425,2071,1536,810,371,388,6601,13550,18744,18744
Turks and Caicos Islands,2001,TC,TCA,AMR,1067,1704,2771,1354,2188,1849,1040,461,376,7268,981,1631,2612,1438,2126,1676,900,384,402,6926,14194,19578,19578
Turks and Caicos Islands,2002,TC,TCA,AMR,1118,1746,2864,1437,2234,1987,1120,517,399,7694,1025,1684,2709,1502,2160,1812,1002,418,440,7334,15028,20598,20598
Turks and Caicos Islands,2003,TC,TCA,AMR,1141,1791,2932,1554,2290,2118,1217,583,434,8196,1067,1750,2817,1594,2185,1941,1116,469,489,7794,15990,21739,21739
Turks and Caicos Islands,2004,TC,TCA,AMR,1145,1843,2988,1657,2345,2256,1328,644,476,8706,1096,1832,2928,1660,2224,2059,1230,531,546,8250,16956,22869,22869
Turks and Caicos Islands,2005,TC,TCA,AMR,1129,1904,3033,1727,2407,2390,1456,720,522,9222,1107,1923,3030,1705,2279,2171,1347,607,607,8716,17938,23995,23995
Turks and Caicos Islands,2006,TC,TCA,AMR,1102,1982,3084,1761,2484,2514,1586,804,580,9729,1099,2034,3133,1724,2339,2283,1465,696,682,9189,18918,25128,25128
Turks and Caicos Islands,2007,TC,TCA,AMR,1086,2062,3148,1775,2565,2626,1724,894,645,10229,1090,2150,3240,1726,2400,2393,1575,797,760,9651,19880,26268,26268
Turks and Caicos Islands,2008,TC,TCA,AMR,1093,2128,3221,1767,2647,2747,1864,992,723,10740,1088,2251,3339,1729,2464,2495,1684,903,847,10122,20862,27422,27422
Turks and Caicos Islands,2009,TC,TCA,AMR,1112,2173,3285,1753,2716,2886,2002,1089,800,11246,1095,2323,3418,1746,2530,2587,1808,1018,939,10628,21874,28581,28581
Turks and Caicos Islands,2010,TC,TCA,AMR,1135,2195,3330,1750,2765,3050,2144,1172,885,11766,1106,2359,3465,1787,2593,2669,1939,1134,1033,11155,22921,29726,29726
Turks and Caicos Islands,2011,TC,TCA,AMR,1123,2204,3327,1766,2794,3227,2277,1258,987,12309,1104,2370,3474,1846,2636,2767,2068,1259,1128,11704,24013,30816,30816
Turks and Caicos Islands,2012,TC,TCA,AMR,1095,2215,3310,1834,2845,3393,2432,1357,1095,12956,1089,2380,3469,1956,2688,2879,2200,1396,1234,12353,25309,32081,32081
Turks and Caicos Islands,2013,TC,TCA,AMR,1076,2233,3309,1954,2937,3537,2610,1476,1193,13707,1078,2414,3492,2110,2744,3002,2353,1526,1346,13081,26788,33594,33594
Turks and Caicos Islands,2014,TC,TCA,AMR,1061,2247,3308,2061,3002,3663,2784,1604,1292,14406,1065,2444,3509,2260,2764,3133,2492,1646,1463,13758,28164,34985,34985
Turks and Caicos Islands,2015,TC,TCA,AMR,1063,2257,3320,2175,3091,3792,2953,1749,1413,15173,1063,2478,3541,2413,2811,3268,2628,1773,1609,14502,29675,36538,36538
Turks and Caicos Islands,2016,TC,TCA,AMR,1108,2233,3341,2298,3195,3941,3113,1905,1543,15995,1097,2496,3593,2572,2888,3392,2776,1914,1771,15313,31308,38246,38246
Turks and Caicos Islands,2017,TC,TCA,AMR,1174,2205,3379,2403,3285,4076,3260,2055,1676,16755,1152,2496,3648,2710,2952,3485,2924,2049,1940,16060,32815,39844,39844
Turks and Caicos Islands,2018,TC,TCA,AMR,1227,2209,3436,2483,3393,4206,3422,2199,1811,17514,1204,2516,3720,2822,3049,3574,3072,2184,2113,16814,34328,41487,41487
Turks and Caicos Islands,2019,TC,TCA,AMR,1280,2227,3507,2530,3504,4323,3605,2338,1930,18230,1255,2543,3798,2899,3167,3669,3200,2326,2279,17540,35770,43080,43080
Turks and Caicos Islands,2020,TC,TCA,AMR,1330,2255,3585,2526,3565,4403,3775,2467,2008,18744,1299,2559,3858,2919,3263,3744,3297,2466,2408,18097,36841,44276,44276
Turks and Caicos Islands,2021,TC,TCA,AMR,1367,2284,3651,2494,3571,4450,3920,2577,2064,19076,1329,2572,3901,2897,3325,3791,3378,2581,2513,18485,37561,45114,45114
Turks and Caicos Islands,2022,TC,TCA,AMR,1392,2313,3705,2467,3525,4466,4030,2698,2114,19300,1348,2574,3922,2879,3351,3818,3447,2675,2603,18773,38073,45703,45703
Turks and Caicos Islands,2023,TC,TCA,AMR,1406,2345,3751,2447,3430,4442,4110,2824,2169,19422,1355,2558,3913,2875,3345,3805,3503,2767,2682,18977,38399,46062,46062
Turks and Caicos Islands,2024,TC,TCA,AMR,1416,2376,3792,2437,3335,4406,4172,2946,2248,19544,1360,2545,3905,2880,3344,3770,3576,2845,2775,19190,38734,46431,46431
Turks and Caicos Islands,2025,TC,TCA,AMR,1414,2423,3837,2434,3244,4349,4234,3056,2345,19662,1359,2541,3900,2882,3344,3728,3647,2916,2882,19399,39061,46797,46797
Turks and Caicos Islands,2026,TC,TCA,AMR,1410,2503,3913,2403,3174,4267,4295,3150,2463,19752,1353,2566,3919,2862,3347,3677,3693,2989,3005,19573,39325,47160,47160
Turks and Caicos Islands,2027,TC,TCA,AMR,1403,2594,3997,2369,3109,4177,4353,3240,2588,19836,1344,2607,3951,2828,3358,3623,3726,3067,3134,19736,39572,47519,47519
Turks and Caicos Islands,2028,TC,TCA,AMR,1393,2663,4056,2366,3042,4081,4396,3342,2703,19930,1335,2643,3978,2803,3355,3584,3749,3139,3269,19899,39829,47862,47862
Turks and Caicos Islands,2029,TC,TCA,AMR,1385,2727,4112,2378,2969,3978,4423,3459,2812,20019,1330,2678,4008,2777,3337,3562,3779,3198,3409,20062,40081,48202,48202
Turks and Caicos Islands,2030,TC,TCA,AMR,1380,2780,4160,2405,2889,3888,4439,3577,2920,20118,1320,2710,4030,2758,3302,3552,3810,3241,3565,20228,40346,48538,48538
Turks and Caicos Islands,1950,TC,TCA,AMR,445,602,1047,284,201,206,135,101,116,1043,429,658,1087,466,408,400,257,159,174,1864,2907,5036,5036
Turks and Caicos Islands,1951,TC,TCA,AMR,454,592,1046,304,199,203,135,100,109,1050,441,650,1091,477,409,383,253,164,168,1854,2904,5046,5046
Turks and Caicos Islands,1952,TC,TCA,AMR,456,582,1038,318,200,196,131,101,108,1054,448,639,1087,488,407,360,249,167,163,1834,2888,5014,5014
Turks and Caicos Islands,1953,TC,TCA,AMR,454,577,1031,318,201,187,128,98,110,1042,453,639,1092,489,405,351,251,170,162,1828,2870,4989,4989
Turks and Caicos Islands,1954,TC,TCA,AMR,462,590,1052,319,207,189,131,95,110,1051,458,646,1104,484,404,345,254,170,168,1825,2876,5029,5029
Turks and Caicos Islands,1955,TC,TCA,AMR,481,618,1099,323,214,196,140,95,107,1075,471,661,1132,478,405,341,260,172,175,1831,2906,5127,5127
Turks and Caicos Islands,1956,TC,TCA,AMR,493,655,1148,327,222,215,150,97,104,1115,480,677,1157,470,407,332,268,175,176,1828,2943,5244,5244
Turks and Caicos Islands,1957,TC,TCA,AMR,498,697,1195,331,228,222,162,95,99,1137,484,698,1182,460,403,329,277,179,183,1831,2968,5348,5348
Turks and Caicos Islands,1958,TC,TCA,AMR,494,737,1231,340,233,234,177,94,97,1175,481,722,1203,448,396,327,279,182,193,1825,3000,5437,5437
Turks and Caicos Islands,1959,TC,TCA,AMR,490,776,1266,352,230,240,194,97,98,1211,483,748,1231,444,388,330,274,185,201,1822,3033,5535,5535
Turks and Caicos Islands,1960,TC,TCA,AMR,489,800,1289,365,231,237,209,100,95,1237,483,770,1253,449,380,325,272,191,203,1820,3057,5604,5604
Turks and Caicos Islands,1961,TC,TCA,AMR,490,804,1294,386,232,231,215,105,94,1263,481,771,1252,450,373,321,268,194,204,1810,3073,5625,5625
Turks and Caicos Islands,1962,TC,TCA,AMR,493,800,1293,404,231,224,217,113,93,1282,477,773,1250,449,369,325,261,204,199,1807,3089,5633,5633
Turks and Caicos Islands,1963,TC,TCA,AMR,493,798,1291,421,231,216,217,123,94,1302,467,774,1241,447,359,324,254,214,197,1795,3097,5634,5634
Turks and Caicos Islands,1964,TC,TCA,AMR,494,800,1294,431,231,211,221,132,95,1321,459,779,1238,450,349,322,251,219,199,1790,3111,5642,5642
Turks and Caicos Islands,1965,TC,TCA,AMR,492,808,1300,437,233,210,226,137,96,1339,453,788,1241,449,341,321,240,223,198,1772,3111,5650,5650
Turks and Caicos Islands,1966,TC,TCA,AMR,487,824,1311,441,227,210,228,142,92,1340,447,799,1246,440,324,324,232,225,198,1743,3083,5652,5652
Turks and Caicos Islands,1967,TC,TCA,AMR,485,841,1326,444,225,210,224,151,90,1344,445,809,1254,437,310,329,232,224,205,1737,3081,5662,5662
Turks and Caicos Islands,1968,TC,TCA,AMR,484,863,1347,443,221,217,217,161,94,1353,448,813,1261,435,292,326,235,214,203,1705,3058,5668,5668
Turks and Caicos Islands,1969,TC,TCA,AMR,476,885,1361,444,213,219,208,168,94,1346,449,824,1273,440,275,325,240,200,206,1686,3032,5663,5663
Turks and Caicos Islands,2031,TC,TCA,AMR,1370,2814,4184,2431,2829,3801,4449,3690,3031,20231,1320,2729,4049,2744,3261,3553,3832,3289,3707,20386,40617,48858,48858
Turks and Caicos Islands,2032,TC,TCA,AMR,1370,2835,4205,2460,2790,3705,4450,3785,3169,20359,1310,2736,4046,2737,3233,3549,3847,3342,3861,20569,40928,49175,49175
Turks and Caicos Islands,2033,TC,TCA,AMR,1361,2842,4203,2486,2772,3614,4428,3861,3326,20487,1308,2734,4042,2722,3226,3541,3837,3398,4018,20742,41229,49484,49484
Turks and Caicos Islands,2034,TC,TCA,AMR,1360,2841,4201,2521,2764,3525,4394,3925,3494,20623,1301,2732,4033,2708,3231,3545,3804,3474,4162,20924,41547,49780,49780
Turks and Caicos Islands,2035,TC,TCA,AMR,1354,2835,4189,2570,2759,3435,4341,3988,3662,20755,1298,2726,4024,2706,3234,3543,3763,3541,4309,21096,41851,50066,50066
Turks and Caicos Islands,2036,TC,TCA,AMR,1349,2825,4174,2650,2731,3365,4262,4050,3830,20888,1292,2713,4005,2731,3215,3548,3714,3593,4472,21273,42161,50335,50335
Turks and Caicos Islands,2037,TC,TCA,AMR,1344,2812,4156,2739,2696,3299,4173,4107,3993,21007,1286,2699,3985,2774,3181,3560,3658,3625,4646,21444,42451,50590,50590
Turks and Caicos Islands,2038,TC,TCA,AMR,1338,2799,4137,2810,2695,3233,4077,4149,4160,21124,1280,2685,3965,2809,3154,3554,3621,3653,4812,21603,42727,50839,50839
Turks and Caicos Islands,2039,TC,TCA,AMR,1333,2786,4119,2872,2707,3165,3983,4180,4338,21245,1276,2677,3953,2843,3131,3532,3600,3682,4964,21752,42997,51074,51074
Turks and Caicos Islands,2040,TC,TCA,AMR,1327,2774,4101,2923,2734,3090,3898,4199,4507,21351,1274,2665,3939,2874,3112,3502,3595,3714,5114,21911,43262,51298,51298
Turks and Caicos Islands,2041,TC,TCA,AMR,1325,2768,4093,2961,2758,3026,3813,4212,4672,21442,1268,2652,3920,2894,3101,3463,3595,3736,5262,22051,43493,51506,51506
Turks and Caicos Islands,2042,TC,TCA,AMR,1320,2753,4073,2979,2789,2990,3724,4213,4841,21536,1263,2641,3904,2900,3092,3435,3592,3751,5411,22181,43717,51700,51700
Turks and Caicos Islands,2043,TC,TCA,AMR,1318,2743,4061,2989,2819,2972,3634,4200,5015,21629,1261,2632,3893,2901,3080,3431,3585,3747,5567,22311,43940,51887,51887
Turks and Caicos Islands,2044,TC,TCA,AMR,1315,2734,4049,2988,2849,2964,3547,4173,5187,21708,1256,2625,3881,2900,3065,3436,3586,3711,5727,22425,44133,52062,52062
Turks and Caicos Islands,2045,TC,TCA,AMR,1311,2725,4036,2981,2895,2961,3462,4126,5348,21773,1255,2615,3870,2890,3061,3437,3589,3674,5884,22535,44308,52217,52217
Turks and Caicos Islands,2046,TC,TCA,AMR,1311,2718,4029,2970,2979,2929,3393,4056,5507,21834,1254,2604,3858,2881,3086,3417,3593,3630,6034,22641,44475,52365,52365
Turks and Caicos Islands,2047,TC,TCA,AMR,1310,2710,4020,2959,3070,2899,3333,3976,5662,21899,1254,2594,3848,2865,3128,3384,3605,3581,6178,22741,44640,52513,52513
Turks and Caicos Islands,2048,TC,TCA,AMR,1312,2698,4010,2945,3138,2897,3269,3892,5807,21948,1254,2587,3841,2855,3163,3361,3603,3543,6308,22833,44781,52642,52642
Turks and Caicos Islands,2049,TC,TCA,AMR,1311,2689,4000,2934,3201,2912,3202,3806,5950,22005,1251,2580,3831,2840,3198,3337,3582,3528,6439,22924,44929,52758,52758
Turks and Caicos Islands,2050,TC,TCA,AMR,1314,2685,3999,2923,3252,2932,3131,3729,6072,22039,1255,2573,3828,2830,3226,3315,3549,3524,6557,23001,45040,52865,52865
Chad,1970,TD,TCD,AFR,321123,463404,784527,330296,234505,176014,133283,88794,62766,1025658,317296,462843,780139,329891,235571,185854,143651,101866,80229,1077062,2102720,3667394,3667394
Chad,1971,TD,TCD,AFR,331067,473862,804929,338990,237291,177718,134454,90047,63633,1042133,326969,472981,799950,339588,238223,187459,145552,103156,81551,1095529,2137662,3742534,3742534
Chad,1972,TD,TCD,AFR,343248,484864,828112,348258,239865,179624,135528,91402,64480,1059157,338847,483678,822525,349827,240828,189164,147385,104422,82975,1114601,2173758,3824399,3824399
Chad,1973,TD,TCD,AFR,357092,496613,853705,358227,242476,181778,136619,92886,65378,1077364,352402,495116,847518,360500,243487,190933,149175,105730,84491,1134316,2211680,3912905,3912905
Chad,1974,TD,TCD,AFR,370268,509160,879428,369445,243912,183793,137651,94329,66283,1095413,365299,507294,872593,372006,245003,192393,150784,107068,85880,1153134,2248547,4000559,4000559
Chad,1975,TD,TCD,AFR,382538,522668,905206,378878,246064,185262,138496,95614,67150,1111464,377304,520362,897666,381220,247623,193263,152125,108416,87128,1169775,2281239,4084110,4084110
Chad,1976,TD,TCD,AFR,393897,537244,931141,385215,249686,186066,139089,96723,67983,1124762,388471,534473,922944,387123,252183,193527,153187,109824,88363,1184207,2308969,4163051,4163051
Chad,1977,TD,TCD,AFR,403192,553916,957108,391155,252535,186333,139478,97671,68810,1135982,397645,550680,948325,392742,256093,193339,153999,111314,89644,1197131,2333113,4238551,4238551
Chad,1978,TD,TCD,AFR,410580,572424,983004,397359,255255,186416,139812,98525,69694,1147061,404930,568699,973629,398616,259798,192974,154640,112835,90921,1209784,2356845,4313479,4313479
Chad,1979,TD,TCD,AFR,417994,591691,1009685,406040,260197,187474,140608,99501,70824,1164644,412251,587526,999777,407114,265677,193617,155575,114474,92376,1228833,2393477,4402942,4402942
Chad,1980,TD,TCD,AFR,423221,608988,1032209,402571,251552,181662,138446,99088,70937,1144256,417347,604396,1021743,402421,257762,187948,153854,114977,93057,1210019,2354275,4408230,4408230
Chad,1981,TD,TCD,AFR,425487,626432,1051919,400898,242620,175186,136115,98497,71119,1124435,419477,621599,1041076,399557,249423,181726,151893,115347,93847,1191793,2316228,4409225,4409225
Chad,1982,TD,TCD,AFR,431974,649122,1081096,432383,267981,184808,141073,100996,74197,1201438,425838,644373,1070211,432454,275694,190668,156154,118203,96911,1270084,2471522,4622828,4622828
Chad,1983,TD,TCD,AFR,445815,671324,1117139,463593,296123,195456,146617,103645,77261,1282695,439380,666739,1106119,465224,304940,200839,160919,121199,100107,1353228,2635923,4859173,4859173
Chad,1984,TD,TCD,AFR,461017,688147,1149164,465759,296503,190966,145868,103492,77646,1280234,454157,683629,1137786,466675,306113,197035,160210,121931,101409,1353373,2633607,4920556,4920556
Chad,1985,TD,TCD,AFR,474261,704691,1178952,467593,293688,186497,144409,103115,77982,1273284,467032,700226,1167258,467357,303374,193638,158743,122341,102647,1348100,2621384,4967590,4967590
Chad,1986,TD,TCD,AFR,491305,721329,1212634,486541,305348,192220,146281,104277,79796,1314463,483733,716976,1200709,486335,314851,200228,160062,123859,105016,1390351,2704814,5118160,5118160
Chad,1987,TD,TCD,AFR,514565,735317,1249882,509516,320741,199881,148756,105624,81675,1366193,506580,731004,1237584,510987,331567,209186,162150,125611,107688,1447189,2813382,5300852,5300852
Chad,1988,TD,TCD,AFR,537387,752757,1290144,531736,335075,207204,150980,106861,83294,1415150,528990,748221,1277211,534305,347183,217767,164004,127135,110132,1500526,2915676,5483038,5483038
Chad,1989,TD,TCD,AFR,558508,775573,1334081,553719,349954,215003,153411,108292,84983,1465362,549740,770511,1320251,555802,362141,226264,165842,128513,112363,1550925,3016287,5670619,5670619
Chad,1990,TD,TCD,AFR,582133,797379,1379512,569086,358594,220083,154473,109094,86037,1497367,572874,791657,1364531,571118,371661,232566,166773,129397,114133,1585648,3083015,5827069,5827069
Chad,1991,TD,TCD,AFR,609737,819963,1429700,592638,376049,229900,157333,110767,87816,1554503,599825,813499,1413324,595094,390002,243302,169334,130879,116305,1644916,3199419,6042428,6042428
Chad,1992,TD,TCD,AFR,639816,846607,1486423,620950,400020,243593,161422,113213,90047,1629245,629028,839157,1468185,623363,414126,257413,172855,132766,118555,1719078,3348323,6302926,6302926
Chad,1993,TD,TCD,AFR,667964,874893,1542857,629020,404244,248358,161179,113859,90474,1647134,656044,866046,1522090,629826,418135,263131,172721,133104,119284,1736201,3383335,6448280,6448280
Chad,1994,TD,TCD,AFR,691971,907415,1599386,637201,408120,254282,160042,114413,90938,1664996,678921,896999,1575920,636340,421476,269849,171810,133265,119945,1752685,3417681,6592998,6592998
Chad,1995,TD,TCD,AFR,716833,946756,1663589,667926,435897,271310,165258,117113,93472,1750976,702722,934806,1637528,667208,448795,286535,176974,135089,122161,1836762,3587738,6888856,6888856
Chad,1996,TD,TCD,AFR,746309,990046,1736355,694964,464900,287638,172939,119859,95938,1836238,731049,976469,1707518,694389,477281,302215,184979,136946,124368,1920178,3756416,7200291,7200291
Chad,1997,TD,TCD,AFR,774936,1037470,1812406,706862,484038,299305,178650,121598,97342,1887795,758634,1021992,1780626,705510,495729,313660,191331,137996,125824,1970050,3857845,7450874,7450874
Chad,1998,TD,TCD,AFR,800577,1085929,1886506,722261,504321,311629,184796,123411,98763,1945181,783489,1068375,1851864,720013,515251,325839,198077,139145,127239,2025564,3970745,7709115,7709115
Chad,1999,TD,TCD,AFR,829013,1129962,1958975,743770,525483,325031,191612,125404,100278,2011578,811144,1110319,1921463,740545,535639,339121,205430,140530,128610,2089875,4101453,7981889,7981889
Chad,2000,TD,TCD,AFR,860044,1174431,2034475,764567,545836,338701,198821,127420,101766,2077111,841288,1152735,1994023,760279,555324,352741,213200,142070,129907,2153521,4230632,8259137,8259137
Chad,2001,TD,TCD,AFR,888679,1225242,2113921,783850,564823,352306,206421,129377,103247,2140024,868951,1201426,2070377,778309,573665,366318,221399,143658,131140,2214489,4354513,8538804,8538804
Chad,2002,TD,TCD,AFR,915406,1278790,2194196,808199,585231,367308,215219,131444,105007,2212408,894554,1252746,2147300,801338,593435,381142,230724,145359,132468,2284466,4496874,8838369,8838369
Chad,2003,TD,TCD,AFR,943764,1332280,2276044,844532,612980,386776,226586,134257,107510,2312641,921653,1304055,2225708,836757,620737,400099,242352,147758,134278,2381981,4694622,9196366,9196366
Chad,2004,TD,TCD,AFR,976773,1386327,2363100,890464,647333,410561,241103,137210,110490,2437161,953212,1356066,2309278,882193,654918,423133,256922,150310,136483,2503959,4941120,9613503,9613503
Chad,2005,TD,TCD,AFR,1013976,1439164,2453140,931406,674812,432087,254194,140744,112659,2545902,988559,1406884,2395443,922040,682347,444086,269955,153995,138104,2610527,5156429,10005012,10005012
Chad,2006,TD,TCD,AFR,1052472,1492678,2545150,968805,692622,451019,264977,145570,114152,2637145,1024845,1458347,2483192,957876,700254,462671,280613,159510,139203,2700127,5337272,10365614,10365614
Chad,2007,TD,TCD,AFR,1092592,1545005,2637597,1009399,704536,470128,275946,150492,115472,2725973,1062563,1508821,2571384,996669,712356,481557,291677,165219,140294,2787772,5513745,10722731,10722731
Chad,2008,TD,TCD,AFR,1134626,1595331,2729957,1052284,720469,490914,287789,155886,116974,2824316,1102253,1557575,2659828,1037490,728283,502049,303695,171390,141657,2884564,5708880,11098664,11098664
Chad,2009,TD,TCD,AFR,1175724,1651486,2827210,1092703,742397,512464,300559,161824,118733,2928680,1141202,1611991,2753193,1075834,750025,523236,316656,178054,143235,2987040,5915720,11496128,11496128
Chad,2010,TD,TCD,AFR,1214797,1714914,2929711,1131955,761657,532899,313451,168027,120454,3028443,1178434,1673214,2851648,1112886,768923,543420,329837,185027,144831,3084924,6113367,11894727,11894727
Chad,2011,TD,TCD,AFR,1253919,1779291,3033210,1179250,781443,553946,327198,174935,122471,3139243,1216104,1735195,2951299,1158118,788236,564276,343859,192715,146776,3193980,6333223,12317730,12317730
Chad,2012,TD,TCD,AFR,1293617,1844122,3137739,1229125,803606,574639,341491,182533,124568,3255962,1254576,1797444,3052020,1206034,809786,584912,358424,201156,148873,3309185,6565147,12754906,12754906
Chad,2013,TD,TCD,AFR,1334232,1911509,3245741,1279782,831430,595581,356695,191002,126884,3381374,1294038,1862198,3156236,1255080,836862,605907,373839,210466,151257,3433411,6814785,13216766,13216766
Chad,2014,TD,TCD,AFR,1375414,1981084,3356498,1331000,863502,616248,372687,200773,128865,3513075,1334195,1929096,3263291,1304924,868095,626741,390002,221111,153382,3564255,7077330,13697126,13697126
Chad,2015,TD,TCD,AFR,1414322,2052773,3467095,1374927,890072,632539,387672,209775,131044,3626029,1372124,1998037,3370161,1347115,893716,643577,405376,230909,156298,3676991,7303020,14140274,14140274
Chad,2016,TD,TCD,AFR,1450303,2127292,3577595,1421387,920011,646216,403334,218239,134809,3743996,1407180,2069520,3476700,1391857,922505,657696,421305,239855,161071,3794289,7538285,14592585,14592585
Chad,2017,TD,TCD,AFR,1484405,2205675,3690080,1472531,960221,659311,421408,227838,139345,3880654,1440530,2144699,3585229,1441728,961438,670963,439430,249899,166465,3929923,7810577,15085884,15085884
Chad,2018,TD,TCD,AFR,1518609,2286749,3805358,1523563,1003427,676081,440957,238165,144343,4026536,1474080,2222862,3696942,1491889,1003321,687900,459057,260809,172384,4075360,8101896,15604210,15604210
Chad,2019,TD,TCD,AFR,1554440,2367087,3921527,1577897,1040943,695974,460126,248841,149517,4173298,1509269,2300619,3809888,1545230,1039547,708037,478445,272237,178660,4222156,8395454,16126866,16126866
Chad,2020,TD,TCD,AFR,1591923,2444866,4036789,1636867,1076298,713723,478267,259200,153886,4318241,1546029,2376133,3922162,1602657,1073648,726062,497075,283622,184439,4367503,8685744,16644701,16644701
Chad,2021,TD,TCD,AFR,1632247,2520327,4152574,1698158,1118981,730901,496043,269400,157478,4470961,1585435,2449757,4035192,1662291,1115174,743406,515555,294985,189610,4521021,8991982,17179740,17179740
Chad,2022,TD,TCD,AFR,1676290,2593769,4270059,1759150,1163143,749692,513107,279776,161077,4625945,1628358,2521794,4150152,1721471,1158382,762333,533546,306568,194861,4677161,9303106,17723315,17723315
Chad,2023,TD,TCD,AFR,1721439,2667480,4388919,1821955,1205812,771683,529663,290841,165625,4785579,1672334,2594108,4266442,1782238,1200191,784292,551080,318795,201035,4837631,9623210,18278568,18278568
Chad,2024,TD,TCD,AFR,1763538,2743216,4506754,1887211,1248589,796797,545900,302948,171632,4953077,1713421,2668467,4381888,1845314,1242187,809162,568245,331941,208583,5005432,9958509,18847148,18847148
Chad,2025,TD,TCD,AFR,1801618,2819673,4621291,1955919,1291738,824143,561967,316122,179041,5128930,1750908,2743606,4494514,1911719,1284683,836110,585187,346040,217491,5181230,10310160,19425960,19425960
Chad,2026,TD,TCD,AFR,1837385,2895504,4732889,2027272,1336691,854533,575820,330072,187395,5311783,1786387,2818139,4604526,1980780,1329125,866059,599823,360849,227378,5364014,10675797,20013209,20013209
Chad,2027,TD,TCD,AFR,1871480,2971793,4843273,2101695,1381174,889560,586917,345125,196250,5500721,1820309,2893190,4713499,2052957,1373181,900598,611603,376781,237877,5552997,11053718,20610497,20610497
Chad,2028,TD,TCD,AFR,1904556,3048213,4952769,2178771,1424075,925461,600461,361072,205588,5695428,1853218,2968447,4821665,2127908,1415731,935830,625798,393633,248957,5747857,11443285,21217718,21217718
Chad,2029,TD,TCD,AFR,1937850,3123074,5060924,2255650,1472230,957850,617603,376988,215385,5895706,1886193,3042330,4928523,2202863,1463515,967425,643584,410485,260594,5948466,11844172,21833626,21833626
Chad,2030,TD,TCD,AFR,1972567,3196397,5168964,2330647,1527456,990784,634128,392788,225615,6101418,1920385,3114884,5035269,2276258,1518157,999630,660655,427283,272760,6154743,12256161,22460393,22460393
Chad,1950,TD,TCD,AFR,194225,288398,482623,224351,179278,136554,101953,65902,50217,758255,188990,282303,471293,229030,184647,143136,110301,74748,58659,800521,1558776,2512688,2512688
Chad,1951,TD,TCD,AFR,201298,293877,495175,227947,181532,138717,103406,66578,50775,768955,197285,287001,484286,232002,187454,144995,111724,75814,59762,811751,1580706,2560171,2560171
Chad,1952,TD,TCD,AFR,208307,299081,507388,231881,183695,141048,104655,67504,51266,780049,205455,291640,497095,235150,190201,146794,112939,77176,60890,823150,1603199,2607678,2607678
Chad,1953,TD,TCD,AFR,215599,304125,519724,236085,185818,143499,105797,68659,51700,791558,213747,296362,510109,238419,192885,148614,114064,78747,61968,834697,1626255,2656088,2656088
Chad,1954,TD,TCD,AFR,224377,308023,532400,240386,187968,145939,106958,69942,52065,803258,223224,300309,523533,241699,195522,150598,115270,80406,62937,846432,1649690,2705622,2705622
Chad,1955,TD,TCD,AFR,231762,313768,545530,244674,190189,148303,108206,71289,52364,815025,230785,306625,537410,244920,198110,152756,116621,82045,63752,858204,1673229,2756169,2756169
Chad,1956,TD,TCD,AFR,236473,322608,559081,249024,192501,150601,109522,72730,52590,826968,235333,316407,551740,248149,200650,155085,118117,83692,64416,870109,1697077,2807901,2807901
Chad,1957,TD,TCD,AFR,241331,331660,572991,253515,194933,152847,110902,74253,52779,839229,240033,326422,566455,251471,203136,157598,119762,85324,64934,882225,1721454,2860901,2860901
Chad,1958,TD,TCD,AFR,246281,340915,587196,258220,197515,155025,112375,75783,53021,851939,244820,336635,581455,255019,205611,160232,121492,86894,65450,894698,1746637,2915287,2915287
Chad,1959,TD,TCD,AFR,251348,350354,601702,263134,200275,157135,113979,77207,53376,865106,249724,347048,596772,258908,208128,162867,123223,88364,66181,907671,1772777,2971246,2971246
Chad,1960,TD,TCD,AFR,256528,360000,616528,268217,203217,159178,115714,78493,53884,878703,254736,357671,612407,263131,210700,165438,124917,89712,67154,921052,1799755,3028688,3028688
Chad,1961,TD,TCD,AFR,261821,369959,631780,273334,206407,161156,117586,79646,54549,892678,259849,368597,628446,267548,213371,167958,126586,90924,68366,934753,1827431,3087657,3087657
Chad,1962,TD,TCD,AFR,267264,380453,647717,278223,209921,163067,119621,80672,55390,906894,265102,379987,645089,271920,216207,170419,128201,91990,69810,948547,1855441,3148242,3148242
Chad,1963,TD,TCD,AFR,272835,391471,664306,282924,213660,164933,121745,81612,56332,921206,270501,391770,662271,276349,219133,172813,129838,92999,71383,962515,1883721,3210296,3210296
Chad,1964,TD,TCD,AFR,278533,404065,682598,286477,217365,166763,123831,82559,57309,934304,276033,404880,680913,279954,221953,175120,131597,94069,72918,975611,1909915,3273419,3273419
Chad,1965,TD,TCD,AFR,284347,415511,699858,291470,220780,168506,125773,83535,58245,948309,281666,416360,698026,285514,224461,177255,133447,95205,74266,990148,1938457,3336338,3336338
Chad,1966,TD,TCD,AFR,290403,424587,714990,298925,223712,170051,127516,84493,59124,963821,287539,425150,712689,294039,226661,179188,135375,96423,75476,1007162,1970983,3398664,3398664
Chad,1967,TD,TCD,AFR,296910,433917,730827,306340,226323,171457,129090,85441,59996,978647,293868,434205,728073,302668,228688,180955,137429,97756,76629,1024125,2002772,3461664,3461664
Chad,1968,TD,TCD,AFR,304041,443463,747504,313998,228942,172887,130575,86458,60912,993772,300768,443470,744238,311467,230738,182613,139546,99141,77748,1041253,2035025,3526770,3526770
Chad,1969,TD,TCD,AFR,312060,453275,765335,321977,231672,174404,131975,87583,61843,1009454,308506,452995,761501,320520,233020,184237,141636,100514,78935,1058862,2068316,3595152,3595152
Chad,2031,TD,TCD,AFR,2008422,3270163,5278585,2403340,1583705,1029165,649679,408436,236261,6310586,1955594,3187972,5143566,2347692,1573598,1037414,676621,444012,285416,6364753,12675339,23097491,23097491
Chad,2032,TD,TCD,AFR,2043490,3345251,5388741,2474305,1640738,1069796,667122,423756,247356,6523073,1989988,3262486,5252474,2417628,1629621,1077570,694388,460502,298571,6578280,13101353,23742563,23742563
Chad,2033,TD,TCD,AFR,2077852,3419920,5497772,2545476,1700214,1109756,687660,438542,258911,6740559,2023659,3336705,5360364,2487840,1688005,1117179,715176,476538,312217,6796955,13537514,24395658,24395658
Chad,2034,TD,TCD,AFR,2112518,3491878,5604396,2618520,1761962,1149779,710824,452707,270998,6964790,2057612,3408297,5465909,2560025,1748584,1156955,738523,492008,326455,7022550,13987340,25057645,25057645
Chad,2035,TD,TCD,AFR,2147178,3562152,5709330,2692477,1827041,1190180,735892,466478,283691,7195759,2091489,3478267,5569756,2633201,1812423,1197244,763730,507093,341352,7255043,14450802,25729890,25729890
Chad,2036,TD,TCD,AFR,2180481,3632055,5812536,2766054,1894700,1232301,763601,478243,296976,7431875,2124051,3547891,5671942,2706021,1878866,1239405,791648,520070,356929,7492939,14924814,26409296,26409296
Chad,2037,TD,TCD,AFR,2213322,3699683,5913005,2840131,1965291,1274033,795435,487754,311303,7673947,2156205,3615325,5771530,2779396,1948319,1281252,823764,530592,373671,7736994,15410941,27095478,27095478
Chad,2038,TD,TCD,AFR,2247101,3765721,6012822,2914399,2038399,1314363,828175,499511,326461,7921308,2189294,3681150,5870444,2853038,2020447,1321752,856601,543399,391407,7986644,15907952,27791218,27791218
Chad,2039,TD,TCD,AFR,2280301,3832318,6112619,2987235,2111380,1359586,857836,514418,341732,8172187,2221903,3747396,5969299,2925434,2092645,1367194,886168,559472,409351,8240264,16412451,28494382,28494382
Chad,2040,TD,TCD,AFR,2311086,3900230,6211316,3058657,2182677,1411392,887945,528809,357052,8426532,2252156,3814743,6066899,2996609,2163428,1419101,916293,574920,427428,8497779,16924311,29202529,29202529
Chad,2041,TD,TCD,AFR,2341550,3967985,6309535,3130552,2251870,1464228,922949,542363,372351,8684313,2282039,3881840,6163879,3068363,2232405,1471834,951552,589395,445600,8759149,17443462,29916883,29916883
Chad,2042,TD,TCD,AFR,2370501,4034670,6405171,3203750,2319518,1517873,960039,557557,387518,8946255,2310415,3947884,6258299,3141549,2300032,1525202,989044,605494,463731,9025052,17971307,30634772,30634772
Chad,2043,TD,TCD,AFR,2395269,4101625,6496894,3276604,2387462,1573854,996588,575417,402435,9212360,2334650,4014189,6348839,3214522,2368015,1580854,1026089,624294,481646,9295420,18507780,31353517,31353517
Chad,2044,TD,TCD,AFR,2418055,4168375,6586430,3346935,2457289,1632009,1033247,595517,417093,9482090,2356897,4080341,6437238,3285047,2437981,1638640,1063341,645374,499356,9569739,19051829,32075501,32075501
Chad,2045,TD,TCD,AFR,2439906,4232784,6672690,3415725,2528088,1693330,1070296,617248,431738,9756425,2378308,4144160,6522468,3354074,2509015,1699571,1101116,668114,517085,9848975,19605400,32800555,32800555
Chad,2046,TD,TCD,AFR,2460043,4295623,6755666,3484227,2598630,1757127,1108930,641087,445142,10035143,2398087,4206405,6604492,3422835,2579809,1763043,1140663,693129,533449,10132928,20168071,33528227,33528227
Chad,2047,TD,TCD,AFR,2479806,4356688,6836494,3550623,2669753,1823714,1147278,668321,457469,10317158,2417524,4266908,6684432,3489552,2651236,1829417,1179976,721760,548614,10420555,20737713,34258637,34258637
Chad,2048,TD,TCD,AFR,2500516,4414628,6915144,3615547,2741140,1892712,1184466,696513,472115,10602493,2437950,4324327,6762277,3554786,2723015,1898395,1218136,751199,566334,10711865,21314358,34991776,34991776
Chad,2049,TD,TCD,AFR,2518666,4470108,6988774,3681055,2811270,1961694,1226129,722213,489199,10891560,2455862,4379376,6835238,3620470,2793694,1967550,1260907,777869,586748,11007238,21898798,35722806,35722806
Chad,2050,TD,TCD,AFR,2534533,4522394,7056927,3747854,2880137,2029219,1273779,748176,505768,11184933,2471531,4431372,6902903,3687261,2863289,2035495,1309703,804936,606588,11307272,22492205,36452035,36452035
Togo,1970,TG,TGO,AFR,202905,287707,490612,207512,140702,100666,71304,45465,29456,595105,202535,289965,492500,208713,142662,103866,76166,52301,35451,619159,1214264,2197383,2197383
Togo,1971,TG,TGO,AFR,209920,297839,507759,213952,145551,103289,73090,46856,30087,612825,209448,299998,509446,215250,147261,106518,77944,53818,36396,637187,1250012,2267211,2267211
Togo,1972,TG,TGO,AFR,216398,307238,523636,219497,150215,105605,74630,48083,30680,628710,215815,309281,525096,220829,151701,108884,79491,55090,37275,653270,1281980,2330704,2330704
Togo,1973,TG,TGO,AFR,222670,316267,538937,224537,154786,107758,76028,49197,31275,643581,221948,318175,540123,225889,156052,111077,80910,56194,38142,668264,1311845,2390909,2390909
Togo,1974,TG,TGO,AFR,228869,325343,554212,229583,159201,109858,77384,50242,31911,658179,227959,327083,555042,230937,160303,113148,82269,57197,39050,682904,1341083,2450335,2450335
Togo,1975,TG,TGO,AFR,235003,334557,569560,234709,163546,111950,78723,51229,32598,672755,233854,336094,569948,236055,164554,115128,83587,58130,40004,697458,1370213,2509713,2509713
Togo,1976,TG,TGO,AFR,241162,343918,585080,239803,168000,114082,80075,52168,33333,687461,239750,345240,584990,241125,168971,117102,84903,59002,41034,712137,1399598,2569671,2569671
Togo,1977,TG,TGO,AFR,247293,353451,600744,245130,172437,116304,81468,53067,34121,702527,245590,354568,600158,246418,173437,119141,86243,59822,42134,727195,1429722,2630626,2630626
Togo,1978,TG,TGO,AFR,253339,363260,616599,250884,176868,118740,82926,53959,34958,718335,251331,364148,615479,252119,177952,121350,87637,60651,43279,742988,1461323,2693400,2693400
Togo,1979,TG,TGO,AFR,259485,373873,633358,257355,181478,121586,84512,54943,35876,735750,257198,374498,631696,258530,182698,123932,89189,61599,44489,760437,1496187,2761240,2761240
Togo,1980,TG,TGO,AFR,266045,385886,651931,264920,186526,125018,86340,56117,36925,755846,263505,386193,649698,266028,187903,127087,91027,62775,45818,780638,1536484,2838110,2838110
Togo,1981,TG,TGO,AFR,273221,399494,672715,273753,192048,129175,88496,57495,38108,779075,270425,399490,669915,274805,193537,131055,93240,64213,47316,804166,1583241,2925865,2925865
Togo,1982,TG,TGO,AFR,280939,414515,695454,283656,198002,134003,90960,59050,39415,805086,277873,414211,692084,284692,199587,135750,95828,65902,48965,830724,1635810,3023343,3023343
Togo,1983,TG,TGO,AFR,288954,430331,719285,294279,204234,139243,93621,60711,40792,832880,285583,429724,715307,295301,205931,140880,98622,67728,50698,859160,1692040,3126635,3126635
Togo,1984,TG,TGO,AFR,297065,446220,743285,305390,210764,144538,96360,62413,42190,861655,293369,445321,738690,306373,212584,146139,101451,69602,52469,888618,1750273,3232244,3232244
Togo,1985,TG,TGO,AFR,304928,461586,766514,316626,217340,149768,99073,64086,43534,890427,300942,460404,761346,317595,219317,151417,104204,71443,54237,918213,1808640,3336508,3336508
Togo,1986,TG,TGO,AFR,312497,476509,789006,327947,223821,155067,101786,65736,44854,919211,308287,475033,783320,328894,225955,156835,106918,73256,55977,947835,1867046,3439370,3439370
Togo,1987,TG,TGO,AFR,320251,491437,811688,339683,230670,160459,104650,67466,46177,949105,315860,489654,805514,340618,232956,162410,109762,75132,57744,978622,1927727,3544927,3544927
Togo,1988,TG,TGO,AFR,328158,506378,834536,351828,237999,165910,107736,69269,47520,980262,323629,504286,827915,352739,240435,168113,112793,77077,59554,1010711,1990973,3653420,3653420
Togo,1989,TG,TGO,AFR,335932,521240,857172,364387,245738,171354,111067,71087,48893,1012526,331342,518808,850150,365215,248309,173844,116035,79060,61352,1043815,2056341,3763657,3763657
Togo,1990,TG,TGO,AFR,343713,535999,879712,377432,253911,176785,114648,72925,50281,1045982,339127,533196,872323,378103,256586,179569,119506,81055,63114,1077933,2123915,3875947,3875947
Togo,1991,TG,TGO,AFR,351550,550631,902181,390922,262536,182130,118553,74814,51692,1080647,346980,547411,894391,391371,265267,185111,123346,83100,64807,1113002,2193649,3990215,3990215
Togo,1992,TG,TGO,AFR,359233,565298,924531,404824,271523,187429,122776,76774,53122,1116448,354658,561599,916257,404975,274269,190533,127527,85230,66453,1148987,2265435,4106219,4106219
Togo,1993,TG,TGO,AFR,354074,560045,914119,404655,271241,186135,122864,76088,52673,1113656,349656,555947,905603,404444,273847,189226,127409,84395,65699,1145020,2258676,4078392,4078392
Togo,1994,TG,TGO,AFR,352596,560341,912937,408473,274035,186953,124160,76204,52716,1122541,348271,555834,904105,407906,276490,190048,128617,84405,65559,1153025,2275566,4092612,4092612
Togo,1995,TG,TGO,AFR,366019,584245,950264,429172,288585,195832,130652,79572,54960,1178773,361561,579260,940821,428224,290986,199071,135288,87973,68168,1209710,2388483,4279566,4279566
Togo,1996,TG,TGO,AFR,377222,605152,982374,447810,302100,203836,136703,82607,56932,1229988,372650,599748,972398,446439,304401,207182,141545,91138,70412,1261117,2491105,4445883,4445883
Togo,1997,TG,TGO,AFR,386196,622481,1008677,464589,315105,211387,142197,85340,58661,1277279,381557,616701,998258,462833,317290,214776,147246,93900,72303,1308348,2585627,4592550,4592550
Togo,1998,TG,TGO,AFR,394252,637247,1031499,480114,328102,218949,147324,87958,60227,1322674,389556,631132,1020688,477986,330153,222311,152575,96473,73941,1353439,2676113,4728297,4728297
Togo,1999,TG,TGO,AFR,403428,652119,1055547,495371,341531,226948,152482,90804,61824,1368960,398648,645658,1044306,492768,343370,230243,157941,99226,75579,1399127,2768087,4867941,4867941
Togo,2000,TG,TGO,AFR,413611,666969,1080580,509799,354866,235129,157533,93819,63402,1414548,408700,660176,1068876,506639,356438,238351,163229,102156,77218,1444031,2858579,5008035,5008035
Togo,2001,TG,TGO,AFR,424674,681595,1106269,523039,367614,243274,162322,97016,64942,1458207,419561,674467,1094028,519214,368859,246436,168204,105359,78849,1486921,2945128,5145426,5145426
Togo,2002,TG,TGO,AFR,436535,696090,1132625,535565,379890,251394,166934,100420,66528,1500731,431138,688612,1119750,530942,380723,254480,172942,108815,80528,1528430,3029161,5281538,5281538
Togo,2003,TG,TGO,AFR,448573,711175,1159748,548247,392312,259832,171602,104028,68221,1544242,442839,703352,1146191,542790,392678,262807,177731,112496,82317,1570819,3115061,5421001,5421001
Togo,2004,TG,TGO,AFR,459863,727574,1187437,561430,405099,268881,176619,107703,70017,1589749,453779,719295,1173074,555145,404937,271662,182823,116260,84133,1614960,3204709,5565218,5565218
Togo,2005,TG,TGO,AFR,470719,745049,1215768,574700,417680,278292,181876,111438,71887,1635873,464296,736144,1200440,567617,416888,280831,188133,120120,85925,1659514,3295387,5711597,5711597
Togo,2006,TG,TGO,AFR,482331,763736,1246067,589898,432113,289005,187698,115554,74060,1688328,475593,754079,1229672,582168,430608,291189,193908,124363,87934,1710170,3398498,5874240,5874240
Togo,2007,TG,TGO,AFR,495115,783509,1278624,605810,447319,300523,194049,119830,76428,1743959,488081,773034,1261115,597474,445043,302281,200152,128781,90109,1763840,3507799,6047537,6047537
Togo,2008,TG,TGO,AFR,508744,804026,1312770,621116,461961,312159,200720,124110,78902,1798968,501436,792654,1294090,612111,458809,313455,206695,133225,92360,1816655,3615623,6222482,6222482
Togo,2009,TG,TGO,AFR,523232,824773,1348005,635940,476063,323972,207692,128367,81502,1853536,515685,812470,1328155,626260,471963,324760,213523,137670,94755,1868931,3722467,6398624,6398624
Togo,2010,TG,TGO,AFR,538394,846014,1384408,649608,488816,335620,214801,132525,84183,1905553,530610,832747,1363357,639160,483714,335868,220493,142041,97270,1918546,3824099,6571855,6571855
Togo,2011,TG,TGO,AFR,552678,868810,1421488,663375,501502,347719,222373,136706,87185,1958860,544672,854514,1399186,652119,495321,347334,227875,146332,100156,1969137,3927997,6748672,6748672
Togo,2012,TG,TGO,AFR,564430,893565,1457995,677216,514244,360192,230321,140925,90459,2013357,556195,878227,1434422,665179,506948,359114,235611,150607,103404,2020863,4034220,6926635,6926635
Togo,2013,TG,TGO,AFR,574182,919464,1493646,691708,527087,372914,238624,145224,93939,2069496,565683,903126,1468809,678912,518663,371121,243681,154979,106920,2074276,4143772,7106229,7106229
Togo,2014,TG,TGO,AFR,582770,945545,1528315,707555,539967,385687,247364,149785,97482,2127840,573963,928314,1502277,693972,530460,383174,252164,159621,110559,2129950,4257790,7288383,7288383
Togo,2015,TG,TGO,AFR,590104,972110,1562214,724610,552955,398425,256545,154598,101113,2188246,580945,954099,1535044,710162,542459,395159,261064,164529,114346,2187719,4375965,7473229,7473229
Togo,2016,TG,TGO,AFR,597486,998263,1595749,742678,566080,411208,266128,159577,104943,2250614,587946,979587,1567533,727294,554665,407146,270353,169595,118407,2247460,4498074,7661354,7661354
Togo,2017,TG,TGO,AFR,605915,1022940,1628855,761827,579314,423961,276086,164875,108925,2314988,595984,1003676,1599660,745509,567027,419079,280008,174989,122672,2309284,4624272,7852795,7852795
Togo,2018,TG,TGO,AFR,614814,1046519,1661333,781884,592639,436628,286362,170540,113005,2381058,604506,1026742,1631248,764666,579562,430912,289982,180771,127145,2373038,4754096,8046679,8046679
Togo,2019,TG,TGO,AFR,623750,1069841,1693591,802320,606130,449232,297013,176551,117179,2448425,613066,1049623,1662689,784255,592377,442678,300327,186929,131824,2438390,4886815,8243094,8243094
Togo,2020,TG,TGO,AFR,632575,1092784,1725359,823558,619846,461791,308101,182927,121482,2517705,621535,1072167,1693702,804687,605485,454396,311076,193468,136709,2505821,5023526,8442580,8442580
Togo,2021,TG,TGO,AFR,640889,1114964,1755853,846325,633683,474288,319596,189685,125851,2589428,629543,1094009,1723552,826696,618802,466083,322218,200406,141788,2575993,5165421,8644829,8644829
Togo,2022,TG,TGO,AFR,648650,1135752,1784402,870921,647526,486818,331430,196761,130369,2663825,637101,1114465,1751566,850551,632189,477800,333684,207662,147023,2648909,5312734,8848699,8848699
Togo,2023,TG,TGO,AFR,656332,1155012,1811344,896554,661916,499410,343483,204137,135052,2740552,644672,1133310,1777982,875433,646116,489545,345331,215171,152331,2723927,5464479,9053799,9053799
Togo,2024,TG,TGO,AFR,663971,1173100,1837071,922377,677611,512032,355587,211895,139908,2819410,652260,1150934,1803194,900610,661310,501368,357022,223049,157833,2801192,5620602,9260864,9260864
Togo,2025,TG,TGO,AFR,671791,1189736,1861527,948689,694477,524771,367672,220038,144957,2900604,660033,1167105,1827138,926393,677600,513388,368666,231304,163542,2880893,5781497,9470157,9470157
Togo,2026,TG,TGO,AFR,680158,1205761,1885919,974611,712317,537647,379805,228538,150231,2983149,668299,1182716,1851015,951911,694803,525617,380327,239903,169491,2962052,5945201,9682133,9682133
Togo,2027,TG,TGO,AFR,688859,1222254,1911113,999099,731202,550641,391927,237385,155785,3066039,676861,1198860,1875721,976079,713040,537988,391939,248839,175721,3043606,6109645,9896486,9896486
Togo,2028,TG,TGO,AFR,697821,1239182,1937003,1022534,750982,563742,403997,246535,161654,3149444,685685,1215499,1901184,999256,732177,550524,403456,258063,182295,3125771,6275215,10113397,10113397
Togo,2029,TG,TGO,AFR,707671,1256040,1963711,1045730,771133,577017,416030,256032,167828,3233770,695379,1232113,1927492,1022226,751708,563310,414900,267614,189180,3208938,6442708,10333905,10333905
Togo,2030,TG,TGO,AFR,718362,1272856,1991218,1068536,791980,590432,427988,265897,174284,3319117,705900,1248727,1954627,1044836,771954,576286,426261,277510,196373,3293220,6612337,10558178,10558178
Togo,1950,TG,TGO,AFR,122062,168007,290069,125579,93443,67874,46800,35887,30393,399976,122260,170720,292980,128731,97076,72409,50432,37276,29578,415502,815478,1398525,1398525
Togo,1951,TG,TGO,AFR,124800,171976,296776,127495,94750,69162,47357,35315,30262,404341,125076,174391,299467,130626,98286,73708,51123,37321,29580,420644,824985,1421232,1421232
Togo,1952,TG,TGO,AFR,127306,176341,303647,129500,96092,70459,48006,34794,30134,408985,127588,178500,306088,132653,99578,74931,51911,37372,29593,426038,835023,1444757,1444757
Togo,1953,TG,TGO,AFR,129654,180974,310628,131591,97464,71736,48742,34351,29991,413875,129937,182889,312826,134761,100934,76087,52796,37442,29628,431648,845523,1468982,1468982
Togo,1954,TG,TGO,AFR,132105,185597,317702,133740,98863,72971,49562,34033,29776,418945,132378,187350,319728,136867,102316,77181,53778,37556,29663,437361,856306,1493731,1493731
Togo,1955,TG,TGO,AFR,134575,190242,324817,135948,100291,74152,50451,33854,29478,424174,134849,191902,326751,138937,103709,78212,54838,37713,29675,443084,867258,1518825,1518825
Togo,1956,TG,TGO,AFR,136901,195063,331964,138234,101765,75276,51398,33810,29121,429604,137177,196709,333886,141042,105122,79173,55978,37915,29702,448932,878536,1544388,1544388
Togo,1957,TG,TGO,AFR,139283,199878,339161,140635,103300,76332,52396,33893,28708,435264,139553,201581,341134,143232,106572,80063,57202,38166,29747,454982,890246,1570541,1570541
Togo,1958,TG,TGO,AFR,141711,204596,346307,143220,104866,77344,53426,34079,28267,441202,141968,206425,348393,145554,108046,80918,58443,38480,29795,461236,902438,1597137,1597137
Togo,1959,TG,TGO,AFR,144234,209152,353386,146027,106399,78347,54454,34342,27849,447418,144483,211153,355636,148048,109517,81785,59629,38861,29853,467693,915111,1624127,1624127
Togo,1960,TG,TGO,AFR,146904,213496,360400,149029,107876,79339,55452,34665,27464,453825,147150,215688,362838,150716,110962,82677,60710,39313,29921,474299,928124,1651367,1651367
Togo,1961,TG,TGO,AFR,149693,217545,367238,152305,109340,80315,56413,35046,27105,460524,149945,219837,369782,153723,112422,83585,61700,39827,29980,481237,941761,1678788,1678788
Togo,1962,TG,TGO,AFR,152673,221374,374047,155857,110844,81292,57357,35478,26794,467622,152907,223698,376605,157042,113951,84523,62602,40395,30049,488562,956184,1706841,1706841
Togo,1963,TG,TGO,AFR,156022,225235,381257,159670,112446,82313,58298,35991,26545,475263,156208,227586,383794,160636,115573,85537,63464,41043,30137,496390,971653,1736697,1736697
Togo,1964,TG,TGO,AFR,160024,229982,390006,163912,114423,83596,59374,36666,26410,484381,160152,232352,392504,164734,117521,86824,64447,41887,30343,505756,990137,1772652,1772652
Togo,1965,TG,TGO,AFR,165122,236355,401477,169177,117154,85421,60773,37621,26493,496639,165183,238757,403940,169931,120162,88647,65784,43053,30764,518341,1014980,1820396,1820396
Togo,1966,TG,TGO,AFR,171584,244506,416090,175861,120812,87904,62569,38896,26818,512860,171573,246923,418496,176606,123698,91133,67538,44596,31437,535008,1047868,1882458,1882458
Togo,1967,TG,TGO,AFR,179139,254453,433592,183648,125327,90983,64704,40459,27359,532480,179052,256871,435923,184439,128065,94204,69640,46484,32334,555166,1087646,1957164,1957164
Togo,1968,TG,TGO,AFR,187164,265545,452709,191957,130399,94368,66994,42182,28040,553940,186994,267945,454939,192853,132938,97563,71905,48540,33375,577174,1131114,2038765,2038765
Togo,1969,TG,TGO,AFR,195215,276854,472069,200080,135632,97676,69244,43893,28766,575291,194950,279199,474149,201121,137901,100867,74133,50524,34432,598978,1174269,2120486,2120486
Togo,2031,TG,TGO,AFR,729009,1289574,2018583,1090587,814248,603885,439867,276121,181058,3405766,716392,1265284,1981676,1066703,793627,589353,437547,287747,203899,3378876,6784642,10784898,10784898
Togo,2032,TG,TGO,AFR,739864,1306099,2045963,1111274,838361,617406,451814,286660,188151,3493666,727087,1281715,2008802,1087202,817164,602549,448882,298280,211757,3465834,6959500,11014261,11014261
Togo,2033,TG,TGO,AFR,751082,1322887,2073969,1130496,863572,631541,463872,297410,195524,3582415,738134,1298478,2036612,1106216,841849,616394,460329,309028,219921,3553737,7136152,11246734,11246734
Togo,2034,TG,TGO,AFR,761869,1340508,2102377,1148585,888985,646943,475976,308216,203270,3671975,748744,1316109,2064853,1124058,866849,631471,471863,319833,228469,3642543,7314518,11481745,11481745
Togo,2035,TG,TGO,AFR,772264,1359130,2131394,1165267,914891,663474,488196,319013,211404,3762245,758964,1334746,2093710,1140497,892468,647615,483592,330602,237418,3732192,7494437,11719540,11719540
Togo,2036,TG,TGO,AFR,782854,1378251,2161105,1181354,940428,680958,500553,329861,219905,3853059,769389,1353839,2123228,1156399,917851,664660,495536,341394,246767,3822607,7675666,11959996,11959996
Togo,2037,TG,TGO,AFR,793159,1397916,2191075,1197907,964593,699458,513026,340705,228808,3944497,779540,1373438,2152978,1172829,941947,682714,507627,352153,256541,3913811,7858308,12202363,12202363
Togo,2038,TG,TGO,AFR,803007,1418197,2221204,1214881,987748,718828,525614,351520,238105,4036696,789217,1393636,2182853,1189745,965106,701650,519881,362839,266732,4005953,8042649,12446712,12446712
Togo,2039,TG,TGO,AFR,812714,1438914,2251628,1231789,1010677,738568,538372,362319,247802,4129527,798786,1414259,2213045,1206644,988080,720983,532380,373481,277345,4098913,8228440,12693112,12693112
Togo,2040,TG,TGO,AFR,821874,1460065,2281939,1248662,1033241,758982,551268,373067,257913,4223133,807834,1435305,2243139,1223547,1010724,741025,545077,384059,288373,4192805,8415938,12941012,12941012
Togo,2041,TG,TGO,AFR,830277,1481383,2311660,1265444,1055091,780777,564216,383772,268446,4317746,816118,1456539,2272657,1240398,1032672,762462,557869,394588,299854,4287843,8605589,13189909,13189909
Togo,2042,TG,TGO,AFR,838206,1502643,2340849,1282048,1075643,804365,577242,394561,279347,4413206,823920,1477716,2301636,1257138,1053323,785730,570805,405192,311732,4383920,8797126,13439606,13439606
Togo,2043,TG,TGO,AFR,846064,1523801,2369865,1298912,1094780,829024,590865,405467,290506,4509554,831630,1498779,2330409,1274213,1072547,810130,584369,415920,323900,4481079,8990633,13690907,13690907
Togo,2044,TG,TGO,AFR,853562,1544412,2397974,1316597,1112821,853899,605692,416421,301857,4607287,838989,1519313,2358302,1292152,1090646,834861,599131,426737,336290,4579817,9187104,13943382,13943382
Togo,2045,TG,TGO,AFR,860944,1564101,2425045,1335266,1129503,879264,621610,427488,313393,4706524,846259,1538962,2385221,1311073,1107385,860219,614928,437754,348862,4680221,9386745,14197015,14197015
Togo,2046,TG,TGO,AFR,868683,1583240,2451923,1354434,1145609,904291,638440,438699,325143,4806616,853898,1558061,2411959,1330452,1123611,885366,631601,448979,361653,4781662,9588278,14452162,14452162
Togo,2047,TG,TGO,AFR,876448,1601637,2478085,1374133,1162163,927992,656243,450027,337060,4907618,861588,1576413,2438001,1350320,1140352,909285,649255,460356,374639,4884207,9791825,14707912,14707912
Togo,2048,TG,TGO,AFR,883896,1619506,2503402,1394433,1179123,950724,674865,461460,349134,5009739,869020,1594217,2463237,1370787,1157556,932302,667761,471895,387796,4988097,9997836,14964474,14964474
Togo,2049,TG,TGO,AFR,891012,1636894,2527906,1415161,1196016,973229,693836,473061,361399,5112702,876125,1611577,2487702,1391666,1174742,955153,686654,483675,401145,5093035,10205737,15221353,15221353
Togo,2050,TG,TGO,AFR,898003,1653642,2551645,1436320,1212870,995388,713447,484795,373828,5216648,883081,1628347,2511428,1412964,1191932,977690,706233,495645,414696,5199160,10415808,15478883,15478883
Thailand,1970,TH,THA,SEA,3114915,5077980,8192895,3440064,2405923,1737584,1070158,662608,453564,9769901,2958624,4848076,7806700,3324598,2385687,1814924,1127962,745224,623828,10022223,19792124,35791728,35791728
Thailand,1971,TH,THA,SEA,3139500,5226867,8366367,3591362,2458411,1796354,1113586,679604,469621,10108938,2981178,4989735,7970913,3474963,2423626,1881276,1172460,762604,646851,10361780,20470718,36807997,36807997
Thailand,1972,TH,THA,SEA,3154702,5371793,8526495,3747057,2514206,1857968,1162972,697112,486529,10465844,2994798,5127676,8122474,3628032,2467656,1949532,1222183,780495,671673,10719571,21185415,37834384,37834384
Thailand,1973,TH,THA,SEA,3159900,5511185,8671085,3908392,2576949,1921582,1217075,715490,504230,10843718,2998914,5260358,8259272,3785061,2522150,2017697,1276801,799372,697899,11098980,21942698,38873060,38873060
Thailand,1974,TH,THA,SEA,3153960,5641198,8795158,4070787,2650712,1983365,1272635,735336,522902,11235737,2992709,5383963,8376672,3935431,2597613,2080369,1334891,819958,725141,11493403,22729140,39900961,39900961
Thailand,1975,TH,THA,SEA,3138113,5759167,8897280,4225829,2742880,2041910,1328138,757316,542444,11638517,2977570,5495865,8473435,4078250,2694075,2135549,1395471,842889,753010,11899244,23537761,40908471,40908471
Thailand,1976,TH,THA,SEA,3111696,5862318,8974014,4373928,2848863,2098349,1383318,781277,563033,12048768,2952534,5593741,8546275,4220933,2799949,2184452,1458037,868146,781559,12313076,24361844,41882128,41882128
Thailand,1977,TH,THA,SEA,3075238,5948984,9024222,4525220,2967310,2155824,1438615,807074,584427,12478470,2917986,5676160,8594146,4367098,2920115,2230872,1522969,895696,810209,12746959,25225429,42843802,42843802
Thailand,1978,TH,THA,SEA,3034569,6016834,9051403,4680353,3099838,2214174,1494495,835573,605895,12930328,2879631,5740528,8620159,4517675,3055898,2275958,1590043,926331,838922,13204827,26135155,43806715,43806715
Thailand,1979,TH,THA,SEA,2997732,6064222,9061954,4834598,3240784,2270598,1551041,868244,627059,13392324,2844849,5785174,8630023,4667828,3201776,2318387,1657977,961322,868499,13675789,27068113,44760091,44760091
Thailand,1980,TH,THA,SEA,2973974,6093099,9067073,4989122,3389979,2327864,1609017,905856,648560,13870398,2822231,5812098,8634329,4818861,3356721,2362561,1726281,1001555,899971,14165950,28036348,45737753,45737753
Thailand,1981,TH,THA,SEA,2962279,6102501,9064780,5141140,3544882,2386579,1668928,948482,671041,14361052,2810777,5820437,8631214,4967542,3516959,2409725,1795683,1046856,933480,14670245,29031297,46727292,46727292
Thailand,1982,TH,THA,SEA,2952185,6092262,9044447,5289054,3703178,2447294,1731317,996345,694866,14862054,2800514,5809930,8610444,5111847,3678552,2461463,1866470,1096806,968257,15183395,30045449,47700340,47700340
Thailand,1983,TH,THA,SEA,2937337,6067525,9004862,5434355,3868822,2513886,1795688,1048439,720816,15382006,2785521,5785376,8570897,5253374,3845194,2522238,1936769,1150951,1004266,15712792,31094798,48670565,48670565
Thailand,1984,TH,THA,SEA,2914753,6035908,8950661,5572032,4038929,2592155,1859431,1102450,749914,15914911,2763276,5754097,8517373,5387087,4008190,2604625,2002574,1208631,1042669,16253776,32168687,49636724,49636724
Thailand,1985,TH,THA,SEA,2879659,6007152,8886811,5697832,4204425,2689519,1921457,1157328,783064,16453625,2729375,5725497,8454872,5508613,4165582,2709329,2062308,1269308,1084490,16799630,33253255,50594940,50594940
Thailand,1986,TH,THA,SEA,2836916,5980099,8817015,5808315,4365507,2802885,1983245,1212976,820241,16993169,2688250,5698276,8386526,5614796,4324641,2826132,2117544,1332613,1129652,17345378,34338547,51542094,51542094
Thailand,1987,TH,THA,SEA,2797530,5944455,8741985,5901546,4527871,2927253,2045997,1269212,861753,17533632,2650296,5662517,8312813,5703745,4484581,2955570,2170176,1398339,1178338,17890749,35424381,52479181,52479181
Thailand,1988,TH,THA,SEA,2764770,5898723,8663493,5976713,4692444,3063401,2108990,1325998,907120,18074666,2618722,5617171,8235893,5774757,4646698,3098144,2220784,1465923,1230606,18436912,36511578,53410965,53410965
Thailand,1989,TH,THA,SEA,2742260,5847727,8589987,6029266,4854144,3207313,2170100,1383346,955873,18600042,2596913,5566952,8163865,5823392,4806314,3250241,2268756,1534306,1287102,18970111,37570153,54324004,54324004
Thailand,1990,TH,THA,SEA,2725416,5767114,8492530,5997757,5042146,3389474,2238338,1447224,1007414,19122353,2583380,5494772,8078152,5823625,4999307,3435137,2327861,1607390,1342047,19535367,38657720,55228410,55228410
Thailand,1991,TH,THA,SEA,2705991,5683126,8389117,5896485,5227558,3605223,2312376,1517280,1061746,19620668,2564622,5423249,7987871,5775292,5201251,3646959,2398141,1685648,1394921,20102212,39722880,56099865,56099865
Thailand,1992,TH,THA,SEA,2678653,5627542,8306195,5755127,5374552,3845527,2393951,1591471,1120089,20080717,2526505,5378782,7905287,5688951,5382161,3875987,2481011,1765689,1453019,20646818,40727535,56939020,56939020
Thailand,1993,TH,THA,SEA,2648458,5586106,8234564,5567279,5489175,4115191,2493793,1671113,1181927,20518478,2476698,5351499,7828197,5565121,5554109,4127563,2584925,1846189,1516938,21194845,41713323,57776082,57776082
Thailand,1994,TH,THA,SEA,2624814,5559011,8183825,5379795,5545225,4390699,2611426,1758227,1245835,20931207,2434392,5340306,7774698,5416575,5690713,4387465,2707509,1932502,1585509,21720273,42651480,58610010,58610010
Thailand,1995,TH,THA,SEA,2602116,5544864,8146980,5236033,5543922,4641659,2739418,1854313,1309807,21325152,2408467,5331955,7740422,5273047,5773854,4638647,2839782,2030084,1656872,22212286,43537438,59424834,59424834
Thailand,1996,TH,THA,SEA,2577559,5533202,8110761,5143445,5499631,4858134,2884338,1947646,1374593,21707787,2393711,5312892,7706603,5162846,5806431,4874447,2982544,2128327,1731355,22685950,44393737,60211096,60211096
Thailand,1997,TH,THA,SEA,2555100,5502329,8057429,5090689,5409985,5062297,3066386,2022408,1447060,22098825,2385386,5273640,7659026,5087552,5799687,5106067,3155497,2210047,1814968,23173818,45272643,60989108,60989108
Thailand,1998,TH,THA,SEA,2527184,5459930,7987114,5085979,5268472,5252691,3282777,2076410,1532167,22498496,2372812,5226193,7599005,5043253,5745138,5331381,3357541,2271876,1911417,23660606,46159102,61745217,61745217
Thailand,1999,TH,THA,SEA,2474527,5425571,7900098,5108147,5091523,5421585,3520587,2122729,1626448,22891019,2332718,5179591,7512309,5028368,5640127,5547814,3580444,2326700,2015778,24139231,47030250,62442651,62442651
Thailand,2000,TH,THA,SEA,2396268,5390392,7786660,5167671,4960005,5517676,3754179,2165838,1720401,23285770,2262774,5121859,7384633,5072685,5518133,5703251,3809829,2378596,2127042,24609536,47895306,63066603,63066603
Thailand,2001,TH,THA,SEA,2319312,5341482,7660794,5254327,4916728,5521228,3969266,2214365,1810638,23686552,2188980,5054169,7243149,5155056,5424340,5771360,4028519,2436500,2243625,25059400,48745952,63649892,63649892
Thailand,2002,TH,THA,SEA,2259894,5286829,7546723,5321033,4904873,5495239,4166134,2283485,1903283,24074047,2130048,4987284,7117332,5217687,5359475,5806488,4230535,2511339,2358944,25484468,49558515,64222580,64222580
Thailand,2003,TH,THA,SEA,2214115,5228213,7442328,5354019,4900030,5475788,4337952,2373174,2001462,24442425,2084724,4920658,7005382,5250609,5303195,5842947,4414981,2599451,2475638,25886821,50329246,64776956,64776956
Thailand,2004,TH,THA,SEA,2183434,5156943,7340377,5351016,4922852,5454101,4489010,2473018,2107839,24797836,2055675,4852789,6908464,5251981,5249180,5871548,4594251,2692655,2604881,26264496,51062332,65311166,65311166
Thailand,2005,TH,THA,SEA,2160406,5072131,7232537,5330269,4963828,5428000,4627425,2576682,2220095,25146299,2035711,4783633,6819344,5228856,5202414,5881499,4771913,2793214,2745285,26623181,51769480,65821360,65821360
Thailand,2006,TH,THA,SEA,2136929,4985723,7122652,5296984,5013183,5407650,4751396,2696429,2323971,25489613,2015573,4712026,6727599,5188761,5182631,5878112,4936444,2914069,2879645,26979662,52469275,66319525,66319525
Thailand,2007,TH,THA,SEA,2118295,4909012,7027307,5234506,5082167,5388537,4863726,2841509,2411659,25822104,1998915,4643716,6642631,5125703,5197521,5862949,5087507,3061607,2999424,27334711,53156815,66826754,66826754
Thailand,2008,TH,THA,SEA,2107921,4839577,6947498,5158012,5150209,5361367,4972580,3001274,2491715,26135157,1988916,4576924,6565840,5053408,5219858,5833367,5231634,3229307,3112162,27679736,53814893,67328239,67328239
Thailand,2009,TH,THA,SEA,2102565,4770253,6872818,5095298,5193055,5332170,5073327,3164115,2576346,26434311,1983083,4505852,6488935,4990216,5233745,5790163,5367026,3407188,3229246,28017584,54451895,67813654,67813654
Thailand,2010,TH,THA,SEA,2098448,4678721,6777169,5081719,5208913,5284868,5153872,3330181,2674646,26734199,1978325,4413321,6391646,4962708,5236622,5724890,5484860,3594026,3364367,28367473,55101672,68270489,68270489
Thailand,2011,TH,THA,SEA,2096216,4564787,6661003,5112027,5210972,5223633,5205251,3500804,2788709,27041396,1975524,4301325,6276849,4971717,5229888,5647164,5578036,3785904,3520894,28733603,55774999,68712846,68712846
Thailand,2012,TH,THA,SEA,2092550,4458012,6550562,5141687,5208317,5169113,5234453,3669785,2919859,27343214,1971762,4198471,6170233,4979559,5218637,5575149,5650816,3975785,3693062,29093008,56436222,69157023,69157023
Thailand,2013,TH,THA,SEA,2081233,4373207,6454440,5148130,5199569,5120026,5250954,3829852,3070154,27618685,1961035,4118825,6079860,4963398,5204603,5505002,5712027,4158611,3881986,29425627,57044312,69578602,69578602
Thailand,2014,TH,THA,SEA,2059837,4313305,6373142,5124677,5183421,5084555,5251405,3980479,3234275,27858812,1940992,4065219,6006211,4921333,5186257,5431518,5758439,4340082,4085152,29722781,57581593,69960943,69960943
Thailand,2015,TH,THA,SEA,2029366,4266364,6295730,5073624,5169438,5060792,5237641,4123597,3404652,28069744,1912234,4024989,5937223,4859604,5166530,5358107,5785321,4519853,4302282,29991697,58061441,70294397,70294397
Thailand,2016,TH,THA,SEA,1988170,4229166,6217336,5007550,5160801,5050692,5216399,4255072,3578197,28268711,1873133,3992698,5865831,4785612,5150469,5303556,5794229,4688734,4532563,30255163,58523874,70607037,70607037
Thailand,2017,TH,THA,SEA,1937697,4204125,6141822,4937628,5137402,5061707,5183198,4375301,3757086,28452322,1825353,3969654,5795007,4708088,5121877,5276215,5783278,4847163,4772425,30509046,58961368,70898202,70898202
Thailand,2018,TH,THA,SEA,1884365,4183650,6068015,4860094,5099182,5081564,5133091,4487612,3941816,28603359,1774923,3949397,5724320,4624294,5078147,5259503,5750229,4997663,5022281,30732117,59335476,71127802,71127802
Thailand,2019,TH,THA,SEA,1831652,4159680,5991332,4774511,5070009,5094441,5072086,4587460,4133550,28732057,1725096,3925271,5650367,4533537,5036870,5244202,5696156,5138212,5285026,30934003,59666060,71307763,71307763
Thailand,2020,TH,THA,SEA,1783246,4127355,5910601,4674288,5072146,5102079,5011107,4664464,4334782,28858866,1679356,3893303,5572659,4430870,5017940,5235583,5625751,5258535,5564861,31133540,59992406,71475664,71475664
Thailand,2021,TH,THA,SEA,1740268,4083508,5823776,4559204,5098123,5105312,4958039,4711531,4538020,28970229,1638761,3850705,5489466,4315861,5020153,5227135,5551201,5350850,5852428,31317628,60287857,71601103,71601103
Thailand,2022,TH,THA,SEA,1700527,4027918,5728445,4450188,5119795,5100125,4910447,4740603,4756492,29077650,1601236,3797524,5398760,4208956,5017729,5210986,5480761,5423439,6150301,31492172,60569822,71697030,71697030
Thailand,2023,TH,THA,SEA,1665516,3962623,5628139,4364604,5119347,5088212,4868263,4761564,4995591,29197581,1568185,3735601,5303786,4127210,4992659,5191746,5412038,5485622,6462498,31671773,60869354,71801279,71801279
Thailand,2024,TH,THA,SEA,1636194,3888545,5524739,4304278,5090880,5070125,4839406,4769023,5238424,29312136,1540447,3665634,5206081,4072142,4943508,5169166,5340372,5533772,6783892,31842852,61154988,71885799,71885799
Thailand,2025,TH,THA,SEA,1611713,3809704,5421417,4257488,5037902,5056570,4822414,4764766,5480323,29419463,1517288,3591041,5108329,4031245,4877771,5147584,5269719,5563711,7113811,32003841,61423304,71953054,71953054
Thailand,2026,TH,THA,SEA,1591878,3725170,5317048,4220255,4968551,5046339,4817046,4753882,5716112,29522185,1498530,3510856,5009386,3998224,4798112,5127463,5216355,5575626,7441331,32157111,61679296,72005720,72005720
Thailand,2027,TH,THA,SEA,1576730,3634531,5211261,4195029,4894732,5020475,4830550,4731910,5947736,29620432,1484137,3424996,4909133,3974446,4714287,5093476,5188748,5567546,7763980,32302483,61922915,72043300,72043300
Thailand,2028,TH,THA,SEA,1564892,3546361,5111253,4175179,4818737,4985076,4854077,4695379,6178379,29706827,1472802,3341544,4814346,3954427,4630174,5049561,5173566,5538792,8086474,32432994,62139821,72065413,72065413
Thailand,2029,TH,THA,SEA,1554987,3465030,5020017,4152247,4737777,4961433,4871680,4649372,6405388,29777897,1463276,3264548,4727824,3931032,4542485,5011271,5160906,5490211,8409472,32545377,62323274,72071120,72071120
Thailand,2030,TH,THA,SEA,1545610,3392453,4938063,4120547,4640221,4966065,4882596,4602367,6621096,29832892,1454285,3195840,4650125,3899369,4440649,4993025,5153561,5425310,8727025,32638939,62471831,72060018,72060018
Thailand,1950,TH,THA,SEA,1705138,2665153,4370291,2058033,1386945,1025751,713226,397738,287889,5869582,1642701,2592022,4234723,2054418,1358510,1008163,713220,434399,368333,5937043,11806625,20411638,20411638
Thailand,1951,TH,THA,SEA,1782909,2707105,4490014,2111771,1426236,1038010,725836,406431,289099,5997383,1718262,2616565,4334827,2116549,1401554,1024231,731865,441147,376997,6092343,12089726,20914570,20914570
Thailand,1952,TH,THA,SEA,1864211,2750411,4614622,2166798,1472172,1050306,737539,417609,290094,6134518,1795504,2645124,4440628,2178614,1449395,1040114,749756,450722,385568,6254169,12388687,21443932,21443932
Thailand,1953,TH,THA,SEA,1949337,2797180,4746517,2220803,1522394,1062693,748521,430390,291015,6275816,1874655,2680068,4554723,2237133,1501026,1056151,766838,462629,393843,6417620,12693436,21994681,21994681
Thailand,1954,TH,THA,SEA,2034779,2855769,4890548,2271546,1573887,1076305,759794,443609,292608,6417749,1946576,2736460,4683036,2288029,1555622,1073588,783552,476041,401635,6578467,12996216,22569794,22569794
Thailand,1955,TH,THA,SEA,2112176,2936367,5048543,2318775,1625515,1092418,771840,456723,295276,6560547,2011548,2816584,4828132,2330442,1612773,1093609,800207,490602,409118,6736751,13297298,23173970,23173970
Thailand,1956,TH,THA,SEA,2183245,3035237,5218482,2364410,1677134,1110629,784628,469747,298782,6705330,2078474,2909192,4987666,2366371,1672129,1116042,816779,506217,416323,6893861,13599191,23805336,23805336
Thailand,1957,TH,THA,SEA,2253056,3146149,5399205,2409741,1728268,1130534,798400,482686,303068,6852697,2144472,3015044,5159516,2397857,1733237,1140659,833302,522763,422965,7050783,13903480,24462194,24462194
Thailand,1958,TH,THA,SEA,2320314,3268117,5588431,2452897,1778443,1153041,812470,495183,308302,7000336,2208196,3132733,5340929,2424429,1794716,1167838,849299,539755,429544,7205581,14205917,25135270,25135270
Thailand,1959,TH,THA,SEA,2388409,3400847,5789256,2494071,1829472,1181057,826566,507193,314730,7153089,2272710,3262186,5534896,2447727,1856563,1199649,865026,556669,437440,7363074,14516163,25840323,25840323
Thailand,1960,TH,THA,SEA,2459912,3543455,6003367,2536534,1882594,1216058,841332,519310,322896,7318724,2340379,3401655,5742034,2472881,1918760,1237605,881458,573820,447938,7532462,14851186,26596584,26596584
Thailand,1961,TH,THA,SEA,2534119,3693056,6227175,2580713,1937930,1257769,857021,531842,333234,7498509,2410513,3547289,5957802,2501068,1981933,1281389,898749,591554,461791,7716484,15214993,27399963,27399963
Thailand,1962,TH,THA,SEA,2611663,3846745,6458408,2626905,1995393,1305933,873247,544328,345100,7690906,2483666,3695002,6178668,2533789,2046091,1330393,916466,609341,478109,7914189,15605095,28242174,28242174
Thailand,1963,TH,THA,SEA,2691913,4004283,6696196,2677292,2052809,1358386,889888,556669,357566,7892610,2559291,3844521,6403812,2573783,2107806,1383460,934564,626656,495236,8121505,16014115,29114124,29114124
Thailand,1964,TH,THA,SEA,2771701,4163977,6935678,2739464,2107612,1412195,907824,569605,370401,8107101,2634615,3988438,6623053,2634964,2162779,1439612,954038,643780,512573,8347746,16454847,30013573,30013573
Thailand,1965,TH,THA,SEA,2848602,4318543,7167145,2822836,2159303,1466227,928158,583485,383651,8343660,2707445,4127543,6834988,2718952,2209910,1498366,975979,660975,530293,8594475,16938135,30940270,30940270
Thailand,1966,TH,THA,SEA,2919910,4468818,7388728,2923484,2209336,1520114,950413,598178,397170,8598695,2775068,4269780,7044848,2814972,2250747,1559158,1000141,678132,548336,8851486,17450181,31883754,31883754
Thailand,1967,TH,THA,SEA,2983168,4620831,7603999,3035512,2258828,1573369,974189,613744,410762,8866404,2835005,4413820,7248825,2923763,2287160,1621539,1026290,695136,566214,9120102,17986506,32839341,32839341
Thailand,1968,TH,THA,SEA,3036945,4773826,7810771,3159888,2307672,1626582,1000824,629884,424468,9149318,2885760,4558957,7444717,3045859,2320321,1685193,1055301,711844,584042,9402560,18551878,33807357,33807357
Thailand,1969,TH,THA,SEA,3080567,4926307,8006874,3295148,2355593,1680977,1032467,646113,438584,9448882,2926693,4703813,7630506,3180106,2351412,1749702,1088794,728360,602945,9701319,19150201,34787583,34787583
Thailand,2031,TH,THA,SEA,1535466,3329925,4865391,4077328,4528192,4993875,4888889,4561859,6821561,29871704,1444595,3136663,4581258,3857089,4326732,4995862,5146230,5356337,9031479,32713729,62585433,72032081,72032081
Thailand,2032,TH,THA,SEA,1525072,3275562,4800634,4022678,4423588,5018978,4888346,4526499,7015752,29895841,1434699,3085163,4519862,3804454,4222294,4995511,5132101,5291678,9325328,32771366,62667207,71987707,71987707
Thailand,2033,TH,THA,SEA,1513554,3229002,4742556,3958173,4340838,5021335,4881468,4496022,7207452,29905288,1423800,3040961,4464761,3742855,4141411,4971384,5114560,5228534,9613340,32812084,62717372,71924682,71924682
Thailand,2034,TH,THA,SEA,1500593,3190027,4690620,3884891,4282844,4996086,4868670,4477742,7389468,29899701,1411588,3003858,4415446,3673216,4087027,4923298,5093683,5162630,9895617,32835471,62735172,71841240,71841240
Thailand,2035,TH,THA,SEA,1486274,3156395,4642669,3806845,4238080,4946750,4860213,4470132,7558991,29881011,1398104,2971855,4369959,3598952,4046720,4858719,5073768,5097735,10167572,32843466,62724477,71737106,71737106
Thailand,2036,TH,THA,SEA,1470857,3126628,4597485,3723111,4202658,4881300,4854910,4472953,7715758,29850690,1383541,2943542,4327083,3519110,4014234,4780324,5055339,5049495,10419047,32837549,62688239,71612807,71612807
Thailand,2037,TH,THA,SEA,1454543,3101268,4555811,3633300,4178993,4811258,4834473,4492968,7857427,29808419,1368139,2919381,4287520,3433600,3990928,4697763,5023284,5026068,10645956,32817599,62626018,71469353,71469353
Thailand,2038,TH,THA,SEA,1437743,3078085,4515828,3545919,4160505,4738859,4804616,4521762,7983535,29755196,1352330,2897263,4249593,3350494,3971338,4614867,4981410,5014498,10852154,32784761,62539957,71305381,71305381
Thailand,2039,TH,THA,SEA,1421155,3055375,4476530,3465319,4138848,4661441,4785710,4544301,8096261,29691880,1336713,2875640,4212353,3273817,3948357,4528400,4945008,5005121,11039008,32739711,62431591,71120475,71120475
Thailand,2040,TH,THA,SEA,1405414,3031832,4437246,3393407,4108415,4567769,4793858,4559932,8196532,29619913,1321883,2853271,4175154,3205396,3917128,4427925,4928360,5000619,11204336,32683764,62303677,70916075,70916075
Thailand,2041,TH,THA,SEA,1390949,3006414,4397363,3331475,4066527,4459964,4824236,4570792,8287741,29540735,1308317,2829127,4137444,3146486,3875310,4315499,4932471,4995896,11352583,32618245,62158980,70693792,70693792
Thailand,2042,TH,THA,SEA,1377121,2979840,4356961,3277648,4013270,4359388,4851771,4575095,8376902,29454074,1295369,2803936,4099305,3095230,3823166,4212486,4933354,4984515,11494090,32542841,61996915,70453178,70453178
Thailand,2043,TH,THA,SEA,1364027,2951659,4315686,3231569,3950211,4280092,4857037,4573480,8467546,29359935,1283063,2777331,4060394,3051243,3762084,4132807,4910681,4969841,11630807,32457463,61817398,70193472,70193472
Thailand,2044,TH,THA,SEA,1352215,2922239,4274454,3193023,3878416,4224904,4835321,4566370,8560057,29258091,1271955,2749604,4021559,3014343,3692983,4079384,4864240,4951876,11758917,32361743,61619834,69915845,69915845
Thailand,2045,TH,THA,SEA,1341115,2892305,4233420,3159776,3801860,4182560,4790216,4563440,8650910,29148762,1261544,2721393,3982937,2982519,3619268,4039891,4801463,4934816,11877895,32255852,61404614,69620972,69620972
Thailand,2046,TH,THA,SEA,1329307,2862541,4191848,3130361,3719651,4149314,4729492,4563558,8740054,29032430,1250440,2693363,3943803,2954372,3539987,4008148,4725074,4919295,11993236,32140112,61172542,69308194,69308194
Thailand,2047,TH,THA,SEA,1316777,2832515,4149292,3105319,3631407,4127519,4664123,4549437,8831906,28909711,1238614,2665108,3903722,2930362,3455055,3985497,4644521,4890571,12108796,32014802,60924513,68977527,68977527
Thailand,2048,TH,THA,SEA,1303842,2802731,4106573,3082428,3545535,4110679,4596224,4526262,8918745,28779873,1226435,2637088,3863523,2908388,3372504,3966494,4563553,4852217,12216180,31879336,60659209,68629306,68629306
Thailand,2049,TH,THA,SEA,1289436,2774435,4063871,3059991,3466336,4090603,4523371,4513061,8989142,28642504,1212894,2610450,3823344,2886899,3296346,3944090,4479034,4819076,12307853,31733298,60375802,68263020,68263020
Thailand,2050,TH,THA,SEA,1273769,2747700,4021469,3036707,3395701,4061813,4434917,4525246,9043795,28498179,1198148,2585294,3783442,2864665,3228403,3913456,4380760,4805186,12384523,31576993,60075172,67880083,67880083
Tajikistan,1970,TJ,TJK,EUR,263654,427909,691563,230677,178928,172961,81806,60764,58901,784037,253123,416000,669123,232319,177852,177253,106256,82987,71637,848304,1632341,2993019,2993019
Tajikistan,1971,TJ,TJK,EUR,268806,442233,711039,250724,173850,177513,89144,60392,59845,811468,257967,429662,687629,251737,172662,181720,111811,83786,74104,875820,1687288,3085961,3085961
Tajikistan,1972,TJ,TJK,EUR,274302,455114,729416,271611,168966,181119,98637,59878,60640,840851,263135,441901,705036,271021,168748,185928,118987,84069,76407,905160,1746011,3180461,3180461
Tajikistan,1973,TJ,TJK,EUR,280056,466799,746855,292813,165375,184247,109459,59364,61326,872584,268540,452954,721494,290404,166291,190080,127203,84028,78550,936556,1809140,3277487,3277487
Tajikistan,1974,TJ,TJK,EUR,286238,477573,763811,313847,164808,186670,120112,59140,61996,906573,274332,463105,737437,309378,167083,193247,135354,84147,80725,969934,1876507,3377758,3377758
Tajikistan,1975,TJ,TJK,EUR,293078,487714,780792,334337,168152,188166,129820,59545,62650,942670,280744,472625,753369,328203,171299,195069,142902,84804,83022,1005299,1947969,3482125,3482125
Tajikistan,1976,TJ,TJK,EUR,300746,497418,798164,354766,174720,188784,138508,60442,63302,980522,287946,481674,769620,347977,178050,195115,149828,85902,85432,1042304,2022826,3590606,3590606
Tajikistan,1977,TJ,TJK,EUR,309423,506866,816289,374663,184629,188612,146096,61655,63961,1019616,296121,490462,786583,367231,188649,193336,155916,87388,88003,1080523,2100139,3703010,3703010
Tajikistan,1978,TJ,TJK,EUR,319259,516413,835672,393255,198174,186650,152662,63637,64497,1058875,305419,499336,804755,385165,202434,189990,161205,89530,90484,1118808,2177683,3818114,3818114
Tajikistan,1979,TJ,TJK,EUR,329964,526576,856540,409797,214826,181738,158276,66857,64888,1096382,315579,508799,824378,401003,219078,184039,166023,92404,92838,1155385,2251767,3932682,3932682
Tajikistan,1980,TJ,TJK,EUR,341115,537842,878957,424132,232071,175994,163034,71450,65055,1131736,326188,519329,845517,414595,236369,177495,170380,96072,94849,1189760,2321496,4045965,4045965
Tajikistan,1981,TJ,TJK,EUR,352592,550423,903015,436758,249788,170308,166810,77731,64848,1166243,337141,531140,868281,426480,253630,171681,174266,100982,96164,1223203,2389446,4160745,4160745
Tajikistan,1982,TJ,TJK,EUR,364333,564291,928624,448086,268174,164749,169703,85819,64397,1200928,348394,544201,892595,437079,270598,167042,177897,107275,96869,1256760,2457688,4278908,4278908
Tajikistan,1983,TJ,TJK,EUR,376510,579473,955983,458381,286620,160224,172072,94935,63851,1236083,360088,558548,918636,446670,287396,163626,181406,114433,97275,1290806,2526889,4401502,4401502
Tajikistan,1984,TJ,TJK,EUR,389426,595917,985343,467952,304707,158388,173662,103745,63473,1271927,372493,574121,946614,455574,303594,163160,183888,121470,97925,1325611,2597538,4529501,4529501
Tajikistan,1985,TJ,TJK,EUR,402042,608925,1010967,476580,322546,160326,173039,110730,64137,1307358,387112,590570,977682,467806,321151,164389,183241,127695,100314,1364596,2671954,4660598,4660598
Tajikistan,1986,TJ,TJK,EUR,416886,617688,1034574,483336,341203,165282,170798,115570,65668,1341857,406728,606896,1013624,483259,341970,166842,179209,132745,104208,1408233,2750090,4798281,4798281
Tajikistan,1987,TJ,TJK,EUR,435979,626043,1062022,488722,360275,173358,168038,119026,67232,1376651,431117,623195,1054312,497882,363769,174224,172782,136559,108087,1453303,2829954,4946293,4946293
Tajikistan,1988,TJ,TJK,EUR,456748,635557,1092305,493370,379287,184846,163478,121493,68873,1411347,455278,641932,1097210,511140,386598,186417,163586,139194,112220,1499155,2910502,5100020,5100020
Tajikistan,1989,TJ,TJK,EUR,477862,653435,1131297,500127,397083,199529,158094,124333,70414,1449580,474569,664875,1139444,521298,407795,203111,154574,141123,116109,1544010,2993590,5264332,5264332
Tajikistan,1990,TJ,TJK,EUR,496394,678776,1175170,508128,410681,214299,152373,127291,72378,1485150,487737,691295,1179032,527660,423497,220044,146775,141946,118587,1578509,3063659,5417860,5417860
Tajikistan,1991,TJ,TJK,EUR,509426,706949,1216375,516269,420665,228110,146774,129227,75449,1516494,494850,721221,1216071,533982,435635,235278,139830,142345,120298,1607368,3123862,5556306,5556306
Tajikistan,1992,TJ,TJK,EUR,517153,735018,1252171,520670,424372,238655,140848,128896,78807,1532248,496878,751126,1248004,538391,442586,247451,133493,141275,120587,1623783,3156031,5656208,5656208
Tajikistan,1993,TJ,TJK,EUR,519556,763208,1282764,520191,421698,246547,134177,126300,81755,1530668,496367,778905,1275272,540735,444834,257820,127402,138434,119876,1629101,3159769,5717806,5717806
Tajikistan,1994,TJ,TJK,EUR,517838,795513,1313351,524799,420398,257869,129780,124335,84568,1541749,494336,807701,1302037,547368,447371,271192,124130,136492,120303,1646856,3188605,5803993,5803993
Tajikistan,1995,TJ,TJK,EUR,514012,830354,1344366,535019,420995,272641,128609,123908,87396,1568568,490340,838157,1328497,556705,450306,286944,124166,135083,121544,1674748,3243316,5916173,5916173
Tajikistan,1996,TJ,TJK,EUR,507938,864887,1372825,547333,422255,288413,130394,123795,89883,1602073,484348,867678,1352026,567057,454455,303588,127932,133017,122626,1708675,3310748,6035600,6035600
Tajikistan,1997,TJ,TJK,EUR,493971,884556,1378527,560373,425091,301893,134785,121659,92556,1636357,474934,885912,1360846,579689,457709,318223,135267,127634,122816,1741338,3377695,6117069,6117069
Tajikistan,1998,TJ,TJK,EUR,476070,884656,1360726,574593,428803,312445,141220,116806,95759,1669626,465536,890155,1355691,595246,459055,330455,144739,118905,122362,1770762,3440388,6156805,6156805
Tajikistan,1999,TJ,TJK,EUR,459762,875018,1334780,592017,433106,321747,148934,110799,99215,1705818,457603,888370,1345973,613555,461177,341713,154934,109880,121734,1802993,3508811,6189565,6189565
Tajikistan,2000,TJ,TJK,EUR,452279,873138,1325417,615267,439516,332473,158822,105796,102307,1754181,451676,891143,1342819,636741,466832,354310,167119,103189,122392,1850583,3604764,6272998,6272998
Tajikistan,2001,TJ,TJK,EUR,456569,878748,1335317,644205,447395,344436,171220,102700,105193,1815149,450584,895580,1346164,664907,474424,367635,181447,99387,124382,1912182,3727331,6408810,6408810
Tajikistan,2002,TJ,TJK,EUR,462675,879493,1342168,674764,455489,354708,184807,100840,108490,1879098,451549,894334,1345883,694438,481449,378689,196320,97219,126487,1974602,3853700,6541755,6541755
Tajikistan,2003,TJ,TJK,EUR,467200,880268,1347468,704353,464655,363137,199445,100130,111903,1943623,451183,892764,1343947,723492,488956,387697,211941,96639,128723,2037448,3981071,6672492,6672492
Tajikistan,2004,TJ,TJK,EUR,471680,880294,1351974,732237,475009,369844,215108,100666,115277,2008141,450783,890453,1341236,751178,496975,394798,228355,97679,130873,2099858,4107999,6801204,6801204
Tajikistan,2005,TJ,TJK,EUR,475376,880576,1355952,758860,486485,375478,231353,102543,118359,2073078,451837,886525,1338362,777250,505747,400599,245195,100451,132506,2161748,4234826,6929145,6929145
Tajikistan,2006,TJ,TJK,EUR,477851,883368,1361219,783223,499087,380405,247590,106126,120836,2137267,453981,883315,1337296,800181,515649,405426,261886,105341,133149,2221632,4358899,7057417,7057417
Tajikistan,2007,TJ,TJK,EUR,483123,887785,1370908,803788,512770,384930,263422,111634,122180,2198724,458850,881742,1340592,818689,527008,409457,278153,112545,132302,2278154,4476878,7188391,7188391
Tajikistan,2008,TJ,TJK,EUR,492920,893124,1386044,820337,528096,389510,278431,119071,122354,2257799,468069,880751,1348820,833150,540150,413129,293662,121914,129960,2331965,4589764,7324627,7324627
Tajikistan,2009,TJ,TJK,EUR,507567,897353,1404920,834433,546280,394178,292415,128204,121810,2317320,481936,878656,1360592,845276,555711,416680,308195,132980,126922,2385764,4703084,7468596,7468596
Tajikistan,2010,TJ,TJK,EUR,526151,900968,1427119,845571,568674,399130,305088,138533,120873,2377869,499598,876218,1375816,854493,575423,420477,321530,145073,123977,2440973,4818842,7621779,7621779
Tajikistan,2011,TJ,TJK,EUR,547193,908010,1455203,850545,595522,404879,316064,149705,120100,2436815,519637,877438,1397075,857501,600156,425014,333236,157864,121955,2495726,4932541,7784819,7784819
Tajikistan,2012,TJ,TJK,EUR,568263,919955,1488218,850991,624854,411673,325414,161741,120004,2494677,539760,883804,1423564,855719,627947,430383,343200,171378,121302,2549929,5044606,7956382,7956382
Tajikistan,2013,TJ,TJK,EUR,588278,935071,1523349,851873,653959,419890,333157,174782,120782,2554443,558911,893506,1452417,854145,656231,436684,351472,185745,122128,2606405,5160848,8136610,8136610
Tajikistan,2014,TJ,TJK,EUR,606807,955197,1562004,852360,682100,429770,339464,188779,122442,2614915,576606,908103,1484709,852417,684256,444171,358317,201049,124510,2664720,5279635,8326348,8326348
Tajikistan,2015,TJ,TJK,EUR,623162,978677,1601839,853455,709734,441357,344986,203255,124880,2677667,592159,928196,1520355,849668,711815,453233,364364,216892,128227,2724199,5401866,8524063,8524063
Tajikistan,2016,TJ,TJK,EUR,635968,1003577,1639545,857378,735859,454697,350080,217680,128137,2743831,604274,951950,1556224,848197,737356,464294,369944,232745,133183,2785719,5529550,8725318,8725318
Tajikistan,2017,TJ,TJK,EUR,644013,1031439,1675452,863197,758918,469770,355054,231768,132114,2810821,611769,978682,1590451,848867,759519,477672,375208,248388,139136,2848790,5659611,8925525,8925525
Tajikistan,2018,TJ,TJK,EUR,648854,1062852,1711706,870244,778614,487124,360367,245186,136882,2878417,616152,1008901,1625053,850613,778569,493695,380583,263508,145991,2912959,5791376,9128132,9128132
Tajikistan,2019,TJ,TJK,EUR,651767,1097654,1749421,876587,796396,507954,366061,257821,142658,2947477,618695,1042359,1661054,851764,796108,512998,386289,277926,153967,2979052,5926529,9337003,9337003
Tajikistan,2020,TJ,TJK,EUR,652129,1134260,1786389,882582,811579,533184,371890,268568,147297,3015100,618824,1077524,1696348,852858,811153,536807,392246,290764,161544,3045372,6060472,9543207,9543207
Tajikistan,2021,TJ,TJK,EUR,651251,1169710,1820961,891921,820595,562867,378583,277961,153255,3085182,617771,1111530,1729301,857438,819840,565512,398930,302136,170760,3114616,6199798,9750064,9750064
Tajikistan,2022,TJ,TJK,EUR,651441,1200100,1851541,904579,823305,594178,386179,286569,162383,3157193,617649,1140645,1758294,865414,821989,596482,406286,312385,183209,3185765,6342958,9952787,9952787
Tajikistan,2023,TJ,TJK,EUR,650937,1225876,1876813,918970,824433,624137,394572,293459,172465,3228036,616839,1165298,1782137,875127,822398,626946,414067,320887,197135,3256560,6484596,10143543,10143543
Tajikistan,2024,TJ,TJK,EUR,648069,1247989,1896058,938392,824607,652791,404456,299166,183996,3303408,613857,1186360,1800217,889646,821893,656676,422756,328052,212808,3331831,6635239,10331513,10331513
Tajikistan,2025,TJ,TJK,EUR,644269,1265138,1909407,961238,824876,680565,415868,304261,196535,3383343,610038,1202565,1812603,909617,819625,685447,432720,334444,229732,3411585,6794928,10516940,10516940
Tajikistan,2026,TJ,TJK,EUR,640556,1277329,1917885,985588,827448,706449,428808,308989,209552,3466834,606381,1213913,1820294,933245,817902,711694,444351,340317,247353,3494862,6961696,10699866,10699866
Tajikistan,2027,TJ,TJK,EUR,637144,1285845,1922989,1012970,831423,728855,443205,313539,222610,3552602,603132,1221573,1824705,959856,817614,734034,457939,345792,265213,3580448,7133050,10880747,10880747
Tajikistan,2028,TJ,TJK,EUR,634586,1290432,1925018,1043955,836218,747408,459557,318259,235256,3640653,600755,1225421,1826176,989949,817762,752685,473786,351232,282893,3668307,7308960,11060158,11060158
Tajikistan,2029,TJ,TJK,EUR,633892,1290534,1924426,1078342,840020,763525,478983,323162,247473,3731505,600154,1225054,1825208,1023242,816781,769198,492505,356807,300307,3758840,7490345,11239983,11239983
Tajikistan,2030,TJ,TJK,EUR,635535,1286990,1922525,1114466,843266,776550,502537,328398,259253,3824470,601804,1221265,1823069,1058116,815290,782563,515364,362664,317369,3851366,7675836,11421430,11421430
Tajikistan,1950,TJ,TJK,EUR,92859,173728,266587,168296,79510,72165,72075,49513,33212,474771,95071,168689,263760,167695,103606,93843,77022,45852,33006,521024,995795,1526140,1526140
Tajikistan,1951,TJ,TJK,EUR,103946,168553,272499,175828,89895,72568,73312,50231,34902,496736,105505,163488,268993,175163,111789,95631,79897,46738,35024,544242,1040978,1582466,1582466
Tajikistan,1952,TJ,TJK,EUR,115580,163399,278979,181415,102095,72534,73955,50893,36719,517611,115587,159421,275008,181399,121129,96585,82012,47725,37254,566104,1083715,1637708,1637708
Tajikistan,1953,TJ,TJK,EUR,127287,159321,286608,185624,115221,72236,74068,51659,38517,537325,125571,156607,282178,186699,131046,96952,83520,49030,39517,586764,1124089,1692876,1692876
Tajikistan,1954,TJ,TJK,EUR,138603,158242,296845,188374,127650,72027,73800,52768,40082,554701,134981,156974,291955,190224,140383,97271,84734,50939,41426,604977,1159678,1748476,1748476
Tajikistan,1955,TJ,TJK,EUR,149302,161158,310460,189587,138585,72347,73197,54244,41350,569310,144209,160762,304971,191742,148614,97956,85766,53489,42897,620464,1189774,1805209,1805209
Tajikistan,1956,TJ,TJK,EUR,160207,167400,327607,189462,148045,73076,72496,55907,42343,581329,154678,167135,321813,190960,155820,98961,86825,56498,43981,633045,1214374,1863791,1863791
Tajikistan,1957,TJ,TJK,EUR,171241,177166,348407,188266,156086,74064,71941,57587,43059,591003,165273,177494,342767,188010,161878,100255,88191,59785,44652,642771,1233774,1924945,1924945
Tajikistan,1958,TJ,TJK,EUR,182228,191061,373289,185218,162964,75973,71367,59215,43668,598405,175811,191449,367260,183463,167003,102273,89574,63177,45159,650649,1249054,1989603,1989603
Tajikistan,1959,TJ,TJK,EUR,193168,209161,402329,179538,169047,79523,70906,60602,44387,604003,186282,209290,395572,176698,171854,105223,90971,66329,45915,656990,1260993,2058891,2058891
Tajikistan,1960,TJ,TJK,EUR,203898,228859,432757,173480,174384,84889,70480,61599,45302,610134,196544,228784,425328,169818,176391,109215,92249,68991,47108,663772,1273906,2131992,2131992
Tajikistan,1961,TJ,TJK,EUR,214125,249509,463634,167752,178678,92455,69843,62239,46386,617353,206314,248716,455030,163974,180476,114774,92970,71152,48662,672008,1289361,2208026,2208026
Tajikistan,1962,TJ,TJK,EUR,223498,271045,494543,162425,182083,102414,69089,62514,47621,626146,215258,268542,483800,159669,184412,122105,93172,72769,50563,682690,1308836,2287181,2287181
Tajikistan,1963,TJ,TJK,EUR,231691,292756,524447,158509,185056,113864,68360,62468,48974,637231,223060,288328,511388,156962,188382,130607,93071,73974,52804,695800,1333031,2368868,2368868
Tajikistan,1964,TJ,TJK,EUR,238490,314161,552651,157816,187413,125205,67968,62230,50471,651103,229516,307581,537097,157699,191473,139112,93169,75042,55322,711817,1362920,2452671,2452671
Tajikistan,1965,TJ,TJK,EUR,243875,334903,578778,161244,188937,135617,68299,61824,52092,668013,234604,326568,561172,162033,193312,147046,93838,76056,58043,730328,1398341,2538295,2538295
Tajikistan,1966,TJ,TJK,EUR,248107,355501,603608,168079,189681,145016,69208,61428,53684,687096,238578,346437,585015,169066,193464,154393,94997,77173,60841,749934,1437030,2625653,2625653
Tajikistan,1967,TJ,TJK,EUR,251687,375518,627205,178442,189748,153350,70498,61211,55133,708382,241917,365729,607646,180109,191887,160943,96578,78629,63587,771733,1480115,2714959,2714959
Tajikistan,1968,TJ,TJK,EUR,255183,394435,649618,192862,188201,160739,72732,61017,56515,732066,245177,383923,629100,194714,188947,166763,98923,80133,66302,795782,1527848,2806566,2806566
Tajikistan,1969,TJ,TJK,EUR,259094,411968,671062,211204,183950,167288,76460,60893,57796,757591,248836,400746,649582,212939,183664,172236,102126,81635,69018,821618,1579209,2899854,2899854
Tajikistan,2031,TJ,TJK,EUR,639565,1282205,1921770,1149440,849755,783105,530131,334263,270477,3917171,605735,1216348,1822083,1091801,817073,789130,542730,369027,333867,3943628,7860799,11604659,11604659
Tajikistan,2032,TJ,TJK,EUR,646094,1278929,1925023,1179582,860980,784612,559707,340929,281316,4007126,612031,1212907,1824938,1120786,823694,790252,572649,375955,349948,4033284,8040410,11790372,11790372
Tajikistan,2033,TJ,TJK,EUR,655071,1275963,1931034,1205268,875340,785881,588650,348741,291951,4095831,620618,1209833,1830451,1145426,833480,790824,602592,383548,365843,4121713,8217544,11979029,11979029
Tajikistan,2034,TJ,TJK,EUR,665552,1272484,1938036,1227307,894679,786213,616326,357970,302584,4185079,630589,1206346,1836935,1166477,848034,790485,631803,392038,381774,4210611,8395690,12170662,12170662
Tajikistan,2035,TJ,TJK,EUR,676527,1270401,1946928,1244405,917413,786654,643155,368660,313328,4273615,641013,1204260,1845273,1182685,868000,788399,660069,401789,397820,4298762,8572377,12364586,12364586
Tajikistan,2036,TJ,TJK,EUR,687575,1270780,1958355,1256568,941644,789366,668143,380770,323981,4360472,651502,1204610,1856112,1194049,891602,786840,685853,413150,413744,4385238,8745710,12560173,12560173
Tajikistan,2037,TJ,TJK,EUR,698526,1273949,1972475,1265070,968870,793434,689734,394205,334354,4445667,661894,1207718,1869612,1201724,918158,786688,707794,426384,429286,4470034,8915701,12757794,12757794
Tajikistan,2038,TJ,TJK,EUR,708713,1280411,1989124,1269658,999645,798284,707591,409414,344413,4529005,671537,1213976,1885513,1205596,948164,786952,726113,441759,444423,4553007,9082012,12956641,12956641
Tajikistan,2039,TJ,TJK,EUR,717513,1290214,2007727,1269781,1033787,802160,723125,427424,354180,4610457,679848,1223376,1903224,1205264,981347,786091,742348,459867,459269,4634186,9244643,13155611,13155611
Tajikistan,2040,TJ,TJK,EUR,725135,1302842,2027977,1266281,1069643,805505,735759,449227,363824,4690239,687021,1235473,1922494,1201521,1016091,784732,755546,481931,473922,4713743,9403982,13354458,13354458
Tajikistan,2041,TJ,TJK,EUR,731320,1317920,2049240,1261550,1104346,812025,742228,474722,373507,4768378,692797,1249913,1942710,1196650,1049646,786608,762135,508290,488409,4791738,9560116,13552075,13552075
Tajikistan,2042,TJ,TJK,EUR,735386,1335395,2070781,1258314,1134253,823196,743875,501992,383543,4845173,696558,1266615,1963173,1193251,1078521,793267,763409,537052,502937,4868437,9713610,13747565,13747565
Tajikistan,2043,TJ,TJK,EUR,737400,1354553,2091953,1255393,1159746,837459,745329,528630,394421,4920978,698398,1284859,1983257,1190212,1103077,803068,764167,565792,517860,4944176,9865154,13940358,13940358
Tajikistan,2044,TJ,TJK,EUR,737875,1373829,2111704,1251969,1181645,856634,745905,554086,406539,4996778,698797,1303151,2001948,1186770,1124072,817608,764042,593807,533626,5019925,10016703,14130345,14130345
Tajikistan,2045,TJ,TJK,EUR,736929,1392426,2129355,1249936,1198652,879167,746646,578763,420026,5073190,697836,1320762,2018598,1184728,1140256,837510,762221,620909,550678,5096302,10169492,14317447,14317447
Tajikistan,2046,TJ,TJK,EUR,734916,1409672,2144588,1250365,1210774,903201,749620,601714,434703,5150377,695858,1337047,2032905,1185112,1151616,861013,760929,645625,569135,5173430,10323807,14501303,14501303
Tajikistan,2047,TJ,TJK,EUR,732516,1424710,2157226,1253580,1219275,930176,753877,621463,450347,5228718,693534,1351220,2044754,1188254,1159321,887446,760993,666647,589019,5251680,10480398,14682375,14682375
Tajikistan,2048,TJ,TJK,EUR,729625,1436939,2166564,1260074,1223909,960639,758847,637737,467276,5308482,690744,1362729,2053473,1194545,1163238,917290,761446,684204,610572,5331295,10639777,14859804,14859804
Tajikistan,2049,TJ,TJK,EUR,725665,1446256,2171921,1269899,1224125,994404,762900,651989,486406,5389723,686924,1371468,2058392,1203965,1162975,950273,760811,699836,634451,5412311,10802034,15032352,15032352
Tajikistan,2050,TJ,TJK,EUR,721143,1452982,2174125,1282540,1220759,1029856,766484,663797,508654,5472090,682568,1377712,2060280,1216077,1159321,984810,759714,712696,661875,5494493,10966583,15200989,15200989
Tokelau,1970,TK,TKL,WPR,137,282,419,94,62,76,51,46,40,369,135,287,422,138,105,86,78,36,58,501,870,1714,1714
Tokelau,1971,TK,TKL,WPR,132,272,404,92,59,71,51,46,39,358,132,284,416,135,98,79,75,36,58,481,839,1659,1659
Tokelau,1972,TK,TKL,WPR,131,261,392,100,54,67,56,42,39,358,128,277,405,140,94,78,73,34,56,475,833,1628,1628
Tokelau,1973,TK,TKL,WPR,133,255,388,110,48,65,62,40,40,365,125,268,393,146,92,80,73,35,55,481,846,1625,1625
Tokelau,1974,TK,TKL,WPR,130,256,386,122,45,63,65,36,38,369,122,259,381,147,94,84,71,39,53,488,857,1625,1625
Tokelau,1975,TK,TKL,WPR,129,262,391,130,44,57,69,34,36,370,120,254,374,145,96,86,69,44,52,492,862,1621,1621
Tokelau,1976,TK,TKL,WPR,126,268,394,132,44,54,73,32,38,373,120,248,368,137,101,86,68,48,52,492,865,1626,1626
Tokelau,1977,TK,TKL,WPR,124,272,396,138,46,53,73,34,41,385,120,244,364,131,107,87,69,53,52,499,884,1637,1637
Tokelau,1978,TK,TKL,WPR,121,269,390,134,51,54,70,37,43,389,119,240,359,129,109,89,69,60,51,507,896,1645,1645
Tokelau,1979,TK,TKL,WPR,120,267,387,141,55,55,68,38,44,401,118,237,355,134,105,91,68,67,48,513,914,1649,1649
Tokelau,1980,TK,TKL,WPR,120,259,379,145,56,55,66,36,43,401,117,231,348,139,103,91,70,69,44,516,917,1647,1647
Tokelau,1981,TK,TKL,WPR,118,257,375,154,60,53,65,39,39,410,115,226,341,146,103,90,73,65,42,519,929,1641,1641
Tokelau,1982,TK,TKL,WPR,116,249,365,154,69,48,62,47,36,416,115,219,334,150,104,89,75,63,40,521,937,1640,1640
Tokelau,1983,TK,TKL,WPR,115,248,363,165,76,44,59,52,36,432,115,218,333,156,106,89,77,63,43,534,966,1663,1663
Tokelau,1984,TK,TKL,WPR,116,247,363,181,83,43,56,56,38,457,116,221,337,165,103,91,80,61,49,549,1006,1704,1704
Tokelau,1985,TK,TKL,WPR,117,244,361,197,88,44,52,60,38,479,117,223,340,174,99,94,82,59,54,562,1041,1739,1739
Tokelau,1986,TK,TKL,WPR,120,238,358,208,94,44,50,63,34,493,120,222,342,177,96,99,80,59,61,572,1065,1759,1759
Tokelau,1987,TK,TKL,WPR,122,229,351,202,96,46,49,63,34,490,123,219,342,170,93,105,82,59,62,571,1061,1749,1749
Tokelau,1988,TK,TKL,WPR,124,224,348,184,96,50,49,60,39,478,124,213,337,153,91,106,85,56,61,552,1030,1718,1718
Tokelau,1989,TK,TKL,WPR,125,227,352,168,95,54,51,57,42,467,123,215,338,139,92,102,88,54,64,539,1006,1692,1692
Tokelau,1990,TK,TKL,WPR,129,231,360,147,97,55,52,56,46,453,122,216,338,126,89,100,88,52,64,519,972,1669,1669
Tokelau,1991,TK,TKL,WPR,130,236,366,135,93,59,51,54,48,440,122,217,339,114,88,99,86,57,66,510,950,1657,1657
Tokelau,1992,TK,TKL,WPR,126,233,359,134,93,68,47,52,49,443,117,216,333,115,88,97,86,59,68,513,956,1652,1652
Tokelau,1993,TK,TKL,WPR,119,230,349,135,99,75,44,50,51,454,110,215,325,120,88,97,85,63,67,520,974,1645,1645
Tokelau,1994,TK,TKL,WPR,115,223,338,136,103,81,42,47,53,462,108,204,312,123,88,91,86,67,69,524,986,1639,1639
Tokelau,1995,TK,TKL,WPR,113,222,335,136,105,87,41,44,54,467,105,202,307,124,90,89,86,71,70,530,997,1632,1632
Tokelau,1996,TK,TKL,WPR,115,213,328,135,105,90,42,43,57,472,103,194,297,125,92,85,86,71,74,533,1005,1626,1626
Tokelau,1997,TK,TKL,WPR,115,212,327,136,107,89,44,44,58,478,100,193,293,126,93,80,91,68,74,532,1010,1628,1628
Tokelau,1998,TK,TKL,WPR,115,213,328,133,110,86,49,46,59,483,96,191,287,132,94,79,89,72,72,538,1021,1637,1637
Tokelau,1999,TK,TKL,WPR,114,215,329,136,114,84,53,47,58,492,97,189,286,133,98,81,84,75,71,542,1034,1649,1649
Tokelau,2000,TK,TKL,WPR,113,216,329,131,117,88,54,47,58,495,101,188,289,132,103,82,83,77,72,549,1044,1666,1666
Tokelau,2001,TK,TKL,WPR,112,217,329,136,119,90,58,46,59,508,107,182,289,132,106,85,83,76,75,557,1065,1679,1679
Tokelau,2002,TK,TKL,WPR,106,210,316,131,112,92,66,42,62,505,105,171,276,130,103,88,79,75,79,554,1059,1652,1652
Tokelau,2003,TK,TKL,WPR,93,204,297,128,103,96,73,38,62,500,96,158,254,121,94,87,78,72,79,531,1031,1585,1585
Tokelau,2004,TK,TKL,WPR,81,190,271,125,92,97,79,38,60,491,84,154,238,110,88,82,76,70,83,509,1000,1508,1508
Tokelau,2005,TK,TKL,WPR,72,176,248,119,91,92,83,38,58,481,75,150,225,96,82,76,73,65,87,479,960,1429,1429
Tokelau,2006,TK,TKL,WPR,70,157,227,114,87,87,84,38,58,468,69,143,212,84,74,71,71,66,89,455,923,1365,1365
Tokelau,2007,TK,TKL,WPR,70,147,217,116,88,85,85,39,59,472,66,140,206,81,72,67,67,69,94,450,922,1343,1343
Tokelau,2008,TK,TKL,WPR,70,141,211,121,89,83,82,43,57,475,64,140,204,84,73,65,67,70,96,455,930,1347,1347
Tokelau,2009,TK,TKL,WPR,70,138,208,124,90,83,80,47,57,481,64,139,203,88,73,63,73,68,95,460,941,1355,1355
Tokelau,2010,TK,TKL,WPR,76,135,211,123,89,85,84,48,58,487,67,138,205,94,68,64,77,66,91,460,947,1367,1367
Tokelau,2011,TK,TKL,WPR,78,134,212,119,88,87,86,51,60,491,68,137,205,101,67,63,82,64,91,468,959,1382,1382
Tokelau,2012,TK,TKL,WPR,77,138,215,125,95,87,91,60,59,517,67,142,209,111,75,63,86,69,94,498,1015,1440,1440
Tokelau,2013,TK,TKL,WPR,76,145,221,133,98,86,96,69,55,537,69,146,215,122,82,66,86,76,99,531,1068,1502,1502
Tokelau,2014,TK,TKL,WPR,73,150,223,131,96,85,96,73,52,533,70,146,216,116,83,70,85,71,99,524,1057,1494,1494
Tokelau,2015,TK,TKL,WPR,71,154,225,121,91,87,88,74,52,513,68,142,210,107,82,73,85,61,96,504,1017,1454,1454
Tokelau,2016,TK,TKL,WPR,70,157,227,118,90,87,84,76,52,507,65,148,213,99,81,75,82,48,96,481,988,1427,1427
Tokelau,2017,TK,TKL,WPR,70,168,238,121,95,93,85,76,56,526,66,155,221,106,85,80,83,47,101,502,1028,1486,1486
Tokelau,2018,TK,TKL,WPR,75,184,259,129,102,102,94,72,63,562,75,163,238,127,99,94,84,56,102,562,1124,1621,1621
Tokelau,2019,TK,TKL,WPR,78,200,278,139,109,109,106,67,68,598,80,172,252,147,110,106,88,73,96,620,1218,1752,1752
Tokelau,2020,TK,TKL,WPR,83,202,285,147,114,113,112,71,67,624,84,179,263,155,118,110,90,87,88,648,1272,1827,1827
Tokelau,2021,TK,TKL,WPR,85,194,279,155,116,112,115,75,68,641,85,179,264,157,121,113,83,98,83,655,1296,1849,1849
Tokelau,2022,TK,TKL,WPR,86,185,271,166,120,112,111,80,71,660,84,179,263,161,121,117,77,107,85,668,1328,1871,1871
Tokelau,2023,TK,TKL,WPR,85,177,262,177,126,111,105,88,73,680,83,178,261,168,121,117,77,107,88,678,1358,1893,1893
Tokelau,2024,TK,TKL,WPR,86,169,255,188,132,107,105,91,77,700,84,175,259,173,124,116,81,103,94,691,1391,1915,1915
Tokelau,2025,TK,TKL,WPR,88,163,251,196,136,105,106,94,81,718,85,171,256,177,130,113,87,101,96,704,1422,1934,1934
Tokelau,2026,TK,TKL,WPR,89,161,250,202,138,106,106,95,85,732,85,170,255,179,134,112,94,98,98,715,1447,1952,1952
Tokelau,2027,TK,TKL,WPR,90,160,250,207,139,107,107,96,84,740,85,170,255,179,139,111,102,92,101,724,1464,1972,1972
Tokelau,2028,TK,TKL,WPR,90,162,252,209,140,108,109,100,83,749,86,170,256,177,144,111,108,86,105,731,1480,1994,1994
Tokelau,2029,TK,TKL,WPR,90,166,256,207,142,110,111,104,85,759,87,169,256,176,150,113,110,83,111,743,1502,2021,2021
Tokelau,2030,TK,TKL,WPR,90,170,260,201,147,113,110,107,89,767,88,169,257,177,154,117,110,81,119,758,1525,2046,2046
Tokelau,1950,TK,TKL,WPR,120,198,318,117,114,67,70,43,30,441,143,216,359,146,113,56,78,53,40,486,927,1599,1599
Tokelau,1951,TK,TKL,WPR,128,186,314,104,98,70,68,47,32,419,140,214,354,142,114,60,76,57,44,493,912,1579,1579
Tokelau,1952,TK,TKL,WPR,132,185,317,104,95,74,64,47,33,417,139,219,358,140,112,65,73,60,42,492,909,1587,1587
Tokelau,1953,TK,TKL,WPR,135,185,320,112,95,77,59,48,33,424,141,227,368,146,112,70,69,59,38,494,918,1603,1603
Tokelau,1954,TK,TKL,WPR,135,186,321,117,94,78,57,45,30,421,140,234,374,151,113,75,62,55,37,493,914,1614,1614
Tokelau,1955,TK,TKL,WPR,137,189,326,119,94,81,55,45,28,422,142,244,386,154,111,78,55,56,41,495,917,1629,1629
Tokelau,1956,TK,TKL,WPR,142,194,336,119,94,80,53,47,27,420,143,250,393,159,108,80,54,55,45,501,921,1646,1646
Tokelau,1957,TK,TKL,WPR,150,200,350,121,93,78,50,48,26,416,147,253,400,162,108,82,57,53,49,511,927,1673,1673
Tokelau,1958,TK,TKL,WPR,157,205,362,124,92,80,52,47,25,420,153,255,408,167,113,81,57,53,51,522,942,1712,1712
Tokelau,1959,TK,TKL,WPR,164,214,378,128,90,82,54,48,25,427,159,254,413,173,119,83,51,54,49,529,956,1751,1751
Tokelau,1960,TK,TKL,WPR,172,223,395,129,89,81,58,47,27,431,166,258,424,178,123,86,50,54,47,538,969,1795,1795
Tokelau,1961,TK,TKL,WPR,181,236,417,129,91,82,60,46,30,438,173,263,436,181,127,90,51,52,50,551,989,1847,1847
Tokelau,1962,TK,TKL,WPR,185,248,433,121,93,84,60,48,32,438,175,265,440,177,133,94,53,49,55,561,999,1874,1874
Tokelau,1963,TK,TKL,WPR,187,259,446,105,93,84,63,46,34,425,176,270,446,164,137,99,56,47,57,560,985,1879,1879
Tokelau,1964,TK,TKL,WPR,187,275,462,94,93,83,67,45,36,418,175,271,446,153,139,102,61,45,58,558,976,1888,1888
Tokelau,1965,TK,TKL,WPR,189,291,480,86,87,82,71,42,36,404,172,279,451,145,138,105,67,44,57,556,960,1896,1896
Tokelau,1966,TK,TKL,WPR,187,305,492,80,82,81,72,40,36,391,166,286,452,141,132,110,72,44,53,552,943,1896,1896
Tokelau,1967,TK,TKL,WPR,175,309,484,82,75,81,69,39,36,382,159,288,447,145,122,110,76,46,52,551,933,1867,1867
Tokelau,1968,TK,TKL,WPR,159,301,460,86,68,81,65,40,37,377,148,287,435,144,117,103,75,45,52,536,913,1819,1819
Tokelau,1969,TK,TKL,WPR,149,291,440,92,66,79,61,43,40,381,139,288,427,142,109,94,79,40,56,520,901,1769,1769
Tokelau,2031,TK,TKL,WPR,90,173,263,194,154,115,109,108,96,776,89,170,259,177,156,120,113,76,124,766,1542,2067,2067
Tokelau,2032,TK,TKL,WPR,91,175,266,185,165,119,106,105,100,780,90,169,259,177,160,121,116,73,130,777,1557,2087,2087
Tokelau,2033,TK,TKL,WPR,92,175,267,177,177,125,105,98,106,788,90,169,259,176,167,119,116,75,137,790,1578,2107,2107
Tokelau,2034,TK,TKL,WPR,93,175,268,169,188,130,101,98,113,799,90,171,261,173,172,123,114,79,141,802,1601,2130,2130
Tokelau,2035,TK,TKL,WPR,94,177,271,163,195,134,100,99,115,806,90,173,263,169,176,129,111,85,139,809,1615,2150,2150
Tokelau,2036,TK,TKL,WPR,95,178,273,160,201,137,101,100,121,820,90,174,264,167,178,134,108,90,135,812,1632,2168,2168
Tokelau,2037,TK,TKL,WPR,95,180,275,158,206,138,103,102,122,829,90,175,265,167,179,138,107,97,136,824,1653,2189,2189
Tokelau,2038,TK,TKL,WPR,95,182,277,159,208,139,106,103,126,841,91,176,267,168,177,144,107,102,135,833,1674,2213,2213
Tokelau,2039,TK,TKL,WPR,95,183,278,163,206,141,108,102,126,846,91,177,268,168,176,150,109,104,133,840,1686,2233,2233
Tokelau,2040,TK,TKL,WPR,95,184,279,168,199,146,109,101,132,855,91,178,269,168,176,154,113,104,133,848,1703,2253,2253
Tokelau,2041,TK,TKL,WPR,95,185,280,172,191,152,112,102,137,866,91,179,270,169,176,156,116,106,139,862,1728,2276,2276
Tokelau,2042,TK,TKL,WPR,95,186,281,174,183,162,116,103,138,876,90,180,270,168,175,160,118,109,142,872,1748,2297,2297
Tokelau,2043,TK,TKL,WPR,94,187,281,174,175,174,122,100,142,887,90,180,270,169,172,166,118,110,145,880,1767,2317,2317
Tokelau,2044,TK,TKL,WPR,93,188,281,175,167,185,128,96,147,898,90,180,270,171,169,170,122,108,150,890,1788,2337,2337
Tokelau,2045,TK,TKL,WPR,92,189,281,176,161,194,130,95,146,902,90,180,270,173,167,172,128,106,155,901,1803,2351,2351
Tokelau,2046,TK,TKL,WPR,91,190,281,177,159,201,132,94,144,907,90,180,270,174,166,174,133,104,158,909,1816,2364,2364
Tokelau,2047,TK,TKL,WPR,90,190,280,179,158,206,134,95,148,920,89,180,269,175,166,174,137,103,162,917,1837,2383,2383
Tokelau,2048,TK,TKL,WPR,90,189,279,181,159,208,136,97,151,932,88,180,268,176,166,172,143,104,162,923,1855,2400,2400
Tokelau,2049,TK,TKL,WPR,90,188,278,182,162,205,138,99,155,941,87,180,267,176,166,170,147,107,165,931,1872,2414,2414
Tokelau,2050,TK,TKL,WPR,90,187,277,183,166,197,143,102,157,948,86,180,266,177,166,170,150,110,168,941,1889,2430,2430
Turkmenistan,1970,TM,TKM,EUR,184232,311538,495770,172360,138006,124296,57511,48597,41862,582632,178533,307663,486196,171156,132411,124917,78971,72536,56846,636837,1219469,2201432,2201432
Turkmenistan,1971,TM,TKM,EUR,185674,322215,507889,186032,134726,128748,62075,47876,42568,602025,179784,317795,497579,185438,129350,128103,82499,72696,58856,656942,1258967,2264434,2264434
Turkmenistan,1972,TM,TKM,EUR,187716,331310,519026,200477,131203,132783,68334,46929,43201,622927,181618,326340,507958,200371,126120,131412,87608,72203,60752,678466,1301393,2328374,2328374
Turkmenistan,1973,TM,TKM,EUR,190378,338813,529191,215455,128261,136324,75603,45900,43795,645338,184056,333314,517370,215660,123591,134623,93598,71269,62683,701424,1346762,2393323,2393323
Turkmenistan,1974,TM,TKM,EUR,193721,344887,538608,229769,128214,138899,82788,44987,44420,669077,187153,338861,526014,230100,124069,136998,99314,70295,64848,725624,1394701,2459325,2459325
Turkmenistan,1975,TM,TKM,EUR,197544,349812,547356,243271,131413,140243,89380,44378,45023,693708,190719,343272,533991,243419,128050,138157,104270,69548,67256,750700,1444408,2525760,2525760
Turkmenistan,1976,TM,TKM,EUR,201719,353968,555687,257055,136172,140681,95400,44004,45604,718916,194624,346922,541546,256729,133782,138436,108468,68888,69839,776142,1495058,2592280,2592280
Turkmenistan,1977,TM,TKM,EUR,206294,357622,563916,270801,142410,140515,100776,43733,46206,744441,198915,350061,548976,269958,140942,138161,111764,68245,72608,801678,1546119,2659019,2659019
Turkmenistan,1978,TM,TKM,EUR,211108,361177,572285,284038,150414,139438,105566,43938,46753,770147,203427,353121,556548,282654,149797,137051,114403,68046,75398,827349,1597496,2726327,2726327
Turkmenistan,1979,TM,TKM,EUR,216016,365136,581152,296427,159928,137064,110016,45254,47057,795746,208022,356591,564613,294471,160110,134698,117000,68870,77737,852886,1648632,2794392,2794392
Turkmenistan,1980,TM,TKM,EUR,220511,369757,590268,307863,171105,132896,113610,47750,47101,820325,212649,360975,573624,306126,172226,130679,119277,70933,79453,878694,1699019,2862903,2862903
Turkmenistan,1981,TM,TKM,EUR,224806,375356,600162,317838,183977,127599,116044,51433,46912,843803,217493,366629,584122,317277,186150,125688,120907,74299,80536,904857,1748660,2932934,2932934
Turkmenistan,1982,TM,TKM,EUR,229875,381831,611706,325890,197773,122712,117793,56331,46423,866922,223127,373425,596552,326523,200931,121202,122303,78851,80978,930788,1797710,3005972,3005972
Turkmenistan,1983,TM,TKM,EUR,236076,388381,624457,332464,212088,119250,118833,61796,45785,890216,230017,381093,611110,333699,216160,118257,123341,83849,81116,956422,1846638,3082202,3082202
Turkmenistan,1984,TM,TKM,EUR,243558,394560,638118,338063,226324,118622,119001,67025,45208,914243,238289,389594,627883,338882,231285,118282,123593,88427,81451,981920,1896163,3162165,3162165
Turkmenistan,1985,TM,TKM,EUR,252237,400868,653105,342915,240454,120882,118369,71637,44805,939062,248047,398933,646980,342618,246328,121396,123005,92258,82128,1007733,1946795,3246887,3246887
Turkmenistan,1986,TM,TKM,EUR,262046,408255,670301,346711,254713,125304,117067,75599,44584,963978,259303,408902,668205,345682,261641,126907,121666,95313,83078,1034287,1998265,3336773,3336773
Turkmenistan,1987,TM,TKM,EUR,272259,417177,689436,349663,268565,132153,114923,78746,44581,988631,271054,419611,690665,348739,276879,135079,119369,97411,84289,1061766,2050397,3430501,3430501
Turkmenistan,1988,TM,TKM,EUR,281139,427161,708300,353170,281345,141638,111584,80994,44912,1013643,281574,431446,713020,352291,291512,146134,115925,98470,85819,1090151,2103794,3525110,3525110
Turkmenistan,1989,TM,TKM,EUR,290230,438668,728898,357823,291947,153225,108215,83009,45779,1039998,289920,444089,734009,356087,303947,159294,112488,99066,87518,1118400,2158398,3621303,3621303
Turkmenistan,1990,TM,TKM,EUR,298567,452483,751050,363799,300587,166001,105769,85068,47384,1068608,295009,457888,752897,360843,314167,173437,110037,99751,89494,1147729,2216337,3720278,3720278
Turkmenistan,1991,TM,TKM,EUR,303461,468166,771627,371189,308394,179494,104067,87002,49752,1099898,296683,473430,770113,367638,323236,188067,108466,100694,92047,1180148,2280046,3821782,3821782
Turkmenistan,1992,TM,TKM,EUR,306520,485087,791607,378803,316004,193364,103420,88918,52687,1133196,296720,490176,786896,375785,330891,202938,107977,102070,95011,1214672,2347868,3926369,3926369
Turkmenistan,1993,TM,TKM,EUR,308773,502120,810893,385666,323729,207353,104069,90679,55934,1167430,296182,507067,803249,384669,336859,217895,108834,103678,98187,1250122,2417552,4031698,4031698
Turkmenistan,1994,TM,TKM,EUR,308053,519969,828022,391742,331080,221419,106038,92200,59231,1201710,294188,523398,817586,394017,340983,232947,111174,105136,101459,1285716,2487426,4133037,4133037
Turkmenistan,1995,TM,TKM,EUR,304537,537623,842160,397533,337178,235216,109431,93336,62229,1234923,290869,538204,829073,403055,343659,247809,115202,106208,104526,1320459,2555382,4226623,4226623
Turkmenistan,1996,TM,TKM,EUR,299910,552755,852665,402683,339455,247407,114244,93641,64685,1262115,286474,550568,837042,409690,343886,261192,121084,106400,107023,1349275,2611390,4301093,4301093
Turkmenistan,1997,TM,TKM,EUR,293642,566102,859744,408844,339282,258242,120811,92885,66657,1286721,280492,561045,841537,415659,343109,273345,129207,105435,108920,1375675,2662396,4363672,4363672
Turkmenistan,1998,TM,TKM,EUR,286399,577860,864259,417703,340839,268613,129619,91183,68479,1316436,273571,569772,843343,424290,344082,285175,139887,103539,110510,1407483,2723919,4431517,4431517
Turkmenistan,1999,TM,TKM,EUR,279147,586629,865776,428656,344075,277834,140173,88810,70342,1349890,266626,575513,842139,435309,346192,296095,152476,101055,112143,1443270,2793160,4501079,4501079
Turkmenistan,2000,TM,TKM,EUR,272646,591209,863855,441800,348237,285414,151628,86480,72414,1385973,260362,577088,837450,448383,349211,305529,165908,98721,114102,1481854,2867827,4569132,4569132
Turkmenistan,2001,TM,TKM,EUR,266931,591613,858544,456896,353070,291437,163419,84789,74788,1424399,254825,574478,829303,463292,353436,313031,179482,97128,116470,1522839,2947238,4635094,4635094
Turkmenistan,2002,TM,TKM,EUR,261921,588706,850627,473358,357714,296656,175299,84020,77391,1464438,249925,568765,818690,479548,358505,318444,192987,96489,119235,1565208,3029646,4698968,4698968
Turkmenistan,2003,TM,TKM,EUR,258119,583673,841792,489539,361073,301419,187067,84344,79983,1503425,246143,561181,807324,495529,363687,321592,206336,97063,122242,1606449,3109874,4758988,4758988
Turkmenistan,2004,TM,TKM,EUR,256169,575612,831781,506634,364096,305941,198972,85869,82360,1543872,244119,552037,796156,511081,369758,323009,219820,99081,125231,1647980,3191852,4819792,4819792
Turkmenistan,2005,TM,TKM,EUR,256332,565721,822053,524262,368301,310090,210967,88763,84276,1586659,244116,542437,786553,525893,377012,323794,233405,102786,127622,1690512,3277171,4885775,4885775
Turkmenistan,2006,TM,TKM,EUR,258975,555946,814921,539718,374257,312817,222521,93236,85464,1628013,246461,532916,779377,538620,384463,324488,246566,108560,129021,1731718,3359731,4954029,4954029
Turkmenistan,2007,TM,TKM,EUR,264250,545492,809742,553453,382281,314448,233423,99349,85753,1668707,251314,522699,774013,549518,392441,325510,259140,116565,129259,1772433,3441140,5024894,5024894
Turkmenistan,2008,TM,TKM,EUR,271781,535164,806945,565380,391719,316614,243398,107056,85180,1709347,258305,512543,770848,558415,401669,327079,270888,126630,128269,1812950,3522297,5100083,5100083
Turkmenistan,2009,TM,TKM,EUR,281349,526573,807922,574256,402674,319861,252086,116122,84211,1749210,267204,504019,771223,564230,412639,329197,281492,138304,126735,1852597,3601807,5180957,5180957
Turkmenistan,2010,TM,TKM,EUR,292885,520700,813585,578975,415807,323970,259270,125984,83544,1787550,277943,498070,776013,565894,425647,332190,290660,150774,125659,1890824,3678374,5267970,5267970
Turkmenistan,2011,TM,TKM,EUR,305980,518039,824019,579538,430885,328720,265039,136233,83681,1824096,290145,495158,785303,563380,440486,336374,297958,163441,125756,1927395,3751491,5360811,5360811
Turkmenistan,2012,TM,TKM,EUR,320131,518664,838795,576780,447284,333249,270102,146693,84815,1858923,303358,495352,798710,557757,456623,341321,303222,176130,127195,1962248,3821171,5458682,5458682
Turkmenistan,2013,TM,TKM,EUR,334233,522757,856990,571976,463912,337075,275038,157267,86893,1892161,316576,498832,815408,550332,473034,346893,306531,188819,129931,1995540,3887701,5560095,5560095
Turkmenistan,2014,TM,TKM,EUR,346914,530665,877579,564142,481448,340659,279792,167967,89626,1923634,328513,505937,834450,541348,489044,353407,308201,201669,133814,2027483,3951117,5663152,5663152
Turkmenistan,2015,TM,TKM,EUR,356985,542481,899466,554386,498938,344859,283956,178629,93003,1953771,338030,516750,854780,531820,503712,360540,309045,214525,138780,2058422,4012193,5766431,5766431
Turkmenistan,2016,TM,TKM,EUR,363653,558263,921916,544758,514328,350807,286822,188936,97168,1982819,344361,531329,875690,522368,516340,367889,309827,226963,144740,2088127,4070946,5868561,5868561
Turkmenistan,2017,TM,TKM,EUR,366688,577687,944375,534475,528116,358873,288665,198654,101900,2010683,347250,549397,896647,512251,527258,375860,310965,238824,151517,2116675,4127358,5968383,5968383
Turkmenistan,2018,TM,TKM,EUR,366411,599266,965677,524319,540080,368284,290893,207377,106952,2037905,346967,569581,916548,502207,536185,385071,312626,249860,158981,2144930,4182835,6065066,6065066
Turkmenistan,2019,TM,TKM,EUR,363499,621428,984927,515888,548990,379146,294005,214797,112476,2065302,344172,590359,934531,493796,542039,395993,314803,259774,167254,2173659,4238961,6158420,6158420
Turkmenistan,2020,TM,TKM,EUR,358849,642988,1001837,510538,554198,392338,297948,220764,118529,2094315,339725,610614,950339,488349,544170,409100,317868,268224,176225,2203936,4298251,6250438,6250438
Turkmenistan,2021,TM,TKM,EUR,353308,662766,1016074,508729,555734,407666,302577,225570,125387,2125663,334434,629214,963648,486293,542581,424235,322178,274925,186273,2236485,4362148,6341855,6341855
Turkmenistan,2022,TM,TKM,EUR,347161,679993,1027154,510106,554008,424271,307034,229962,133317,2158698,328681,645404,974085,487277,537984,440707,327279,279862,197711,2270820,4429518,6430770,6430770
Turkmenistan,2023,TM,TKM,EUR,340603,693930,1034533,514847,550271,441086,310901,234358,142067,2193530,322666,658478,981144,491464,531676,457502,332992,283041,210221,2306896,4500426,6516100,6516100
Turkmenistan,2024,TM,TKM,EUR,334046,703876,1037922,523278,543586,458841,314665,238755,151435,2230560,316668,667808,984476,499158,523856,473947,339637,284761,223756,2345115,4575675,6598071,6598071
Turkmenistan,2025,TM,TKM,EUR,327705,709449,1037154,535496,535043,476578,319093,242731,161181,2270122,310868,673056,983924,510447,515528,489107,346907,285768,238013,2385770,4655892,6676966,6676966
Turkmenistan,2026,TM,TKM,EUR,321653,710705,1032358,551564,526624,492269,325177,245553,171000,2312187,305324,674276,979600,525389,507302,502303,354426,286792,252627,2428839,4741026,6752978,6752978
Turkmenistan,2027,TM,TKM,EUR,316253,707780,1024033,571178,517548,506415,333243,247440,180583,2356407,300327,671619,971946,543732,498404,513854,362597,288192,267224,2474003,4830410,6826380,6826380
Turkmenistan,2028,TM,TKM,EUR,311789,701182,1012971,592878,508581,518821,342622,249680,189559,2402141,296169,665537,961706,564111,489553,523478,372011,290107,281392,2520652,4922793,6897471,6897471
Turkmenistan,2029,TM,TKM,EUR,308282,691991,1000273,615117,501274,528301,353412,252700,197781,2448585,292907,656991,949898,585047,482280,530124,383126,292510,294938,2568025,5016610,6966778,6966778
Turkmenistan,2030,TM,TKM,EUR,305815,681219,987034,636661,496562,533824,366215,256353,205260,2494875,290620,646955,937575,605365,477473,532752,396239,295705,307732,2615266,5110141,7034758,7034758
Turkmenistan,1950,TM,TKM,EUR,72668,132824,205492,124653,61961,66957,57484,44885,33799,389739,68803,123466,192269,119768,80886,86271,61664,40952,37054,426595,816334,1214096,1214096
Turkmenistan,1951,TM,TKM,EUR,80319,128957,209276,128204,66165,65251,58474,43705,34798,396597,77142,119911,197053,121793,83695,85968,64203,40452,38203,434314,830911,1237242,1237242
Turkmenistan,1952,TM,TKM,EUR,88047,124900,212947,131497,72551,63337,59358,42421,35945,405109,85465,116282,201747,124207,88428,85000,66427,39983,39572,443617,848726,1263426,1263426
Turkmenistan,1953,TM,TKM,EUR,95862,121539,217401,134488,80339,61384,60112,41272,37053,414648,93718,113480,207198,126794,94333,83585,68470,39777,40962,453921,868569,1293173,1293173
Turkmenistan,1954,TM,TKM,EUR,102651,121381,224032,136737,88249,59640,60713,40586,37913,423838,100809,113959,214768,128810,100133,82131,70550,40173,42080,463877,887715,1326518,1326518
Turkmenistan,1955,TM,TKM,EUR,108584,124905,233489,137994,95689,58360,61125,40446,38429,432043,106759,118314,225073,129871,105302,80954,72699,41240,42820,472886,904929,1363507,1363507
Turkmenistan,1956,TM,TKM,EUR,115158,130376,245534,138602,102683,57463,61349,40831,38670,439598,113095,124786,237881,130320,109844,79901,74937,42989,43214,481205,920803,1404216,1404216
Turkmenistan,1957,TM,TKM,EUR,122415,137691,260106,138837,109138,56757,61427,41734,38639,446532,120084,133020,253104,130461,113583,78882,77274,45454,43280,488934,935466,1448678,1448678
Turkmenistan,1958,TM,TKM,EUR,130172,147079,277251,138277,115023,56700,61325,42942,38445,452712,127551,143222,270773,129901,116697,78373,79452,48343,43187,495953,948665,1496703,1496703
Turkmenistan,1959,TM,TKM,EUR,138340,158274,296614,136431,120515,58140,60892,44162,38238,458378,135404,155146,290550,128160,119786,79091,81035,51178,43154,502404,960782,1547947,1547947
Turkmenistan,1960,TM,TKM,EUR,146669,170900,317569,133565,125653,61265,60115,45238,38102,463938,143411,168439,311850,125499,123030,81203,81837,53784,43335,508688,972626,1602052,1602052
Turkmenistan,1961,TM,TKM,EUR,154807,184742,339549,130088,130253,66135,59052,46199,38020,469747,151223,182841,334064,122322,126262,84822,81948,56141,43715,515210,984957,1658569,1658569
Turkmenistan,1962,TM,TKM,EUR,162341,199381,361722,126330,134365,72881,57729,47039,37949,476293,158444,197920,356364,118964,129592,90124,81352,58192,44264,522488,998781,1716868,1716868
Turkmenistan,1963,TM,TKM,EUR,168878,214596,383474,123200,137949,80760,56303,47751,37958,483921,164681,213395,378076,116354,132828,96377,80257,60070,45031,530917,1014838,1776387,1776387
Turkmenistan,1964,TM,TKM,EUR,174133,229213,403346,123182,140588,88595,55004,48332,38118,493819,169658,228105,397763,116936,135265,102368,79085,61985,46054,541693,1035512,1836621,1836621
Turkmenistan,1965,TM,TKM,EUR,177989,243164,421153,126746,142080,95846,54076,48763,38431,505942,173264,241850,415114,121317,136568,107598,78134,63958,47314,554889,1060831,1897095,1897095
Turkmenistan,1966,TM,TKM,EUR,180515,257573,438088,132214,142791,102551,53447,49041,38920,518964,175565,255794,431359,127778,137126,112113,77272,66019,48838,569146,1088110,1957557,1957557
Turkmenistan,1967,TM,TKM,EUR,181975,272090,454065,139489,143052,108657,52969,49233,39573,532973,176818,269818,446636,135981,137279,115762,76438,68197,50697,584354,1117327,2018024,2018024
Turkmenistan,1968,TM,TKM,EUR,182772,286160,468932,148800,142503,114194,53070,49290,40343,548200,177430,283371,460801,146123,136709,118766,76073,70242,52735,600648,1148848,2078581,2078581
Turkmenistan,1969,TM,TKM,EUR,183377,299426,482803,159876,140727,119391,54525,49085,41121,564725,177856,296094,473950,157964,134993,121750,76860,71736,54779,618082,1182807,2139557,2139557
Turkmenistan,2031,TM,TKM,EUR,304408,669783,974191,656358,494916,535394,380829,260506,212235,2540238,289339,636296,925635,623954,475587,531333,411165,299992,319589,2661620,5201858,7101681,7101681
Turkmenistan,2032,TM,TKM,EUR,304278,658386,962664,673511,496388,533812,396652,264528,219209,2584100,289264,625704,914968,640136,476676,526912,427375,304959,330439,2706497,5290597,7168235,7168235
Turkmenistan,2033,TM,TKM,EUR,305426,647497,952923,687373,501165,530282,412675,268114,226574,2626183,290390,615644,906034,653201,480908,520773,443873,310481,340364,2749600,5375783,7234748,7234748
Turkmenistan,2034,TM,TKM,EUR,307554,637555,945109,697264,509583,523912,429598,271706,234279,2666342,292442,606489,898931,662531,488632,513147,460026,316865,349631,2790832,5457174,7301217,7301217
Turkmenistan,2035,TM,TKM,EUR,310510,628855,939365,702811,521745,515756,446492,275922,241810,2704536,295285,598500,893785,667790,499924,505013,474912,323848,358655,2830142,5534678,7367831,7367831
Turkmenistan,2036,TM,TKM,EUR,314129,621497,935626,704064,537709,507715,461415,281556,248365,2740824,298756,591763,890519,669033,514847,496978,487867,331091,367791,2867607,5608431,7434587,7434587
Turkmenistan,2037,TM,TKM,EUR,317858,616053,933911,701159,557171,499040,474862,288892,253921,2775045,302315,586770,889085,666417,533153,488278,499212,338982,377082,2903124,5678169,7501167,7501167
Turkmenistan,2038,TM,TKM,EUR,321389,612812,934201,694604,578689,490482,486666,297397,259276,2807114,305679,583806,889485,660377,553479,479627,508682,348075,386307,2936547,5743661,7567351,7567351
Turkmenistan,2039,TM,TKM,EUR,324579,611500,936079,685471,600725,483550,495704,307183,264669,2837302,308715,582657,891372,651889,574360,472528,515252,358791,395342,2968162,5805464,7632912,7632912
Turkmenistan,2040,TM,TKM,EUR,327181,612041,939222,674776,622070,479148,501021,318775,270026,2865816,311188,583266,894454,641910,594618,467879,517906,371423,404393,2998129,5863945,7697615,7697615
Turkmenistan,2041,TM,TKM,EUR,329308,614295,943603,663414,641579,477734,502635,331990,275475,2892827,313204,585498,898702,631303,613155,466111,516626,385802,413608,3026605,5919432,7761736,7761736
Turkmenistan,2042,TM,TKM,EUR,330952,617928,948880,652091,658576,479362,501288,346259,280931,2918507,314768,589015,903783,620765,629296,467283,512430,401377,422624,3053775,5972282,7824940,7824940
Turkmenistan,2043,TM,TKM,EUR,332073,622633,954706,641280,672306,484212,498103,360645,286470,2943016,315828,593540,909368,610756,642333,471570,506554,417177,431398,3079788,6022804,7886878,7886878
Turkmenistan,2044,TM,TKM,EUR,332668,627984,960652,631408,682114,492621,492285,375825,292443,2966696,316387,598659,915046,601650,651651,479299,499227,432629,440521,3104977,6071673,7947372,7947372
Turkmenistan,2045,TM,TKM,EUR,332580,633570,966150,622774,687630,504686,484824,390970,298939,2989823,316274,604004,920278,593705,656924,490572,491409,446855,450160,3129625,6119448,8005874,8005874
Turkmenistan,2046,TM,TKM,EUR,331628,639339,970967,615478,688910,520463,477463,404291,305962,3012567,315331,609511,924842,587006,658203,505436,483682,459212,460367,3153906,6166473,8062292,8062292
Turkmenistan,2047,TM,TKM,EUR,329887,644745,974632,610087,686088,539640,469522,416274,313701,3035312,313629,614656,928285,582053,655640,523645,475310,470043,471515,3178206,6213518,8116436,8116436
Turkmenistan,2048,TM,TKM,EUR,327443,649428,976871,606894,679669,560819,461722,426791,322321,3058216,311253,619106,930359,579120,649679,543857,466999,479117,483922,3202694,6260910,8168136,8168136
Turkmenistan,2049,TM,TKM,EUR,324363,653260,977623,605617,670705,582501,455486,434870,332134,3081313,308269,622727,930996,577998,641281,564609,460215,485454,497819,3227376,6308689,8217307,8217307
Turkmenistan,2050,TM,TKM,EUR,320885,655822,976707,606187,660201,603500,451668,439693,343469,3104718,304909,625118,930027,578628,631400,584750,455834,488121,513658,3252391,6357109,8263833,8263833
Timor-Leste,2002,TL,TLS,SEA,77009,126120,203129,83579,63637,47602,33040,20610,15088,263556,71621,117665,189286,81151,59043,47323,32140,19324,14688,253669,517225,909639,909639
Timor-Leste,2003,TL,TLS,SEA,78748,128712,207460,86281,63204,47937,33638,20733,15854,267647,73138,119638,192776,84326,59242,47431,33052,19424,15358,258833,526480,926721,926721
Timor-Leste,2004,TL,TLS,SEA,80570,131283,211853,89416,62765,48627,34096,21248,16740,272892,74800,121788,196588,87520,59537,47526,33823,20032,16210,264648,537540,945989,945989
Timor-Leste,2005,TL,TLS,SEA,82408,133881,216289,93095,62621,49820,34409,22684,17751,280380,76587,124315,200902,90764,59910,47681,34218,21828,17346,271747,552127,969313,969313
Timor-Leste,2006,TL,TLS,SEA,83777,136794,220571,96920,62900,51210,34561,24630,18917,289138,77981,127235,205216,94026,60518,47938,34142,24291,18728,279643,568781,994564,994564
Timor-Leste,2007,TL,TLS,SEA,84368,140158,224526,100576,63658,52477,34650,26435,20234,298030,78604,130437,209041,97260,61541,48281,33768,26617,20291,287758,585788,1019362,1019362
Timor-Leste,2008,TL,TLS,SEA,84035,143877,227912,104034,65008,53484,34847,27861,21735,306969,78303,133779,212082,100514,63060,48647,33293,28493,22111,296118,603087,1043076,1043076
Timor-Leste,2009,TL,TLS,SEA,82797,147923,230720,107227,66980,54151,35288,28739,23501,315886,77064,137228,214292,103737,65106,48969,32896,29652,24291,304651,620537,1065540,1065540
Timor-Leste,2010,TL,TLS,SEA,81613,152137,233750,110082,69360,54627,36168,28986,25373,324596,75898,140909,216807,106814,67582,49374,33020,29901,26651,313342,637938,1088486,1088486
Timor-Leste,2011,TL,TLS,SEA,81214,155947,237161,112834,71840,55135,37522,28871,26933,333135,75626,144660,220286,109786,70361,50079,33944,29561,28661,322392,655527,1112976,1112976
Timor-Leste,2012,TL,TLS,SEA,81158,158912,240070,115856,74434,55655,39017,28841,28211,342014,75705,147911,223616,112882,73403,50954,35184,29253,30301,331977,673991,1137676,1137676
Timor-Leste,2013,TL,TLS,SEA,81021,160893,241914,119375,77217,56050,40474,29005,29449,351570,75585,150206,225791,116362,76686,51813,36380,29143,31886,342270,693840,1161555,1161555
Timor-Leste,2014,TL,TLS,SEA,80724,162154,242878,123422,80095,56308,41934,29317,30678,361754,75192,151667,226859,120368,80148,52641,37604,29143,33442,353346,715100,1184830,1184830
Timor-Leste,2015,TL,TLS,SEA,80647,162848,243495,127597,83033,56470,43451,29434,31479,371464,75080,152271,227351,124118,83475,53411,38958,28900,34635,363497,734961,1205813,1205813
Timor-Leste,2016,TL,TLS,SEA,80808,162987,243795,131747,86019,56704,45013,29375,31856,380714,75345,152182,227527,127390,86582,54243,40414,28487,35413,372529,753243,1224562,1224562
Timor-Leste,2017,TL,TLS,SEA,80947,162724,243671,135940,89013,57234,46490,29507,32173,390357,75620,151794,227414,130633,89613,55338,41823,28307,36073,381787,772144,1243235,1243235
Timor-Leste,2018,TL,TLS,SEA,81185,161972,243157,140088,92025,58212,47766,29866,32406,400363,76016,151058,227074,133778,92554,56822,43102,28409,36582,391247,791610,1261845,1261845
Timor-Leste,2019,TL,TLS,SEA,81247,161058,242305,144163,95064,59679,48764,30474,32567,410711,76279,150202,226481,136846,95414,58741,44211,28781,36952,400945,811656,1280438,1280438
Timor-Leste,2020,TL,TLS,SEA,81095,160319,241414,148134,98284,61682,49511,31305,32638,421554,76250,149618,225868,139892,98337,61144,45173,29408,37204,411158,832712,1299995,1299995
Timor-Leste,2021,TL,TLS,SEA,81081,159687,240768,151841,101855,64192,50103,32306,32538,432835,76229,149217,225446,142842,101483,63997,46065,30233,37282,421902,854737,1320942,1320942
Timor-Leste,2022,TL,TLS,SEA,81199,159179,240378,154642,105501,66951,50541,33437,32501,443573,76342,148869,225211,145119,104544,67057,46880,31196,37330,432126,875699,1341296,1341296
Timor-Leste,2023,TL,TLS,SEA,81396,158901,240297,156307,109223,69806,50841,34697,32655,453529,76534,148694,225228,146448,107524,70169,47637,32305,37470,441553,895082,1360596,1360596
Timor-Leste,2024,TL,TLS,SEA,81659,158869,240528,157193,113223,72764,51079,36052,32840,463151,76792,148746,225538,147076,110707,73353,48386,33542,37605,450669,913820,1379883,1379883
Timor-Leste,2025,TL,TLS,SEA,81914,158988,240902,157633,117354,75780,51301,37490,33075,472633,77045,148940,225985,147260,114023,76559,49162,34891,37766,459661,932294,1399184,1399184
Timor-Leste,2026,TL,TLS,SEA,82148,159163,241311,157753,121577,78828,51622,38950,33378,482108,77280,149206,226486,147157,117406,79745,50049,36291,37975,468623,950731,1418535,1418535
Timor-Leste,2027,TL,TLS,SEA,82346,159460,241806,157483,125814,81884,52229,40328,33748,491486,77477,149635,227112,146759,120739,82856,51192,37645,38275,477466,968952,1437870,1437870
Timor-Leste,2028,TL,TLS,SEA,82475,159966,242441,156735,129982,84951,53258,41517,34215,500658,77608,150293,227901,146018,123941,85873,52713,38877,38666,486088,986746,1457084,1457084
Timor-Leste,2029,TL,TLS,SEA,82549,160356,242905,155829,134044,88040,54756,42455,34801,509925,77689,150884,228573,145169,127042,88803,54658,39942,39151,494765,1004690,1476177,1476177
Timor-Leste,2030,TL,TLS,SEA,82514,160500,243014,155095,137847,91150,56690,43140,35532,519454,77669,151150,228819,144576,129950,91651,56993,40859,39757,503786,1023240,1495081,1495081
Timor-Leste,2031,TL,TLS,SEA,82364,160711,243075,154435,141143,94338,58986,43646,36381,528929,77535,151363,228898,144141,132504,94451,59654,41672,40476,512898,1041827,1513799,1513799
Timor-Leste,2032,TL,TLS,SEA,82106,161035,243141,153923,143705,97716,61564,44036,37321,538265,77299,151684,228983,143784,134547,97281,62557,42435,41289,521893,1060158,1532284,1532284
Timor-Leste,2033,TL,TLS,SEA,81738,161394,243132,153678,145380,101393,64332,44336,38379,547498,76961,152041,229002,143640,135900,100256,65609,43171,42228,530804,1078302,1550436,1550436
Timor-Leste,2034,TL,TLS,SEA,81288,161766,243054,153677,146290,105348,67196,44588,39534,556633,76540,152421,228961,143720,136567,103433,68729,43911,43295,539655,1096288,1568297,1568297
Timor-Leste,2035,TL,TLS,SEA,80791,162024,242815,153822,146759,109431,70119,44842,40805,565778,76069,152688,228757,143944,136790,106741,71873,44680,44489,548517,1114295,1585869,1585869
Timor-Leste,2036,TL,TLS,SEA,80215,162137,242352,154020,146915,113599,73067,45200,42137,574938,75525,152826,228351,144234,136729,110116,75000,45564,45798,557441,1132379,1603089,1603089
Timor-Leste,2037,TL,TLS,SEA,79547,162109,241656,154339,146680,117785,76026,45823,43460,584113,74891,152819,227710,144683,136374,113438,78052,46699,47161,566407,1150520,1619889,1619889
Timor-Leste,2038,TL,TLS,SEA,78849,161902,240751,154864,145977,121902,79002,46835,44700,593280,74234,152641,226875,145359,135673,116636,81020,48188,48513,575389,1168669,1636299,1636299
Timor-Leste,2039,TL,TLS,SEA,78129,161560,239689,155270,145116,125918,82007,48274,45826,602411,73558,152332,225890,145968,134865,119729,83912,50068,49818,584360,1186771,1652352,1652352
Timor-Leste,2040,TL,TLS,SEA,77409,161055,238464,155433,144421,129677,85032,50102,46854,611519,72882,151870,224752,146254,134315,122635,86720,52328,51099,593351,1204870,1668074,1668074
Timor-Leste,2041,TL,TLS,SEA,76707,160358,237065,155664,143796,132934,88138,52259,47812,620603,72222,151219,223441,146482,133908,125191,89488,54885,52391,602345,1222948,1683455,1683455
Timor-Leste,2042,TL,TLS,SEA,76052,159458,235510,156000,143316,135471,91431,54670,48751,629639,71603,150379,221982,146817,133584,127239,92285,57676,53730,611331,1240970,1698451,1698451
Timor-Leste,2043,TL,TLS,SEA,75449,158422,233871,156374,143094,137137,95016,57248,49697,638566,71036,149403,220439,147190,133465,128602,95229,60605,55150,620241,1258807,1713117,1713117
Timor-Leste,2044,TL,TLS,SEA,74903,157278,232181,156757,143112,138047,98867,59905,50697,647385,70516,148327,218843,147580,133567,129286,98366,63596,56685,629080,1276465,1727485,1727485
Timor-Leste,2045,TL,TLS,SEA,74405,156086,230491,157024,143277,138527,102839,62609,51769,656045,70043,147198,217241,147860,133804,129531,101636,66609,58351,637791,1293836,1741563,1741563
Timor-Leste,2046,TL,TLS,SEA,73938,154835,228773,157149,143490,138700,106898,65344,52966,664547,69593,146017,215610,148006,134108,129493,104968,69604,60191,646370,1310917,1755296,1755296
Timor-Leste,2047,TL,TLS,SEA,73521,153533,227054,157134,143815,138488,110970,68089,54374,672870,69195,144780,213975,148013,134573,129166,108246,72536,62270,654804,1327674,1768695,1768695
Timor-Leste,2048,TL,TLS,SEA,73156,152257,225413,156938,144351,137809,114977,70861,56017,680953,68844,143569,212413,147845,135260,128497,111404,75392,64631,663029,1343982,1781805,1781805
Timor-Leste,2049,TL,TLS,SEA,72779,151013,223792,156605,144769,136985,118886,73670,57904,688819,68482,142389,210871,147542,135875,127723,114459,78183,67274,671056,1359875,1794541,1794541
Timor-Leste,2050,TL,TLS,SEA,72370,149818,222188,156117,144943,136327,122542,76512,60012,696453,68090,141252,209342,147087,136170,127198,117330,80908,70189,678882,1375335,1806869,1806869
Tonga,1970,TO,TON,WPR,8032,13268,21300,8068,5256,4065,2840,1649,1276,23154,7462,12214,19676,7692,5227,3974,2571,1513,1373,22350,45504,86484,86484
Tonga,1971,TO,TON,WPR,7980,13618,21598,8276,5252,4099,2923,1698,1303,23551,7411,12555,19966,7870,5268,4037,2661,1547,1398,22781,46332,87904,87904
Tonga,1972,TO,TON,WPR,7876,13961,21837,8532,5236,4132,2997,1753,1329,23979,7310,12892,20202,8096,5296,4096,2751,1592,1429,23260,47239,89275,89275
Tonga,1973,TO,TON,WPR,7754,14267,22021,8826,5217,4161,3064,1811,1352,24431,7196,13190,20386,8355,5325,4147,2840,1643,1454,23764,48195,90611,90611
Tonga,1974,TO,TON,WPR,7701,14519,22220,9102,5221,4199,3139,1880,1393,24934,7131,13400,20531,8595,5385,4203,2937,1708,1488,24316,49250,92007,92007
Tonga,1975,TO,TON,WPR,7706,14752,22458,9375,5215,4255,3213,1958,1440,25456,7110,13548,20658,8829,5454,4269,3038,1778,1534,24902,50358,93477,93477
Tonga,1976,TO,TON,WPR,7703,14970,22673,9674,5200,4301,3276,2037,1496,25984,7098,13681,20779,9075,5502,4339,3139,1855,1576,25486,51470,94921,94921
Tonga,1977,TO,TON,WPR,7654,15006,22660,9928,5222,4308,3321,2114,1542,26435,7057,13697,20754,9298,5549,4392,3220,1925,1617,26001,52436,95847,95847
Tonga,1978,TO,TON,WPR,7576,14875,22451,10099,5290,4269,3349,2182,1573,26762,6988,13600,20588,9462,5615,4417,3285,1991,1660,26430,53192,96227,96227
Tonga,1979,TO,TON,WPR,7520,14733,22253,10221,5376,4218,3375,2245,1603,27038,6944,13472,20416,9586,5691,4424,3343,2050,1707,26801,53839,96506,96506
Tonga,1980,TO,TON,WPR,7476,14573,22049,10314,5460,4161,3400,2300,1639,27274,6911,13326,20237,9684,5774,4429,3394,2115,1752,27148,54422,96708,96708
Tonga,1981,TO,TON,WPR,7435,14409,21844,10410,5529,4101,3413,2346,1681,27480,6875,13174,20049,9777,5844,4432,3437,2179,1800,27469,54949,96846,96846
Tonga,1982,TO,TON,WPR,7400,14226,21626,10530,5570,4043,3415,2386,1726,27670,6845,13003,19848,9892,5898,4431,3478,2236,1849,27784,55454,96931,96931
Tonga,1983,TO,TON,WPR,7381,14016,21397,10685,5593,3975,3401,2423,1776,27853,6840,12797,19637,10039,5924,4422,3517,2288,1907,28097,55950,96981,96981
Tonga,1984,TO,TON,WPR,7389,13793,21182,10872,5588,3896,3372,2454,1834,28016,6860,12576,19436,10216,5931,4392,3548,2338,1967,28392,56408,97022,97022
Tonga,1985,TO,TON,WPR,7425,13577,21002,11087,5554,3801,3328,2473,1898,28141,6899,12370,19269,10399,5912,4350,3568,2388,2031,28648,56789,97055,97055
Tonga,1986,TO,TON,WPR,7458,13400,20858,11301,5495,3703,3276,2480,1964,28219,6939,12211,19150,10568,5871,4304,3573,2443,2085,28844,57063,97078,97078
Tonga,1987,TO,TON,WPR,7480,13273,20753,11459,5560,3673,3245,2493,2034,28464,6951,12127,19078,10665,5909,4318,3567,2500,2136,29095,57559,97392,97392
Tonga,1988,TO,TON,WPR,7474,13212,20686,11513,5759,3716,3236,2532,2079,28835,6917,12125,19042,10659,6028,4384,3560,2558,2181,29370,58205,97939,97939
Tonga,1989,TO,TON,WPR,7429,13226,20655,11463,5965,3775,3230,2576,2118,29127,6836,12179,19015,10577,6156,4449,3560,2612,2233,29587,58714,98379,98379
Tonga,1990,TO,TON,WPR,7368,13293,20661,11316,6191,3828,3234,2614,2155,29338,6725,12279,19004,10421,6297,4489,3573,2653,2294,29727,59065,98727,98727
Tonga,1991,TO,TON,WPR,7321,13378,20699,11107,6427,3875,3247,2643,2193,29492,6618,12375,18993,10239,6446,4502,3601,2676,2358,29822,59314,99010,99010
Tonga,1992,TO,TON,WPR,7288,13466,20754,10875,6660,3914,3253,2669,2249,29620,6539,12441,18980,10050,6600,4502,3637,2700,2414,29903,59523,99260,99260
Tonga,1993,TO,TON,WPR,7278,13524,20802,10678,6853,3968,3234,2691,2308,29732,6512,12457,18969,9891,6733,4498,3662,2725,2473,29982,59714,99492,99492
Tonga,1994,TO,TON,WPR,7304,13541,20845,10552,6991,4027,3198,2717,2372,29857,6552,12406,18958,9799,6819,4502,3667,2754,2533,30074,59931,99731,99731
Tonga,1995,TO,TON,WPR,7345,13528,20873,10496,7073,4079,3159,2738,2433,29978,6649,12302,18951,9776,6849,4521,3663,2775,2589,30173,60151,99977,99977
Tonga,1996,TO,TON,WPR,7368,13504,20872,10516,7111,4123,3128,2745,2500,30123,6741,12173,18914,9821,6846,4529,3666,2782,2642,30286,60409,100195,100195
Tonga,1997,TO,TON,WPR,7367,13426,20793,10583,7239,4192,3137,2731,2553,30435,6796,12054,18850,9896,6937,4561,3677,2793,2714,30578,61013,100658,100658
Tonga,1998,TO,TON,WPR,7359,13327,20686,10636,7451,4307,3182,2703,2584,30863,6808,11966,18774,9968,7124,4633,3705,2803,2790,31023,61886,101343,101343
Tonga,1999,TO,TON,WPR,7344,13267,20611,10672,7591,4448,3237,2684,2603,31235,6779,11938,18717,10035,7274,4705,3726,2820,2854,31414,62649,101982,101982
Tonga,2000,TO,TON,WPR,7331,13251,20582,10688,7658,4617,3285,2677,2631,31556,6736,11960,18696,10090,7372,4807,3736,2852,2908,31765,63321,102603,102603
Tonga,2001,TO,TON,WPR,7342,13262,20604,10672,7669,4822,3322,2677,2656,31818,6721,12016,18737,10105,7424,4929,3743,2884,2955,32040,63858,103210,103210
Tonga,2002,TO,TON,WPR,7378,13301,20679,10631,7637,5037,3363,2680,2690,32038,6747,12085,18832,10073,7434,5084,3750,2910,3007,32258,64296,103804,103804
Tonga,2003,TO,TON,WPR,7431,13373,20804,10569,7582,5245,3412,2668,2728,32204,6814,12162,18976,10013,7405,5250,3771,2921,3063,32423,64627,104410,104410
Tonga,2004,TO,TON,WPR,7495,13472,20967,10508,7503,5439,3484,2651,2774,32359,6894,12249,19143,9953,7353,5417,3812,2909,3120,32564,64923,105036,105036
Tonga,2005,TO,TON,WPR,7549,13580,21129,10479,7391,5615,3558,2640,2807,32490,6942,12363,19305,9926,7283,5565,3877,2889,3170,32710,65200,105633,105633
Tonga,2006,TO,TON,WPR,7590,13675,21265,10493,7268,5760,3638,2635,2832,32626,6975,12481,19456,9924,7217,5682,3938,2877,3204,32842,65468,106190,106190
Tonga,2007,TO,TON,WPR,7569,13707,21276,10473,7199,5876,3719,2660,2853,32780,6968,12549,19517,9921,7239,5786,3987,2895,3238,33066,65846,106638,106638
Tonga,2008,TO,TON,WPR,7459,13700,21159,10392,7188,5973,3806,2706,2845,32910,6906,12587,19493,9902,7344,5885,4026,2937,3274,33368,66278,106932,106932
Tonga,2009,TO,TON,WPR,7360,13699,21059,10305,7166,6011,3907,2773,2834,32996,6808,12627,19435,9878,7449,5978,4068,2992,3293,33658,66654,107144,107144
Tonga,2010,TO,TON,WPR,7368,13628,20996,10280,7111,5985,4036,2819,2839,33070,6746,12606,19352,9898,7553,6047,4116,3025,3319,33958,67028,107383,107383
Tonga,2011,TO,TON,WPR,7415,13557,20972,10275,7040,5893,4191,2830,2882,33111,6749,12535,19284,9917,7656,6051,4205,3026,3391,34246,67357,107611,107611
Tonga,2012,TO,TON,WPR,7355,13501,20856,10215,6984,5791,4337,2827,2909,33063,6717,12494,19211,9871,7697,6032,4316,3017,3441,34374,67437,107502,107502
Tonga,2013,TO,TON,WPR,7257,13373,20630,10135,6926,5707,4461,2839,2910,32978,6640,12464,19104,9811,7643,6003,4423,3026,3472,34378,67356,107089,107089
Tonga,2014,TO,TON,WPR,7178,13236,20414,10071,6815,5606,4596,2873,2900,32861,6593,12403,18996,9754,7556,5965,4543,3066,3480,34364,67225,106626,106626
Tonga,2015,TO,TON,WPR,7017,13172,20189,10038,6667,5510,4712,2917,2887,32731,6552,12275,18827,9733,7488,5923,4636,3128,3470,34378,67109,106122,106122
Tonga,2016,TO,TON,WPR,6848,13107,19955,10031,6571,5415,4817,2951,2881,32666,6468,12161,18629,9750,7447,5901,4717,3176,3474,34465,67131,105707,105707
Tonga,2017,TO,TON,WPR,6748,12980,19728,10006,6546,5362,4880,2993,2869,32656,6346,12102,18448,9771,7397,5912,4810,3193,3498,34581,67237,105415,105415
Tonga,2018,TO,TON,WPR,6646,12833,19479,9979,6542,5364,4913,3019,2876,32693,6194,12045,18239,9798,7339,5964,4898,3211,3536,34746,67439,105150,105150
Tonga,2019,TO,TON,WPR,6504,12732,19236,9984,6529,5350,4934,3061,2896,32754,6063,11942,18005,9838,7280,6056,4985,3236,3557,34952,67706,104951,104951
Tonga,2020,TO,TON,WPR,6377,12707,19084,10079,6582,5363,4903,3164,2912,33003,5958,11873,17831,9927,7303,6163,5055,3289,3596,35333,68336,105254,105254
Tonga,2021,TO,TON,WPR,6301,12675,18976,10294,6669,5415,4845,3310,2936,33469,5882,11847,17729,10069,7353,6293,5091,3398,3642,35846,69315,106017,106017
Tonga,2022,TO,TON,WPR,6261,12662,18923,10545,6755,5444,4780,3451,2950,33925,5835,11850,17685,10241,7371,6365,5126,3524,3688,36315,70240,106858,106858
Tonga,2023,TO,TON,WPR,6245,12723,18968,10752,6890,5438,4733,3578,2966,34357,5803,11868,17671,10409,7426,6370,5151,3667,3763,36786,71143,107773,107773
Tonga,2024,TO,TON,WPR,6233,12747,18980,10935,7072,5398,4689,3718,2996,34808,5787,11887,17674,10538,7509,6351,5163,3822,3844,37227,72035,108683,108683
Tonga,2025,TO,TON,WPR,6233,12633,18866,11188,7296,5354,4653,3853,3038,35382,5779,11859,17638,10628,7631,6360,5178,3960,3948,37705,73087,109596,109596
Tonga,2026,TO,TON,WPR,6235,12507,18742,11424,7528,5348,4608,3973,3089,35970,5780,11790,17570,10725,7774,6379,5216,4083,4048,38225,74195,110504,110504
Tonga,2027,TO,TON,WPR,6233,12489,18722,11555,7732,5385,4600,4043,3133,36448,5782,11713,17495,10849,7909,6376,5270,4203,4130,38737,75185,111401,111401
Tonga,2028,TO,TON,WPR,6242,12470,18712,11642,7941,5440,4635,4087,3186,36931,5787,11621,17408,10953,8048,6358,5358,4319,4219,39255,76186,112305,112305
Tonga,2029,TO,TON,WPR,6252,12409,18661,11751,8182,5486,4652,4116,3247,37434,5798,11545,17343,11000,8208,6338,5478,4429,4316,39769,77203,113213,113213
Tonga,2030,TO,TON,WPR,6266,12338,18604,11867,8423,5549,4670,4094,3354,37957,5812,11480,17292,11031,8353,6355,5590,4513,4421,40263,78220,114124,114124
Tonga,1950,TO,TON,WPR,4575,6854,11429,4844,3345,2237,1590,972,1041,14029,4271,6451,10722,4810,3166,2009,1452,971,1242,13650,27679,49830,49830
Tonga,1951,TO,TON,WPR,4732,7088,11820,4995,3460,2301,1623,991,1013,14383,4416,6652,11068,4949,3303,2076,1486,987,1212,14013,28396,51288,51288
Tonga,1952,TO,TON,WPR,4918,7318,12236,5154,3576,2369,1659,1016,987,14761,4589,6857,11446,5086,3447,2149,1522,1008,1185,14397,29158,52837,52837
Tonga,1953,TO,TON,WPR,5121,7550,12671,5318,3694,2444,1693,1044,963,15156,4782,7072,11854,5221,3594,2231,1555,1033,1162,14796,29952,54474,54474
Tonga,1954,TO,TON,WPR,5326,7807,13133,5491,3813,2520,1727,1077,944,15572,4976,7309,12285,5354,3743,2322,1587,1059,1144,15209,30781,56200,56200
Tonga,1955,TO,TON,WPR,5548,8079,13627,5669,3935,2607,1761,1109,923,16004,5182,7565,12747,5491,3894,2420,1623,1088,1124,15640,31644,58024,58024
Tonga,1956,TO,TON,WPR,5776,8371,14147,5851,4061,2702,1802,1144,910,16470,5396,7840,13236,5631,4044,2526,1659,1120,1112,16092,32562,59944,59944
Tonga,1957,TO,TON,WPR,6000,8663,14663,6009,4183,2807,1843,1181,907,16930,5600,8105,13705,5758,4180,2628,1693,1153,1106,16518,33448,61818,61818
Tonga,1958,TO,TON,WPR,6215,8948,15163,6147,4293,2917,1891,1220,917,17385,5794,8361,14155,5873,4297,2729,1730,1188,1112,16929,34314,63625,63625
Tonga,1959,TO,TON,WPR,6431,9248,15679,6287,4402,3032,1946,1258,935,17860,5987,8624,14611,5993,4410,2832,1770,1223,1117,17345,35205,65498,65498
Tonga,1960,TO,TON,WPR,6647,9562,16209,6431,4515,3150,2009,1292,955,18352,6180,8899,15079,6129,4517,2943,1817,1254,1130,17790,36142,67428,67428
Tonga,1961,TO,TON,WPR,6855,9887,16742,6584,4629,3266,2073,1325,984,18861,6369,9180,15549,6278,4616,3054,1872,1280,1144,18244,37105,69391,69391
Tonga,1962,TO,TON,WPR,7045,10242,17287,6732,4744,3384,2145,1357,1018,19380,6544,9487,16031,6414,4712,3168,1935,1304,1154,18687,38067,71388,71388
Tonga,1963,TO,TON,WPR,7224,10621,17845,6883,4859,3499,2224,1386,1051,19902,6707,9819,16526,6561,4801,3285,2004,1330,1187,19168,39070,73441,73441
Tonga,1964,TO,TON,WPR,7395,11004,18399,7058,4974,3613,2310,1416,1083,20454,6863,10154,17017,6731,4890,3403,2078,1356,1211,19669,40123,75544,75544
Tonga,1965,TO,TON,WPR,7552,11402,18954,7247,5090,3727,2402,1449,1126,21041,7004,10502,17506,6915,4973,3524,2153,1381,1246,20192,41233,77686,77686
Tonga,1966,TO,TON,WPR,7690,11786,19476,7439,5200,3844,2500,1486,1165,21634,7129,10837,17966,7106,5051,3635,2236,1408,1281,20717,42351,79794,79794
Tonga,1967,TO,TON,WPR,7834,12163,19997,7602,5263,3932,2595,1525,1203,22120,7266,11169,18435,7265,5113,3737,2314,1433,1311,21173,43293,81725,81725
Tonga,1968,TO,TON,WPR,7963,12539,20502,7734,5270,3982,2678,1565,1226,22455,7394,11521,18915,7395,5154,3823,2397,1455,1331,21555,44010,83430,83430
Tonga,1969,TO,TON,WPR,8028,12908,20936,7888,5265,4024,2765,1604,1251,22797,7458,11867,19325,7534,5190,3903,2480,1481,1352,21940,44737,84997,84997
Tonga,2031,TO,TON,WPR,6289,12296,18585,11919,8696,5608,4707,4046,3491,38467,5832,11427,17259,11063,8497,6356,5705,4553,4569,40743,79210,115046,115046
Tonga,2032,TO,TON,WPR,6322,12269,18591,11949,8977,5676,4727,3991,3612,38932,5863,11389,17252,11095,8675,6355,5767,4591,4721,41204,80136,115978,115978
Tonga,2033,TO,TON,WPR,6361,12258,18619,12006,9181,5806,4724,3953,3722,39392,5897,11368,17265,11116,8840,6413,5771,4615,4894,41649,81041,116920,116920
Tonga,2034,TO,TON,WPR,6402,12259,18661,12032,9366,5985,4685,3916,3853,39837,5934,11363,17297,11136,8973,6494,5755,4633,5085,42076,81913,117874,117874
Tonga,2035,TO,TON,WPR,6445,12271,18716,11920,9619,6205,4650,3896,3991,40281,5974,11370,17344,11110,9062,6620,5769,4656,5283,42500,82781,118833,118833
Tonga,2036,TO,TON,WPR,6482,12296,18778,11799,9851,6435,4646,3868,4110,40709,6010,11390,17400,11041,9160,6760,5786,4690,5453,42890,83599,119784,119784
Tonga,2037,TO,TON,WPR,6510,12331,18841,11783,9982,6638,4683,3865,4192,41143,6035,11422,17457,10970,9285,6896,5787,4747,5618,43303,84446,120733,120733
Tonga,2038,TO,TON,WPR,6523,12379,18902,11761,10065,6839,4740,3898,4254,41557,6047,11463,17510,10878,9390,7035,5772,4833,5786,43694,85251,121669,121669
Tonga,2039,TO,TON,WPR,6529,12430,18959,11703,10176,7078,4788,3919,4313,41977,6052,11513,17565,10802,9438,7191,5759,4951,5945,44086,86063,122590,122590
Tonga,2040,TO,TON,WPR,6527,12485,19012,11636,10295,7316,4851,3941,4362,42401,6051,11568,17619,10740,9468,7337,5777,5062,6082,44466,86867,123504,123504
Tonga,2041,TO,TON,WPR,6520,12546,19066,11593,10346,7582,4907,3974,4410,42812,6042,11623,17665,10688,9505,7479,5785,5171,6222,44850,87662,124398,124398
Tonga,2042,TO,TON,WPR,6505,12608,19113,11566,10377,7858,4976,3997,4447,43221,6030,11677,17707,10653,9538,7655,5786,5234,6364,45230,88451,125270,125270
Tonga,2043,TO,TON,WPR,6485,12662,19147,11559,10435,8058,5102,3992,4485,43631,6009,11728,17737,10634,9557,7819,5841,5238,6509,45598,89229,126117,126117
Tonga,2044,TO,TON,WPR,6457,12709,19166,11562,10460,8240,5277,3965,4542,44046,5985,11771,17756,10627,9580,7948,5921,5226,6663,45965,90011,126936,126936
Tonga,2045,TO,TON,WPR,6419,12752,19171,11573,10356,8486,5490,3938,4613,44456,5949,11805,17754,10634,9553,8041,6046,5242,6821,46337,90793,127727,127727
Tonga,2046,TO,TON,WPR,6378,12778,19156,11600,10238,8714,5707,3942,4670,44871,5909,11835,17744,10657,9489,8137,6186,5265,6979,46713,91584,128483,128483
Tonga,2047,TO,TON,WPR,6327,12790,19117,11635,10222,8843,5903,3983,4711,45297,5865,11849,17714,10686,9419,8262,6318,5268,7129,47082,92379,129214,129214
Tonga,2048,TO,TON,WPR,6278,12788,19066,11681,10202,8930,6101,4041,4769,45724,5818,11844,17662,10732,9326,8367,6458,5259,7315,47457,93181,129913,129913
Tonga,2049,TO,TON,WPR,6228,12764,18992,11737,10146,9042,6333,4087,4812,46157,5770,11822,17592,10783,9255,8417,6611,5250,7513,47829,93986,130583,130583
Tonga,2050,TO,TON,WPR,6174,12728,18902,11793,10081,9156,6560,4150,4857,46597,5722,11787,17509,10836,9194,8450,6755,5276,7699,48210,94807,131225,131225
Trinidad and Tobago,1970,TT,TTO,AMR,64369,139105,203474,100535,57660,43384,38145,26133,17821,283678,64078,137623,201701,102106,60305,47564,38207,27023,24832,300037,583715,988890,988890
Trinidad and Tobago,1971,TT,TTO,AMR,63380,138787,202167,104275,60057,43439,38090,26660,18214,290735,62518,137390,199908,105999,62429,47680,38730,27225,25256,307319,598054,1000130,1000130
Trinidad and Tobago,1972,TT,TTO,AMR,63699,138102,201801,107441,62810,43642,37981,27201,18627,297702,62216,136753,198969,109385,64946,47839,39224,27520,25643,314557,612259,1013031,1013031
Trinidad and Tobago,1973,TT,TTO,AMR,64725,136948,201673,110311,65845,43999,37802,27753,19039,304749,62921,135323,198244,112467,67788,48080,39676,27884,26015,321910,626659,1026563,1026563
Trinidad and Tobago,1974,TT,TTO,AMR,65978,135114,201092,113208,69133,44523,37603,28321,19556,312344,64037,133080,197117,115449,70951,48436,40097,28329,26476,329738,642082,1040291,1040291
Trinidad and Tobago,1975,TT,TTO,AMR,67229,132793,200022,116137,72647,45212,37446,28829,20150,320421,65165,130355,195520,118410,74406,48939,40454,28867,26984,338060,658481,1054017,1054017
Trinidad and Tobago,1976,TT,TTO,AMR,68316,130341,198657,119123,76299,46041,37341,29178,20657,328639,66129,127651,193780,121318,77986,49638,40760,29430,27485,346617,675256,1067696,1067696
Trinidad and Tobago,1977,TT,TTO,AMR,69197,127968,197165,122259,79950,47051,37308,29408,21173,337149,66911,125365,192276,123982,81591,50544,41052,29959,27976,355104,692253,1081693,1081693
Trinidad and Tobago,1978,TT,TTO,AMR,70240,125795,196035,125184,83594,48332,37365,29584,21797,345856,67868,123591,191459,125904,85387,51652,41356,30451,28475,363225,709081,1096569,1096569
Trinidad and Tobago,1979,TT,TTO,AMR,71866,124049,195915,127043,87396,49907,37453,29710,22453,353962,69414,122176,191590,126648,89542,53004,41655,30937,29051,370837,724799,1112310,1112310
Trinidad and Tobago,1980,TT,TTO,AMR,73983,123065,197048,127454,91161,51758,37495,29766,23058,360692,71457,120996,192453,126571,93591,54629,41836,31420,29615,377662,738354,1127852,1127852
Trinidad and Tobago,1981,TT,TTO,AMR,76329,123035,199364,126861,94329,53859,37527,29733,23622,365931,73730,120283,194013,126106,96949,56496,41885,31861,30087,383384,749315,1142695,1142695
Trinidad and Tobago,1982,TT,TTO,AMR,78619,123872,202491,125766,96810,56180,37631,29606,24105,370098,75949,120459,196408,125071,99685,58639,41921,32248,30580,388144,758242,1157140,1157140
Trinidad and Tobago,1983,TT,TTO,AMR,80415,125471,205886,124227,99018,58720,37864,29429,24550,373808,77714,121715,199429,123270,102131,61048,42033,32585,31092,392159,765967,1171273,1171273
Trinidad and Tobago,1984,TT,TTO,AMR,81360,127855,209215,122096,101273,61464,38234,29232,24969,377268,78678,123923,202601,120766,104493,63730,42240,32870,31564,395663,772931,1184747,1184747
Trinidad and Tobago,1985,TT,TTO,AMR,81746,130996,212742,119793,103734,64501,38808,29104,25327,381267,79116,126882,205998,118099,107035,66779,42651,33137,32081,399782,781049,1199785,1199785
Trinidad and Tobago,1986,TT,TTO,AMR,81576,134486,216062,117629,106436,67768,39586,29112,25699,386230,79032,130176,209208,115711,109698,70029,43325,33427,32679,404869,791099,1216370,1216370
Trinidad and Tobago,1987,TT,TTO,AMR,80475,137742,218217,115542,109268,71016,40529,29180,26040,391575,78036,133272,211308,113709,112114,73297,44180,33718,33327,410345,801920,1231442,1231442
Trinidad and Tobago,1988,TT,TTO,AMR,78557,140708,219265,113653,111880,74242,41700,29295,26326,397096,76221,136119,212340,112185,113822,76755,45213,34015,33941,415931,813027,1244633,1244633
Trinidad and Tobago,1989,TT,TTO,AMR,76036,143466,219502,112234,113540,77665,43146,29443,26610,402638,73794,138811,212605,111037,114502,80584,46487,34307,34544,421461,824099,1256210,1256210
Trinidad and Tobago,1990,TT,TTO,AMR,72888,146128,219016,111689,114046,81155,44896,29596,26896,408278,70748,141446,212194,110258,114639,84400,48058,34530,35143,427028,835306,1266518,1266518
Trinidad and Tobago,1991,TT,TTO,AMR,69318,148496,217814,112227,113918,84240,46947,29810,27211,414353,67279,143813,211092,110119,114674,87721,49944,34717,35795,432970,847323,1276224,1276224
Trinidad and Tobago,1992,TT,TTO,AMR,65872,150043,215915,113676,113514,86827,49247,30118,27472,420854,63926,145391,209317,110949,114298,90613,52140,34948,36466,439414,860268,1285502,1285502
Trinidad and Tobago,1993,TT,TTO,AMR,62720,150398,213118,115853,112736,89248,51776,30541,27703,427857,60872,145798,206670,112819,113240,93310,54603,35253,37104,446329,874186,1293974,1293974
Trinidad and Tobago,1994,TT,TTO,AMR,59930,149355,209285,118754,111382,91738,54482,31070,27894,435320,58144,144843,202987,115559,111516,95971,57339,35656,37754,453795,889115,1301393,1301393
Trinidad and Tobago,1995,TT,TTO,AMR,57515,146997,204512,122120,109656,94265,57356,31727,28098,443222,55748,142627,198375,118756,109426,98629,60313,36179,38408,461711,904933,1307822,1307822
Trinidad and Tobago,1996,TT,TTO,AMR,55364,143530,198894,125601,107884,96865,60345,32498,28356,451549,53592,139332,192924,122066,107416,101251,63380,36878,39076,470067,921616,1313434,1313434
Trinidad and Tobago,1997,TT,TTO,AMR,53416,139283,192699,128889,106215,99622,63321,33409,28606,460062,51641,135275,186916,125211,105799,103648,66468,37723,39639,478488,938550,1318171,1318171
Trinidad and Tobago,1998,TT,TTO,AMR,51792,134562,186354,131931,104741,102186,66298,34523,28910,468589,50021,130731,180752,128150,104639,105392,69755,38736,40207,486879,955468,1322572,1322572
Trinidad and Tobago,1999,TT,TTO,AMR,50651,129645,180296,134802,103704,103849,69458,35852,29182,476847,48890,125954,174844,130968,103816,106180,73404,39957,40755,495080,971927,1327063,1327063
Trinidad and Tobago,2000,TT,TTO,AMR,49994,124527,174521,137599,103487,104479,72679,37428,29477,485149,48246,120932,169178,133759,103343,106503,77033,41440,41283,503361,988510,1332203,1332203
Trinidad and Tobago,2001,TT,TTO,AMR,49724,119306,169030,140130,104296,104564,75535,39261,29874,493660,47986,115796,163782,136318,103505,106786,80238,43241,41994,512082,1005742,1338567,1338567
Trinidad and Tobago,2002,TT,TTO,AMR,49694,114440,164134,141894,105956,104438,77970,41331,30408,501997,47962,111010,158972,138134,104614,106709,83102,45364,42940,520863,1022860,1345964,1345964
Trinidad and Tobago,2003,TT,TTO,AMR,49805,110178,159983,142531,108293,103968,80271,43581,31011,509655,48064,106829,154893,138835,106711,105981,85812,47730,43940,529009,1038664,1353548,1353548
Trinidad and Tobago,2004,TT,TTO,AMR,49913,106700,156613,141843,111325,102974,82679,45995,31738,516554,48161,103407,151568,138241,109636,104641,88508,50356,45051,536433,1052987,1361172,1361172
Trinidad and Tobago,2005,TT,TTO,AMR,49996,104007,154003,139920,114807,101661,85165,48573,32664,522790,48236,100729,148965,136450,113005,102978,91249,53240,46399,543321,1066111,1369075,1369075
Trinidad and Tobago,2006,TT,TTO,AMR,50192,101888,152080,136943,118402,100314,87744,51255,33723,528381,48406,98606,147012,133623,116479,101388,93943,56201,47810,549444,1077825,1376919,1376919
Trinidad and Tobago,2007,TT,TTO,AMR,50571,100152,150723,133224,121839,99078,90499,53952,34946,533538,48744,96865,145609,130061,119805,100176,96436,59206,49308,554992,1088530,1384861,1384861
Trinidad and Tobago,2008,TT,TTO,AMR,51040,98855,149895,129036,125049,98013,93073,56632,36298,538101,49172,95551,144723,126016,122959,99397,98325,62418,50977,560092,1098193,1392803,1392803
Trinidad and Tobago,2009,TT,TTO,AMR,51443,98020,149463,124639,128127,97360,94854,59524,37888,542392,49546,94702,144248,121723,126029,98930,99372,66027,53004,565085,1107477,1401191,1401191
Trinidad and Tobago,2010,TT,TTO,AMR,51784,97644,149428,120021,131152,97497,95717,62503,39736,546626,49864,94317,144181,117170,129080,98789,100019,69651,55343,570052,1116678,1410296,1410296
Trinidad and Tobago,2011,TT,TTO,AMR,52047,97774,149821,115272,133914,98585,96073,65149,41815,550808,50122,94423,144545,112465,131894,99240,100583,72823,57834,574839,1125647,1420020,1420020
Trinidad and Tobago,2012,TT,TTO,AMR,52123,98336,150459,110853,135935,100461,96242,67450,44190,555131,50212,94935,145147,108070,133959,100585,100759,75657,60615,579645,1134776,1430377,1430377
Trinidad and Tobago,2013,TT,TTO,AMR,51989,99132,151121,106997,136876,102975,96098,69665,46811,559422,50104,95665,145769,104244,134932,102876,100316,78358,63693,584419,1143841,1440729,1440729
Trinidad and Tobago,2014,TT,TTO,AMR,51750,99847,151597,103888,136535,106156,95463,71987,49604,563633,49886,96323,146209,101142,134650,105969,99296,81060,67103,589220,1152853,1450661,1450661
Trinidad and Tobago,2015,TT,TTO,AMR,51384,100467,151851,101503,134971,109763,94542,74400,52572,567751,49542,96901,146443,98753,133199,109509,97993,83823,70854,594131,1161882,1460177,1460177
Trinidad and Tobago,2016,TT,TTO,AMR,50805,101123,151928,99687,132404,113518,93616,76906,55667,571798,48983,97519,146502,96917,130775,113201,96800,86595,74814,599102,1170900,1469330,1469330
Trinidad and Tobago,2017,TT,TTO,AMR,50063,101776,151839,98439,129325,117235,92838,79577,58794,576208,48268,98130,146398,95560,127730,116825,95989,89180,78882,604166,1180374,1478607,1478607
Trinidad and Tobago,2018,TT,TTO,AMR,49549,102684,152233,101096,129675,122684,93056,82463,62302,591276,47792,98945,146737,96517,126169,121196,95931,91344,83310,614467,1205743,1504709,1504709
Trinidad and Tobago,2019,TT,TTO,AMR,48874,103137,152011,101717,127662,127023,93189,84443,65852,599886,47146,99393,146539,96583,123265,125029,95948,92609,88091,621525,1221411,1519955,1519955
Trinidad and Tobago,2020,TT,TTO,AMR,47874,103028,150902,99267,121778,129534,93262,85238,69199,598278,46163,99346,145509,95160,118220,127996,95898,93330,92857,623461,1221739,1518147,1518147
Trinidad and Tobago,2021,TT,TTO,AMR,47002,102895,149897,99582,117948,132833,94645,85664,72227,602899,45321,99225,144546,95421,114072,131178,96560,93966,97131,628328,1231227,1525663,1525663
Trinidad and Tobago,2022,TT,TTO,AMR,46098,102344,148442,99922,113999,135195,96651,85832,75047,606646,44443,98716,143159,95854,109991,133491,98022,94183,101261,632802,1239448,1531044,1531044
Trinidad and Tobago,2023,TT,TTO,AMR,45154,101433,146587,100146,110150,136322,99198,85776,78223,609815,43523,97863,141386,96307,106217,134636,100380,93870,105729,637139,1246954,1534937,1534937
Trinidad and Tobago,2024,TT,TTO,AMR,44169,100420,144589,100358,106941,136212,102381,85302,81625,612819,42573,96896,139469,96722,103110,134534,103512,93016,110429,641323,1254142,1538200,1538200
Trinidad and Tobago,2025,TT,TTO,AMR,43251,99250,142501,100545,104375,134930,105988,84596,85215,615649,41689,95772,137461,97086,100651,133271,107072,91885,115364,645329,1260978,1540943,1540943
Trinidad and Tobago,2026,TT,TTO,AMR,42469,97801,140270,100839,102247,132646,109733,83919,88998,618382,40933,94376,135309,97517,98664,131010,110770,90857,120445,649263,1267645,1543223,1543223
Trinidad and Tobago,2027,TT,TTO,AMR,41783,96166,137949,101196,100373,129655,113370,83391,92990,620975,40273,92793,133066,97976,96985,128030,114365,90197,125488,653041,1274016,1545029,1545029
Trinidad and Tobago,2028,TT,TTO,AMR,41208,94407,135615,101513,98827,126187,116837,83047,96944,623355,39718,91085,130803,98369,95662,124550,117817,89924,130275,656597,1279952,1546363,1546363
Trinidad and Tobago,2029,TT,TTO,AMR,40722,92597,133319,101728,97634,122438,120172,83007,100477,625456,39250,89331,128581,98635,94728,120756,121174,89891,134688,659872,1285328,1547228,1547228
Trinidad and Tobago,2030,TT,TTO,AMR,40301,90828,131129,101781,96803,118358,123396,83561,103363,627262,38845,87618,126463,98723,94178,116609,124459,90100,138765,662834,1290096,1547690,1547690
Trinidad and Tobago,1950,TT,TTO,AMR,54301,76119,130420,52865,48902,40162,27200,14721,11196,195046,53995,75475,129470,56233,47570,37077,24531,13982,14294,193687,388733,648616,648616
Trinidad and Tobago,1951,TT,TTO,AMR,56510,79678,136188,53625,48933,40911,28098,14998,11054,197619,55915,78942,134857,56746,48371,37884,25339,14303,13973,196616,394235,665279,665279
Trinidad and Tobago,1952,TT,TTO,AMR,58648,83407,142055,54661,48947,41673,28973,15396,10917,200567,57742,82680,140422,57341,49253,38660,26171,14752,13576,199753,400320,682801,682801
Trinidad and Tobago,1953,TT,TTO,AMR,60796,87218,148014,56007,48965,42421,29846,15922,10843,204004,59592,86516,146108,58114,50161,39422,27038,15308,13190,203233,407237,701361,701361
Trinidad and Tobago,1954,TT,TTO,AMR,63081,91128,154209,57696,48982,43121,30726,16557,10852,207934,61482,90543,152025,59229,50997,40197,27953,15933,12975,207284,415218,721449,721449
Trinidad and Tobago,1955,TT,TTO,AMR,65231,95294,160525,59722,49023,43735,31607,17275,10919,212281,63320,94709,158029,60739,51711,40982,28874,16576,12864,211746,424027,742576,742576
Trinidad and Tobago,1956,TT,TTO,AMR,66819,99582,166401,62066,49100,44263,32477,18067,11020,216993,64809,98774,163583,62655,52311,41773,29809,17239,12870,216657,433650,763630,763630
Trinidad and Tobago,1957,TT,TTO,AMR,68037,103798,171835,64737,49216,44710,33320,18932,11172,222087,65939,102753,168692,64964,52815,42549,30753,17906,12973,221960,444047,784574,784574
Trinidad and Tobago,1958,TT,TTO,AMR,69176,107921,177097,67699,49410,45070,34150,19840,11384,227553,67007,106616,173623,67625,53258,43326,31691,18594,13178,227672,455225,805948,805948
Trinidad and Tobago,1959,TT,TTO,AMR,70073,112017,182090,70816,49725,45302,34933,20727,11657,233160,67844,110419,178263,70520,53639,44092,32583,19310,13482,233626,466786,827138,827138
Trinidad and Tobago,1960,TT,TTO,AMR,70784,115842,186626,73928,50139,45350,35619,21545,11996,238577,68508,113917,182425,73474,53959,44772,33364,20028,13839,239436,478013,847063,847063
Trinidad and Tobago,1961,TT,TTO,AMR,71800,118701,190501,76491,50596,45248,36169,22274,12481,243259,69620,116632,186252,76084,54174,45358,34042,20920,14429,245007,488266,865028,865028
Trinidad and Tobago,1962,TT,TTO,AMR,73000,120864,193864,78562,51091,45059,36627,22899,13071,247309,70959,118911,189870,78373,54341,45911,34620,21981,15256,250482,497791,881519,881519
Trinidad and Tobago,1963,TT,TTO,AMR,74021,123039,197060,80647,51685,44817,37057,23452,13677,251335,71913,121346,193259,80658,54601,46416,35122,23023,16178,255998,507333,897658,897658
Trinidad and Tobago,1964,TT,TTO,AMR,74710,125277,199987,82851,52373,44513,37442,23946,14314,255439,72379,123891,196270,83080,55034,46796,35587,23991,17216,261704,517143,913399,913399
Trinidad and Tobago,1965,TT,TTO,AMR,74747,127532,202279,85322,53114,44192,37763,24382,14959,259732,72276,126592,198868,85695,55629,47022,36056,24828,18355,267585,527317,928462,928462
Trinidad and Tobago,1966,TT,TTO,AMR,73816,130003,203819,87993,53847,43906,38003,24760,15612,264121,71551,129595,201146,88373,56350,47141,36520,25512,19609,273505,537626,942599,942599
Trinidad and Tobago,1967,TT,TTO,AMR,71919,132838,204757,90737,54566,43684,38154,25097,16258,268496,70200,132660,202860,91162,57161,47224,36968,26070,20981,279566,548062,955681,955681
Trinidad and Tobago,1968,TT,TTO,AMR,69394,135789,205183,93589,55314,43540,38207,25415,16861,272926,68380,135309,203689,94261,58000,47328,37384,26507,22426,285906,558832,967699,967699
Trinidad and Tobago,1969,TT,TTO,AMR,66632,138202,204834,96785,56132,43442,38188,25725,17393,277665,66262,137084,203346,97973,58889,47450,37773,26819,23893,292797,570462,978642,978642
Trinidad and Tobago,2031,TT,TTO,AMR,39936,89132,129068,101554,96402,114029,126307,84850,105626,628768,38490,85977,124467,98533,94051,112204,127455,90801,142449,665493,1294261,1547804,1547804
Trinidad and Tobago,2032,TT,TTO,AMR,39624,87519,127143,100970,96395,109887,128461,86758,107505,629976,38191,84415,122606,97994,94287,108020,129669,92277,145577,667824,1297800,1547540,1547540
Trinidad and Tobago,2033,TT,TTO,AMR,39361,86010,125371,100070,96644,106175,129584,89186,109176,630835,37938,82945,120883,97148,94748,104313,130805,94593,148190,669797,1300632,1546883,1546883
Trinidad and Tobago,2034,TT,TTO,AMR,39152,84547,123699,99067,96872,103088,129519,92194,110698,631438,37736,81534,119270,96188,95169,101264,130732,97632,150486,671471,1302909,1545880,1545880
Trinidad and Tobago,2035,TT,TTO,AMR,38981,83214,122195,97911,97081,100624,128338,95588,112192,631734,37571,80251,117822,95068,95536,98849,129528,101082,152739,672802,1304536,1544560,1544560
Trinidad and Tobago,2036,TT,TTO,AMR,38809,82073,120882,96474,97395,98581,126210,99126,113902,631688,37406,79146,116552,93675,95973,96905,127355,104669,155191,673768,1305456,1542899,1542899
Trinidad and Tobago,2037,TT,TTO,AMR,38637,81081,119718,94857,97768,96792,123412,102583,115952,631364,37239,78188,115427,92099,96437,95260,124484,108168,157951,674399,1305763,1540902,1540902
Trinidad and Tobago,2038,TT,TTO,AMR,38476,80250,118726,93115,98103,95318,120155,105882,118130,630703,37079,77387,114466,90403,96833,93974,121123,111533,160804,674670,1305373,1538563,1538563
Trinidad and Tobago,2039,TT,TTO,AMR,38312,79563,117875,91322,98337,94189,116633,109048,120236,629765,36912,76724,113636,88657,97105,93071,117462,114796,163525,674616,1304381,1535893,1535893
Trinidad and Tobago,2040,TT,TTO,AMR,38142,78978,117120,89567,98413,93412,112794,112104,122332,628622,36747,76155,112902,86950,97199,92543,113454,117985,166173,674304,1302926,1532947,1532947
Trinidad and Tobago,2041,TT,TTO,AMR,37946,78440,116386,87889,98211,93055,108722,114864,124562,627303,36555,75635,112190,85314,97013,92433,109203,120897,168907,673767,1301070,1529645,1529645
Trinidad and Tobago,2042,TT,TTO,AMR,37704,77963,115667,86292,97654,93084,104827,116930,127017,625804,36319,75173,111492,83757,96485,92679,105158,123056,171858,672993,1298797,1525952,1525952
Trinidad and Tobago,2043,TT,TTO,AMR,37438,77543,114981,84797,96790,93362,101342,118048,129795,624134,36059,74763,110822,82297,95650,93146,101585,124193,175112,671983,1296117,1521918,1521918
Trinidad and Tobago,2044,TT,TTO,AMR,37154,77173,114327,83350,95823,93620,98451,118079,132973,622296,35782,74402,110184,80892,94699,93578,98641,124175,178770,670755,1293051,1517572,1517572
Trinidad and Tobago,2045,TT,TTO,AMR,36845,76837,113682,82031,94705,93860,96157,117090,136505,620348,35481,74074,109555,79611,93595,93957,96326,123083,182788,669360,1289708,1512948,1512948
Trinidad and Tobago,2046,TT,TTO,AMR,36529,76470,112999,80905,93313,94198,94268,115244,140380,618308,35174,73716,108890,78513,92214,94402,94466,121076,187149,667820,1286128,1508022,1508022
Trinidad and Tobago,2047,TT,TTO,AMR,36207,76062,112269,79924,91739,94600,92615,112799,144509,616186,34862,73313,108175,77560,90652,94876,92899,118407,191746,666140,1282326,1502772,1502772
Trinidad and Tobago,2048,TT,TTO,AMR,35849,75640,111489,79104,90040,94963,91264,109943,148663,613977,34514,72897,107411,76762,88968,95281,91676,115276,196343,664306,1278283,1497180,1497180
Trinidad and Tobago,2049,TT,TTO,AMR,35455,75194,110649,78427,88293,95227,90242,106837,152670,611696,34135,72460,106595,76106,87238,95561,90826,111857,200765,662353,1274049,1491290,1491290
Trinidad and Tobago,2050,TT,TTO,AMR,35034,74719,109753,77848,86583,95331,89557,103446,156593,609358,33730,71994,105724,75541,85543,95670,90341,108107,205102,660304,1269662,1485139,1485139
Tunisia,1970,TN,TUN,EMR,451334,728769,1180103,462217,292323,225450,172594,122852,79242,1354678,434894,696415,1131309,457821,323605,242714,173537,114640,68998,1381315,2735993,5047404,5047404
Tunisia,1971,TN,TUN,EMR,456335,747763,1204098,485314,301013,228141,174719,125406,81908,1396501,439206,716944,1156150,475577,333013,247618,178022,118406,72655,1425291,2821792,5182040,5182040
Tunisia,1972,TN,TUN,EMR,461275,765677,1226952,510671,310531,230377,177156,127841,84691,1441267,443364,736339,1179703,495880,342724,252138,182759,122201,76526,1472228,2913495,5320148,5320148
Tunisia,1973,TN,TUN,EMR,467396,783057,1250453,537990,319997,232478,179926,130199,87784,1488374,448410,754829,1203239,518707,351853,256551,187778,126039,80663,1521591,3009965,5463650,5463650
Tunisia,1974,TN,TUN,EMR,475356,799691,1275047,565417,330487,235079,183008,132472,91080,1537543,455093,772205,1227298,542610,360984,261468,193072,129905,85183,1573222,3110765,5613116,5613116
Tunisia,1975,TN,TUN,EMR,485357,815673,1301030,591606,343015,238516,186342,134728,94577,1588784,463669,788535,1252204,566371,371006,267197,198569,133875,90036,1627054,3215838,5769074,5769074
Tunisia,1976,TN,TUN,EMR,497797,829831,1327628,615520,356321,243713,191147,137945,99624,1644270,473915,802413,1276328,589614,380179,273964,204742,137883,95388,1681770,3326040,5929998,5929998
Tunisia,1977,TN,TUN,EMR,511088,842555,1353643,636724,370100,250578,197620,142216,106415,1703653,484593,813873,1298466,612186,388353,281486,211792,141925,101259,1737001,3440654,6092769,6092769
Tunisia,1978,TN,TUN,EMR,521970,856334,1378304,656766,384797,258145,204382,146571,113299,1763960,493516,825107,1318623,634672,397196,289327,219246,146131,107412,1793984,3557944,6254876,6254876
Tunisia,1979,TN,TUN,EMR,529441,872059,1401500,675768,400674,266627,210922,151000,119901,1824892,499844,837163,1337007,656805,407357,297731,226725,150552,113630,1852800,3677692,6416191,6416191
Tunisia,1980,TN,TUN,EMR,533872,889470,1423342,694099,418063,275934,217135,155573,126414,1887218,503998,849991,1353989,678565,419404,306517,234095,155255,119774,1913610,3800828,6578156,6578156
Tunisia,1981,TN,TUN,EMR,537135,908266,1445401,711655,437628,285894,222939,160264,132711,1951091,507400,863881,1371281,699465,434023,315411,241241,160252,125885,1976277,3927368,6744050,6744050
Tunisia,1982,TN,TUN,EMR,541052,927757,1468809,728297,459206,296277,228220,165143,138849,2015992,511315,878731,1390046,718952,451412,324130,247973,165528,132123,2040118,4056110,6914963,6914963
Tunisia,1983,TN,TUN,EMR,546253,947072,1493325,745385,483276,305926,232862,169925,144344,2081718,516688,893743,1410431,737551,472453,331761,254358,171176,138493,2105792,4187510,7091270,7091270
Tunisia,1984,TN,TUN,EMR,552977,967359,1520336,765181,509983,315268,236385,173662,148073,2148552,524457,910407,1434864,756060,498005,338775,260515,177324,144722,2175401,4323953,7279157,7279157
Tunisia,1985,TN,TUN,EMR,561538,987980,1549518,784373,536819,326445,240103,177476,151782,2216998,533784,928553,1462337,773037,525296,346889,266801,183909,151314,2247246,4464244,7476092,7476092
Tunisia,1986,TN,TUN,EMR,570426,1008766,1579192,800343,562902,339671,244880,182414,156812,2287022,542177,948026,1490203,787354,552631,356368,273228,190913,158586,2319080,4606102,7675499,7675499
Tunisia,1987,TN,TUN,EMR,576666,1029946,1606612,815944,588788,354416,250042,187789,162189,2359168,547355,968869,1516224,800524,580557,367029,279581,198394,166208,2392293,4751461,7874302,7874302
Tunisia,1988,TN,TUN,EMR,579087,1049650,1628737,832661,614050,370763,255932,193368,167848,2434622,548381,989156,1537537,813863,608447,379159,286195,206160,174067,2467891,4902513,8068788,8068788
Tunisia,1989,TN,TUN,EMR,576354,1067814,1644168,851274,638215,388735,262849,198756,173608,2513437,544331,1008308,1552639,828388,635644,392994,293433,213811,181884,2546154,5059591,8256396,8256396
Tunisia,1990,TN,TUN,EMR,570101,1084230,1654331,871578,661348,408528,270705,203802,179465,2595426,536917,1025921,1562838,844089,661971,408915,301194,221199,190056,2627424,5222850,8440023,8440023
Tunisia,1991,TN,TUN,EMR,562416,1098462,1660878,893319,683114,430638,279443,208458,185575,2680547,528096,1041255,1569351,861278,686811,427489,309314,228215,198972,2712079,5392626,8622853,8622853
Tunisia,1992,TN,TUN,EMR,554016,1110049,1664065,915845,703333,454917,288838,212584,191908,2767425,518723,1053441,1572164,879934,709596,448904,317582,234632,208240,2798888,5566313,8802540,8802540
Tunisia,1993,TN,TUN,EMR,545938,1118779,1664717,938010,722512,481046,298027,216318,198404,2854317,510079,1062237,1572316,898591,730402,473135,325281,240607,217806,2885822,5740139,8977173,8977173
Tunisia,1994,TN,TUN,EMR,538134,1123838,1661972,959963,740768,507028,307917,219940,204723,2940339,502335,1066668,1569003,916760,749000,498589,333109,246602,227757,2971817,5912156,9143141,9143141
Tunisia,1995,TN,TUN,EMR,527893,1126764,1654657,979687,755939,531705,319724,224026,211308,3022389,492827,1068584,1561411,934417,764517,524218,342251,252812,237430,3055645,6078034,9294102,9294102
Tunisia,1996,TN,TUN,EMR,513769,1127844,1641613,997553,767330,556077,333030,228701,218695,3101386,479943,1068442,1548385,953028,776879,550606,352552,259059,247037,3139161,6240547,9430550,9430550
Tunisia,1997,TN,TUN,EMR,497641,1125140,1622781,1015459,777558,579904,347766,233757,226640,3181084,465226,1064249,1529475,972987,787650,577336,363973,265343,257326,3224615,6405699,9557948,9557948
Tunisia,1998,TN,TUN,EMR,480495,1118589,1599084,1031940,788173,602687,363967,239463,234771,3261001,449304,1056347,1505651,992598,798260,603802,376764,271989,267994,3311407,6572408,9677148,9677148
Tunisia,1999,TN,TUN,EMR,463106,1107067,1570173,1047010,799953,623982,381699,246162,242778,3341584,432740,1044182,1476922,1011318,809723,629368,391158,279418,278396,3399381,6740965,9788067,9788067
Tunisia,2000,TN,TUN,EMR,447535,1089957,1537492,1060562,812813,643867,401171,253862,250696,3422971,417596,1027160,1444756,1028754,822092,653859,407520,287556,288325,3488106,6911077,9893316,9893316
Tunisia,2001,TN,TUN,EMR,435288,1067710,1502998,1072209,826574,661930,422780,262443,258405,3504341,405558,1005466,1411024,1044164,835748,676672,426358,296173,297643,3576758,7081099,9995123,9995123
Tunisia,2002,TN,TUN,EMR,426368,1042332,1468700,1081538,840817,677997,446292,271683,265767,3584094,396755,981013,1377768,1056626,850779,697261,447800,305053,306481,3664000,7248094,10094561,10094561
Tunisia,2003,TN,TUN,EMR,421628,1015955,1437583,1088268,854096,692410,471504,280836,273110,3660224,391993,955820,1347813,1066036,865800,715688,471940,313479,315239,3748182,7408406,10193798,10193798
Tunisia,2004,TN,TUN,EMR,421334,989717,1411051,1091434,865449,704856,496952,290991,280933,3730615,391550,931068,1322618,1071897,880304,731672,497638,322111,324314,3827936,7558551,10292225,10292225
Tunisia,2005,TN,TUN,EMR,425913,963193,1389106,1091657,875396,715229,521023,302923,289907,3796135,395743,906167,1301910,1074496,894237,743739,522594,331335,334797,3901198,7697333,10388344,10388344
Tunisia,2006,TN,TUN,EMR,433916,936599,1370515,1089515,885841,723770,544270,315970,299796,3859162,403146,881246,1284392,1073774,909208,752115,546932,340902,346557,3969488,7828650,10483558,10483558
Tunisia,2007,TN,TUN,EMR,443016,911993,1355009,1084292,896877,731447,566898,330336,309973,3919823,411530,858275,1269805,1069133,925780,759180,571413,351473,358783,4035762,7955585,10580395,10580395
Tunisia,2008,TN,TUN,EMR,452430,891433,1343863,1075967,907090,739642,588511,346019,320515,3977744,420179,838846,1259025,1060903,942285,766333,595441,363274,371510,4099746,8077490,10680380,10680380
Tunisia,2009,TN,TUN,EMR,461777,876423,1338200,1063306,916743,749204,608692,362984,331259,4032188,428888,824201,1253089,1048436,958318,774642,618390,376490,384750,4161026,8193214,10784504,10784504
Tunisia,2010,TN,TUN,EMR,472383,867161,1339544,1045670,925966,760055,627460,381364,342116,4082631,438991,814692,1253683,1031118,973627,784254,640104,391494,398609,4219206,8301837,10895063,10895063
Tunisia,2011,TN,TUN,EMR,485469,863013,1348482,1030178,941642,772295,644083,400862,351116,4140176,451568,809091,1260659,1010925,991281,797238,660381,409439,413946,4283210,8423386,11032528,11032528
Tunisia,2012,TN,TUN,EMR,501175,863926,1365101,1009715,955731,785300,658850,422023,360385,4192004,467066,808593,1275659,986936,1006130,811740,678387,429577,428848,4341618,8533622,11174383,11174383
Tunisia,2013,TN,TUN,EMR,517989,870405,1388394,979958,960951,797583,672441,445234,371424,4227591,484211,814489,1298700,959498,1014311,824787,693896,451284,441819,4385595,8613186,11300284,11300284
Tunisia,2014,TN,TUN,EMR,533746,882465,1416211,950994,963968,809188,684172,468328,383266,4259916,500675,825657,1326332,932614,1019246,838096,707062,474215,455264,4426497,8686413,11428948,11428948
Tunisia,2015,TN,TUN,EMR,546742,899266,1446008,922742,965628,820558,694070,490329,396894,4290221,514585,841525,1356110,906304,1021728,852132,717927,497294,470059,4465444,8755665,11557779,11557779
Tunisia,2016,TN,TUN,EMR,554617,920843,1475460,895606,965951,832867,702428,511810,411495,4320157,523518,862071,1385589,880854,1021717,868155,726791,520972,485979,4504468,8824625,11685667,11685667
Tunisia,2017,TN,TUN,EMR,557424,946143,1503567,871061,963250,846073,710113,532593,427121,4350211,527241,886389,1413630,857607,1017824,885992,734503,544934,503172,4544032,8894243,11811443,11811443
Tunisia,2018,TN,TUN,EMR,555954,971928,1527882,851070,957455,858640,718351,552411,443890,4381817,526495,911597,1438092,838113,1010401,903883,742317,568501,522031,4585246,8967063,11933041,11933041
Tunisia,2019,TN,TUN,EMR,550494,996504,1546998,837048,947396,870693,727868,570949,461771,4415725,521770,936076,1457846,823550,998860,921360,751195,591095,542688,4628748,9044473,12049314,12049314
Tunisia,2020,TN,TUN,EMR,541892,1019463,1561355,830831,934169,882125,738463,587717,478167,4451472,513952,959051,1473003,814724,983503,938449,761388,612698,565128,4675890,9127362,12161723,12161723
Tunisia,2021,TN,TUN,EMR,530915,1040686,1571601,831404,917963,892549,749780,601683,492063,4485442,503908,980266,1484174,811244,964283,954300,773096,632018,586789,4721730,9207172,12262946,12262946
Tunisia,2022,TN,TUN,EMR,518361,1059450,1577811,837619,900170,901482,761451,613379,506462,4520563,492427,999032,1491459,812429,942777,967905,786335,648665,608177,4766288,9286851,12356117,12356117
Tunisia,2023,TN,TUN,EMR,505509,1074057,1579566,849507,883181,909024,772883,624814,526053,4565462,480713,1013906,1494619,818405,921158,979289,800279,664123,635322,4818576,9384038,12458223,12458223
Tunisia,2024,TN,TUN,EMR,493222,1083542,1576764,865711,866894,914807,784013,635638,550362,4617425,469524,1024231,1493755,829120,899898,987499,814764,677879,667588,4876748,9494173,12564689,12564689
Tunisia,2025,TN,TUN,EMR,481526,1087229,1568755,885529,851198,919792,794917,644871,575593,4671900,458839,1029169,1488008,844070,878932,993348,830054,689323,701409,4937136,9609036,12665802,12665802
Tunisia,2026,TN,TUN,EMR,470752,1083545,1554297,909171,836045,923912,806789,652748,601672,4730337,448957,1027131,1476088,863413,858350,996712,847333,698734,736666,5001208,9731545,12761929,12761929
Tunisia,2027,TN,TUN,EMR,460772,1073358,1534130,935771,822624,925514,819598,660080,628480,4792067,439787,1018689,1458476,886373,839388,996202,866439,706981,773153,5068536,9860603,12853207,12853207
Tunisia,2028,TN,TUN,EMR,451552,1058748,1510300,962278,812707,924530,831861,668067,655778,4855221,431287,1005750,1437037,910158,823549,992192,885660,715313,810540,5137412,9992633,12939969,12939969
Tunisia,2029,TN,TUN,EMR,443174,1040592,1483766,987154,807583,919793,843724,677404,683270,4918928,423504,989276,1412780,933242,811994,984080,904520,724704,848378,5206918,10125846,13022396,13022396
Tunisia,2030,TN,TUN,EMR,435619,1019978,1455597,1010173,807298,910563,855081,688084,711089,4982288,416452,970354,1386806,955194,805054,971211,922601,735320,886700,5276080,10258368,13100768,13100768
Tunisia,1950,TN,TUN,EMR,303796,431194,734990,319672,252379,194209,133559,89448,68344,1057611,296793,425280,722073,315735,250089,194236,140356,100720,90483,1091619,2149230,3606288,3606288
Tunisia,1951,TN,TUN,EMR,309476,447020,756496,324386,255368,197894,135594,90410,67418,1071070,301688,441062,742750,320853,253222,197679,141896,101253,88562,1103465,2174535,3673778,3673778
Tunisia,1952,TN,TUN,EMR,315582,463254,778836,329297,258520,201438,137742,91165,66879,1085041,307118,457269,764387,326019,256500,201015,143450,101442,87686,1116112,2201153,3744372,3744372
Tunisia,1953,TN,TUN,EMR,323390,478430,801820,334831,261938,204872,140027,91753,66746,1100167,314147,472602,786749,331555,259850,204198,145252,101608,86946,1129409,2229576,3818148,3818148
Tunisia,1954,TN,TUN,EMR,331518,493203,824721,341570,265474,208110,142536,92299,66723,1116712,321735,487300,809035,338190,263318,207209,147488,102023,86081,1144309,2261021,3894776,3894776
Tunisia,1955,TN,TUN,EMR,338994,508264,847258,349909,269116,211171,145390,93001,66945,1135532,329010,501882,830892,346381,266995,210112,150086,102675,85606,1161855,2297387,3975544,3975544
Tunisia,1956,TN,TUN,EMR,345744,522958,868702,360734,271138,213058,147731,92663,67055,1152379,335994,516176,852170,355488,269372,211712,151661,101250,83630,1173113,2325492,4046367,4046367
Tunisia,1957,TN,TUN,EMR,353401,532404,885805,367617,271626,213247,150054,92489,66832,1161865,343064,524771,867835,362374,271050,211754,152220,98927,79820,1176145,2338010,4091649,4091649
Tunisia,1958,TN,TUN,EMR,362676,536935,899611,369053,272249,212788,153024,93755,66461,1167330,350604,527574,878178,367076,273458,211504,152940,97972,75823,1178773,2346103,4123891,4123891
Tunisia,1959,TN,TUN,EMR,371476,542438,913914,371031,272593,212285,155807,95269,66157,1173142,358014,530687,888701,372388,275792,211407,153580,97165,71809,1182141,2355283,4157892,4157892
Tunisia,1960,TN,TUN,EMR,379537,549672,929209,373634,272731,211920,158305,96985,65976,1179551,365087,534956,900043,378200,278091,211616,154109,96547,68099,1186662,2366213,4195467,4195467
Tunisia,1961,TN,TUN,EMR,386529,559448,945977,376449,272437,211592,160473,98816,65901,1185668,371591,541195,912786,384124,280340,212130,154570,96080,64715,1191959,2377627,4236386,4236386
Tunisia,1962,TN,TUN,EMR,393095,571810,964905,379320,271775,211449,162381,100753,66021,1191699,377922,549763,927685,389715,282405,212956,154987,95696,61688,1197447,2389146,4281744,4281744
Tunisia,1963,TN,TUN,EMR,400004,586803,986807,381453,271234,211662,164084,102885,66410,1197728,384559,560959,945518,393996,284568,214154,155384,95495,59270,1202867,2400595,4332926,4332926
Tunisia,1964,TN,TUN,EMR,407196,602853,1010049,383736,271227,212118,165503,105255,67085,1204924,391435,573610,965045,397531,287426,215768,155808,95621,57245,1209399,2414323,4389417,4389417
Tunisia,1965,TN,TUN,EMR,415231,619408,1034639,388023,272368,213034,166752,107891,68106,1216174,399135,587413,986548,401727,291422,218016,156532,96336,55887,1219920,2436094,4457282,4457282
Tunisia,1966,TN,TUN,EMR,423356,640344,1063700,395718,273325,214394,167623,110722,69709,1231491,407392,606584,1013976,408156,295772,221677,158628,98790,56776,1239799,2471290,4548972,4548972
Tunisia,1967,TN,TUN,EMR,430871,664242,1095113,407601,274555,216371,168279,113731,71821,1252358,415290,629879,1045169,417439,300523,226633,161913,102715,59410,1268633,2520991,4661271,4661271
Tunisia,1968,TN,TUN,EMR,438298,687102,1125400,423223,278529,219313,169334,116920,74112,1281431,422742,652842,1075584,428969,306903,232091,165477,106796,62348,1302584,2584015,4785003,4785003
Tunisia,1969,TN,TUN,EMR,445301,708528,1153829,441671,284778,222494,170799,120041,76589,1316372,429437,674974,1104411,442477,314812,237535,169350,110803,65571,1340548,2656920,4915162,4915162
Tunisia,2031,TN,TUN,EMR,428911,998025,1426936,1031337,811286,897040,865599,700009,739126,5044397,410159,950139,1360298,975731,802554,953621,939167,747593,925217,5343883,10388280,13175516,13175516
Tunisia,2032,TN,TUN,EMR,423324,975454,1398778,1050061,819199,881014,874905,712612,766849,5104640,404896,929401,1334297,994186,804229,933138,953323,761503,963254,5409633,10514273,13247347,13247347
Tunisia,2033,TN,TUN,EMR,418974,953555,1372529,1064712,831201,864550,882830,724651,793950,5161894,400785,909319,1310104,1009091,810274,911815,964870,775753,1000480,5472283,10634177,13316811,13316811
Tunisia,2034,TN,TUN,EMR,415905,933046,1348951,1074261,847444,848721,888867,735997,820221,5215511,397866,890451,1288317,1019449,821011,890797,973161,790264,1036666,5531348,10746859,13384136,13384136
Tunisia,2035,TN,TUN,EMR,414168,913933,1328101,1078036,867278,833473,894114,747082,845690,5265673,396217,872808,1269025,1024429,835971,870071,979115,805534,1071798,5586918,10852591,13449717,13449717
Tunisia,2036,TN,TUN,EMR,413931,896583,1310514,1074475,890904,818761,898524,759056,870507,5312227,396018,856723,1252741,1022450,855316,849724,982619,822728,1106039,5638876,10951103,13514365,13514365
Tunisia,2037,TN,TUN,EMR,415132,881136,1296268,1064448,917474,805766,900486,771935,895362,5355471,397202,842368,1239570,1014079,878261,830995,982309,841703,1140025,5687372,11042843,13578685,13578685
Tunisia,2038,TN,TUN,EMR,417484,867674,1285158,1050018,943959,796231,899923,784349,921135,5395615,399473,829829,1229302,1001219,902036,815370,978542,860801,1174606,5732574,11128189,13642656,13642656
Tunisia,2039,TN,TUN,EMR,420805,856326,1277131,1032056,968832,791430,895697,796452,948161,5432628,402682,819192,1221874,984836,925110,804004,970728,879570,1210280,5774528,11207156,13706160,13706160
Tunisia,2040,TN,TUN,EMR,424930,847126,1272056,1011646,991867,791404,887082,808159,976598,5466756,406663,810549,1217212,966002,947056,797221,958204,897603,1247230,5813316,11280072,13769345,13769345
Tunisia,2041,TN,TUN,EMR,429424,840267,1269691,989904,1013065,795594,874267,819146,1006288,5498264,410975,804113,1215088,945879,967591,794851,941012,914190,1285608,5849131,11347395,13832171,13832171
Tunisia,2042,TN,TUN,EMR,433870,835953,1269823,967540,1031844,803657,858990,828991,1036221,5527243,415229,800080,1215309,925232,986045,796619,920960,928431,1324740,5882027,11409270,13894401,13894401
Tunisia,2043,TN,TUN,EMR,437963,834025,1271988,945838,1046582,815756,843259,837458,1064993,5553886,419130,798283,1217413,905232,1000965,802730,900061,940091,1363076,5912155,11466041,13955442,13955442
Tunisia,2044,TN,TUN,EMR,441475,834336,1275811,925512,1056258,832045,828123,844023,1092352,5578313,422459,798611,1221070,886442,1011345,813502,879446,948528,1400322,5939585,11517898,14014784,14014784
Tunisia,2045,TN,TUN,EMR,444202,836780,1280982,906577,1060207,851886,813546,849781,1118755,5600752,425026,800977,1226003,868876,1016365,828468,859109,954657,1436975,5964450,11565202,14072181,14072181
Tunisia,2046,TN,TUN,EMR,445946,841088,1287034,889390,1056879,875489,799503,854752,1145441,5621454,426646,805119,1231765,852856,1014443,847805,839154,958396,1474317,5986971,11608425,14127222,14127222
Tunisia,2047,TN,TUN,EMR,446657,846779,1293436,874091,1047125,902015,787148,857399,1173037,5640815,427286,810578,1237864,838565,1006151,870719,820796,958427,1512909,6007567,11648382,14179682,14179682
Tunisia,2048,TN,TUN,EMR,446289,853268,1299557,860764,1032993,928457,778195,857628,1201109,5659146,426898,816776,1243674,826085,993387,894459,805514,955078,1552004,6026527,11685673,14228906,14228906
Tunisia,2049,TN,TUN,EMR,444787,860141,1304928,849542,1015349,953315,773888,854367,1230193,5676654,425423,823338,1248761,815499,977101,917506,794449,947779,1591660,6043994,11720648,14274332,14274332
Tunisia,2050,TN,TUN,EMR,442131,867029,1309160,840458,995265,976355,774260,846906,1260340,5693584,422856,829906,1252762,806904,958370,939429,787918,935884,1631769,6060274,11753858,14315779,14315779
Türkiye,1970,TR,TUR,EUR,3030131,4848345,7878476,3300796,2228707,1717959,1223053,876873,762454,10109842,2910593,4480391,7390984,3272183,2231419,1719293,1189249,866030,883515,10161689,20271531,35540990,35540990
Türkiye,1971,TR,TUR,EUR,3023648,5008828,8032476,3418709,2287712,1759047,1259720,887062,791533,10403783,2907582,4583846,7491428,3390798,2275317,1757441,1225040,877078,906595,10432269,20836052,36359957,36359957
Türkiye,1972,TR,TUR,EUR,3047698,5134330,8182028,3536824,2366290,1810685,1304321,897871,817341,10733332,2933391,4660701,7594092,3470370,2321854,1795032,1265573,890323,935431,10678583,21411915,37188035,37188035
Türkiye,1973,TR,TUR,EUR,3034493,5300943,8335436,3637445,2453746,1863541,1350632,911458,843306,11060128,2928174,4790857,7719031,3527294,2376955,1831998,1307437,906455,963500,10913639,21973767,38028236,38028236
Türkiye,1974,TR,TUR,EUR,3024920,5457502,8482422,3724241,2553740,1918123,1398175,928192,869168,11391639,2923136,4923614,7846750,3564081,2444411,1868035,1349447,926200,990435,11142609,22534248,38863420,38863420
Türkiye,1975,TR,TUR,EUR,3064782,5528599,8593381,3825012,2654548,1972270,1446051,948220,893161,11739262,2952455,5001471,7953926,3609984,2517454,1903293,1391229,949100,1015958,11387018,23126280,39673590,39673590
Türkiye,1976,TR,TUR,EUR,3122651,5559307,8681958,3948555,2723723,2013698,1491344,970480,907532,12055332,2994922,5087551,8082473,3700755,2592345,1942350,1434609,973438,1037726,11681223,23736555,40500997,40500997
Türkiye,1977,TR,TUR,EUR,3189849,5593608,8783457,4107072,2749625,2045374,1532800,994292,915391,12344554,3052516,5192947,8245463,3833719,2656639,1986004,1479429,999603,1056786,12012180,24356734,41385656,41385656
Türkiye,1978,TR,TUR,EUR,3233067,5654155,8887222,4223831,2833278,2076887,1571866,1020510,925810,12652182,3094244,5297670,8391914,3926559,2775177,2029694,1523770,1028482,1077203,12360885,25013067,42292206,42292206
Türkiye,1979,TR,TUR,EUR,3260460,5718761,8979221,4308863,2953536,2105003,1608810,1049414,938795,12964421,3124289,5385865,8510154,4000455,2934365,2072152,1567486,1060229,1099003,12733690,25698111,43187476,43187476
Türkiye,1980,TR,TUR,EUR,3289409,5786331,9075740,4448094,3039442,2135279,1642175,1078244,947446,13290680,3155619,5470389,8626008,4104047,3055245,2112092,1609422,1093602,1122243,13096651,26387331,44089069,44089069
Türkiye,1981,TR,TUR,EUR,3316419,5860031,9176450,4596548,3126919,2171461,1672167,1106248,951542,13624885,3182421,5562167,8744588,4205351,3154648,2152664,1649049,1127707,1146539,13435958,27060843,44981877,44981877
Türkiye,1982,TR,TUR,EUR,3338081,5952886,9290967,4736610,3225533,2221240,1704718,1137077,959523,13984701,3201814,5667595,8869409,4319892,3252061,2205245,1690706,1164286,1172732,13804922,27789623,45949991,45949991
Türkiye,1983,TR,TUR,EUR,3359710,5999215,9358925,4942419,3330885,2289519,1741407,1170719,971335,14446284,3219927,5728300,8948227,4512484,3345198,2274202,1735786,1203559,1201760,14272989,28719273,47026425,47026425
Türkiye,1984,TR,TUR,EUR,3371707,6047755,9419462,5144625,3432708,2371601,1778639,1204994,984856,14917423,3228781,5789206,9017987,4713029,3423177,2357263,1781439,1244088,1232898,14751894,29669317,48106764,48106764
Türkiye,1985,TR,TUR,EUR,3380774,6148441,9529215,5269069,3550934,2458637,1815918,1239259,1000037,15333854,3234700,5893785,9128485,4853806,3506768,2445865,1826336,1285464,1265877,15184116,30517970,49175673,49175673
Türkiye,1986,TR,TUR,EUR,3388919,6236642,9625561,5376789,3697133,2536437,1853256,1273029,1017213,15753857,3239563,5984123,9223686,4987120,3609191,2526824,1869703,1327241,1300707,15620786,31374643,50223885,50223885
Türkiye,1987,TR,TUR,EUR,3395716,6313219,9708935,5481194,3878326,2583675,1890697,1306079,1036426,16176397,3243440,6061032,9304472,5119736,3733837,2587733,1912493,1369092,1337458,16060349,32236746,51250152,51250152
Türkiye,1988,TR,TUR,EUR,3402617,6381391,9784008,5574647,4023701,2684209,1928409,1338615,1057619,16607200,3247642,6127927,9375569,5239555,3825353,2701512,1955108,1411052,1376537,16509117,33116317,52275890,52275890
Türkiye,1989,TR,TUR,EUR,3408220,6445748,9853968,5645702,4156870,2824777,1966069,1370807,1080904,17045129,3251052,6189369,9440421,5335302,3907552,2855152,1996700,1453000,1418016,16965722,34010851,53305234,53305234
Türkiye,1990,TR,TUR,EUR,3407232,6507548,9914780,5711250,4331950,2928981,2005641,1402924,1106386,17487132,3248749,6246984,9495733,5422518,4026563,2980787,2040051,1494964,1461619,17426502,34913634,54324142,54324142
Türkiye,1991,TR,TUR,EUR,3401982,6555133,9957115,5785659,4496869,3033652,2050962,1435339,1134180,17936661,3242786,6289705,9532491,5514434,4146979,3098775,2089967,1537141,1507603,17894899,35831560,55321172,55321172
Türkiye,1992,TR,TUR,EUR,3394617,6594391,9989008,5875606,4638593,3137781,2103874,1468339,1164014,18388207,3235088,6322804,9557892,5616540,4264880,3203345,2146741,1579588,1555824,18366918,36755125,56302037,56302037
Türkiye,1993,TR,TUR,EUR,3389060,6630860,10019920,5919531,4829957,3233003,2166680,1502274,1195557,18847002,3229568,6352227,9581795,5674551,4444156,3287796,2212261,1622562,1605967,18847293,37694295,57296008,57296008
Türkiye,1994,TR,TUR,EUR,3392044,6656077,10048121,5967108,5018894,3325023,2242344,1537021,1228391,19318781,3232741,6370934,9603675,5734409,4632702,3357277,2291318,1666107,1657853,19339666,38658447,58310245,58310245
Türkiye,1995,TR,TUR,EUR,3404629,6671162,10075791,6062936,5129529,3432793,2322488,1572005,1261800,19781551,3244662,6380122,9624784,5834369,4760772,3432188,2375761,1709060,1711217,19823367,39604918,59305490,59305490
Türkiye,1996,TR,TUR,EUR,3429280,6680885,10110165,6144496,5223830,3569013,2394238,1607509,1295943,20235029,3266920,6384631,9651551,5917794,4881749,3527007,2453282,1751026,1766185,20297043,40532072,60293786,60293786
Türkiye,1997,TR,TUR,EUR,3461934,6687083,10149017,6214461,5316194,3741043,2437260,1643552,1330763,20683273,3295446,6386695,9682141,5987085,5003043,3645562,2511829,1792939,1822535,20762993,41446266,61277426,61277426
Türkiye,1998,TR,TUR,EUR,3491028,6693769,10184797,6276029,5396149,3877377,2531108,1679615,1366454,21126732,3319021,6390047,9709068,6045736,5109292,3730132,2621648,1834592,1880203,21221603,42348335,62242204,62242204
Türkiye,1999,TR,TUR,EUR,3505594,6705730,10211324,6334945,5453699,4001284,2662709,1715169,1403185,21570991,3327224,6399243,9726467,6099488,5190194,3804126,2769547,1874840,1938641,21676836,43247827,63185615,63185615
Türkiye,2000,TR,TUR,EUR,3502917,6721000,10223917,6394203,5507957,4166329,2759154,1752558,1441878,22022079,3319003,6411885,9730888,6152356,5264125,3914500,2889737,1917023,1998917,22136658,44158737,64113547,64113547
Türkiye,2001,TR,TUR,EUR,3492633,6745637,10238270,6444390,5577823,4325599,2858426,1796335,1483506,22486079,3305161,6433009,9738170,6196048,5349637,4030303,3004448,1966803,2062263,22609502,45095581,65072018,65072018
Türkiye,2002,TR,TUR,EUR,3459654,6776045,10235699,6485662,5664030,4463006,2958236,1847191,1527207,22945332,3271733,6458540,9730273,6229678,5445916,4144176,3106483,2023481,2127621,23077355,46022687,65988663,65988663
Türkiye,2003,TR,TUR,EUR,3396633,6804930,10201563,6528129,5708332,4649367,3050237,1906621,1573292,23415978,3211971,6481556,9693527,6264235,5501160,4318301,3188721,2088396,2195444,23556257,46972235,66867327,66867327
Türkiye,2004,TR,TUR,EUR,3334736,6829003,10163739,6566404,5765041,4836873,3141525,1977847,1621841,23909531,3155528,6499081,9654609,6295867,5566795,4504378,3257581,2166603,2265970,24057194,47966725,67785075,67785075
Türkiye,2005,TR,TUR,EUR,3291992,6845351,10137343,6592312,5873106,4951501,3250094,2053749,1671708,24392470,3118298,6508807,9627105,6315756,5676259,4634069,3333286,2250605,2337825,24547800,48940270,68704715,68704715
Türkiye,2006,TR,TUR,EUR,3256181,6864331,10120512,6606689,5965501,5051464,3386423,2121866,1722382,24854325,3087217,6521410,9608627,6324405,5768200,4758171,3429016,2328003,2410076,25017871,49872196,69601333,69601333
Türkiye,2007,TR,TUR,EUR,3238226,6868494,10106720,6612533,6043433,5149455,3556370,2162880,1774180,25298851,3072315,6520567,9592882,6325216,5843765,4883020,3548065,2386729,2483618,25470413,50769264,70468869,70468869
Türkiye,2008,TR,TUR,EUR,3251160,6838695,10089855,6617631,6112520,5236259,3694050,2251184,1826976,25738620,3085827,6488082,9573909,6326037,5908915,4994542,3635009,2495254,2558588,25918345,51656965,71320726,71320726
Türkiye,2009,TR,TUR,EUR,3271068,6795936,10067004,6637148,6187522,5305895,3823662,2375287,1881427,26210941,3105117,6443991,9549108,6342731,5978563,5086250,3714560,2641539,2634939,26398582,52609523,72225639,72225639
Türkiye,2010,TR,TUR,EUR,3284073,6756545,10040618,6669632,6272226,5376681,3993976,2467157,1939889,26719561,3117195,6404210,9521405,6373311,6056993,5175412,3831435,2761187,2715420,26913758,53633319,73195345,73195345
Türkiye,2011,TR,TUR,EUR,3290056,6716354,10006410,6711261,6347096,5461054,4157118,2560764,2002579,27239872,3122128,6364870,9486998,6412117,6125263,5274220,3952318,2874505,2802152,27440575,54680447,74173854,74173854
Türkiye,2012,TR,TUR,EUR,3303713,6675558,9979271,6773446,6432695,5572639,4303673,2658284,2074593,27815330,3134366,6326387,9460753,6471380,6203657,5394465,4075518,2977723,2899347,28022090,55837420,75277439,75277439
Türkiye,2013,TR,TUR,EUR,3334621,6639872,9974493,6853282,6542136,5653640,4502855,2753884,2161234,28467031,3163427,6294244,9457671,6548927,6305828,5483591,4261953,3064606,3012012,28676917,57143948,76576117,76576117
Türkiye,2014,TR,TUR,EUR,3387429,6614861,10002290,6950099,6674453,5757651,4707754,2853441,2262267,29205665,3214129,6273818,9487947,6644683,6432299,5592604,4463719,3141079,3141794,29416178,58621843,78112073,78112073
Türkiye,2015,TR,TUR,EUR,3455967,6600322,10056289,7026016,6795607,5915211,4843115,2969754,2366579,29916282,3280226,6263563,9543789,6718713,6549160,5748590,4611325,3224703,3277331,30129822,60046104,79646178,79646178
Türkiye,2016,TR,TUR,EUR,3524813,6583519,10108332,7072336,6886818,6053756,4963094,3109484,2460642,30546130,3346436,6250050,9596486,6761256,6637810,5885158,4752992,3326659,3404557,30768432,61314562,81019394,81019394
Türkiye,2017,TR,TUR,EUR,3575470,6584477,10159947,7055715,6926740,6163006,5075153,3275093,2528310,31024017,3394946,6252093,9647039,6738045,6676187,5992299,4890597,3448418,3513280,31258826,62282843,82089826,82089826
Türkiye,2018,TR,TUR,EUR,3586775,6622900,10209675,6959056,6912630,6241960,5167908,3411170,2635340,31328064,3405969,6288636,9694605,6632480,6660251,6069026,5007629,3537877,3669689,31576952,62905016,82809304,82809304
Türkiye,2019,TR,TUR,EUR,3550983,6683851,10234834,6856471,6899325,6318756,5241032,3542148,2774385,31632117,3372660,6346537,9719197,6522309,6645339,6142120,5102083,3620581,3863103,31895535,63527652,83481684,83481684
Türkiye,2020,TR,TUR,EUR,3478481,6753394,10231875,6776200,6895485,6399272,5310296,3701247,2868600,31951100,3304918,6412609,9717527,6436564,6639443,6217955,5190481,3735040,4015449,32234932,64186032,84135428,84135428
Türkiye,2021,TR,TUR,EUR,3388639,6820204,10208843,6712777,6904203,6471351,5391723,3848462,2952480,32280996,3221158,6475702,9696860,6370118,6644292,6284815,5288178,3850676,4150638,32588717,64869713,84775404,84775404
Türkiye,2022,TR,TUR,EUR,3291024,6877014,10168038,6635900,6894390,6526589,5489585,3980921,3067006,32594391,3130153,6528837,9658990,6291066,6628434,6334369,5396659,3966514,4302780,32919822,65514213,85341241,85341241
Türkiye,2023,TR,TUR,EUR,3200620,6911927,10112547,6549427,6855482,6567003,5542872,4160410,3203577,32878771,3045855,6561474,9607329,6203047,6581426,6369195,5459226,4139929,4464733,33217556,66096327,85816199,85816199
Türkiye,2024,TR,TUR,EUR,3131210,6914445,10045655,6477206,6803848,6592455,5600446,4337286,3347580,33158821,2981245,6564293,9545538,6131063,6519752,6389686,5524025,4321046,4624834,33510406,66669227,86260417,86260417
Türkiye,2025,TR,TUR,EUR,3078628,6892301,9970929,6426710,6743348,6605464,5707912,4448868,3510063,33442365,2932376,6544447,9476823,6081708,6448073,6398308,5633228,4448782,4796257,33806356,67248721,86696476,86696476
Türkiye,2026,TR,TUR,EUR,3033268,6853217,9886485,6387630,6688533,6610354,5806538,4551701,3690663,33735419,2890263,6508843,9399106,6044011,6381491,6399353,5731661,4574408,4980397,34111321,67846740,87132333,87132333
Türkiye,2027,TR,TUR,EUR,2988585,6797657,9786242,6381107,6624687,6608036,5896765,4655923,3878056,34044574,2848786,6457769,9306555,6037854,6306589,6394005,5819831,4703509,5169856,34431644,68476218,87569007,87569007
Türkiye,2028,TR,TUR,EUR,2944923,6722090,9667013,6424857,6534236,6601372,5980488,4751935,4078553,34371441,2808216,6387977,9196193,6079898,6206957,6384776,5900003,4821407,5375699,34768740,69140181,88003385,88003385
Türkiye,2029,TR,TUR,EUR,2904433,6621009,9525442,6494524,6439173,6595118,6061701,4830246,4300094,34720856,2770504,6294116,9064620,6147039,6103918,6376155,5976266,4917524,5606374,35127276,69848132,88438200,88438200
Türkiye,2030,TR,TUR,EUR,2866064,6497995,9364059,6574808,6358539,6586746,6141355,4905031,4527054,35093533,2734613,6179515,8914128,6224706,6016523,6364695,6050023,5006667,5845363,35507977,70601510,88879698,88879698
Türkiye,1950,TR,TUR,EUR,1740135,2622466,4362601,2055359,1430139,1103722,813587,450905,302314,6156026,1685397,2464662,4150059,1898324,1401352,1082178,854390,583834,488932,6309010,12465036,20977697,20977697
Türkiye,1951,TR,TUR,EUR,1819272,2656758,4476030,2109009,1474574,1119789,842737,473406,313673,6333188,1750641,2501670,4252311,1941734,1441528,1096902,872902,599741,505271,6458078,12791266,21519610,21519610
Türkiye,1952,TR,TUR,EUR,1860456,2716156,4576612,2166812,1522339,1136227,869299,495517,326313,6516507,1798667,2585571,4384238,1983429,1482472,1117986,894014,617663,521589,6617153,13133660,22094511,22094511
Türkiye,1953,TR,TUR,EUR,1968405,2771495,4739900,2208988,1569744,1156126,896172,519758,340314,6691102,1888277,2607236,4495513,2022099,1529314,1133530,907825,633490,537817,6764075,13455177,22690585,22690585
Türkiye,1954,TR,TUR,EUR,2096546,2835533,4932079,2236594,1616870,1179455,922108,545982,355865,6856874,1986831,2591192,4578023,2056376,1581036,1146385,915535,647612,554038,6900982,13757856,23267962,23267962
Türkiye,1955,TR,TUR,EUR,2122079,2945229,5067308,2268377,1667403,1204130,943901,572236,372786,7028833,2016696,2660638,4677334,2085192,1631312,1169334,926933,664639,570467,7047877,14076710,23821353,23821353
Türkiye,1956,TR,TUR,EUR,2170267,3061947,5232214,2301839,1721873,1232331,964327,601130,390062,7211562,2068146,2760170,4828316,2111708,1680783,1196643,939968,684184,588276,7201562,14413124,24473658,24473658
Türkiye,1957,TR,TUR,EUR,2292855,3141222,5434077,2342564,1778655,1264686,982624,631624,408277,7408430,2183292,2843221,5026513,2145762,1729686,1227540,953884,705111,607748,7369731,14778161,25238751,25238751
Türkiye,1958,TR,TUR,EUR,2362026,3271381,5633407,2386302,1833920,1300554,997610,660972,428383,7607741,2257246,2965786,5223032,2183784,1778502,1261771,966409,724686,628368,7543520,15151261,26007700,26007700
Türkiye,1959,TR,TUR,EUR,2377895,3446184,5824079,2432242,1887524,1340321,1010797,689264,450929,7811077,2286569,3124930,5411499,2223663,1827353,1298727,977969,744012,649780,7721504,15532581,26768160,26768160
Türkiye,1960,TR,TUR,EUR,2408928,3591813,6000741,2481197,1938211,1382868,1023742,716423,476126,8018567,2321708,3264422,5586130,2266804,1875254,1338022,989490,763644,672332,7905546,15924113,27510980,27510980
Türkiye,1961,TR,TUR,EUR,2444523,3732664,6177187,2535175,1982827,1423331,1036630,740195,500099,8218257,2356813,3408914,5765727,2315907,1918495,1379602,1002535,781468,695830,8093837,16312094,28255002,28255002
Türkiye,1962,TR,TUR,EUR,2493242,3864946,6358188,2599714,2026812,1464302,1051040,760609,523269,8425746,2404243,3554064,5958307,2371167,1958780,1425338,1018626,797500,719992,8291403,16717149,29033647,29033647
Türkiye,1963,TR,TUR,EUR,2547852,3984275,6532127,2676728,2070255,1506606,1067110,779254,549210,8649163,2457019,3684458,6141477,2438786,1999453,1472489,1036493,812166,745722,8505109,17154272,29827877,29827877
Türkiye,1964,TR,TUR,EUR,2604877,4093423,6698300,2764794,2107704,1546390,1083449,796022,577481,8875840,2509862,3793258,6303120,2525377,2041054,1516724,1054310,825220,772881,8735566,17611406,30612821,30612821
Türkiye,1965,TR,TUR,EUR,2631921,4215485,6847406,2860880,2141803,1585422,1101315,810499,607110,9107029,2536112,3908631,6444743,2623011,2081907,1560491,1073489,836699,799771,8975368,18082397,31374536,31374536
Türkiye,1966,TR,TUR,EUR,2705414,4334163,7039577,2938522,2163612,1620303,1123827,824270,636434,9306968,2599656,4041992,6641648,2715362,2111790,1598609,1094693,843156,820977,9184587,18491555,32172785,32172785
Türkiye,1967,TR,TUR,EUR,2828100,4470031,7298131,2979391,2180878,1652344,1149729,837577,665979,9465898,2709942,4192821,6902763,2786514,2137059,1633462,1118648,846977,837034,9359694,18825592,33026490,33026490
Türkiye,1968,TR,TUR,EUR,2965542,4570545,7536087,3061800,2183204,1670976,1172570,851900,697164,9637614,2840248,4282144,7122392,2928672,2161153,1656649,1138021,850874,852614,9587983,19225597,33884075,33884075
Türkiye,1969,TR,TUR,EUR,3044465,4674559,7719024,3187832,2190471,1687662,1195290,865772,729639,9856666,2918360,4355261,7273621,3119299,2189777,1680539,1158828,856487,867751,9872681,19729347,34721990,34721990
Türkiye,2031,TR,TUR,EUR,2830941,6362655,9193596,6654312,6291277,6581501,6208412,4991434,4753789,35480725,2701673,6053472,8755145,6301720,5944382,6354276,6110474,5104126,6087362,35902340,71383065,89331813,89331813
Türkiye,2032,TR,TUR,EUR,2800174,6223012,9023186,6728793,6234879,6577339,6267334,5093727,4969796,35871868,2672738,5923598,8596336,6374130,5885365,6342493,6161739,5213859,6322502,36300088,72171956,89791477,89791477
Türkiye,2033,TR,TUR,EUR,2773396,6095150,8868546,6784079,6191784,6566174,6321593,5157727,5224447,36245804,2647411,5804847,8452258,6428826,5841884,6321557,6207805,5282037,6598860,36680969,72926773,90247581,90247581
Türkiye,2034,TR,TUR,EUR,2750690,5991664,8742354,6804726,6164050,6544913,6362592,5226962,5482574,36585817,2625851,5708845,8334696,6451260,5815884,6288694,6240951,5353125,6879148,37029062,73614879,90691921,90691921
Türkiye,2035,TR,TUR,EUR,2732690,5906525,8639215,6797629,6154889,6513780,6390987,5341108,5697354,36895747,2608752,5629793,8238545,6447661,5809437,6244959,6262018,5466650,7117149,37347874,74243621,91121385,91121385
Türkiye,2036,TR,TUR,EUR,2718118,5830878,8548996,6770439,6152344,6485751,6410273,5446637,5919193,37184637,2594939,5559486,8154425,6424865,5809751,6203907,6274598,5569344,7363385,37645850,74830487,91533912,91533912
Türkiye,2037,TR,TUR,EUR,2708249,5759299,8467548,6723950,6177041,6445773,6421137,5543828,6146910,37458639,2585615,5492850,8078465,6383489,5836179,6151747,6279670,5661590,7616009,37928684,75387323,91933341,91933341
Türkiye,2038,TR,TUR,EUR,2703908,5692101,8396009,6655217,6247119,6376819,6426634,5634449,6377790,37718028,2581526,5430106,8011632,6320913,5905852,6072546,6279923,5745630,7871614,38196478,75914506,92322146,92322146
Türkiye,2039,TR,TUR,EUR,2702127,5631678,8333805,6559182,6338067,6300379,6431300,5722194,6610185,37961307,2579873,5373526,7953399,6232274,5995387,5987150,6279638,5825366,8128084,38447899,76409206,92696412,92696412
Türkiye,2040,TR,TUR,EUR,2703276,5577457,8280733,6439638,6433641,6234044,6431947,5807570,6842446,38189286,2581012,5322604,7903616,6121137,6089116,5913168,6274767,5901899,8383777,38683864,76873150,93057500,93057500
Türkiye,2041,TR,TUR,EUR,2709204,5529176,8238380,6306450,6522463,6176267,6433474,5880304,7083247,38402205,2586607,5277203,7863810,5997115,6175822,5849662,6268894,5964711,8648250,38904454,77306659,93408844,93408844
Türkiye,2042,TR,TUR,EUR,2716651,5489307,8205958,6168003,6601463,6125178,6434099,5944526,7326698,38599967,2593632,5239651,7833283,5868231,6252774,5795123,6259857,6017850,8915860,39109695,77709662,93748894,93748894
Türkiye,2043,TR,TUR,EUR,2722905,5458562,8181467,6040797,6658579,6084857,6426584,6003662,7568556,38783035,2599596,5210552,7810148,5749912,6309113,5753626,6240639,6065431,9181538,39300259,78083294,94074910,94074910
Türkiye,2044,TR,TUR,EUR,2729175,5434283,8163458,5937713,6680071,6058806,6408572,6050129,7816812,38952103,2605584,5187501,7793085,5654112,6332088,5728575,6209134,6100282,9452510,39476701,78428804,94385345,94385345
Türkiye,2045,TR,TUR,EUR,2734345,5417566,8151911,5852860,6673457,6050774,6380442,6084314,8064778,39106625,2610522,5171622,7782144,5575176,6328616,5722583,6166599,6123191,9722418,39638583,78745208,94679255,94679255
Türkiye,2046,TR,TUR,EUR,2735404,5409023,8144427,5777455,6646683,6049187,6355185,6109526,8309623,39247659,2611624,5163465,7775089,5504953,6305861,5723226,6126645,6137703,9988795,39787183,79034842,94954360,94954360
Türkiye,2047,TR,TUR,EUR,2731837,5406693,8138530,5706111,6600705,6074680,6317961,6126452,8550742,39376651,2608366,5161225,7769591,5438410,6264617,5749911,6075625,6144803,10250511,39923877,79300528,95208646,95208646
Türkiye,2048,TR,TUR,EUR,2723839,5408698,8132537,5639142,6532586,6145234,6251917,6137994,8786973,39493846,2600821,5163158,7763979,5375763,6202263,5819697,5997702,6147132,10506446,40049003,79542849,95439365,95439365
Türkiye,2049,TR,TUR,EUR,2712190,5413277,8125467,5578933,6437241,6236523,6178476,6148683,9020380,39600236,2589759,5167552,7757311,5319274,6113899,5909279,5913645,6148951,10758248,40163296,79763532,95646318,95646318
Türkiye,2050,TR,TUR,EUR,2696831,5419686,8116517,5524905,6318437,6332419,6115026,6155418,9250381,39696586,2575102,5173687,7748789,5268439,6003080,6003056,5840949,6146254,11005593,40267371,79963957,95829258,95829258
Tuvalu,1970,TV,TUV,WPR,437,833,1270,470,253,230,203,127,130,1413,389,825,1214,579,393,321,267,210,143,1913,3326,5814,5814
Tuvalu,1971,TV,TUV,WPR,423,844,1267,485,261,228,205,127,127,1433,380,824,1204,591,404,320,274,216,146,1951,3384,5854,5854
Tuvalu,1972,TV,TUV,WPR,408,856,1264,499,266,226,206,131,123,1451,368,822,1190,604,414,321,278,219,150,1986,3437,5891,5891
Tuvalu,1973,TV,TUV,WPR,395,867,1262,518,273,225,206,139,123,1484,361,822,1183,613,418,325,280,219,154,2009,3493,5934,5934
Tuvalu,1974,TV,TUV,WPR,394,882,1276,540,290,225,217,150,116,1538,364,833,1197,641,430,333,289,224,165,2082,3620,6100,6100
Tuvalu,1975,TV,TUV,WPR,409,907,1316,578,309,234,237,160,112,1630,382,853,1235,695,451,349,300,232,174,2201,3831,6381,6381
Tuvalu,1976,TV,TUV,WPR,427,929,1356,618,328,241,256,172,112,1727,404,863,1267,754,475,363,316,238,184,2330,4057,6677,6677
Tuvalu,1977,TV,TUV,WPR,449,942,1391,671,345,245,274,186,114,1835,426,865,1291,811,500,385,329,246,195,2466,4301,6984,6984
Tuvalu,1978,TV,TUV,WPR,473,948,1421,733,364,257,284,206,113,1957,446,865,1311,869,541,400,336,263,201,2610,4567,7297,7297
Tuvalu,1979,TV,TUV,WPR,497,940,1437,793,384,259,293,222,112,2063,466,858,1324,912,582,408,342,275,209,2728,4791,7552,7552
Tuvalu,1980,TV,TUV,WPR,522,922,1444,849,402,260,290,231,113,2145,489,846,1335,939,614,411,343,278,218,2803,4948,7731,7731
Tuvalu,1981,TV,TUV,WPR,550,900,1450,898,422,264,278,237,116,2215,515,825,1340,955,649,414,345,282,225,2870,5085,7874,7874
Tuvalu,1982,TV,TUV,WPR,577,869,1446,928,439,281,271,245,123,2287,542,807,1349,952,681,415,346,287,234,2915,5202,7993,7993
Tuvalu,1983,TV,TUV,WPR,606,840,1446,934,459,301,269,259,129,2351,569,788,1357,937,700,419,349,295,243,2943,5294,8099,8099
Tuvalu,1984,TV,TUV,WPR,634,813,1447,911,491,330,269,271,137,2409,597,769,1366,898,721,434,360,305,253,2971,5380,8197,8197
Tuvalu,1985,TV,TUV,WPR,661,812,1473,883,524,350,276,279,151,2463,622,770,1392,857,745,453,370,313,262,3000,5463,8329,8329
Tuvalu,1986,TV,TUV,WPR,684,831,1515,865,564,370,276,283,160,2518,643,791,1434,824,777,473,372,317,268,3031,5549,8496,8496
Tuvalu,1987,TV,TUV,WPR,707,855,1562,836,609,383,281,285,167,2561,662,819,1481,787,802,493,380,321,279,3062,5623,8665,8665
Tuvalu,1988,TV,TUV,WPR,727,889,1616,806,653,405,288,280,177,2609,681,852,1533,749,820,523,385,320,288,3085,5694,8844,8844
Tuvalu,1989,TV,TUV,WPR,742,929,1671,769,693,428,290,274,191,2645,694,895,1589,716,837,556,384,321,293,3107,5752,9017,9017
Tuvalu,1990,TV,TUV,WPR,749,978,1727,734,727,451,294,266,206,2678,701,942,1643,682,846,587,385,324,304,3128,5806,9182,9182
Tuvalu,1991,TV,TUV,WPR,745,1039,1784,704,752,481,302,259,219,2717,699,997,1696,654,846,618,392,325,310,3145,5862,9354,9354
Tuvalu,1992,TV,TUV,WPR,734,1102,1836,676,767,502,309,251,230,2735,687,1047,1734,630,843,649,394,323,325,3164,5899,9466,9466
Tuvalu,1993,TV,TUV,WPR,717,1152,1869,647,781,519,316,245,239,2747,666,1077,1743,613,828,677,396,319,329,3162,5909,9517,9517
Tuvalu,1994,TV,TUV,WPR,698,1186,1884,631,776,541,328,244,240,2760,650,1090,1740,613,806,698,403,315,337,3172,5932,9559,9559
Tuvalu,1995,TV,TUV,WPR,684,1213,1897,626,765,555,339,247,247,2779,638,1090,1728,624,772,718,411,316,341,3182,5961,9585,9585
Tuvalu,1996,TV,TUV,WPR,671,1232,1903,629,746,569,354,245,248,2791,627,1085,1712,645,734,740,419,312,347,3197,5988,9611,9611
Tuvalu,1997,TV,TUV,WPR,654,1238,1892,646,724,594,369,246,251,2830,619,1075,1694,670,694,754,436,315,346,3215,6045,9630,9630
Tuvalu,1998,TV,TUV,WPR,640,1235,1875,672,690,617,385,250,245,2859,610,1062,1672,691,655,756,465,310,347,3224,6083,9634,9634
Tuvalu,1999,TV,TUV,WPR,634,1229,1863,705,652,641,403,247,247,2895,604,1054,1658,708,624,757,492,305,342,3228,6123,9640,9640
Tuvalu,2000,TV,TUV,WPR,624,1219,1843,739,618,659,419,249,240,2924,595,1050,1645,718,592,756,519,300,337,3222,6146,9638,9638
Tuvalu,2001,TV,TUV,WPR,622,1209,1831,768,582,667,440,250,236,2943,583,1052,1635,717,569,754,544,297,328,3209,6152,9621,9621
Tuvalu,2002,TV,TUV,WPR,620,1203,1823,799,550,676,458,252,230,2965,567,1066,1633,704,557,749,566,297,316,3189,6154,9609,9609
Tuvalu,2003,TV,TUV,WPR,616,1197,1813,843,535,683,474,258,228,3021,552,1089,1641,703,552,731,584,302,318,3190,6211,9668,9668
Tuvalu,2004,TV,TUV,WPR,605,1196,1801,895,541,684,496,270,230,3116,542,1107,1649,721,564,706,600,313,325,3229,6345,9791,9791
Tuvalu,2005,TV,TUV,WPR,598,1194,1792,943,551,681,509,280,232,3196,539,1111,1650,743,574,673,620,323,334,3267,6463,9912,9912
Tuvalu,2006,TV,TUV,WPR,597,1186,1783,987,565,676,530,289,239,3286,538,1109,1647,771,589,637,643,335,342,3317,6603,10030,10030
Tuvalu,2007,TV,TUV,WPR,598,1174,1772,1021,592,669,547,303,237,3369,542,1098,1640,806,601,602,658,353,347,3367,6736,10149,10149
Tuvalu,2008,TV,TUV,WPR,609,1167,1776,1045,629,662,568,314,232,3450,547,1087,1634,843,604,578,664,376,346,3411,6861,10272,10272
Tuvalu,2009,TV,TUV,WPR,622,1157,1779,1066,668,650,591,333,233,3541,557,1075,1632,881,613,563,669,394,343,3463,7004,10408,10408
Tuvalu,2010,TV,TUV,WPR,641,1152,1793,1074,713,633,611,354,229,3614,571,1062,1633,913,626,550,673,410,340,3512,7126,10550,10550
Tuvalu,2011,TV,TUV,WPR,664,1152,1816,1074,759,619,624,380,226,3682,589,1054,1643,936,649,536,683,419,342,3565,7247,10700,10700
Tuvalu,2012,TV,TUV,WPR,682,1163,1845,1077,800,607,641,395,226,3746,609,1044,1653,960,668,519,677,432,345,3601,7347,10854,10854
Tuvalu,2013,TV,TUV,WPR,685,1164,1849,1072,830,590,659,408,232,3791,618,1033,1651,975,687,503,663,447,350,3625,7416,10918,10918
Tuvalu,2014,TV,TUV,WPR,670,1161,1831,1062,846,574,660,416,235,3793,611,1023,1634,980,704,499,634,468,353,3638,7431,10899,10899
Tuvalu,2015,TV,TUV,WPR,657,1161,1818,1042,864,568,655,426,245,3800,602,1022,1624,975,722,493,594,496,351,3631,7431,10877,10877
Tuvalu,2016,TV,TUV,WPR,646,1160,1806,1017,889,564,645,439,253,3807,588,1027,1615,965,742,502,550,529,341,3629,7436,10852,10852
Tuvalu,2017,TV,TUV,WPR,633,1167,1800,984,908,568,629,449,256,3794,576,1033,1609,948,766,505,510,549,340,3618,7412,10828,10828
Tuvalu,2018,TV,TUV,WPR,628,1175,1803,971,922,581,606,465,261,3806,570,1048,1618,933,794,509,484,562,350,3632,7438,10865,10865
Tuvalu,2019,TV,TUV,WPR,633,1183,1816,972,937,597,578,485,278,3847,577,1064,1641,914,821,519,474,570,369,3667,7514,10956,10956
Tuvalu,2020,TV,TUV,WPR,637,1191,1828,971,945,617,553,499,289,3874,588,1081,1669,902,843,541,465,574,372,3697,7571,11069,11069
Tuvalu,2021,TV,TUV,WPR,647,1205,1852,975,945,645,532,504,303,3904,604,1091,1695,898,857,570,453,578,394,3750,7654,11204,11204
Tuvalu,2022,TV,TUV,WPR,654,1210,1864,989,940,670,508,514,313,3934,616,1103,1719,893,869,599,437,580,417,3795,7729,11312,11312
Tuvalu,2023,TV,TUV,WPR,660,1218,1878,1003,929,695,488,522,317,3954,620,1119,1739,892,876,620,429,563,442,3822,7776,11396,11396
Tuvalu,2024,TV,TUV,WPR,658,1226,1884,1013,921,720,481,521,328,3984,618,1134,1752,894,876,641,429,538,476,3854,7838,11478,11478
Tuvalu,2025,TV,TUV,WPR,656,1235,1891,1032,906,748,480,514,342,4022,616,1145,1761,907,871,660,434,510,512,3894,7916,11565,11565
Tuvalu,2026,TV,TUV,WPR,650,1243,1893,1052,884,777,481,503,354,4051,610,1154,1764,927,860,681,442,475,549,3934,7985,11641,11641
Tuvalu,2027,TV,TUV,WPR,645,1251,1896,1072,862,803,487,490,363,4077,605,1159,1764,944,850,705,456,445,576,3976,8053,11707,11707
Tuvalu,2028,TV,TUV,WPR,637,1256,1893,1096,848,816,501,469,373,4103,598,1166,1764,971,830,732,461,424,597,4015,8118,11779,11779
Tuvalu,2029,TV,TUV,WPR,632,1264,1896,1112,840,834,513,445,393,4137,593,1176,1769,994,811,752,469,416,613,4055,8192,11852,11852
Tuvalu,2030,TV,TUV,WPR,628,1271,1899,1124,839,836,528,426,407,4160,588,1185,1773,1012,789,761,490,406,623,4081,8241,11917,11917
Tuvalu,1950,TV,TUV,WPR,284,438,722,484,481,228,164,113,104,1574,314,490,804,500,459,232,178,137,129,1635,3209,4732,4732
Tuvalu,1951,TV,TUV,WPR,341,427,768,481,507,240,158,112,99,1597,351,474,825,515,470,241,180,136,127,1669,3266,4859,4859
Tuvalu,1952,TV,TUV,WPR,397,403,800,478,531,251,161,109,96,1626,392,457,849,526,473,251,179,138,123,1690,3316,4966,4966
Tuvalu,1953,TV,TUV,WPR,444,381,825,471,553,260,163,108,97,1652,426,445,871,530,471,264,183,139,122,1709,3361,5063,5063
Tuvalu,1954,TV,TUV,WPR,473,383,856,462,559,276,161,108,94,1660,445,452,897,530,472,279,182,135,123,1721,3381,5135,5135
Tuvalu,1955,TV,TUV,WPR,476,415,891,435,554,297,170,113,93,1662,451,477,928,511,469,297,185,133,121,1716,3378,5195,5195
Tuvalu,1956,TV,TUV,WPR,480,449,929,402,536,319,182,120,93,1652,455,507,962,477,460,319,190,136,122,1704,3356,5247,5247
Tuvalu,1957,TV,TUV,WPR,483,487,970,358,503,346,191,129,91,1618,458,543,1001,439,447,354,198,137,125,1700,3318,5289,5289
Tuvalu,1958,TV,TUV,WPR,479,539,1018,319,459,375,201,141,91,1586,456,586,1042,394,434,380,209,138,129,1684,3270,5329,5329
Tuvalu,1959,TV,TUV,WPR,475,598,1073,275,420,400,214,152,93,1554,452,633,1085,351,421,402,220,140,125,1659,3213,5369,5369
Tuvalu,1960,TV,TUV,WPR,466,655,1121,221,385,425,229,165,94,1519,444,681,1125,309,407,422,234,141,126,1639,3158,5404,5404
Tuvalu,1961,TV,TUV,WPR,453,708,1161,165,348,452,241,174,104,1484,432,730,1162,264,393,439,254,144,133,1627,3111,5436,5436
Tuvalu,1962,TV,TUV,WPR,438,760,1198,112,316,475,257,186,124,1470,416,778,1194,216,379,452,275,151,141,1614,3084,5471,5471
Tuvalu,1963,TV,TUV,WPR,417,802,1219,75,284,493,272,196,150,1470,397,814,1211,178,366,460,297,160,144,1605,3075,5503,5503
Tuvalu,1964,TV,TUV,WPR,402,818,1220,107,254,473,274,196,161,1465,383,828,1211,208,352,442,308,167,147,1624,3089,5525,5525
Tuvalu,1965,TV,TUV,WPR,401,807,1208,198,232,414,265,182,157,1448,381,824,1205,304,342,408,308,174,147,1683,3131,5548,5548
Tuvalu,1966,TV,TUV,WPR,415,799,1214,287,219,355,252,167,154,1434,390,819,1209,391,335,378,304,185,140,1733,3167,5591,5591
Tuvalu,1967,TV,TUV,WPR,437,797,1234,361,219,301,235,150,149,1415,400,817,1217,469,344,351,293,192,143,1792,3207,5657,5657
Tuvalu,1968,TV,TUV,WPR,455,810,1265,417,238,250,211,135,139,1390,404,821,1225,531,370,329,276,200,144,1850,3240,5729,5729
Tuvalu,1969,TV,TUV,WPR,454,823,1277,449,249,229,201,127,132,1387,399,826,1225,568,387,320,262,205,143,1885,3272,5779,5779
Tuvalu,2031,TV,TUV,WPR,623,1274,1897,1140,839,830,551,407,416,4183,587,1194,1781,1029,774,770,517,395,632,4117,8300,11981,11981
Tuvalu,2032,TV,TUV,WPR,623,1275,1898,1148,853,821,571,392,426,4211,584,1198,1782,1040,769,782,541,381,644,4157,8368,12047,12047
Tuvalu,2033,TV,TUV,WPR,623,1274,1897,1158,865,813,594,378,435,4243,583,1195,1778,1056,763,784,562,373,650,4188,8431,12111,12111
Tuvalu,2034,TV,TUV,WPR,622,1270,1892,1163,877,805,617,375,440,4277,583,1190,1773,1070,771,787,580,376,647,4231,8508,12171,12171
Tuvalu,2035,TV,TUV,WPR,621,1261,1882,1173,896,787,641,373,437,4307,584,1184,1768,1083,781,780,600,383,649,4276,8583,12230,12230
Tuvalu,2036,TV,TUV,WPR,622,1253,1875,1182,914,773,672,373,432,4346,584,1177,1761,1092,799,772,620,389,642,4314,8660,12296,12296
Tuvalu,2037,TV,TUV,WPR,623,1246,1869,1186,936,751,693,381,428,4375,584,1168,1752,1097,825,764,644,399,636,4365,8740,12360,12360
Tuvalu,2038,TV,TUV,WPR,623,1238,1861,1193,958,740,709,391,418,4409,584,1162,1746,1107,845,742,670,407,633,4404,8813,12418,12418
Tuvalu,2039,TV,TUV,WPR,624,1231,1855,1202,974,731,721,403,412,4443,585,1156,1741,1113,869,723,688,417,623,4433,8876,12477,12477
Tuvalu,2040,TV,TUV,WPR,626,1226,1852,1208,989,731,722,415,408,4473,587,1153,1740,1123,891,706,700,434,619,4473,8946,12537,12537
Tuvalu,2041,TV,TUV,WPR,627,1224,1851,1214,999,733,718,433,402,4499,589,1148,1737,1135,902,690,711,457,610,4505,9004,12598,12598
Tuvalu,2042,TV,TUV,WPR,631,1225,1856,1214,1012,745,711,456,397,4535,591,1147,1738,1136,918,683,716,478,601,4532,9067,12665,12665
Tuvalu,2043,TV,TUV,WPR,635,1225,1860,1214,1019,755,703,473,394,4558,596,1148,1744,1135,930,683,723,499,600,4570,9128,12730,12730
Tuvalu,2044,TV,TUV,WPR,639,1226,1865,1210,1029,773,698,492,388,4590,599,1150,1749,1132,949,686,725,518,592,4602,9192,12797,12797
Tuvalu,2045,TV,TUV,WPR,643,1226,1869,1199,1038,786,684,514,386,4607,603,1152,1755,1120,957,700,719,535,594,4625,9232,12867,12867
Tuvalu,2046,TV,TUV,WPR,647,1230,1877,1193,1045,809,671,538,387,4643,606,1153,1759,1119,968,719,712,553,590,4661,9304,12933,12933
Tuvalu,2047,TV,TUV,WPR,650,1233,1883,1188,1051,827,652,557,386,4661,609,1156,1765,1109,974,738,703,577,593,4694,9355,12999,12999
Tuvalu,2048,TV,TUV,WPR,651,1238,1889,1179,1062,851,644,570,390,4696,610,1161,1771,1100,981,761,683,601,589,4715,9411,13075,13075
Tuvalu,2049,TV,TUV,WPR,650,1242,1892,1174,1067,864,637,579,394,4715,610,1165,1775,1099,992,787,664,616,596,4754,9469,13145,13145
Tuvalu,2050,TV,TUV,WPR,650,1250,1900,1171,1075,881,638,582,404,4751,609,1172,1781,1094,1001,806,651,632,610,4794,9545,13211,13211
United Republic of Tanzania,1970,TZ,TZA,AFR,1313510,1837025,3150535,1263161,908682,605095,399821,250051,154914,3581724,1290798,1834797,3125595,1323338,932357,616522,426419,274733,186966,3760335,7342059,13618192,13618192
United Republic of Tanzania,1971,TZ,TZA,AFR,1362511,1898736,3261247,1296632,947142,625315,415373,261939,162365,3708766,1338527,1897071,3235598,1367723,967259,630514,440288,285723,195091,3886598,7595364,14092218,14092218
United Republic of Tanzania,1972,TZ,TZA,AFR,1415505,1962119,3377624,1330831,989172,647352,432377,275291,170676,3845699,1390109,1961242,3351351,1415665,1005127,644092,454730,297533,203876,4021023,7866722,14595699,14595699
United Republic of Tanzania,1973,TZ,TZA,AFR,1471868,2028974,3500842,1367280,1030967,670840,449997,289089,179834,3988007,1445056,2028131,3473187,1466979,1044109,657804,469442,309698,213443,4161475,8149482,15123504,15123504
United Republic of Tanzania,1974,TZ,TZA,AFR,1531075,2101720,3632795,1407638,1068945,695127,467302,302294,189618,4130924,1502909,2099435,3602344,1522378,1081300,672138,484034,321688,223712,4305250,8436174,15671316,15671316
United Republic of Tanzania,1975,TZ,TZA,AFR,1592680,2179789,3772469,1450106,1107017,720650,484952,315892,199964,4278581,1563076,2175785,3738861,1580782,1119374,686830,498563,333919,234444,4453912,8732493,16243826,16243826
United Republic of Tanzania,1976,TZ,TZA,AFR,1654831,2263304,3918135,1493139,1146773,747891,503020,329873,210921,4431617,1623916,2257384,3881300,1638475,1161705,702619,512988,346405,245674,4607866,9039483,16838919,16838919
United Republic of Tanzania,1977,TZ,TZA,AFR,1717510,2352313,4069823,1538058,1186105,777042,521210,343748,222425,4588588,1685591,2343950,4029541,1695332,1207190,720554,527167,358956,257471,4766670,9355258,17454627,17454627
United Republic of Tanzania,1978,TZ,TZA,AFR,1780151,2448678,4228829,1584678,1221654,807695,538023,355676,234124,4741850,1747696,2435904,4183600,1746643,1255792,742554,540414,370618,269691,4925712,9667562,18080005,18080005
United Republic of Tanzania,1979,TZ,TZA,AFR,1839240,2553736,4392976,1633084,1249912,839133,551911,364173,245557,4883770,1806937,2534501,4341438,1789431,1306252,770283,551864,380581,282042,5080453,9964223,18698636,18698636
United Republic of Tanzania,1980,TZ,TZA,AFR,1892768,2659515,4552283,1679612,1271956,868432,562767,371699,256614,5011080,1861324,2639431,4500755,1836440,1353128,799123,560238,390168,294444,5233541,10244621,19297659,19297659
United Republic of Tanzania,1981,TZ,TZA,AFR,1942950,2762421,4705371,1725926,1291368,896183,572639,380110,267442,5133668,1912559,2747450,4660009,1894007,1395470,828297,566637,400378,307099,5391888,10525556,19890930,19890930
United Republic of Tanzania,1982,TZ,TZA,AFR,1991889,2867651,4859540,1777430,1310181,925245,583490,388605,278073,5263024,1962337,2856894,4819231,1955586,1436719,861958,573289,410635,319937,5558124,10821148,20499922,20499922
United Republic of Tanzania,1983,TZ,TZA,AFR,2043364,2985034,5028398,1848105,1332515,961205,598968,396047,288170,5425010,2013979,2966220,4980199,2007174,1484522,907883,584588,420309,332634,5737110,11162120,21170717,21170717
United Republic of Tanzania,1984,TZ,TZA,AFR,2093586,3101183,5194769,1927977,1358170,994273,615911,403772,297733,5597836,2064322,3075815,5140137,2064316,1534504,953195,597023,430097,345298,5924433,11522269,21857176,21857176
United Republic of Tanzania,1985,TZ,TZA,AFR,2143988,3216851,5360839,2020717,1385839,1028903,635464,411464,306767,5789154,2114260,3183327,5297587,2124102,1584611,1003606,612145,439731,357846,6122041,11911195,22569625,22569625
United Republic of Tanzania,1986,TZ,TZA,AFR,2196554,3334809,5531363,2130270,1415219,1068943,659330,419017,315218,6007997,2165259,3288431,5453690,2182147,1632514,1065201,632149,449069,370140,6331220,12339217,23324270,23324270
United Republic of Tanzania,1987,TZ,TZA,AFR,2249265,3450821,5700086,2248998,1447202,1108634,686191,427265,323105,6241395,2215752,3393789,5609541,2245462,1675366,1131014,655849,458509,382187,6548387,12789782,24099415,24099415
United Republic of Tanzania,1988,TZ,TZA,AFR,2299334,3554027,5853361,2359257,1481030,1137594,712093,437453,330948,6458375,2263799,3501590,5765389,2331136,1707210,1187065,678934,468509,394174,6767028,13225403,24844147,24844147
United Republic of Tanzania,1989,TZ,TZA,AFR,2344541,3635638,5980179,2450441,1516791,1154176,737623,451074,339348,6649453,2307187,3604705,5911892,2438297,1726922,1227441,701989,480240,406477,6981366,13630819,25522898,25522898
United Republic of Tanzania,1990,TZ,TZA,AFR,2390757,3713259,6104016,2541778,1558620,1172328,768556,465892,348237,6855411,2351126,3696765,6047891,2539190,1747896,1267740,732428,492454,418992,7198700,14054111,26206012,26206012
United Republic of Tanzania,1991,TZ,TZA,AFR,2438561,3788673,6227234,2629245,1606629,1186946,800717,481098,357596,7062231,2397101,3784360,6181461,2643344,1771509,1302317,766838,504284,431684,7419976,14482207,26890906,26890906
United Republic of Tanzania,1992,TZ,TZA,AFR,2487965,3862714,6350679,2713783,1660610,1198963,832877,496701,367312,7270246,2445413,3867783,6313196,2749969,1800044,1331215,804752,516039,444584,7646603,14916849,27580723,27580723
United Republic of Tanzania,1993,TZ,TZA,AFR,2555152,3987612,6542764,2841023,1732612,1218577,859287,501078,375937,7528514,2510553,3969385,6479938,2856256,1864036,1378768,843540,518796,456408,7917804,15446318,28469017,28469017
United Republic of Tanzania,1994,TZ,TZA,AFR,2642531,4172484,6815015,3020011,1826479,1249859,878690,493162,381888,7850089,2594853,4098778,6693631,2958580,1967406,1454306,881291,512097,465899,8239579,16089668,29598323,29598323
United Republic of Tanzania,1995,TZ,TZA,AFR,2713859,4303839,7017698,3155761,1917652,1275103,902169,499933,386953,8137571,2665599,4214182,6879781,3060308,2043881,1508070,921614,516813,474338,8525024,16662595,30560071,30560071
United Republic of Tanzania,1996,TZ,TZA,AFR,2752284,4328318,7080602,3195975,1990953,1284862,933483,533661,394413,8333347,2706405,4290060,6996465,3165886,2063518,1509371,965118,542326,484089,8730308,17063655,31140733,31140733
United Republic of Tanzania,1997,TZ,TZA,AFR,2801831,4371135,7172966,3241113,2070085,1298521,960555,564433,403763,8538470,2757196,4368169,7125365,3272003,2100197,1508480,1007670,566044,494649,8949043,17487513,31785846,31785846
United Republic of Tanzania,1998,TZ,TZA,AFR,2877891,4461863,7339754,3322756,2161593,1323034,980985,584909,413574,8786851,2832840,4459851,7292691,3375688,2172536,1522778,1048471,582850,504880,9207203,17994054,32626498,32626498
United Republic of Tanzania,1999,TZ,TZA,AFR,2965638,4551356,7516994,3402543,2255329,1353727,998782,607040,423913,9041334,2919922,4549106,7469028,3476805,2252931,1536909,1087767,602821,515175,9472408,18513742,33499772,33499772
United Republic of Tanzania,2000,TZ,TZA,AFR,3063033,4662635,7725668,3492762,2353667,1393640,1013003,627682,434390,9315144,3015835,4651495,7667330,3574019,2348518,1558967,1124608,624153,525308,9755573,19070717,34463704,34463704
United Republic of Tanzania,2001,TZ,TZA,AFR,3153167,4775527,7928694,3570439,2448217,1438814,1026137,653311,445585,9582503,3104943,4765519,7870462,3669267,2439643,1578037,1158091,652035,535739,10032812,19615315,35414469,35414469
United Republic of Tanzania,2002,TZ,TZA,AFR,3240779,4887118,8127897,3635337,2538699,1488851,1038474,682636,458092,9842089,3192394,4885522,8077916,3762766,2527418,1595057,1187446,685790,547153,10305630,20147719,36353531,36353531
United Republic of Tanzania,2003,TZ,TZA,AFR,3336534,5004792,8341326,3691871,2631325,1546529,1052546,710758,472018,10105047,3288291,5010650,8298941,3859134,2619698,1617871,1213842,718474,559580,10588599,20693646,37333918,37333918
United Republic of Tanzania,2004,TZ,TZA,AFR,3441452,5129861,8571313,3741128,2724037,1612250,1070568,736414,487290,10371687,3393172,5142463,8535635,3959595,2714707,1647455,1240383,747167,572939,10882246,21253933,38360879,38360879
United Republic of Tanzania,2005,TZ,TZA,AFR,3555422,5266887,8822309,3791404,2812503,1685093,1089655,760877,503891,10643423,3506392,5284254,8790646,4058499,2812807,1683712,1264971,775815,587327,11183131,21826554,39439505,39439505
United Republic of Tanzania,2006,TZ,TZA,AFR,3670646,5418505,9089151,3844269,2896371,1763839,1109262,785175,522061,10920977,3620073,5439035,9059108,4156628,2913657,1727268,1285252,806791,603217,11492813,22413790,40562052,40562052
United Republic of Tanzania,2007,TZ,TZA,AFR,3780840,5583543,9364383,3901213,2976486,1846606,1131169,808228,542004,11205706,3727902,5605686,9333588,4254246,3018136,1777875,1302761,838825,620973,11812816,23018522,41716497,41716497
United Republic of Tanzania,2008,TZ,TZA,AFR,3883597,5755583,9639180,3949019,3052419,1931562,1157973,831560,563969,11486502,3827570,5783880,9611450,4350139,3120534,1832042,1318409,871484,641145,12133753,23620255,42870884,42870884
United Republic of Tanzania,2009,TZ,TZA,AFR,3972061,5919783,9891844,3961198,3121168,2016637,1193945,859374,588723,11741045,3913129,5970131,9883260,4448443,3208075,1882538,1333615,904575,664535,12441781,24182826,43957933,43957933
United Republic of Tanzania,2010,TZ,TZA,AFR,4052193,6110379,10162572,3990894,3184040,2105070,1234277,883182,616031,12013494,3989483,6171046,10160529,4548805,3305538,1941401,1351139,935594,691458,12773935,24787429,45110527,45110527
United Republic of Tanzania,2011,TZ,TZA,AFR,4130954,6338970,10469924,4081819,3242842,2198325,1275835,897742,644932,12341495,4063311,6384499,10447810,4654170,3427419,2017721,1372381,963479,721631,13156801,25498296,46416031,46416031
United Republic of Tanzania,2012,TZ,TZA,AFR,4206626,6574453,10781079,4205070,3295852,2294416,1322501,909555,675010,12702404,4134279,6599857,10734136,4767135,3554283,2105843,1396741,989737,754770,13568509,26270913,47786137,47786137
United Republic of Tanzania,2013,TZ,TZA,AFR,4293783,6818894,11112677,4359582,3345614,2393907,1374392,919580,704356,13097431,4216396,6819191,11035587,4883827,3685742,2208425,1425110,1015775,789065,14007944,27105375,49253643,49253643
United Republic of Tanzania,2014,TZ,TZA,AFR,4400780,7062500,11463280,4536462,3395927,2493692,1433594,931062,731494,13522231,4317679,7039097,11356776,5009035,3816270,2321803,1458879,1044046,822228,14472261,27994492,50814552,50814552
United Republic of Tanzania,2015,TZ,TZA,AFR,4528625,7328983,11857608,4765599,3450549,2594477,1497040,937902,757367,14002934,4438640,7266944,11705584,5139426,3957575,2453101,1499515,1071184,855896,14976697,28979631,52542823,52542823
United Republic of Tanzania,2016,TZ,TZA,AFR,4672852,7600922,12273774,5041478,3512402,2695311,1565696,941967,782597,14539451,4575392,7493363,12068755,5281502,4102049,2601122,1547306,1095889,891950,15519818,30059269,54401802,54401802
United Republic of Tanzania,2017,TZ,TZA,AFR,4826743,7839296,12666039,5318140,3582598,2792750,1643498,952816,807069,15096871,4722308,7703302,12425610,5444475,4226456,2755025,1601663,1120899,930000,16078518,31175389,56267032,56267032
United Republic of Tanzania,2018,TZ,TZA,AFR,4973262,8048400,13021662,5578109,3659731,2883889,1730809,973832,831304,15657674,4862840,7904181,12767021,5634565,4321546,2908159,1662975,1146689,970154,16644088,32301762,58090443,58090443
United Republic of Tanzania,2019,TZ,TZA,AFR,5098973,8243671,13342644,5822792,3744962,2965485,1826628,1005286,855636,16220789,4983282,8105535,13088817,5854518,4390716,3056030,1732826,1173542,1012691,17220323,33441112,59872579,59872579
United Republic of Tanzania,2020,TZ,TZA,AFR,5216680,8450756,13667436,6078291,3850540,3038985,1924835,1039520,875845,16808016,5095691,8311200,13406891,6087681,4465243,3204330,1811774,1199077,1054071,17822176,34630192,61704518,61704518
United Republic of Tanzania,2021,TZ,TZA,AFR,5331660,8670580,14002240,6336118,3985229,3105100,2022735,1075744,890482,17415408,5205644,8521308,13726952,6319256,4558020,3352476,1898818,1223160,1092000,18443730,35859138,63588334,63588334
United Republic of Tanzania,2022,TZ,TZA,AFR,5444062,8900759,14344821,6583172,4139895,3161783,2121097,1116658,903509,18026114,5313592,8739753,14053345,6546274,4660102,3494989,1995022,1247925,1129168,19073480,37099594,65497748,65497748
United Republic of Tanzania,2023,TZ,TZA,AFR,5555160,9138107,14693267,6820054,4309099,3211671,2220934,1163993,918192,18643943,5420979,8965063,14386042,6770758,4768095,3630087,2102217,1275546,1168145,19714848,38358791,67438106,67438106
United Republic of Tanzania,2024,TZ,TZA,AFR,5662168,9379319,15041487,7050720,4494852,3260652,2320536,1219181,936644,19282585,5525089,9193725,14718814,6993492,4887021,3758103,2219327,1308127,1210124,20376194,39658779,69419073,69419073
United Republic of Tanzania,2025,TZ,TZA,AFR,5761559,9624412,15385971,7274553,4694857,3311169,2417392,1282145,958936,19939052,5622398,9426511,15048909,7211477,5020169,3876451,2344406,1346798,1254572,21053873,40992925,71427810,71427810
United Republic of Tanzania,2026,TZ,TZA,AFR,5855711,9875150,15730861,7486334,4909155,3366727,2510364,1351674,983866,20608120,5714863,9665749,15380612,7418061,5171320,3985292,2476405,1391861,1299921,21742860,42350980,73462459,73462459
United Republic of Tanzania,2027,TZ,TZA,AFR,5945904,10135178,16081082,7686052,5133769,3430459,2599379,1426051,1010649,21286359,5803502,9915087,15718589,7612445,5339277,4085311,2614953,1443172,1345115,22440273,43726632,75526304,75526304
United Republic of Tanzania,2028,TZ,TZA,AFR,6033050,10391592,16424642,7887922,5368671,3501383,2683517,1504483,1040012,21985988,5889113,10161952,16051065,7807633,5526200,4174058,2758576,1501245,1390420,23158132,45144120,77619828,77619828
United Republic of Tanzania,2029,TZ,TZA,AFR,6119540,10628242,16747782,8101676,5617008,3580445,2760382,1586933,1072712,22719156,5973986,10390337,16364323,8013212,5735547,4252044,2904298,1567268,1436209,23908578,46627734,79739837,79739837
United Republic of Tanzania,2030,TZ,TZA,AFR,6207720,10848295,17056015,8319698,5871307,3677605,2829060,1672812,1109249,23479731,6060568,10603663,16664231,8221875,5959036,4330466,3049499,1641665,1482792,24685333,48165064,81885304,81885304
United Republic of Tanzania,1950,TZ,TZA,AFR,708537,1014045,1722582,725529,506956,345491,223520,129995,72907,2004398,714967,1047088,1762055,751121,532995,367022,245309,151849,95069,2143365,4147763,7632399,7632399
United Republic of Tanzania,1951,TZ,TZA,AFR,722128,1045613,1767741,745324,520892,354788,230042,134339,75792,2061177,723542,1080105,1803647,771781,546971,376816,252026,156264,98381,2202239,4263416,7834799,7834799
United Republic of Tanzania,1952,TZ,TZA,AFR,736550,1078477,1815027,765919,535294,364318,236703,138743,78779,2119756,732860,1114488,1847348,793372,561385,386881,258938,160770,101798,2263144,4382900,8045274,8045274
United Republic of Tanzania,1953,TZ,TZA,AFR,754571,1110097,1864668,787141,550132,374083,243487,143191,81860,2179894,746277,1147033,1893310,815688,576254,397202,266028,165355,105309,2325836,4505730,8263710,8263710
United Republic of Tanzania,1954,TZ,TZA,AFR,778491,1138611,1917102,808610,565423,384124,250409,147713,85047,2241326,767955,1173933,1941888,838328,591637,407778,273308,170035,108922,2390008,4631334,8490322,8490322
United Republic of Tanzania,1955,TZ,TZA,AFR,804991,1167555,1972546,830322,581155,394460,257478,152320,88335,2304070,793968,1199277,1993245,861315,607549,418618,280789,174824,112620,2455715,4759785,8725576,8725576
United Republic of Tanzania,1956,TZ,TZA,AFR,831725,1199138,2030863,852649,597411,405120,264702,157017,91727,2368626,820175,1227029,2047204,885006,624028,429712,288446,179710,116406,2523308,4891934,8970007,8970007
United Republic of Tanzania,1957,TZ,TZA,AFR,859745,1232163,2091908,875878,614265,416103,272083,161809,95231,2435369,847607,1256037,2103644,909700,641174,441114,296299,184717,120299,2593303,5028672,9224220,9224220
United Republic of Tanzania,1958,TZ,TZA,AFR,888665,1266431,2155096,900344,631626,427421,279606,166688,98824,2504509,875889,1286128,2162017,935706,658967,452850,304357,189862,124306,2666048,5170557,9487672,9487672
United Republic of Tanzania,1959,TZ,TZA,AFR,918311,1301610,2219921,926526,649362,439156,287300,171688,102515,2576547,904878,1316989,2221867,963466,677265,464888,312629,195158,128430,2741836,5318383,9760165,9760165
United Republic of Tanzania,1960,TZ,TZA,AFR,948718,1337581,2286299,954819,667432,451349,295209,176845,106302,2651956,934659,1348580,2283239,993431,695919,477184,321113,200640,132666,2820953,5472909,10042458,10042458
United Republic of Tanzania,1961,TZ,TZA,AFR,980164,1374174,2354338,985201,686674,464130,303662,182563,110237,2732467,965408,1380978,2346386,1026545,715055,489560,329967,206522,137047,2904696,5637163,10337891,10337891
United Republic of Tanzania,1962,TZ,TZA,AFR,1012416,1412624,2425040,1016666,706841,477366,312380,188447,114350,2816050,996921,1414820,2411741,1061072,735263,502236,339085,212559,141570,2991785,5807835,10644622,10644622
United Republic of Tanzania,1963,TZ,TZA,AFR,1045399,1455760,2501159,1046624,727167,490903,321042,194094,118579,2898409,1029239,1453298,2482537,1092855,756581,515490,348334,218570,146221,3078051,5976460,10960161,10960161
United Republic of Tanzania,1964,TZ,TZA,AFR,1079721,1504802,2584523,1073765,748301,505032,330243,200250,122973,2980564,1062844,1500187,2563031,1120257,778221,528988,357949,224974,151042,3161431,6141995,11289556,11289556
United Republic of Tanzania,1965,TZ,TZA,AFR,1114928,1557179,2672107,1101114,769741,519616,339699,206507,127527,3064204,1097286,1551999,2649285,1146080,800506,542953,367820,231587,156068,3245014,6309218,11630603,11630603
United Republic of Tanzania,1966,TZ,TZA,AFR,1150808,1611117,2761925,1130623,791269,534593,349109,212504,132184,3150282,1132381,1604990,2737371,1173117,824027,557745,377894,238263,161307,3332353,6482635,11981932,11981932
United Republic of Tanzania,1967,TZ,TZA,AFR,1187290,1667147,2854437,1161536,813633,550209,358802,218683,136969,3239832,1168097,1660097,2828194,1201354,848802,573323,388330,245239,166787,3423835,6663667,12346286,12346286
United Republic of Tanzania,1968,TZ,TZA,AFR,1225959,1722674,2948633,1194751,840553,567306,370670,227350,142199,3342829,1205740,1716665,2922405,1236913,874182,588400,399985,253837,172779,3526096,6868925,12739965,12739965
United Republic of Tanzania,1969,TZ,TZA,AFR,1268091,1778341,3046432,1229276,873079,585887,384919,238557,148194,3459912,1246608,1774734,3021342,1279684,901326,602529,412949,264095,179521,3640104,7100016,13167782,13167782
United Republic of Tanzania,2031,TZ,TZA,AFR,6299417,11058548,17357965,8539999,6119064,3802195,2890253,1760660,1149991,24262162,6150736,10808580,16959316,8431945,6183694,4420481,3192360,1723929,1530501,25482910,49745072,84062352,84062352
United Republic of Tanzania,2032,TZ,TZA,AFR,6392799,11261394,17654193,8768494,6358357,3949809,2944093,1850154,1194958,25065865,6242584,11007080,17249664,8649802,6406859,4520015,3329997,1814962,1579523,26301158,51367023,86270886,86270886
United Republic of Tanzania,2033,TZ,TZA,AFR,6487098,11459248,17946346,9004350,6591238,4114853,2992856,1941072,1244301,25888670,6335283,11201276,17536559,8874643,6629413,4626976,3461030,1915956,1630244,27138262,53026932,88509837,88509837
United Republic of Tanzania,2034,TZ,TZA,AFR,6586548,11652011,18238559,9244110,6818325,4296144,3040696,2031131,1298704,26729110,6433081,11390913,17823994,9102910,6850495,4744874,3585267,2025623,1683763,27992932,54722042,90784591,90784591
United Republic of Tanzania,2035,TZ,TZA,AFR,6688403,11839769,18528172,9488098,7039375,4491781,3090230,2118378,1358582,27586444,6533210,11576263,18109473,9335654,7067438,4877204,3700551,2142436,1741167,28864450,56450894,93088536,93088536
United Republic of Tanzania,2036,TZ,TZA,AFR,6785779,12026643,18812422,9737931,7249063,4701693,3144827,2202103,1423897,28459514,6628917,11761096,18390013,9575068,7273504,5027522,3807018,2265660,1803269,29752041,58211555,95413992,95413992
United Republic of Tanzania,2037,TZ,TZA,AFR,6881045,12211253,19092298,9996921,7446984,4921720,3207340,2282412,1494235,29349612,6722626,11943749,18666375,9824517,7467599,5194386,3905200,2395063,1870544,30657309,60006921,97765602,97765602
United Republic of Tanzania,2038,TZ,TZA,AFR,6973931,12393736,19367667,10252359,7647129,5151793,3276799,2358479,1569449,30256008,6813957,12124205,18938162,10071550,7662589,5379877,3992707,2529280,1943678,31579681,61835689,100141517,100141517
United Republic of Tanzania,2039,TZ,TZA,AFR,7060946,12580730,19641676,10488317,7859104,5394963,3354026,2428217,1650006,31174633,6899506,12308947,19208453,10300288,7867985,5587368,4070000,2665598,2023972,32515211,63689844,102539970,102539970
United Republic of Tanzania,2040,TZ,TZA,AFR,7143849,12771806,19915655,10707878,8075389,5644058,3448529,2490807,1735685,32102346,6981039,12497703,19478742,10514114,8076548,5808828,4147914,2801565,2111978,33460947,65563293,104957697,104957697
United Republic of Tanzania,2041,TZ,TZA,AFR,7223336,12961902,20185238,10917748,8294003,5887001,3569220,2546882,1825510,33040364,7058971,12685596,19744567,10719600,8286595,6031598,4237247,2935493,2207641,34418174,67458538,107388342,107388342
United Republic of Tanzania,2042,TZ,TZA,AFR,7299050,13151584,20450634,11120321,8520737,6121853,3711824,2596581,1919101,33990417,7133045,12873085,20006130,10918738,8504406,6253007,4335934,3064718,2311817,35388620,69379037,109835803,109835803
United Republic of Tanzania,2043,TZ,TZA,AFR,7375631,13339824,20715455,11317986,8754756,6350561,3870987,2642048,2016298,34952636,7208177,13058982,20267159,11113607,8729171,6473883,4441931,3188037,2425757,36372386,71325022,112307641,112307641
United Republic of Tanzania,2044,TZ,TZA,AFR,7449492,13527301,20976793,11510633,8992675,6573750,4045652,2687018,2115662,35925390,7280697,13244114,20524811,11303953,8957376,6693409,4558648,3305289,2549220,37367895,73293285,114794893,114794893
United Republic of Tanzania,2045,TZ,TZA,AFR,7518531,13713069,21231600,11698358,9234805,6791170,4233976,2733775,2215779,36907863,7348384,13427542,20775926,11490042,9190054,6908966,4689405,3414417,2681693,38374577,75282440,117289963,117289963
United Republic of Tanzania,2046,TZ,TZA,AFR,7589857,13891059,21480916,11885236,9482716,6997647,4435971,2785395,2316063,37903028,7418377,13603006,21021383,11675629,9429358,7113943,4837669,3515604,2823161,39395364,77298392,119800689,119800689
United Republic of Tanzania,2047,TZ,TZA,AFR,7657922,14063215,21721137,12069887,9739638,7192753,4647704,2844518,2416378,38910878,7485168,13772544,21257712,11859026,9678583,7307218,5002022,3609414,2973858,40430121,79340999,122319850,122319850
United Republic of Tanzania,2048,TZ,TZA,AFR,7717500,14233865,21951365,12252423,9993067,7390130,4868995,2910163,2516015,39930793,7543511,13940642,21484153,12040194,9925378,7501440,5184394,3693602,3133241,41478249,81409042,124844557,124844557
United Republic of Tanzania,2049,TZ,TZA,AFR,7776290,14395920,22172210,12439369,10227317,7599201,5102720,2982971,2613760,40965338,7600834,14100281,21701115,12225554,10154018,7706001,5388014,3768616,3300096,42542299,83507637,127380963,127380963
United Republic of Tanzania,2050,TZ,TZA,AFR,7839250,14549022,22388272,12630299,10445380,7812619,5342285,3071682,2709037,42011302,7661858,14251004,21912862,12414810,10367797,7913735,5605245,3844700,3472789,43619076,85630378,129931520,129931520
Uganda,1970,UG,UGA,AFR,993749,1415633,2409382,988959,567578,464778,354657,228838,132330,2737140,987779,1427467,2415246,991353,585366,492931,353358,209621,122804,2755433,5492573,10317212,10317212
Uganda,1971,UG,UGA,AFR,1027928,1458031,2485959,1026859,579100,464916,359439,234877,137677,2802868,1022012,1469786,2491798,1033528,593485,497759,363166,218820,128957,2835715,5638583,10616338,10616338
Uganda,1972,UG,UGA,AFR,1059038,1502325,2561363,1057419,589667,461504,362479,239721,142451,2853241,1053304,1513975,2567279,1069157,601325,499080,371719,227550,134857,2903688,5756929,10885563,10885563
Uganda,1973,UG,UGA,AFR,1087912,1548731,2636643,1083069,604044,456428,364851,244227,147523,2900142,1082517,1560706,2643223,1098925,612786,497695,379431,236090,141163,2966090,5866232,11146099,11146099
Uganda,1974,UG,UGA,AFR,1114961,1597900,2712861,1107721,628106,452290,367407,248614,152991,2957129,1109948,1610348,2720296,1127689,634547,496158,387305,244715,147988,3038402,5995531,11428676,11428676
Uganda,1975,UG,UGA,AFR,1141737,1649221,2790958,1134440,657009,449070,369936,252816,158716,3021987,1137170,1662311,2799481,1156692,663713,494397,395150,253329,155250,3118531,6140518,11730959,11730959
Uganda,1976,UG,UGA,AFR,1168927,1701693,2870620,1164625,686820,446551,372213,256975,164772,3091956,1164913,1715966,2880879,1186682,695872,491915,402469,261826,163008,3201772,6293728,12045227,12045227
Uganda,1977,UG,UGA,AFR,1195533,1755076,2950609,1196583,718991,445057,373987,260906,170817,3166341,1192085,1770675,2962760,1218653,731056,489389,409240,270187,171029,3289554,6455895,12369253,12369253
Uganda,1978,UG,UGA,AFR,1221883,1808922,3030805,1229900,752971,444811,374989,264449,176522,3243642,1219021,1825635,3044656,1252911,769533,487416,415448,278437,179149,3382894,6626536,12701999,12701999
Uganda,1979,UG,UGA,AFR,1248622,1861491,3110113,1260030,782276,444234,373989,267154,181424,3309107,1246399,1879085,3125484,1284374,804492,484932,419912,286149,186945,3466804,6775911,13011511,13011511
Uganda,1980,UG,UGA,AFR,1273255,1912197,3185452,1286241,803887,443099,370474,268836,185398,3357935,1271710,1930808,3202518,1312684,833263,482357,422109,293170,194531,3538114,6896049,13284026,13284026
Uganda,1981,UG,UGA,AFR,1296761,1961974,3258735,1316150,824275,444877,365980,270116,189020,3410418,1295944,1981773,3277717,1345718,862414,483093,423203,299972,202289,3616689,7027107,13563558,13563558
Uganda,1982,UG,UGA,AFR,1324742,2010655,3335397,1353232,846139,452150,361469,271328,192627,3476945,1324701,2031794,3356495,1386569,894179,489704,423745,306780,210236,3711213,7188158,13880052,13880052
Uganda,1983,UG,UGA,AFR,1358633,2057899,3416532,1396179,867087,465637,356844,272292,196042,3554081,1359188,2080533,3439721,1433878,925923,503554,423536,313476,218232,3818599,7372680,14228932,14228932
Uganda,1984,UG,UGA,AFR,1398607,2105382,3503989,1445326,887960,486723,352640,273186,199379,3645214,1399390,2129610,3529000,1487070,957510,526134,422724,320047,226264,3939749,7584963,14617944,14617944
Uganda,1985,UG,UGA,AFR,1447563,2153920,3601483,1497772,910089,510408,348673,273935,202773,3743650,1448261,2179750,3628011,1542214,987896,553868,420983,326320,234489,4065770,7809420,15038915,15038915
Uganda,1986,UG,UGA,AFR,1505475,2204152,3709627,1552167,934961,533590,344969,274344,206152,3846183,1505877,2231693,3737570,1598092,1018516,583540,418374,332053,242847,4193422,8039605,15486807,15486807
Uganda,1987,UG,UGA,AFR,1569637,2257855,3827492,1610648,965076,559312,342448,274559,209601,3961644,1569828,2287262,3857090,1656044,1052337,615892,415594,337099,251030,4327996,8289640,15974216,15974216
Uganda,1988,UG,UGA,AFR,1637822,2316338,3954160,1670168,999357,586971,341132,274417,213035,4085080,1638229,2347602,3985831,1713101,1087896,650281,412779,341272,258930,4464259,8549339,16489323,16489323
Uganda,1989,UG,UGA,AFR,1707797,2381745,4089542,1728201,1037140,615350,341661,273594,216192,4212138,1708645,2414709,4123354,1769181,1126213,685799,411323,344458,266536,4603510,8815648,17028543,17028543
Uganda,1990,UG,UGA,AFR,1777844,2455325,4233169,1784369,1077944,643328,344557,272034,219001,4341233,1778898,2489922,4268820,1823845,1166590,720790,412120,346402,273657,4743404,9084637,17586630,17586630
Uganda,1991,UG,UGA,AFR,1846999,2538218,4385217,1839797,1123397,671432,350293,269969,221579,4476467,1847654,2574533,4422187,1878452,1210654,755688,415748,347182,280343,4888067,9364534,18171935,18171935
Uganda,1992,UG,UGA,AFR,1917144,2631356,4548500,1895637,1175866,700179,360097,267732,224081,4623592,1916564,2669579,4586143,1934352,1260953,790941,423704,347045,286739,5043734,9667326,18801966,18801966
Uganda,1993,UG,UGA,AFR,1989513,2733631,4723144,1949380,1232912,727462,374543,265256,226271,4775824,1986928,2773915,4760843,1988638,1315024,823973,437074,345818,292611,5203138,9978962,19462958,19462958
Uganda,1994,UG,UGA,AFR,2062460,2842777,4905237,1998518,1288923,750620,393306,262275,227738,4921380,2057406,2884999,4942405,2038674,1367760,852282,456130,343375,297782,5356003,10277383,20125021,20125021
Uganda,1995,UG,UGA,AFR,2132097,2956225,5088322,2028628,1325737,764215,409458,257398,227088,5012524,2124508,2999932,5124440,2068680,1401161,869919,475743,338757,301283,5455543,10468067,20680831,20680831
Uganda,1996,UG,UGA,AFR,2198033,3075942,5273975,2061177,1362448,779816,425000,252702,226107,5107250,2188375,3120607,5308982,2101673,1434648,887935,497016,333678,304416,5559366,10666616,21249572,21249572
Uganda,1997,UG,UGA,AFR,2260313,3202347,5462660,2105115,1405534,800286,442775,249136,225409,5228255,2249031,3247389,5496420,2147015,1474762,910257,521028,328969,307565,5689596,10917851,21876935,21876935
Uganda,1998,UG,UGA,AFR,2319305,3334580,5653885,2157308,1449530,823726,461862,246500,224513,5363439,2306727,3379568,5686295,2200944,1516157,935016,546999,324594,310324,5834034,11197473,22537658,22537658
Uganda,1999,UG,UGA,AFR,2378894,3471226,5850120,2225846,1500757,853990,483148,246129,223933,5533803,2365525,3515850,5881375,2271911,1565485,965880,575333,322224,313118,6013951,11547754,23279247,23279247
Uganda,2000,UG,UGA,AFR,2438743,3608395,6047138,2298513,1546667,885112,503388,247351,222614,5703645,2425088,3652143,6077231,2346592,1609796,996967,602611,321724,315001,6192691,11896336,24020697,24020697
Uganda,2001,UG,UGA,AFR,2501898,3742156,6244054,2376620,1587454,917364,522520,250274,220674,5874906,2488432,3784483,6272915,2426308,1649043,1028292,628602,323253,315953,6371451,12246357,24763325,24763325
Uganda,2002,UG,UGA,AFR,2570192,3873369,6443561,2466215,1628153,953549,541343,256011,218689,6063960,2557464,3913566,6471030,2517733,1688303,1062404,653736,328010,316355,6566541,12630501,25545090,25545090
Uganda,2003,UG,UGA,AFR,2640683,4004068,6644751,2564974,1667717,993092,558965,265317,216643,6266708,2629057,4041437,6670494,2618408,1726276,1098548,676449,337061,316041,6772783,13039491,26354736,26354736
Uganda,2004,UG,UGA,AFR,2712028,4134781,6846809,2664268,1700310,1031408,573454,277966,214002,6461408,2701351,4168968,6870319,2718477,1756713,1132338,694789,350597,314634,6967548,13428956,27146084,27146084
Uganda,2005,UG,UGA,AFR,2782386,4267608,7049994,2768665,1730729,1069797,588138,291877,211274,6660480,2772240,4298572,7070812,2822848,1784992,1165712,711543,367472,312736,7165303,13825783,27946588,27946588
Uganda,2006,UG,UGA,AFR,2850941,4403095,7254036,2879926,1762521,1109198,605253,305641,208798,6871337,2840492,4431237,7271729,2933701,1815467,1200466,729568,386104,310825,7376131,14247468,28773227,28773227
Uganda,2007,UG,UGA,AFR,2917729,4540762,7458491,2998568,1798200,1148796,624150,320223,206715,7096652,2905620,4566717,7472337,3051509,1850549,1235832,749264,406184,308980,7602318,14698970,29629804,29629804
Uganda,2008,UG,UGA,AFR,2982700,4678529,7661229,3124546,1838970,1187030,644760,335550,205125,7335981,2967500,4702821,7670321,3176334,1890892,1270100,770241,427525,307245,7842337,15178318,30509862,30509862
Uganda,2009,UG,UGA,AFR,3046404,4818337,7864741,3254637,1886002,1222599,667071,351042,204370,7585721,3027295,4840909,7868204,3305133,1937824,1302499,792692,449367,306334,8093849,15679570,31412520,31412520
Uganda,2010,UG,UGA,AFR,3111365,4958966,8070331,3386998,1940796,1256202,691448,366312,204782,7846538,3087704,4979641,8067345,3435955,1992983,1333830,816933,470990,306820,8357511,16204049,32341728,32341728
Uganda,2011,UG,UGA,AFR,3177351,5101597,8278948,3517638,2004619,1288323,718385,381441,206506,8116912,3148645,5120158,8268803,3564727,2057549,1364298,843247,492384,308873,8631078,16747990,33295738,33295738
Uganda,2012,UG,UGA,AFR,3242503,5246726,8489229,3646239,2078090,1318400,747980,396220,210018,8396947,3209031,5262477,8471508,3691111,2132555,1393619,871904,513281,313147,8915617,17312564,34273295,34273295
Uganda,2013,UG,UGA,AFR,3306357,5391799,8698156,3775111,2161065,1346761,780143,410047,215927,8689054,3268390,5403768,8672158,3817497,2217910,1422232,903100,532851,320606,9214196,17903250,35273570,35273570
Uganda,2014,UG,UGA,AFR,3367224,5538627,8905851,3912076,2259516,1378838,815737,423319,225097,9014583,3324545,5545673,8870218,3952254,2318689,1454600,937162,551015,332158,9545878,18560461,36336539,36336539
Uganda,2015,UG,UGA,AFR,3424290,5687517,9111807,4059669,2376355,1416960,854822,438084,235863,9381753,3376613,5688588,9065201,4098236,2437607,1492817,974160,569184,346589,9918593,19300346,37477356,37477356
Uganda,2016,UG,UGA,AFR,3481785,5838176,9319961,4224085,2518613,1465956,898720,456239,247670,9811283,3428827,5832050,9260877,4262830,2582286,1542234,1015999,589799,363037,10356185,20167468,38748299,38748299
Uganda,2017,UG,UGA,AFR,3545126,5988005,9533131,4398600,2681865,1525927,945957,477067,260810,10290226,3486240,5973185,9459425,4438766,2747845,1602653,1061067,612914,381055,10844300,21134526,40127085,40127085
Uganda,2018,UG,UGA,AFR,3617554,6134058,9751612,4564187,2849354,1590516,992245,499304,273891,10769497,3552207,6108861,9661068,4605365,2917433,1667917,1105476,637392,399634,11333217,22102714,41515395,41515395
Uganda,2019,UG,UGA,AFR,3700316,6275339,9975655,4728729,3023844,1664244,1038012,523668,287459,11265956,3628651,6238482,9867133,4770525,3094220,1742600,1149836,663947,419213,11840341,23106297,42949080,42949080
Uganda,2020,UG,UGA,AFR,3790712,6412607,10203319,4888791,3200415,1747257,1083117,549754,300431,11769765,3713290,6363021,10076311,4930450,3272949,1826838,1193985,692162,438819,12355203,24124968,44404611,44404611
Uganda,2021,UG,UGA,AFR,3886065,6547723,10433788,5042654,3370603,1838433,1126413,577061,311681,12266845,3803623,6484659,10288282,5083247,3445237,1920090,1237253,721665,457365,12864857,25131702,45853778,45853778
Uganda,2022,UG,UGA,AFR,3977613,6683452,10661065,5184693,3525097,1934352,1166326,606241,323558,12740267,3891226,6606729,10497955,5222154,3601381,2019261,1277857,752763,476880,13350296,26090563,47249585,47249585
Uganda,2023,UG,UGA,AFR,4056368,6825227,10881595,5313781,3663767,2033918,1203179,637514,337041,13189200,3967275,6734917,10702192,5345716,3740969,2123034,1315748,785634,498242,13809343,26998543,48582334,48582334
Uganda,2024,UG,UGA,AFR,4121982,6972333,11094315,5445134,3800553,2142036,1240638,670515,351405,13650281,4030952,6869029,10899981,5470298,3878333,2235738,1354648,820045,520611,14279673,27929954,49924252,49924252
Uganda,2025,UG,UGA,AFR,4175415,7121398,11296813,5581104,3938005,2259808,1279983,704960,366740,14130600,4082924,7005824,11088748,5598627,4016121,2358221,1395769,855809,543967,14768514,28899114,51284671,51284671
Uganda,2026,UG,UGA,AFR,4218437,7272939,11491376,5720898,4076571,2386444,1322246,740706,383137,14630002,4124856,7145775,11270631,5729861,4155050,2489447,1440175,892927,568309,15275769,29905771,52667779,52667779
Uganda,2027,UG,UGA,AFR,4253487,7425507,11678994,5862875,4216170,2521620,1369100,777121,400877,15147763,4158946,7287687,11446633,5862382,4295185,2629040,1489594,930776,593911,15800888,30948651,54074276,54074276
Uganda,2028,UG,UGA,AFR,4284986,7576620,11861606,6005550,4354464,2664802,1421748,813346,420099,15680009,4189579,7429450,11619029,5994624,4433984,2776720,1545184,968524,620862,16339898,32019907,55500544,55500544
Uganda,2029,UG,UGA,AFR,4315513,7723830,12039343,6145155,4492829,2812788,1481683,848756,440886,16222097,4219376,7568877,11788253,6122988,4572270,2929274,1608455,1005632,649246,16887865,33109962,56937558,56937558
Uganda,2030,UG,UGA,AFR,4344093,7865826,12209919,6282159,4630698,2963389,1550232,883865,463418,16773761,4247398,7704504,11951902,6248037,4709434,3084338,1680891,1042719,679254,17444673,34218434,58380262,58380262
Uganda,1950,UG,UGA,AFR,538942,657782,1196724,569294,466868,339860,203179,94263,93656,1767120,517267,663483,1180750,580491,436808,281307,162477,73552,71407,1606042,3373162,5750637,5750637
Uganda,1951,UG,UGA,AFR,568346,676365,1244711,571277,472718,348106,210682,98525,92451,1793759,550941,677047,1227988,586659,447402,292030,168665,77656,70953,1643365,3437124,5909819,5909819
Uganda,1952,UG,UGA,AFR,594570,700690,1295260,573014,478511,355949,218395,103428,91180,1820477,581446,696182,1277628,591918,457876,302830,175118,82296,70431,1680469,3500946,6073833,6073833
Uganda,1953,UG,UGA,AFR,616265,732431,1348696,574762,484218,363361,226288,108928,89837,1847394,607333,722974,1330307,596323,468269,313649,181946,87448,69853,1717488,3564882,6243883,6243883
Uganda,1954,UG,UGA,AFR,632119,772584,1404703,576758,489796,370326,234354,115005,88442,1874681,627307,758666,1385973,599925,478593,324430,189229,93092,69248,1754517,3629198,6419882,6419882
Uganda,1955,UG,UGA,AFR,646716,816196,1462912,579319,495198,376917,242581,121662,87017,1902694,643852,800542,1444394,602922,488817,335170,197017,99227,68633,1791786,3694480,6601785,6601785
Uganda,1956,UG,UGA,AFR,663280,859810,1523090,582860,500361,383255,250912,128720,85784,1931892,660135,845296,1505431,605715,498860,345917,205330,105701,68203,1829726,3761618,6790145,6790145
Uganda,1957,UG,UGA,AFR,679997,905086,1585083,587812,505194,389452,259271,135956,84981,1962666,676643,892458,1569101,608770,508630,356763,214199,112358,68219,1868939,3831605,6985793,6985793
Uganda,1958,UG,UGA,AFR,696807,951854,1648661,594626,509623,395658,267618,143230,84858,1995613,693301,941905,1635206,612526,518005,367744,223608,119057,68852,1909792,3905405,7189279,7189279
Uganda,1959,UG,UGA,AFR,714059,998822,1712881,604606,513636,402035,275946,150043,85958,2032224,710396,992039,1702435,618601,526814,378869,233529,125314,70614,1953741,3985965,7401282,7401282
Uganda,1960,UG,UGA,AFR,731321,1044322,1775643,618461,517015,408458,284087,156396,88189,2072606,727502,1040860,1768362,628097,534708,389955,243798,131144,73433,2001135,4073741,7617746,7617746
Uganda,1961,UG,UGA,AFR,748629,1087921,1836550,636441,519876,414897,292010,162859,90978,2117061,744616,1087965,1832581,641416,541639,400981,254327,137102,76781,2052246,4169307,7838440,7838440
Uganda,1962,UG,UGA,AFR,766971,1129096,1896067,659958,522675,421515,299832,169652,94202,2167834,762705,1132888,1895593,660124,547891,412154,265161,143453,80558,2109341,4277175,8068828,8068828
Uganda,1963,UG,UGA,AFR,787025,1166605,1953630,690599,525516,428251,307540,176775,97834,2226515,782461,1174152,1956613,686186,553381,423463,276231,150268,84733,2174262,4400777,8311013,8311013
Uganda,1964,UG,UGA,AFR,809002,1199412,2008414,729285,528496,434949,315035,184175,101842,2293782,804133,1210671,2014804,720750,558010,434783,287408,157555,89255,2247761,4541543,8564755,8564755
Uganda,1965,UG,UGA,AFR,833304,1231394,2064698,771293,531830,441395,322211,191730,106181,2364640,828163,1244393,2072556,761249,561931,445976,298593,165310,94105,2327164,4691804,8829056,8829056
Uganda,1966,UG,UGA,AFR,860477,1265588,2126065,813339,535868,447447,329072,199330,110808,2435864,855078,1278286,2133364,804597,565506,456883,309732,173485,99249,2409452,4845316,9104743,9104743
Uganda,1967,UG,UGA,AFR,890529,1300764,2191293,857037,541103,453075,335763,206949,115772,2509699,884890,1313188,2198078,850295,569131,467333,320840,182055,104711,2494365,5004064,9393432,9393432
Uganda,1968,UG,UGA,AFR,923528,1337233,2260761,902229,547989,458203,342374,214527,121093,2586415,917720,1349403,2267123,898212,573236,477192,331928,191007,110501,2582076,5168491,9696370,9696370
Uganda,1969,UG,UGA,AFR,958287,1375364,2333651,946832,556819,462265,348741,221869,126642,2663168,952363,1387318,2339681,945979,578519,485910,342830,200239,116553,2670030,5333198,10006526,10006526
Uganda,2031,UG,UGA,AFR,4368412,8002376,12370788,6418399,4769866,3112110,1628203,918768,487874,17335220,4271518,7835846,12107364,6371738,4847306,3237228,1763497,1079899,711105,18010773,35345993,59824141,59824141
Uganda,2032,UG,UGA,AFR,4391729,8128708,12520437,6557287,4911557,3257921,1716032,953014,514307,17910118,4294837,7958160,12252997,6498074,4986742,3386669,1856895,1116671,744887,18589938,36500056,61273497,61273497
Uganda,2033,UG,UGA,AFR,4413751,8241021,12654772,6703931,5054099,3401990,1813235,986772,542699,18502726,4316829,8067719,12384548,6632330,5125880,3533822,1960616,1153214,780690,19186552,37689278,62728594,62728594
Uganda,2034,UG,UGA,AFR,4432963,8339532,12772495,6855348,5198829,3545060,1918663,1021313,572581,19111794,4335998,8164351,12500349,6771901,5266071,3679713,2073224,1190937,818075,19799921,38911715,64184560,64184560
Uganda,2035,UG,UGA,AFR,4454671,8423895,12878566,7008056,5346242,3687847,2032536,1057401,603615,19735697,4357597,8247481,12605078,6913405,5408037,3825136,2194752,1230604,856667,20428601,40164298,65647934,65647934
Uganda,2036,UG,UGA,AFR,4479852,8493428,12973280,7162562,5495006,3830141,2153821,1095801,635679,20373010,4382534,8316481,12699015,7057305,5550322,3970103,2323937,1273087,896462,21071216,41444226,67116524,67116524
Uganda,2037,UG,UGA,AFR,4506396,8553648,13060044,7317386,5643186,3971359,2282018,1137818,668457,21020224,4408741,8376463,12785204,7202395,5690945,4114147,2460204,1319839,937131,21724661,42744885,68590124,68590124
Uganda,2038,UG,UGA,AFR,4533577,8608708,13142285,7470158,5790054,4109868,2416925,1184557,701453,21673015,4435620,8431317,12866937,7346692,5829157,4255397,2603565,1371969,978129,22384909,44057924,70067152,70067152
Uganda,2039,UG,UGA,AFR,4560595,8659881,13220476,7618619,5933029,4247985,2556077,1237466,734448,22327624,4462407,8482388,12944795,7488216,5962602,4395679,2751443,1431023,1019255,23048218,45375842,71541113,71541113
Uganda,2040,UG,UGA,AFR,4585584,8711473,13297057,7761520,6072735,4385297,2697610,1297787,768001,22982950,4487196,8533971,13021167,7625565,6092006,4534540,2901708,1498434,1061245,23713498,46696448,73014668,73014668
Uganda,2041,UG,UGA,AFR,4608786,8762198,13370984,7898692,6211056,4523527,2837391,1366232,802339,23639237,4510306,8584911,13095217,7758330,6219425,4673785,3049959,1575148,1104376,24381023,48020260,74486455,74486455
Uganda,2042,UG,UGA,AFR,4628743,8813173,13441916,8025503,6351443,4663877,2974506,1443119,837185,24295633,4530433,8636206,13166639,7881863,6348869,4814266,3194988,1661690,1148323,25049999,49345632,75954183,75954183
Uganda,2043,UG,UGA,AFR,4646885,8863396,13510281,8138263,6498964,4804779,3110044,1527990,872665,24952705,4548881,8686731,13235612,7992526,6485624,4954198,3337900,1757594,1193292,25721134,50673839,77419738,77419738
Uganda,2044,UG,UGA,AFR,4668218,8910624,13578842,8237248,6650764,4947565,3244714,1619867,909446,25609604,4570356,8734276,13304632,8090197,6627151,5094920,3479666,1861572,1240115,26393621,52003225,78886699,78886699
Uganda,2045,UG,UGA,AFR,4691284,8958221,13649505,8322102,6803422,5092706,3379189,1718934,947882,26264235,4593400,8782128,13375528,8174310,6770136,5237119,3621050,1973681,1289288,27065584,53329819,80354860,80354860
Uganda,2046,UG,UGA,AFR,4715444,9007414,13722858,8392169,6957457,5238884,3513232,1824278,988477,26914497,4617439,8831548,13448987,8244275,6915095,5379391,3762061,2092770,1341570,27735162,54649659,81821514,81821514
Uganda,2047,UG,UGA,AFR,4740718,9054684,13795402,8452956,7111515,5384308,3646385,1935531,1032031,27562726,4642367,8879195,13521562,8305191,7060919,5519845,3902282,2218362,1397880,28404479,55967205,83284173,83284173
Uganda,2048,UG,UGA,AFR,4764028,9100746,13864774,8508598,7263390,5528387,3777216,2052603,1079119,28209313,4665199,8925785,13590984,8360960,7205777,5657845,4039974,2350493,1458752,29073801,57283114,84738864,84738864
Uganda,2049,UG,UGA,AFR,4783344,9149800,13933144,8560342,7410913,5668696,3907884,2173385,1130645,28851865,4684214,8975271,13659485,8412924,7347785,5791163,4176912,2486861,1525314,29740959,58592824,86185454,86185454
Uganda,2050,UG,UGA,AFR,4797889,9198545,13996434,8612488,7552914,5805878,4038003,2296368,1187956,29493607,4698697,9024313,13723010,8465362,7485585,5920524,4312636,2625602,1599326,30409035,59902642,87622081,87622081
Ukraine,1970,UA,UKR,EUR,1778623,4188332,5966955,3581756,3456056,3256931,1876346,1793642,1424980,15389711,1711362,3999951,5711313,3584391,3705773,3695503,3034951,3217827,2972665,20211110,35600821,47279086,47279086
Ukraine,1971,UA,UKR,EUR,1806044,4116726,5922770,3721819,3321038,3298614,2035174,1744352,1458765,15579762,1742237,3922885,5665122,3726972,3574592,3651712,3245957,3155697,3075165,20430095,36009857,47597756,47597756
Ukraine,1972,UA,UKR,EUR,1824547,4060910,5885457,3824985,3185255,3382360,2244701,1676174,1509530,15823005,1760407,3861812,5622219,3813617,3427017,3691944,3463907,3052345,3194676,20643506,36466511,47974187,47974187
Ukraine,1973,UA,UKR,EUR,1844867,3986040,5830907,3914354,3040598,3465578,2457085,1626383,1555378,16059376,1779320,3790472,5569792,3883774,3263753,3759033,3655077,2976099,3303732,20841468,36900844,48301548,48301548
Ukraine,1974,UA,UKR,EUR,1862007,3895910,5757917,3973727,2961405,3513035,2647568,1598218,1603735,16297688,1794232,3718022,5512254,3910664,3164398,3806701,3794994,2933377,3424709,21034843,37332531,48602694,48602694
Ukraine,1975,UA,UKR,EUR,1872400,3809597,5681997,4012900,2944862,3522065,2836529,1558480,1654921,16529757,1808484,3649236,5457720,3921004,3126461,3821942,3925045,2876481,3551774,21222707,37752464,48892187,48892187
Ukraine,1976,UA,UKR,EUR,1871755,3737144,5608899,4044516,2952428,3538867,2976422,1526224,1702996,16741453,1812719,3588604,5401323,3938311,3111765,3846153,3988971,2823563,3684097,21392860,38134313,49144535,49144535
Ukraine,1977,UA,UKR,EUR,1858614,3677551,5536165,4064701,3012591,3542375,3048993,1511066,1754163,16933889,1800389,3540382,5340771,3950096,3151554,3858699,3957665,2791500,3837091,21546605,38480494,49357430,49357430
Ukraine,1978,UA,UKR,EUR,1833616,3624046,5457662,4085131,3138570,3503209,3062890,1521058,1802049,17112907,1776768,3497238,5274006,3961367,3267142,3825719,3852170,2807630,3978013,21692041,38804948,49536615,49536615
Ukraine,1979,UA,UKR,EUR,1830583,3591992,5422575,4083996,3296730,3451539,3041028,1562332,1831857,17267482,1770705,3472763,5243468,3954910,3415471,3788757,3711496,2848668,4086907,21806209,39073691,49739734,49739734
Ukraine,1980,UA,UKR,EUR,1844568,3593988,5438556,4058835,3475845,3338442,3045722,1639284,1833733,17391861,1777443,3477959,5255402,3928676,3585622,3687543,3617035,2923770,4145456,21888102,39279963,49973920,49973920
Ukraine,1981,UA,UKR,EUR,1846580,3609737,5456317,4021340,3622550,3201981,3084592,1767801,1804841,17503105,1776849,3493323,5270172,3890375,3725728,3547803,3583034,3077180,4135203,21959323,39462428,50188922,50188922
Ukraine,1982,UA,UKR,EUR,1851925,3622041,5473966,3954776,3721885,3067881,3155546,1940300,1759973,17600361,1782106,3505029,5287135,3826832,3811239,3395834,3618696,3270945,4088632,22012178,39612539,50373636,50373636
Ukraine,1983,UA,UKR,EUR,1876267,3638617,5514884,3861319,3803087,2933231,3227319,2120780,1730722,17676458,1803290,3517253,5320543,3745532,3877507,3233081,3682743,3450567,4062639,22052069,39728527,50563952,50563952
Ukraine,1984,UA,UKR,EUR,1908826,3662287,5571113,3768180,3839599,2866668,3263762,2280443,1717939,17736591,1832378,3535957,5368335,3662744,3905522,3137076,3723449,3583858,4070154,22082803,39819394,50758846,50758846
Ukraine,1985,UA,UKR,EUR,1931249,3682156,5613405,3679946,3859537,2855899,3269844,2427571,1698677,17791474,1855247,3555853,5411100,3580103,3920948,3103032,3733033,3697930,4066373,22101419,39892893,50917399,50917399
Ukraine,1986,UA,UKR,EUR,1954613,3688344,5642957,3599784,3882834,2865772,3281224,2538893,1692475,17860982,1878547,3563588,5442135,3508301,3943448,3092231,3745515,3764166,4077021,22130682,39991664,51076740,51076740
Ukraine,1987,UA,UKR,EUR,1970056,3683741,5653797,3544417,3889716,2926988,3280104,2601682,1707138,17950045,1893559,3560600,5454159,3460313,3952357,3137291,3744827,3753161,4130480,22178429,40128474,51236432,51236432
Ukraine,1988,UA,UKR,EUR,1951774,3697836,5649610,3508410,3892556,3050745,3246794,2608440,1739192,18046137,1875422,3577562,5452984,3426550,3958221,3255801,3710262,3666292,4206522,22223648,40269785,51372371,51372371
Ukraine,1989,UA,UKR,EUR,1915488,3730644,5646132,3500709,3873977,3192991,3203633,2577136,1789125,18137571,1837551,3609902,5447453,3418472,3942702,3400585,3677874,3523705,4300049,22263387,40400958,51494543,51494543
Ukraine,1990,UA,UKR,EUR,1872534,3759531,5632065,3523120,3832250,3345350,3101315,2572281,1846092,18220408,1791389,3633409,5424798,3445656,3902727,3559112,3585840,3413963,4405254,22312552,40532960,51589817,51589817
Ukraine,1991,UA,UKR,EUR,1812065,3791013,5603078,3549749,3791649,3476274,2975556,2601419,1914096,18308743,1727646,3659743,5387389,3478654,3860727,3694127,3459789,3369134,4511180,22373611,40682354,51672817,51672817
Ukraine,1992,UA,UKR,EUR,1740771,3835824,5576595,3576444,3753217,3575134,2847534,2661530,1998553,18412412,1657142,3699715,5356857,3509830,3818711,3796743,3319737,3398017,4596252,22439290,40851702,51785154,51785154
Ukraine,1993,UA,UKR,EUR,1656781,3875432,5532213,3600238,3693185,3654023,2714649,2718418,2089703,18470216,1576767,3732684,5309451,3531596,3760612,3882711,3164717,3454518,4672379,22466533,40936749,51778418,51778418
Ukraine,1994,UA,UKR,EUR,1558022,3879396,5437418,3613972,3599387,3674437,2643369,2740898,2165061,18437124,1481433,3729519,5210952,3538359,3666574,3910172,3073371,3487031,4726370,22401877,40839001,51487372,51487372
Ukraine,1995,UA,UKR,EUR,1462355,3845738,5308093,3621713,3501080,3673621,2616850,2732509,2225196,18370969,1388815,3690716,5079531,3539860,3562185,3916176,3035733,3490136,4758583,22302673,40673642,51061265,51061265
Ukraine,1996,UA,UKR,EUR,1371697,3793687,5165384,3616680,3423525,3678516,2604613,2714547,2264272,18302153,1300879,3633287,4934166,3531033,3476053,3928753,3016868,3491310,4770391,22214408,40516561,50616105,50616105
Ukraine,1997,UA,UKR,EUR,1288283,3721329,5009612,3607437,3370331,3670439,2637871,2683043,2276285,18245406,1220613,3558641,4779254,3517017,3412018,3927462,3051078,3481747,4745748,22135070,40380476,50169353,50169353
Ukraine,1998,UA,UKR,EUR,1215499,3604574,4820073,3629163,3327859,3664354,2726630,2623818,2263147,18234971,1151874,3443749,4595623,3530405,3359190,3924371,3153847,3439978,4687420,22095211,40330182,49745874,49745874
Ukraine,1999,UA,UKR,EUR,1149329,3456745,4606074,3673145,3296163,3640014,2837147,2558668,2240768,18245905,1089560,3298214,4387774,3565420,3323110,3899640,3283409,3399312,4609474,22080365,40326270,49320119,49320119
Ukraine,2000,UA,UKR,EUR,1091066,3304247,4395313,3708913,3287320,3589290,2956833,2450873,2247560,18240789,1033883,3148178,4182061,3591463,3316522,3848697,3426536,3304214,4574163,22061595,40302384,48879755,48879755
Ukraine,2001,UA,UKR,EUR,1032103,3139437,4171540,3743471,3290837,3528141,3050463,2328562,2290750,18232224,979014,2987879,3966893,3615611,3322373,3786575,3541978,3176431,4600917,22043885,40276109,48414534,48414534
Ukraine,2002,UA,UKR,EUR,988377,2968303,3956680,3782118,3299740,3456220,3109217,2210476,2370735,18228506,937788,2824037,3761825,3643244,3329505,3710292,3617262,3033367,4695862,22029532,40258038,47976537,47976537
Ukraine,2003,UA,UKR,EUR,985293,2804361,3789654,3808263,3316227,3377739,3156800,2097780,2456662,18213471,931898,2668361,3600259,3659964,3340838,3624853,3681162,2879907,4815551,22002275,40215746,47605643,47605643
Ukraine,2004,UA,UKR,EUR,1002295,2649034,3651329,3810719,3341962,3293195,3171777,2046471,2516909,18181033,946058,2520549,3466607,3656562,3359788,3531582,3706723,2796450,4911893,21962998,40144031,47261961,47261961
Ukraine,2005,UA,UKR,EUR,1021566,2506912,3528478,3784729,3369713,3211525,3176096,2034254,2549674,18125991,963905,2384714,3348619,3626745,3380324,3440854,3719784,2766654,4975158,21909519,40035510,46912610,46912610
Ukraine,2006,UA,UKR,EUR,1052933,2377404,3430337,3739487,3390658,3146579,3189840,2034582,2561390,18062536,994414,2260668,3255082,3577626,3394112,3365462,3743006,2755688,5008706,21844600,39907136,46592556,46592556
Ukraine,2007,UA,UKR,EUR,1094708,2268129,3362837,3673418,3414524,3100331,3192193,2068532,2541609,17990607,1035600,2155198,3190798,3511935,3404916,3308861,3751707,2794208,4997199,21768826,39759433,46313068,46313068
Ukraine,2008,UA,UKR,EUR,1141851,2188739,3330590,3561549,3466727,3062346,3191484,2138185,2478922,17899213,1079873,2078061,3157934,3405389,3441146,3261187,3756572,2892839,4918064,21675197,39574410,46062937,46062937
Ukraine,2009,UA,UKR,EUR,1190935,2136898,3327833,3418482,3534700,3042792,3178326,2225995,2410316,17810611,1124145,2027798,3151943,3267434,3494764,3230915,3739938,3016903,4823544,21573498,39384109,45863884,45863884
Ukraine,2010,UA,UKR,EUR,1232051,2102398,3334449,3271822,3589168,3053542,3149806,2326390,2339002,17729730,1161597,1993653,3155250,3125274,3534489,3230733,3697580,3155030,4720486,21463592,39193322,45683020,45683020
Ukraine,2011,UA,UKR,EUR,1262472,2085760,3348232,3114668,3638802,3079743,3115372,2412124,2290093,17650802,1188565,1976928,3165493,2973759,3570210,3245460,3644977,3270276,4646928,21351610,39002412,45516134,45516134
Ukraine,2012,UA,UKR,EUR,1287411,2094394,3381805,2960951,3692335,3105617,3070244,2474676,2280603,17584426,1209762,1984503,3194265,2819810,3607839,3260150,3577863,3350795,4629270,21245727,38830153,45406226,45406226
Ukraine,2013,UA,UKR,EUR,1299114,2130515,3429629,2814891,3732841,3131223,3016992,2528844,2285120,17509911,1220088,2015992,3236080,2672026,3633124,3275848,3500738,3420261,4629481,21131478,38641389,45307099,45307099
Ukraine,2014,UA,UKR,EUR,1289094,2186773,3475867,2671785,3739579,3166542,2957781,2557799,2314210,17407696,1211940,2065400,3277340,2532736,3633005,3298831,3412048,3445874,4664687,20987181,38394877,45148075,45148075
Ukraine,2015,UA,UKR,EUR,1265880,2246526,3512406,2538440,3718423,3204725,2904795,2585136,2357886,17309405,1190579,2119752,3310331,2404541,3607001,3324050,3328022,3463003,4723800,20850417,38159822,44982564,44982564
Ukraine,2016,UA,UKR,EUR,1230815,2308458,3539273,2410588,3685346,3233316,2866625,2624493,2401932,17222300,1156615,2177541,3334156,2282225,3565269,3341996,3263054,3498985,4786310,20737839,37960139,44833569,44833569
Ukraine,2017,UA,UKR,EUR,1176240,2374764,3551004,2301668,3631113,3263266,2842546,2652456,2445088,17136137,1105318,2239704,3345022,2177128,3505935,3356539,3215088,3519572,4850833,20625095,37761232,44657257,44657257
Ukraine,2018,UA,UKR,EUR,1105031,2433006,3538037,2223089,3532804,3321476,2824379,2675885,2479648,17057281,1038429,2293817,3332246,2100232,3405817,3396265,3174977,3536063,4906032,20519386,37576667,44446954,44446954
Ukraine,2019,UA,UKR,EUR,1032728,2474637,3507365,2168257,3402544,3396400,2817733,2681065,2507314,16973313,969739,2331971,3301710,2047742,3272878,3453240,3150861,3530596,4973391,20428708,37402021,44211094,44211094
Ukraine,2020,UA,UKR,EUR,972826,2494326,3467152,2125814,3265668,3455973,2832323,2663725,2521462,16864965,913417,2349568,3262985,2008883,3134348,3495176,3153750,3495771,5026633,20314561,37179526,43909666,43909666
Ukraine,2021,UA,UKR,EUR,926815,2487821,3414636,2102211,3116951,3506054,2855562,2632062,2519861,16732701,870989,2341331,3212320,1987890,2985981,3530836,3168206,3444874,5053978,20171765,36904466,43531422,43531422
Ukraine,2022,UA,UKR,EUR,792059,2371423,3163482,1620921,2426837,3289042,2754976,2526775,2448641,15067192,738978,2221913,2960891,1468668,2291751,3318645,3079267,3333238,5018604,18510173,33577365,39701739,39701739
Ukraine,2023,UA,UKR,EUR,675526,2247643,2923169,1348678,1858153,3109533,2677750,2429534,2408345,13831993,626248,2100597,2726845,1167328,1716908,3138262,3009719,3222218,5008191,17262626,31094619,36744634,36744634
Ukraine,2024,UA,UKR,EUR,669306,2200866,2870172,1721354,1920871,3212264,2748901,2403973,2481385,14488748,625016,2062136,2687152,1558387,1777087,3218557,3063717,3158846,5115156,17891750,32380498,37937821,37937821
Ukraine,2025,UA,UKR,EUR,665696,2131937,2797633,2013438,1941120,3259906,2812257,2381478,2571826,14980025,625279,1999463,2624742,1865253,1795992,3246767,3109195,3095843,5243625,18356675,33336700,38759076,38759076
Ukraine,2026,UA,UKR,EUR,661579,2043293,2704872,2214967,1907042,3253040,2853789,2363895,2656110,15248843,624135,1915686,2539821,2075689,1762303,3222687,3134693,3040863,5363538,18599773,33848616,39093309,39093309
Ukraine,2027,UA,UKR,EUR,656231,1933676,2589907,2348248,1841960,3198242,2884297,2352968,2724081,15349796,621191,1811375,2432566,2212305,1697820,3155591,3146520,2998211,5462666,18673113,34022909,39045383,39045383
Ukraine,2028,UA,UKR,EUR,659595,1810452,2470047,2436032,1788903,3088508,2935813,2344494,2780612,15374362,624576,1695607,2320183,2300653,1645917,3036656,3178055,2961062,5545601,18667944,34042306,38832550,38832550
Ukraine,2029,UA,UKR,EUR,668553,1689342,2357895,2488102,1763051,2943907,2999998,2343702,2825929,15364689,631787,1582959,2214746,2352329,1622779,2881961,3223679,2937126,5609019,18626893,33991582,38564213,38564213
Ukraine,2030,UA,UKR,EUR,675411,1590398,2265809,2508146,1763313,2794890,3049435,2361033,2859015,15335832,637548,1491458,2129006,2372343,1626130,2722597,3253671,2939086,5650963,18564790,33900622,38295429,38295429
Ukraine,1950,UA,UKR,EUR,1459380,3495338,4954718,3324694,1944489,2250802,1574919,1064210,896836,11055950,1488506,3672281,5160787,3683798,2946311,3508788,2434679,1641796,1916170,16131542,27187492,37302996,37302996
Ukraine,1951,UA,UKR,EUR,1646724,3333283,4980007,3391656,2093266,2221944,1628596,1076019,889157,11300638,1643034,3509515,5152549,3679249,3079306,3487375,2539135,1657671,1907360,16350096,27650734,37783286,37783286
Ukraine,1952,UA,UKR,EUR,1819434,3133678,4953112,3464317,2311502,2164250,1686674,1088847,885377,11600967,1785309,3300744,5086053,3699973,3292770,3418879,2640260,1674446,1905265,16631593,28232560,38271725,38271725
Ukraine,1953,UA,UKR,EUR,1961525,2936029,4897554,3539056,2567417,2088339,1748928,1103673,886674,11934087,1899094,3087810,4986904,3739141,3545877,3318627,2739881,1696952,1909501,16949979,28884066,38768511,38768511
Ukraine,1954,UA,UKR,EUR,2037099,2830941,4868040,3602348,2805372,2015114,1814463,1123275,894580,12255152,1945184,2968122,4913306,3779655,3761710,3215096,2844941,1733071,1917023,17251496,29506648,39287994,39287994
Ukraine,1955,UA,UKR,EUR,2048020,2841733,4889753,3642011,3000085,1960277,1879427,1148734,908634,12539168,1940450,2952903,4893353,3804882,3909124,3129677,2954380,1785494,1930682,17514239,30053407,39836510,39836510
Ukraine,1956,UA,UKR,EUR,2044029,2907837,4951866,3668761,3151812,1915631,1946008,1178749,927755,12788716,1936324,2978817,4915141,3828748,3987727,3051757,3070738,1854106,1950007,17743083,30531799,40398805,40398805
Ukraine,1957,UA,UKR,EUR,2045787,3008892,5054679,3697169,3251714,1876705,2015183,1212453,951298,13004522,1937948,3040719,4978667,3867007,3985281,2978396,3194482,1939958,1974541,17939665,30944187,40977535,40977535
Ukraine,1958,UA,UKR,EUR,2043637,3281978,5325615,3733485,3290247,1836426,2004990,1229922,972587,13067657,1943377,3228113,5171490,3877245,3928518,2943103,3200922,2100307,1944513,17994608,31062265,41559369,41559369
Ukraine,1959,UA,UKR,EUR,2052387,3569679,5622066,3727281,3300530,1843221,1976450,1252562,1001311,13101355,1957805,3448597,5406402,3841694,3831193,2961893,3197160,2248367,1944764,18025071,31126426,42154895,42154895
Ukraine,1960,UA,UKR,EUR,2089020,3728563,5817583,3620901,3338959,1937485,1984960,1297513,1041283,13221101,1990808,3605483,5596291,3742860,3740546,3052538,3249850,2318198,2028293,18132285,31353386,42767251,42767251
Ukraine,1961,UA,UKR,EUR,2121373,3851202,5972575,3492507,3402859,2100471,1947027,1348977,1084098,13375939,2019717,3724933,5744650,3608337,3707360,3228631,3219187,2395542,2112996,18272053,31647992,43365219,43365219
Ukraine,1962,UA,UKR,EUR,2133869,3936243,6070112,3351056,3491977,2319283,1878402,1412022,1116735,13569475,2029640,3804734,5834374,3452135,3744908,3444927,3137991,2490275,2180560,18450796,32020271,43924755,43924755
Ukraine,1963,UA,UKR,EUR,2128360,4008146,6136506,3204630,3572027,2549462,1829498,1476609,1144568,13776794,2023178,3868340,5891518,3286031,3801651,3639492,3076552,2590704,2246645,18641075,32417869,44445903,44445903
Ukraine,1964,UA,UKR,EUR,2089664,4057469,6147133,3120813,3624339,2759827,1801767,1540780,1177718,14025244,1985109,3902483,5887592,3185762,3838477,3793814,3045356,2694063,2323971,18881443,32906687,44941406,44941406
Ukraine,1965,UA,UKR,EUR,2016264,4114084,6130348,3076698,3649197,2966487,1761230,1602155,1218606,14274373,1913612,3940825,5854437,3137212,3852164,3937261,2976764,2782337,2442195,19127933,33402306,45387091,45387091
Ukraine,1966,UA,UKR,EUR,1943957,4170520,6114477,3061260,3668541,3129582,1731856,1662104,1256584,14509927,1844687,3983838,5828525,3114755,3871058,4023323,2916899,2869309,2560853,19356197,33866124,45809120,45809120
Ukraine,1967,UA,UKR,EUR,1886123,4210105,6096228,3115065,3670998,3226050,1718406,1723655,1293358,14747532,1790927,4018200,5809127,3153988,3876977,4020013,2885444,2988888,2657166,19582476,34330008,46235370,46235370
Ukraine,1968,UA,UKR,EUR,1833516,4240007,6073523,3247499,3630651,3259163,1729244,1768802,1341976,14977335,1743094,4048744,5791838,3268692,3841668,3939946,2878953,3090377,2772860,19792496,34769831,46635196,46635196
Ukraine,1969,UA,UKR,EUR,1783152,4244782,6027934,3411699,3573989,3250182,1779225,1798526,1392094,15205715,1703646,4056621,5760267,3413136,3804642,3806850,2909820,3180712,2881805,19996965,35202680,46990889,46990889
Ukraine,2031,UA,UKR,EUR,681489,1513651,2195140,2492655,1789530,2635957,3091662,2388725,2888023,15286552,642993,1421319,2064312,2356132,1655960,2554146,3277475,2953774,5682946,18480433,33766985,38026437,38026437
Ukraine,2032,UA,UKR,EUR,687712,1453298,2141010,2445356,1846285,2470005,3132296,2413658,2914279,15221879,648814,1365795,2014609,2308690,1716818,2380759,3300120,2966322,5707459,18380168,33602047,37757668,37757668
Ukraine,2033,UA,UKR,EUR,694667,1412416,2107083,2363086,1932183,2309818,3158135,2436856,2938250,15138328,655412,1328472,1983884,2228691,1804839,2214833,3308439,2978316,5725365,18260483,33398811,37489780,37489780
Ukraine,2034,UA,UKR,EUR,702492,1382577,2085069,2259300,2038231,2158902,3160461,2466113,2961595,15044602,662849,1302007,1964856,2128619,1911927,2058552,3295010,2995836,5739043,18128987,33173589,37223511,37223511
Ukraine,2035,UA,UKR,EUR,711340,1360802,2072142,2153886,2143664,2022509,3134544,2497339,2992041,14943983,671221,1283093,1954314,2026715,2019605,1917592,3253418,3013530,5758457,17989317,32933300,36959760,36959760
Ukraine,2036,UA,UKR,EUR,720893,1348264,2069157,2046661,2243809,1901888,3088517,2523003,3031744,14835622,680228,1272929,1953157,1922959,2121869,1794100,3190423,3024172,5787038,17840561,32676183,36698493,36698493
Ukraine,2037,UA,UKR,EUR,730425,1343695,2074120,1930711,2339779,1806635,3022712,2549467,3071489,14720793,689212,1270358,1959570,1811680,2218962,1696695,3109774,3031428,5815511,17684050,32404843,36438537,36438537
Ukraine,2038,UA,UKR,EUR,739275,1352569,2091844,1806169,2417524,1747314,2916495,2599519,3107202,14594223,697540,1278889,1976429,1694230,2296924,1636479,2989000,3062068,5837748,17516449,32110672,36178944,36178944
Ukraine,2039,UA,UKR,EUR,746335,1369310,2115645,1685341,2468692,1722851,2781407,2662459,3141205,14461955,704194,1293480,1997674,1581587,2347864,1613297,2836830,3107770,5855705,17343053,31805008,35918327,35918327
Ukraine,2040,UA,UKR,EUR,750888,1384994,2135882,1586667,2488228,1724034,2642092,2712072,3180212,14333305,708498,1307566,2016064,1490116,2367373,1616561,2680107,3138366,5878338,17170861,31504166,35656113,35656113
Ukraine,2041,UA,UKR,EUR,752756,1400616,2153372,1510171,2472686,1750768,2493598,2755439,3224716,14207378,710288,1322001,2032289,1420028,2350951,1646311,2514566,3163073,5904275,16999204,31206582,35392256,35392256
Ukraine,2042,UA,UKR,EUR,752322,1416398,2168720,1450052,2425778,1807452,2338495,2796694,3264945,14083416,709908,1336811,2046719,1364572,2303542,1707030,2344238,3186346,5921771,16827499,30910915,35126355,35126355
Ukraine,2043,UA,UKR,EUR,749798,1432233,2182031,1409357,2344265,1892616,2188638,2823691,3302322,13960889,707527,1351752,2059279,1327308,2223723,1794787,2181236,3195338,5933141,16655533,30616422,34857729,34857729
Ukraine,2044,UA,UKR,EUR,745608,1447152,2192760,1379682,2241468,1997379,2047420,2829183,3344926,13840058,703551,1365859,2069410,1300892,2123899,1901465,2027713,3183082,5946756,16483807,30323865,34586035,34586035
Ukraine,2045,UA,UKR,EUR,739722,1460587,2200309,1358044,2137058,2101290,1919841,2809129,3395872,13721234,698000,1378548,2076548,1282018,2022247,2008652,1889255,3143471,5967048,16312691,30033925,34310784,34310784
Ukraine,2046,UA,UKR,EUR,731447,1472042,2203489,1345620,2030842,2199811,1807198,2770733,3450578,13604782,690195,1389365,2079560,1271886,1918753,2110392,1768009,3083055,5990628,16142723,29747505,34030556,34030556
Ukraine,2047,UA,UKR,EUR,721242,1481179,2202421,1341147,1916016,2294181,1718668,2714103,3506774,13490889,680558,1397987,2078545,1269343,1807758,2206968,1672507,3005328,6012421,15974325,29465214,33746167,33746167
Ukraine,2048,UA,UKR,EUR,709296,1487540,2196836,1350067,1792671,2370691,1664380,2621586,3580355,13379750,669286,1403953,2073239,1277878,1690613,2284513,1613688,2889012,6052173,15807877,29187627,33457707,33457707
Ukraine,2049,UA,UKR,EUR,695510,1490455,2185965,1366829,1673017,2421161,1643344,2503441,3663912,13271704,656272,1406658,2062930,1292479,1578268,2335189,1591414,2742570,6104084,15644004,28915708,33164600,33164600
Ukraine,2050,UA,UKR,EUR,680559,1489165,2169724,1382540,1575358,2440538,1646775,2381242,3740755,13167208,642129,1405436,2047565,1306572,1487051,2354584,1595236,2591681,6148099,15483223,28650431,32867719,32867719
Uruguay,1970,UY,URY,AMR,135974,259503,395477,216010,195551,191173,154826,123654,109161,990375,128671,250003,378674,213586,196643,191624,154040,128399,141449,1025741,2016116,2790265,2790265
Uruguay,1971,UY,URY,AMR,135503,260830,396333,217654,194324,190980,156982,124570,110851,995361,127872,251265,379137,215441,195980,191734,156757,130405,144347,1034664,2030025,2805492,2805492
Uruguay,1972,UY,URY,AMR,135794,261529,397323,219435,193338,190342,159599,125119,112378,1000211,127979,251885,379864,217390,195648,191341,160178,131937,147186,1043680,2043891,2821086,2821086
Uruguay,1973,UY,URY,AMR,136584,261781,398365,221427,192462,189328,162440,125421,113835,1004913,128862,251993,380855,219619,195383,190520,164003,133083,150086,1052694,2057607,2836825,2836825
Uruguay,1974,UY,URY,AMR,138219,261725,399944,223770,191561,188048,165038,125710,115423,1009550,130682,251756,382438,222363,194901,189432,167545,134092,153330,1061663,2071213,2853588,2853588
Uruguay,1975,UY,URY,AMR,141019,261236,402255,226209,190886,186613,167162,126141,117203,1014214,133784,251042,384826,225232,194581,188218,170495,135158,156963,1070647,2084861,2871947,2871947
Uruguay,1976,UY,URY,AMR,144012,261057,405069,228780,190731,185210,168768,126505,119232,1019226,137267,250232,387499,227834,194651,186991,172813,136037,160969,1079295,2098521,2891094,2891094
Uruguay,1977,UY,URY,AMR,145993,261581,407574,231488,191048,183868,169844,126774,121577,1024599,139668,249949,389617,230164,195054,185782,174468,136682,165387,1087537,2112136,2909327,2909327
Uruguay,1978,UY,URY,AMR,146808,262311,409119,234112,191729,182492,170499,127232,124086,1030150,140776,250088,390864,232306,195831,184573,175575,137449,169978,1095712,2125862,2925840,2925840
Uruguay,1979,UY,URY,AMR,146120,263789,409909,236417,192790,181163,170824,128061,126441,1035696,140383,251059,391442,234085,196942,183439,176256,138699,174261,1103682,2139378,2940729,2940729
Uruguay,1980,UY,URY,AMR,143563,266330,409893,238330,194126,179981,170895,129306,128503,1041141,138100,253218,391318,235465,198228,182485,176606,140538,178078,1111400,2152541,2953750,2953750
Uruguay,1981,UY,URY,AMR,140150,269383,409533,239857,195756,179033,170713,130997,130217,1046573,134891,256056,390947,236430,199713,181833,176607,142961,181478,1119022,2165595,2966076,2966076
Uruguay,1982,UY,URY,AMR,137172,272266,409438,240987,197736,178440,170303,133176,131531,1052173,131987,258849,390836,236953,201419,181602,176275,146070,184415,1126734,2178907,2979182,2979182
Uruguay,1983,UY,URY,AMR,134843,274658,409501,241968,200162,178082,169736,135657,132560,1058165,129587,261298,390885,237200,203579,181559,175699,149606,187090,1134733,2192898,2993285,2993285
Uruguay,1984,UY,URY,AMR,133217,276415,409632,242894,203140,177773,169083,138018,133618,1064526,127797,263255,391052,237309,206405,181395,175004,152929,190005,1143047,2207573,3008255,3008255
Uruguay,1985,UY,URY,AMR,132743,277406,410149,243581,206346,177736,168404,140037,134891,1070995,127083,264621,391704,237104,209469,181435,174279,155738,193354,1151379,2222374,3024218,3024218
Uruguay,1986,UY,URY,AMR,133002,277603,410605,244322,209550,178116,167638,141794,136418,1077838,127104,265542,392646,236879,212558,182043,173531,158082,197028,1160121,2237959,3041205,3041205
Uruguay,1987,UY,URY,AMR,133164,277143,410307,245545,212799,178898,166817,143252,138264,1085575,127159,265793,392952,237267,215674,183211,172817,159930,201051,1169950,2255525,3058787,3058787
Uruguay,1988,UY,URY,AMR,133815,276165,409980,247105,216113,180121,166032,144328,140368,1094067,127849,265242,393091,238190,218670,184839,172197,161296,205420,1180612,2274679,3077760,3077760
Uruguay,1989,UY,URY,AMR,135274,274324,409598,249349,219142,181723,165281,145075,142647,1103217,129394,263722,393116,239921,221289,186820,171688,162256,209988,1191962,2295179,3097889,3097889
Uruguay,1990,UY,URY,AMR,136401,271682,408083,252513,221729,183548,164627,145540,145017,1112974,130611,261293,391904,242780,223416,188957,171369,162879,214642,1204043,2317017,3117012,3117012
Uruguay,1991,UY,URY,AMR,137180,268851,406031,256069,223850,185602,164158,145737,147476,1122892,131465,258554,390019,246260,225026,191240,171337,163153,219422,1216438,2339330,3135374,3135374
Uruguay,1992,UY,URY,AMR,138273,266267,404540,259317,225414,187870,163960,145673,150004,1132238,132578,256035,388613,249602,226029,193635,171680,163074,224322,1228342,2360580,3153732,3153732
Uruguay,1993,UY,URY,AMR,138914,264731,403645,261937,226602,190434,163889,145397,152550,1140809,133215,254566,387781,252500,226564,196332,172125,162709,229289,1239519,2380328,3171747,3171747
Uruguay,1994,UY,URY,AMR,138965,264648,403613,263832,227543,193403,163791,144987,155035,1148591,133265,254487,387752,254835,226808,199550,172378,162194,234222,1249987,2398578,3189945,3189945
Uruguay,1995,UY,URY,AMR,139433,265342,404775,264861,228084,196486,163877,144498,157436,1155242,133719,255104,388823,256503,226611,202884,172759,161622,239081,1259460,2414702,3208300,3208300
Uruguay,1996,UY,URY,AMR,139941,266422,406363,265052,228723,199604,164331,143957,159779,1161446,134226,256040,390266,257571,226384,206114,173542,161034,243910,1268555,2430001,3226633,3226633
Uruguay,1997,UY,URY,AMR,139999,267853,407852,264741,229701,202700,165229,143386,162052,1167809,134267,257278,391545,257967,226657,209179,174780,160509,248766,1277858,2445667,3245069,3245069
Uruguay,1998,UY,URY,AMR,139626,269377,409003,264086,230717,205666,166563,142817,164241,1174090,133835,258666,392501,257682,227271,212004,176455,160065,253623,1287100,2461190,3262683,3262683
Uruguay,1999,UY,URY,AMR,138520,271034,409554,262647,232418,208324,168234,142299,166347,1180269,132689,260274,392963,256452,228720,214450,178438,159702,258410,1296172,2476441,3278963,3278963
Uruguay,2000,UY,URY,AMR,136648,272643,409291,260248,234799,210393,170003,141882,168331,1185656,130801,261874,392675,254152,231161,216300,180461,159482,263050,1304606,2490262,3292224,3292224
Uruguay,2001,UY,URY,AMR,134369,273757,408126,257257,237011,211667,171758,141588,170161,1189442,128536,263037,391573,251203,233867,217403,182428,159446,267454,1311801,2501243,3300939,3300939
Uruguay,2002,UY,URY,AMR,132208,274578,406786,254234,238449,212125,173515,141501,171847,1191671,126431,263899,390330,248198,236132,217720,184330,159678,271594,1317652,2509323,3306441,3306441
Uruguay,2003,UY,URY,AMR,130308,274448,404756,252234,239070,212090,175407,141523,173408,1193732,124628,263784,388412,246174,237828,217501,186394,159947,275468,1323312,2517044,3310202,3310202
Uruguay,2004,UY,URY,AMR,128632,273042,401674,251892,239119,211849,177649,141540,174864,1196913,123042,262413,385455,245658,239050,217035,188925,160024,279058,1329750,2526663,3313801,3313801
Uruguay,2005,UY,URY,AMR,127362,271456,398818,252455,238646,211365,180153,141849,176334,1200802,121782,260832,382614,245469,239367,216128,191649,160319,282503,1335435,2536237,3317665,3317665
Uruguay,2006,UY,URY,AMR,126371,269703,396074,253541,237779,211053,182864,142603,177815,1205655,120749,259078,379827,245412,238953,215097,194376,161103,285785,1340726,2546381,3322282,3322282
Uruguay,2007,UY,URY,AMR,125219,267734,392953,255163,236809,211201,185707,143730,179261,1211871,119572,257104,376676,246133,238183,214593,197091,162322,288821,1347143,2559014,3328651,3328651
Uruguay,2008,UY,URY,AMR,124077,265632,389709,256961,235837,211553,188600,145224,180699,1218874,118420,254970,373390,247348,236991,214466,199738,163962,291658,1354163,2573037,3336126,3336126
Uruguay,2009,UY,URY,AMR,123148,262993,386141,259007,234451,212592,191272,147052,182163,1226537,117513,252281,369794,249049,235136,215112,202100,165933,294357,1361687,2588224,3344156,3344156
Uruguay,2010,UY,URY,AMR,122182,260070,382252,261127,232692,214634,193600,149070,183679,1234802,116642,249251,365893,251014,232645,216905,204098,168044,296999,1369705,2604507,3352651,3352651
Uruguay,2011,UY,URY,AMR,121346,257118,378464,262916,231080,217179,195537,151267,185276,1243255,115914,246169,362083,252807,230063,219381,205687,170267,299639,1377844,2621099,3361637,3361637
Uruguay,2012,UY,URY,AMR,120876,254116,374992,264537,229982,219588,196975,153617,186994,1251693,115498,243083,358581,254486,227870,221825,206755,172553,302375,1385864,2637557,3371133,3371133
Uruguay,2013,UY,URY,AMR,120723,251354,372077,265287,230097,221577,198059,156158,188732,1259910,115356,240291,355647,255280,226876,223978,207388,175040,304984,1393546,2653456,3381180,3381180
Uruguay,2014,UY,URY,AMR,120739,248972,369711,264783,231749,223092,198877,158985,190384,1267870,115330,237909,353239,254830,227437,225751,207689,177922,307216,1400845,2668715,3391662,3391662
Uruguay,2015,UY,URY,AMR,121004,246987,367991,263992,234244,224091,199263,161888,192165,1275643,115445,235974,351419,254098,228877,227076,207476,180868,309367,1407762,2683405,3402818,3402818
Uruguay,2016,UY,URY,AMR,121048,245443,366491,262908,237122,224554,199638,164831,194177,1283230,115274,234491,349765,253086,230796,227971,207071,183709,311639,1414272,2697502,3413766,3413766
Uruguay,2017,UY,URY,AMR,119731,244052,363783,261523,240181,224612,200353,167845,196362,1290876,113801,233128,346929,251758,233107,228225,207055,186486,313985,1420616,2711492,3422200,3422200
Uruguay,2018,UY,URY,AMR,116617,242950,359567,259914,243159,224451,201180,170876,198675,1298255,110638,232026,342664,250172,235632,227847,207320,189172,316418,1426561,2724816,3427042,3427042
Uruguay,2019,UY,URY,AMR,111973,242206,354179,257683,246195,223751,202625,173685,201030,1304969,106066,231254,337320,247932,238444,226713,208294,191611,318952,1431946,2736915,3428409,3428409
Uruguay,2020,UY,URY,AMR,106106,241675,347781,255204,249261,222666,205065,176195,203991,1312382,100410,230658,331068,245378,241471,224934,210374,193730,321961,1437848,2750230,3429086,3429086
Uruguay,2021,UY,URY,AMR,100192,241048,341240,252742,251935,221677,207861,178043,205996,1318254,94801,229913,324714,242781,244300,223023,213003,195295,323650,1442052,2760306,3426260,3426260
Uruguay,2022,UY,URY,AMR,95620,239395,335015,250165,254345,221152,210418,179388,207890,1323358,90525,228152,318677,240097,246910,221442,215578,196352,325369,1445748,2769106,3422794,3422794
Uruguay,2023,UY,URY,AMR,92677,236254,328931,247754,255860,221863,212632,180694,211363,1330166,87804,224969,312773,237629,248533,221044,217932,197134,328966,1451238,2781404,3423108,3423108
Uruguay,2024,UY,URY,AMR,91203,231753,322956,245642,256031,224020,214342,181747,215031,1336813,86477,220489,306966,235497,248794,222109,219882,197588,332709,1456579,2793392,3423316,3423316
Uruguay,2025,UY,URY,AMR,90816,226242,317058,243861,255812,226911,215495,182385,218909,1343373,86156,215035,301191,233751,248644,223949,221366,197522,336604,1461836,2805209,3423454,3423454
Uruguay,2026,UY,URY,AMR,90770,220420,311190,242468,255206,230097,216093,183004,223035,1349903,86139,209299,295438,232406,248091,226177,222395,197271,340722,1467062,2816965,3423599,3423599
Uruguay,2027,UY,URY,AMR,90688,214579,305267,241194,254233,233385,216292,183944,227425,1356473,86085,203589,289674,231146,247120,228727,222779,197396,345094,1472262,2828735,3423688,3423688
Uruguay,2028,UY,URY,AMR,90653,208568,299221,240191,253006,236569,216300,185002,232057,1363125,86081,197755,283836,230122,245847,231460,222557,197802,349722,1477510,2840635,3423682,3423682
Uruguay,2029,UY,URY,AMR,90628,202505,293133,239533,251155,239825,215844,186652,236751,1369760,86083,191910,277993,229417,243894,234493,221600,198900,354384,1482688,2852448,3423584,3423584
Uruguay,2030,UY,URY,AMR,90596,196277,286873,239062,248940,243028,214993,189184,241317,1376524,86070,185966,272036,228852,241493,237646,219977,201064,358909,1487941,2864465,3423372,3423372
Uruguay,1950,UY,URY,AMR,108753,203631,312384,198771,168825,152808,123141,87979,86549,818073,106347,200953,307300,195737,161733,143311,112416,85857,97326,796380,1614453,2234144,2234144
Uruguay,1951,UY,URY,AMR,109954,204431,314385,199413,171458,153921,125216,88959,86767,825734,107029,201810,308839,196613,164797,145407,114330,87193,98769,807109,1632843,2256072,2256072
Uruguay,1952,UY,URY,AMR,111268,205650,316918,200025,175004,154822,127228,90094,87044,834217,107843,203079,310922,197396,168988,147153,116187,88615,100263,818602,1652819,2280660,2280660
Uruguay,1953,UY,URY,AMR,112911,207106,320017,200566,179129,155608,129188,91409,87398,843298,109119,204447,313566,198058,173921,148607,118077,90136,101815,830614,1673912,2307491,2307491
Uruguay,1954,UY,URY,AMR,115075,208603,323678,201072,183225,156486,131233,92937,87828,852781,111134,205596,316730,198674,178811,149995,120297,91774,103436,842987,1695768,2336182,2336182
Uruguay,1955,UY,URY,AMR,117406,210364,327770,201572,186978,157608,133381,94675,88354,862568,113392,206867,320259,199293,183259,151513,122891,93519,105148,855623,1718191,2366209,2366209
Uruguay,1956,UY,URY,AMR,119790,212517,332307,202057,190381,158887,135633,96620,88970,872548,115651,208523,324174,199899,187281,153031,125877,95386,106937,868411,1740959,2397436,2397436
Uruguay,1957,UY,URY,AMR,122280,215024,337304,202523,193360,160283,138021,98795,89694,882676,117951,210536,328487,200506,190806,154478,129301,97402,108829,881322,1763998,2429787,2429787
Uruguay,1958,UY,URY,AMR,124712,217915,342627,203008,195906,161941,140406,101107,90531,892899,120141,212937,333078,201123,193813,156125,132901,99503,110814,894279,1787178,2462876,2462876
Uruguay,1959,UY,URY,AMR,126973,221178,348151,203532,198033,164095,142524,103386,91480,903050,122158,215671,337829,201752,196340,158373,136207,101582,112886,907140,1810190,2496166,2496166
Uruguay,1960,UY,URY,AMR,129101,224644,353745,204108,199711,166747,144279,105543,92559,912947,124053,218552,342605,202398,198362,161308,139001,103618,115043,919730,1832677,2529021,2529021
Uruguay,1961,UY,URY,AMR,131079,228281,359360,204777,200847,169881,145656,107589,93740,922490,125803,221556,347359,203108,199767,164891,141313,105589,117284,931952,1854442,2561153,2561153
Uruguay,1962,UY,URY,AMR,132868,232060,364928,205636,201397,173526,146641,109475,95013,931688,127359,224642,352001,203970,200499,169204,143124,107431,119592,943820,1875508,2592441,2592441
Uruguay,1963,UY,URY,AMR,134556,236032,370588,206565,201429,177423,147363,111246,96393,940419,128810,228013,356823,204752,200644,173934,144527,109257,121991,955105,1895524,2622936,2622936
Uruguay,1964,UY,URY,AMR,135994,240188,376182,207414,201150,181049,148036,113037,97914,948600,130019,231823,361842,205302,200473,178367,145758,111354,124494,965748,1914348,2652376,2652376
Uruguay,1965,UY,URY,AMR,137032,244181,381213,208411,200685,184136,148847,114877,99573,956529,130846,235627,366473,206007,200160,182164,147022,113770,127097,976220,1932749,2680427,2680427
Uruguay,1966,UY,URY,AMR,137636,247977,385613,209689,200018,186712,149732,116775,101377,964303,131242,239219,370461,207053,199682,185370,148200,116529,129814,986648,1950951,2707030,2707030
Uruguay,1967,UY,URY,AMR,137715,251601,389316,211175,199167,188718,150645,118770,103344,971819,131127,242599,373726,208408,199071,187927,149228,119682,132677,996993,1968812,2731847,2731847
Uruguay,1968,UY,URY,AMR,137345,254912,392257,212812,198132,190115,151701,120722,105373,978855,130518,245665,376183,210039,198346,189792,150345,122969,135621,1007112,1985967,2754417,2754417
Uruguay,1969,UY,URY,AMR,136764,257570,394334,214461,196892,190911,153082,122376,107334,985056,129699,248153,377852,211821,197500,190998,151908,125938,138545,1016710,2001766,2773957,2773957
Uruguay,2031,UY,URY,AMR,90484,190321,280805,238465,246616,245800,214254,192125,245750,1383010,85983,180347,266330,228112,238947,240499,218216,203838,363250,1492862,2875872,3423001,3423001
Uruguay,2032,UY,URY,AMR,90306,185677,275983,236852,244152,248305,213963,194872,249995,1388139,85829,176017,261846,226367,236299,243126,216779,206549,367330,1496450,2884589,3422418,3422418
Uruguay,2033,UY,URY,AMR,90082,182707,272789,233744,241849,249870,214787,197172,254096,1391518,85628,173300,258928,223196,233858,244762,216458,208938,371168,1498380,2889898,3421623,3421623
Uruguay,2034,UY,URY,AMR,89760,181219,270979,229286,239838,250121,217019,198979,258122,1393365,85328,171982,257310,218733,231753,245048,217575,210918,374832,1498859,2892224,3420506,3420506
Uruguay,2035,UY,URY,AMR,89361,180806,270167,223818,238154,249988,219951,200224,261912,1394047,84957,171652,256609,213293,230032,244924,219447,212429,378140,1498265,2892312,3419085,3419085
Uruguay,2036,UY,URY,AMR,88920,180656,269576,218046,236849,249473,223163,200945,265870,1394346,84541,171552,256093,207575,228709,244402,221694,213492,381478,1497350,2891696,3417374,3417374
Uruguay,2037,UY,URY,AMR,88373,180402,268775,212254,235664,248593,226478,201324,270337,1394650,84020,171348,255368,201884,227474,243470,224258,213944,385389,1496419,2891069,3415209,3415209
Uruguay,2038,UY,URY,AMR,87712,180147,267859,206300,234741,247464,229691,201539,275068,1394803,83394,171143,254537,196069,226470,242231,227004,213816,389749,1495339,2890142,3412541,3412541
Uruguay,2039,UY,URY,AMR,86991,179806,266797,200297,234159,245724,232975,201353,280351,1394859,82712,170849,253561,190241,225782,240317,230043,213000,394782,1494165,2889024,3409390,3409390
Uruguay,2040,UY,URY,AMR,86197,179380,265577,194139,233756,243622,236209,200839,286272,1394837,81958,170468,252426,184323,225234,237969,233198,211563,400619,1492906,2887743,3405741,3405741
Uruguay,2041,UY,URY,AMR,85288,178832,264120,188251,233234,241406,239022,200454,292380,1394747,81094,169971,251065,178721,224514,235471,236059,210008,406799,1491572,2886319,3401505,3401505
Uruguay,2042,UY,URY,AMR,84342,178112,262454,183662,231700,239058,241575,200486,298095,1394576,80198,169302,249500,174413,222786,232875,238692,208768,412618,1490152,2884728,3396680,3396680
Uruguay,2043,UY,URY,AMR,83377,177234,260611,180740,228686,236859,243209,201563,303240,1394297,79281,168478,247759,171705,219641,230480,240354,208604,417832,1488616,2882913,3391282,3391282
Uruguay,2044,UY,URY,AMR,82389,176194,258583,179284,224330,234948,243561,203962,307847,1393932,78343,167498,245841,170397,215205,228418,240683,209830,422436,1486969,2880901,3385327,3385327
Uruguay,2045,UY,URY,AMR,81404,175007,256411,178890,218972,233354,243534,206991,311715,1393456,77407,166375,243782,170071,209796,226736,240613,211768,426210,1485194,2878650,3378836,3378836
Uruguay,2046,UY,URY,AMR,80421,173662,254083,178762,213308,232136,243124,210253,315247,1392830,76468,165100,241568,169982,204110,225448,240138,214060,429521,1483259,2876089,3371743,3371743
Uruguay,2047,UY,URY,AMR,79417,172176,251593,178525,207623,231033,242364,213616,318892,1392053,75513,163688,239201,169782,198451,224246,239268,216654,432768,1481169,2873222,3364011,3364011
Uruguay,2048,UY,URY,AMR,78410,170554,248964,178291,201773,230186,241360,216874,322626,1391110,74555,162149,236704,169582,192664,223275,238088,219422,435854,1478885,2869995,3355660,3355660
Uruguay,2049,UY,URY,AMR,77399,168852,246251,177966,195879,229674,239749,220199,326481,1389948,73595,160537,234132,169295,186870,222614,236251,222469,438885,1476384,2866332,3346715,3346715
Uruguay,2050,UY,URY,AMR,76338,167077,243415,177559,189816,229340,237791,223482,330621,1388609,72586,158849,231435,168919,180982,222095,233984,225633,442073,1473686,2862295,3337143,3337143
United States of America,1970,US,USA,AMR,8574952,20302606,28877558,17113433,12173851,12049785,10898759,8665654,8181088,69082570,8253305,19529615,27782920,17580560,12582843,11550427,11688671,9725186,11457603,74585290,143667860,200328340,200328340
United States of America,1971,US,USA,AMR,8543022,20160656,28703678,17830157,12612324,12050963,11000988,8763631,8307652,70565715,8210592,19391219,27601811,18100350,13031416,11482609,11806988,9877196,11738146,76036705,146602420,202907917,202907917
United States of America,1972,US,USA,AMR,8483000,19908448,28391448,18349376,13217867,12000580,11185361,8843934,8443902,72041020,8143993,19151363,27295356,18403657,13705470,11417121,11941843,10012219,12030252,77510562,149551582,205238390,205238390
United States of America,1973,US,USA,AMR,8360473,19606527,27967000,18848274,13828783,11929563,11386286,8868299,8603782,73464987,8018857,18859648,26878505,18719070,14388669,11438956,12022248,10075850,12359477,79004270,152469257,207314764,207314764
United States of America,1974,US,USA,AMR,8197906,19325614,27523520,19421453,14284233,11783582,11559113,9000562,8779210,74828153,7852967,18583650,26436617,19213660,14861944,11459162,12024833,10220232,12709853,80489684,155317837,209277968,209277968
United States of America,1975,US,USA,AMR,8002300,19067633,27069933,20096903,14602434,11637094,11693752,9202097,8977078,76209358,7657962,18327954,25985916,19803868,15221704,11501178,11957854,10432637,13092090,82009331,158218689,211274535,211274535
United States of America,1976,US,USA,AMR,7822663,18778386,26601049,20435046,15251067,11583674,11808311,9313746,9210952,77602796,7482361,18039616,25521977,20082910,15873810,11635766,11884488,10554361,13512874,83544209,161147005,213270022,213270022
United States of America,1977,US,USA,AMR,7770642,18438438,26209080,20549337,16041137,11666338,11889466,9393673,9459233,78999184,7426547,17701247,25127794,20206095,16606620,11855067,11848204,10637845,13947519,85101350,164100534,215437405,215437405
United States of America,1978,US,USA,AMR,7856746,18056964,25913710,20771376,16569784,11917915,11855058,9621967,9692283,80428383,7504860,17323209,24828069,20429431,17130202,12212829,11696831,10883227,14358754,86711274,167139657,217881437,217881437
United States of America,1979,US,USA,AMR,8008847,17699383,25708230,20913384,17195990,12202930,11802463,9825655,9908366,81848788,7650526,16963195,24613721,20570087,17727225,12591053,11546308,11129343,14728359,88292375,170141163,220463115,220463115
United States of America,1980,US,USA,AMR,8195239,17434360,25629599,20957186,17962710,12511831,11801384,9879445,10096954,83209510,7829864,16685857,24515721,20610152,18429150,12934128,11513674,11227992,15070094,89785190,172994700,223140018,223140018
United States of America,1981,US,USA,AMR,8398356,17247844,25646200,20858355,18593500,12912258,11797608,9975297,10280258,84417276,8026760,16483903,24510663,20505795,19004493,13391884,11440680,11334568,15402447,91079867,175497143,225654008,225654008
United States of America,1982,US,USA,AMR,8582986,17133579,25716565,20656825,19049671,13470442,11735194,10138271,10457901,85508304,8205763,16354225,24559988,20292496,19350066,14059158,11352990,11445060,15716790,92216560,177724864,228001418,228001418
United States of America,1983,US,USA,AMR,8718869,17078532,25797401,20441912,19535934,14041093,11671564,10321451,10612833,86624787,8335728,16284482,24620210,20051871,19698283,14730325,11362335,11508661,15996082,93347557,179972344,230389964,230389964
United States of America,1984,US,USA,AMR,8810442,17055132,25865574,20254303,20114910,14483144,11564337,10511750,10831427,87759871,8421581,16248152,24669733,19824146,20220468,15196549,11389909,11524818,16315215,94471105,182230976,232766280,232766280
United States of America,1985,US,USA,AMR,8881598,17037565,25919163,20095116,20782168,14816119,11458960,10672291,11092891,88917545,8486844,16224961,24711805,19609094,20826845,15557895,11443172,11479342,16681312,95597660,184515205,235146182,235146182
United States of America,1986,US,USA,AMR,8952072,17039804,25991876,19924974,21099654,15508261,11417053,10794479,11310977,90055398,8550715,16226452,24777167,19370219,21101616,16241537,11560178,11416927,16997860,96688337,186743735,237512783,237512783
United States of America,1987,US,USA,AMR,9037590,17144242,26181832,19697327,21181942,16321498,11491915,10860461,11505223,91058366,8629933,16321750,24951683,19080518,21196768,16994750,11749627,11363754,17275873,97661290,188719656,239853168,239853168
United States of America,1988,US,USA,AMR,9159412,17341174,26500586,19437086,21342771,16865166,11734417,10809945,11790856,91980241,8745264,16504442,25249706,18757708,21367197,17520723,12085099,11177521,17649031,98557279,190537520,242287814,242287814
United States of America,1989,US,USA,AMR,9327248,17571413,26898661,19202571,21401533,17532247,11998875,10756864,12058687,92950777,8903737,16722711,25626448,18442430,21452392,18136030,12431781,11006294,18009281,99478208,192428985,244954094,244954094
United States of America,1990,US,USA,AMR,9518123,17869386,27387509,19011390,21444527,18334484,12280061,10774789,12218694,94063945,9082772,17008254,26091026,18185606,21505325,18863850,12745092,10984287,18257097,100541257,194605202,248083732,248083732
United States of America,1991,US,USA,AMR,9706129,18228049,27934178,18865739,21461221,19000071,12693097,10818608,12457013,95295749,9261957,17351812,26613769,18009139,21498098,19489454,13212335,10954888,18552579,101716493,197012242,251560189,251560189
United States of America,1992,US,USA,AMR,9882483,18594189,28476672,18813714,21428860,19503728,13282081,10807128,12769318,96604829,9430939,17700215,27131154,17940666,21423664,19911159,13911167,10911648,18864378,102962682,199567511,255175339,255175339
United States of America,1993,US,USA,AMR,10019517,18949307,28968824,18829618,21356094,20032517,13876132,10781052,13069874,97945287,9558878,18037906,27596784,17957264,21315266,20339149,14616619,10950969,19089594,104268861,202214148,258779753,258779753
United States of America,1994,US,USA,AMR,10079479,19284405,29363884,18878732,21262727,20653643,14367191,10726931,13432331,99321555,9613527,18357887,27971414,18005236,21196846,20943174,15147136,11014492,19309848,105616732,204938287,262273589,262273589
United States of America,1995,US,USA,AMR,10052959,19610357,29663316,18953624,21175682,21366157,14754301,10690050,13806180,100745994,9587789,18669536,28257325,18056084,21091759,21633871,15582157,11112744,19517304,106993919,207739913,265660556,265660556
United States of America,1996,US,USA,AMR,9975593,19945400,29920993,19066615,21072846,21752070,15474981,10712728,14102471,102181711,9513580,18989752,28503332,18138695,20975539,22008021,16324828,11275177,19656055,108378315,210560026,268984347,268984347
United States of America,1997,US,USA,AMR,9905651,20295082,30200733,19292581,20931600,21943175,16319179,10832675,14321148,103640358,9446920,19321618,28768538,18339984,20815270,22219361,17144360,11500412,19766426,109785813,213426171,272395438,272395438
United States of America,1998,US,USA,AMR,9873342,20627094,30500436,19598379,20745081,22228042,16904981,11110267,14521148,105107898,9418868,19632565,29051433,18626761,20584210,22501924,17745254,11865143,19851954,111175246,216283144,275835018,275835018
United States of America,1999,US,USA,AMR,9876183,20901864,30778047,19920565,20559945,22389852,17598671,11418090,14686883,106574006,9425990,19891217,29317207,18922503,20316523,22677302,18424149,12250902,19920945,112512324,219086330,279181581,279181581
United States of America,2000,US,USA,AMR,9906728,21076580,30983308,20282020,20403356,22442490,18380386,11742357,14793031,108043640,9460676,20061047,29521723,19246183,20082932,22751321,19170426,12607241,19991774,113849877,221893517,282398554,282398554
United States of America,2001,US,USA,AMR,9960887,21147347,31108234,20678146,20275039,22378889,18984767,12173579,14991478,109481898,9519599,20135555,29655154,19608441,19930934,22710828,19773255,13089081,20112675,115225214,224707112,285470493,285470493
United States of America,2002,US,USA,AMR,10033420,21166640,31200060,21032610,20182791,22232126,19423565,12739042,15199276,110809410,9595168,20161833,29757001,19954603,19872502,22590135,20168919,13765976,20231642,116583777,227393187,288350252,288350252
United States of America,2003,US,USA,AMR,10120554,21152136,31272690,21318830,20116953,22062058,19885036,13314236,15389283,112086396,9682872,20155369,29838241,20241115,19864159,22432932,20562113,14459178,20352986,117912483,229998879,291109820,291109820
United States of America,2004,US,USA,AMR,10210144,21095018,31305162,21583379,20080223,21916223,20442180,13811406,15634728,113468139,9772523,20109196,29881719,20474168,19876384,22279605,21124097,15003876,20534730,119292860,232760999,293947885,293947885
United States of America,2005,US,USA,AMR,10272867,21023104,31295971,21829535,20065287,21800794,21100935,14209322,15921650,114927523,9834809,20051229,29886038,20670260,19901342,22153692,21782053,15457201,20768593,120733141,235660664,296842670,296842670
United States of America,2006,US,USA,AMR,10320612,20983283,31303895,22036762,20097980,21684726,21453046,14887034,16209292,116368840,9878919,20025246,29904165,20849724,19956489,22026905,22138405,16178428,21026254,122176205,238545045,299753098,299753098
United States of America,2007,US,USA,AMR,10388145,20983794,31371939,22221535,20222884,21532799,21624917,15646112,16526869,117775116,9941804,20037844,29979648,21048562,20079176,21858286,22344966,16946018,21339677,123616685,241391801,302743399,302743399
United States of America,2008,US,USA,AMR,10440897,21026851,31467748,22366908,20414732,21303652,21901367,16169388,16968997,119125044,9994384,20091713,30086097,21235901,20254619,21605719,22638308,17516302,21765176,125016025,244141069,305694910,305694910
United States of America,2009,US,USA,AMR,10439411,21106504,31545915,22458678,20624504,21027735,22076745,16803212,17431896,120422770,9995905,20181548,30177453,21374679,20442734,21298701,22840729,18177844,22231211,126365898,246788668,308512035,308512035
United States of America,2010,US,USA,AMR,10407183,21180985,31588168,22532651,20863141,20786551,22127269,17518948,17856134,121684694,9966406,20267767,30234173,21479833,20658488,21030852,22916058,18905256,22685319,127675806,249360500,311182845,311182845
United States of America,2011,US,USA,AMR,10386945,21275823,31662768,22603473,21184714,20661743,22067685,18078122,18410969,123006706,9941290,20367130,30308420,21571184,20915212,20859735,22836303,19475182,23241087,128898703,251905409,313876608,313876608
United States of America,2012,US,USA,AMR,10362621,21421508,31784129,22659865,21546509,20654369,21974828,18488612,19072950,124397133,9907930,20505332,30413262,21654357,21174353,20789715,22675186,19820837,23942352,130056800,254453933,316651321,316651321
United States of America,2013,US,USA,AMR,10320087,21572503,31892590,22681835,21887189,20681258,21877982,18928659,19712834,125769757,9858116,20645499,30503615,21702525,21426258,20769804,22495195,20163615,24651812,131209209,256978966,319375166,319375166
United States of America,2014,US,USA,AMR,10291649,21686171,31977820,22648692,22202355,20719224,21797048,19471051,20287527,127125897,9823890,20748225,30572115,21688591,21673834,20762452,22327759,20671708,25233787,132358131,259484028,322033964,322033964
United States of America,2015,US,USA,AMR,10281168,21748492,32029660,22569648,22494323,20762823,21750956,20114443,20771533,128463726,9814312,20796109,30610421,21622501,21918202,20753600,22200441,21271752,25737465,133503961,261967687,324607776,324607776
United States of America,2016,US,USA,AMR,10281754,21806233,32087987,22470302,22793329,20847876,21709031,20484419,21502375,129807332,9820061,20831906,30651967,21534958,22183349,20779312,22075823,21582541,26506919,134662902,264470234,327210198,327210198
United States of America,2017,US,USA,AMR,10278033,21871425,32149458,22377193,23083971,21043249,21615902,20682495,22329748,131132558,9817913,20877394,30695307,21454956,22451777,20911421,21899164,21739034,27357557,135813909,266946467,329791231,329791231
United States of America,2018,US,USA,AMR,10238885,21899068,32137953,22328873,23305410,21320653,21438519,20967966,23038938,132400359,9782576,20890543,30673119,21417411,22662559,21129925,21644939,21970784,28102980,136928598,269328957,332140037,332140037
United States of America,2019,US,USA,AMR,10148221,21904525,32052746,22338269,23444277,21619346,21232184,21164467,23847542,133646085,9700335,20884717,30585052,21428662,22804802,21372164,21358509,22124098,28947554,138035789,271681874,334319671,334319671
United States of America,2020,US,USA,AMR,9984018,21838429,31822447,22389844,23493403,21906001,21030508,21208006,24654203,134681965,9543673,20821277,30364950,21482020,22864213,21615055,21105693,22158647,29847014,139072642,273754607,335942003,335942003
United States of America,2021,US,USA,AMR,9797889,21659206,31457095,22485503,23468584,22176661,20851764,21075688,25426342,135484542,9366525,20654969,30021494,21579442,22850869,21854390,20919036,22049608,30781139,140034484,275519026,336997624,336997624
United States of America,2022,US,USA,AMR,9668117,21414747,31082864,22652633,23459834,22444315,20763300,20882759,26212431,136415272,9244631,20427463,29672094,21741198,22851044,22092057,20838345,21866724,31730261,141119629,277534901,338289857,338289857
United States of America,2023,US,USA,AMR,9596709,21143368,30740077,22832542,23486837,22701874,20738863,20722573,27072563,137555252,9175311,20178436,29353747,21915228,22875785,22327138,20827586,21675986,32725759,142347482,279902734,339996563,339996563
United States of America,2024,US,USA,AMR,9570073,20889831,30459904,22932257,23497036,22940706,20734847,20611152,27993365,138709363,9145777,19947991,29093768,22012456,22875112,22553428,20829932,21514878,33765572,143551378,282260741,341814420,341814420
United States of America,2025,US,USA,AMR,9595774,20649744,30245518,22934824,23493156,23165060,20733847,20546030,28912751,139785668,9166324,19731338,28897662,22014322,22858373,22773808,20822345,21401335,34804370,144674553,284460221,343603404,343603404
United States of America,2026,US,USA,AMR,9648762,20431642,30080404,22879759,23482047,23387187,20768512,20475474,29808254,140801233,9213671,19535491,28749162,21957773,22835690,22997046,20838519,21283031,35822083,145734142,286535375,345364937,345364937
United States of America,2027,US,USA,AMR,9692827,20253277,29946104,22809809,23472165,23609442,20913022,20339533,30630348,141774319,9252660,19369985,28622645,21892698,22820579,23219090,20955765,21101781,36765272,146755185,288529504,347098261,347098261
United States of America,2028,US,USA,AMR,9738573,20091848,29830421,22718074,23503098,23805026,21143668,20134786,31413449,142718101,9293094,19217084,28510178,21807684,22857128,23407704,21157370,20851647,37664624,147746157,290464258,348804850,348804850
United States of America,2029,US,USA,AMR,9784586,19935229,29719815,22616574,23581769,23953745,21393654,19913434,32191865,143651041,9333889,19067911,28401800,21712091,22944734,23549511,21376757,20575933,38561656,148720682,292371723,350493332,350493332
United States of America,2030,US,USA,AMR,9829200,19785711,29614911,22508106,23698478,24045474,21673656,19739152,32906866,144571732,9373792,18921276,28295068,21614129,23069005,23639291,21619428,20348829,39389909,149680591,294252323,352162301,352162301
United States of America,1950,US,USA,AMR,8208526,12210978,20419504,10535801,11358882,10400881,8517925,6575158,5707947,53096594,7902210,11781267,19683477,10927087,11943700,10682470,8554911,6557467,6416347,55081982,108178576,148281550,148281550
United States of America,1951,US,USA,AMR,8397762,12631532,21029294,10803667,11331237,10511575,8600776,6629060,5878887,53755202,8089376,12160213,20249589,10739776,11953285,10854107,8688979,6668587,6659629,55564363,109319565,150598453,150598453
United States of America,1952,US,USA,AMR,8397405,13239164,21636569,11056747,11394224,10560723,8700604,6681167,6049255,54442720,8066861,12752477,20819338,10574931,11955162,10986384,8828928,6799985,6897719,56043109,110485829,152941727,152941727
United States of America,1953,US,USA,AMR,8535650,13867804,22403454,10840109,11584982,10579314,8794878,6796014,6222686,54817983,8174164,13392417,21566581,10548907,11996104,11048117,8938224,6987648,7144175,56663175,111481158,155451199,155451199
United States of America,1954,US,USA,AMR,8845171,14332809,23177980,10720626,11773960,10698920,8907346,6896092,6402971,55399915,8504639,13816515,22321154,10542584,11965174,11167467,9071365,7156213,7404018,57306821,112706736,158205873,158205873
United States of America,1955,US,USA,AMR,9318352,14647737,23966089,10656437,11943329,10887698,9055780,6964502,6581077,56088823,8965203,14125953,23091156,10564567,11869765,11349526,9252781,7284572,7669177,57990388,114079211,161136449,161136449
United States of America,1956,US,USA,AMR,9510288,15272651,24782939,10635932,12082852,10970738,9256919,7013608,6750366,56710415,9149144,14727382,23876526,10664558,11768772,11448019,9490738,7387978,7933462,58693527,115403942,164063411,164063411
United States of America,1957,US,USA,AMR,9554581,15993185,25547766,10734951,12159167,10998436,9423809,7121634,6893394,57331391,9219419,15387910,24607329,10851968,11695966,11489793,9698097,7551079,8175727,59462630,116794021,166949120,166949120
United States of America,1958,US,USA,AMR,9774181,16448339,26222520,11068448,12089360,11204981,9589362,7245426,7016390,58213967,9433735,15856524,25290259,11201724,11494503,11698369,9897011,7728346,8400408,60420361,118634328,170147101,170147101
United States of America,1959,US,USA,AMR,9933086,16982093,26915179,11428398,11989425,11386221,9779398,7315204,7161337,59059983,9594246,16387788,25982034,11561440,11295190,11899577,10111827,7842108,8657262,61367404,120427387,173324608,173324608
United States of America,1960,US,USA,AMR,10039095,17585758,27624853,11764152,11936032,11393702,9884708,7400929,7316912,59696435,9704360,16963403,26667763,11872509,11219042,11945886,10253802,7962223,8946068,62199530,121895965,176188578,176188578
United States of America,1961,US,USA,AMR,10110208,18044206,28154414,12202618,11898894,11472490,9992622,7497672,7445374,60509670,9777719,17427163,27204882,12331898,11124727,12036601,10408338,8088172,9228573,63218309,123727979,179087278,179087278
United States of America,1962,US,USA,AMR,10117689,18335815,28453504,12829386,11809335,11642115,10073049,7599118,7552975,61505978,9786541,17693320,27479861,13025429,11031259,12150577,10549802,8218052,9503344,64478463,125984441,181917809,181917809
United States of America,1963,US,USA,AMR,10075622,18665887,28741509,13478619,11705412,11833566,10079598,7706849,7663655,62467699,9742640,17971858,27714498,13716999,11037375,12211406,10611650,8360413,9788328,65726171,128193870,184649873,184649873
United States of America,1964,US,USA,AMR,9992003,19120246,29112249,13976719,11555511,11993523,10186193,7819379,7763945,63295270,9654386,18430001,28084387,14195255,11069739,12196973,10744925,8516385,10062199,66785476,130080746,187277378,187277378
United States of America,1965,US,USA,AMR,9825716,19708285,29534001,14272221,11406674,12101876,10355014,7956793,7830244,63922822,9489134,18989554,28478688,14558166,11142159,12112425,10945027,8716165,10293839,67767781,131690603,189703283,189703283
United States of America,1966,US,USA,AMR,9561175,19992857,29554032,14765629,11322674,12200401,10419658,8141357,7876456,64726175,9230722,19251175,28481897,15210986,11301086,12037166,11051761,8969263,10498610,69068872,133795047,191830975,191830975
United States of America,1967,US,USA,AMR,9244586,20076563,29321149,15326948,11364162,12269296,10454327,8297812,7960490,65673035,8920981,19347625,28268606,15927467,11535906,12002322,11119177,9189038,10745748,70519658,136192693,193782438,193782438
United States of America,1968,US,USA,AMR,8933391,20255446,29188837,15712635,11571938,12178543,10665034,8431254,8030654,66590058,8615943,19508956,28124899,16412147,11892846,11809350,11360505,9379964,10984812,71839624,138429682,195743427,195743427
United States of America,1969,US,USA,AMR,8689926,20326405,29016331,16307235,11838480,12068529,10855898,8577084,8075964,67723190,8374461,19564208,27938669,16948694,12254293,11606789,11597166,9580884,11193307,73181133,140904323,197859329,197859329
United States of America,2031,US,USA,AMR,9872770,19663248,29536018,22348362,23870229,24094648,21987196,19630279,33524907,145455621,9412994,18801973,28214967,21466790,23242535,23690609,21891112,20205802,40099523,150596371,296051992,353802974,353802974
United States of America,2032,US,USA,AMR,9916656,19584876,29501532,22117437,24084669,24136541,22283695,19596194,34065093,146283629,9452695,18726294,28178989,21251816,23450665,23733026,22150467,20159282,40702790,151448046,297731675,355412200,355412200
United States of America,2033,US,USA,AMR,9962278,19561050,29523328,21852737,24273747,24174218,22547692,19601240,34594337,147043971,9494389,18699108,28193497,21008108,23632725,23764294,22389143,20164879,41271117,152230266,299274237,356991059,356991059
United States of America,2034,US,USA,AMR,10005449,19582080,29587529,21604786,24381613,24191996,22789900,19619853,35156395,147744543,9534188,18711821,28246009,20782024,23737744,23769382,22617595,20179270,41864693,152950708,300695251,358528775,358528775
United States of America,2035,US,USA,AMR,10044485,19653589,29698074,21369206,24393388,24196524,23019165,19644836,35755282,148378401,9570086,18773281,28343367,20568785,23747748,23759095,22840945,20186151,42493846,153596570,301974971,360016420,360016420
United States of America,2036,US,USA,AMR,10079148,19751225,29830373,21154804,24348049,24194387,23246763,19703852,36324445,148972300,9601849,18860729,28462578,20375605,23699414,23743312,23067318,20216125,43089561,154191335,303163635,361456574,361456574
United States of America,2037,US,USA,AMR,10105972,19840202,29946174,20978990,24287104,24193484,23474150,19862331,36764025,149560084,9626529,18940273,28566802,20211592,23641670,23735074,23292202,20341075,43547166,154768779,304328863,362841838,362841838
United States of America,2038,US,USA,AMR,10116855,19932558,30049413,20819280,24203564,24232473,23675105,20098679,37103315,150132416,9636238,19023214,28659452,20059234,23562894,23777813,23483757,20545247,43890951,155319896,305452312,364161174,364161174
United States of America,2039,US,USA,AMR,10117933,20022461,30140394,20664132,24108031,24316375,23829318,20352386,37421943,150692185,9636653,19104350,28741003,19910224,23470917,23869108,23628222,20765873,44202934,155847278,306539463,365420860,365420860
United States of America,2040,US,USA,AMR,10110037,20106382,30216419,20515832,24002772,24434924,23926773,20633759,37725543,151239603,9628826,19180254,28809080,19763393,23373403,23993920,23720253,21008393,44491782,156351144,307590747,366616240,366616240
United States of America,2041,US,USA,AMR,10090932,20184712,30275644,20394643,23846086,24606637,23982298,20945803,38002158,151777625,9610459,19251150,28861609,19643950,23225802,24166550,23773962,21278287,44745971,156834522,308612147,367749399,367749399
United States of America,2042,US,USA,AMR,10068119,20255558,30323677,20317550,23619053,24820112,24030337,21241160,38278480,152306692,9588273,19315521,28903794,19568268,23010811,24373219,23818690,21536028,44991023,157298039,309604731,368832202,368832202
United States of America,2043,US,USA,AMR,10041233,20312271,30353504,20294791,23358552,25008565,24074228,21506432,38584354,152826922,9562164,19366984,28929148,19541086,22767188,24553886,23852521,21774286,45254504,157743471,310570393,369853049,369853049
United States of America,2044,US,USA,AMR,10009175,20356726,30365901,20316711,23114580,25117213,24099194,21752847,38937757,153338302,9531083,19407258,28938341,19553830,22541179,24658175,23861055,22003821,45554730,158172790,311511092,370815335,370815335
United States of America,2045,US,USA,AMR,9972247,20388068,30360315,20388817,22882817,25131498,24111935,21988739,39335996,153839802,9495197,19435390,28930587,19615276,22328066,24668356,23855040,22229494,45888220,158584452,312424254,371715154,371715154
United States of America,2046,US,USA,AMR,9929764,20403770,30333534,20486766,22671964,25089592,24118459,22223292,39744639,154334712,9454094,19448798,28902892,19702557,22134914,24620645,23843863,22458200,46220596,158980775,313315487,372551915,372551915
United States of America,2047,US,USA,AMR,9879260,20407976,30287236,20576139,22499998,25032890,24126333,22456582,40133545,154825487,9405439,19451366,28856805,19781992,21971531,24564186,23840302,22684779,46523256,159366046,314191533,373335573,373335573
United States of America,2048,US,USA,AMR,9823235,20392288,30215523,20669007,22344703,24954651,24173216,22663619,40511316,155316512,9351694,19435163,28786857,19864967,21820540,24487599,23887062,22878364,46806651,159745183,315061695,374064084,374064084
United States of America,2049,US,USA,AMR,9765621,20361627,30127248,20759446,22194047,24864689,24263671,22825510,40896816,155804179,9296562,19404699,28701261,19946173,21672963,24398045,23981499,23026006,47092220,160116906,315921085,374749589,374749589
United States of America,2050,US,USA,AMR,9708878,20317115,30025993,20843908,22050221,24765148,24387535,22933014,41303291,156283117,9242261,19361192,28603453,20022190,21527649,24303091,24108797,23122881,47394785,160479393,316762510,375391963,375391963
Uzbekistan,1970,UZ,UZB,EUR,1013086,1721808,2734894,974943,697895,682108,297828,232192,278688,3163654,961855,1652213,2614068,936612,711502,712626,407257,311350,419398,3498745,6662399,12011361,12011361
Uzbekistan,1971,UZ,UZB,EUR,1025056,1778863,2803919,1049972,694397,694518,332101,226297,279974,3277259,972807,1706571,2679378,1014878,693302,731236,436824,305552,427780,3609572,6886831,12370120,12370120
Uzbekistan,1972,UZ,UZB,EUR,1042855,1828244,2871099,1128514,690075,700265,375694,220367,280218,3395133,989285,1753506,2742791,1094893,675281,747953,471912,302119,432061,3724219,7119352,12733242,12733242
Uzbekistan,1973,UZ,UZB,EUR,1066238,1870118,2936356,1209884,689835,702186,424535,215177,279689,3521306,1011105,1793142,2804247,1176373,663539,761868,509937,301131,433177,3846025,7367331,13107928,13107928
Uzbekistan,1974,UZ,UZB,EUR,1093130,1905177,2998307,1294930,697204,702685,471856,211757,278806,3657238,1036298,1826089,2862387,1257735,665232,770952,546640,302535,433677,3976771,7634009,13494711,13494711
Uzbekistan,1975,UZ,UZB,EUR,1120304,1935876,3056180,1374480,723443,702767,514004,211524,277699,3803917,1061744,1854705,2916449,1332140,690000,773909,580143,306988,434634,4117814,7921731,13894347,13894347
Uzbekistan,1976,UZ,UZB,EUR,1147460,1963995,3111455,1447190,767651,703300,551380,213835,276571,3959927,1087170,1880726,2967896,1401890,732796,772479,610386,314396,436175,4268122,8228049,14307397,14307397
Uzbekistan,1977,UZ,UZB,EUR,1174378,1990844,3165222,1522019,818802,705384,583662,217755,275292,4122914,1112351,1905529,3017880,1473851,784341,768150,636554,324325,438476,4425697,8548611,14731709,14731709
Uzbekistan,1978,UZ,UZB,EUR,1199874,2019029,3218903,1593590,875549,707403,610190,225171,273402,4285305,1136104,1931612,3067716,1542589,843377,759647,658933,337350,440491,4582387,8867692,15154314,15154314
Uzbekistan,1979,UZ,UZB,EUR,1225180,2049845,3275025,1657046,933955,705415,630613,239248,270121,4436398,1159644,1960136,3119780,1603045,905602,744733,678687,354785,440849,4727701,9164099,15558907,15558907
Uzbekistan,1980,UZ,UZB,EUR,1251566,2082641,3334207,1712644,993649,698830,645519,260520,265567,4576729,1184251,1990446,3174697,1655403,969471,724703,696186,376601,439131,4861495,9438224,15947129,15947129
Uzbekistan,1981,UZ,UZB,EUR,1278074,2120178,3398252,1760975,1056940,690444,654543,289629,260396,4712927,1209043,2025197,3234240,1700553,1036333,702228,712160,403205,435740,4990219,9703146,16335642,16335642
Uzbekistan,1982,UZ,UZB,EUR,1305923,2163165,3469088,1803045,1124155,681768,657892,326767,254813,4848440,1235173,2065120,3300293,1739670,1105338,680406,726567,434754,431077,5117812,9966252,16735643,16735643
Uzbekistan,1983,UZ,UZB,EUR,1338554,2210249,3548803,1838984,1193629,676333,657578,368068,249511,4984103,1265887,2108910,3374797,1772885,1175116,663977,737991,468733,426456,5245158,10229261,17152857,17152857
Uzbekistan,1984,UZ,UZB,EUR,1377681,2261079,3638760,1869541,1266369,677460,655582,407533,245478,5121963,1302734,2156294,3459028,1800895,1244340,659874,744378,501262,423860,5374609,10496572,17594364,17594364
Uzbekistan,1985,UZ,UZB,EUR,1422960,2313824,3736784,1897223,1333854,696062,652740,442041,243853,5265773,1345084,2205564,3550648,1826110,1306676,677531,744438,530665,424580,5510000,10775773,18063201,18063201
Uzbekistan,1986,UZ,UZB,EUR,1474911,2366978,3841889,1923855,1395284,731376,649949,472023,244477,5416964,1393414,2255251,3648665,1850365,1364854,712031,739830,556866,428542,5652488,11069452,18560008,18560008
Uzbekistan,1987,UZ,UZB,EUR,1528533,2421296,3949829,1950634,1459852,772910,648252,497203,246787,5575638,1443267,2306017,3749284,1874924,1426142,754401,732032,579158,435763,5802420,11378058,19077170,19077170
Uzbekistan,1988,UZ,UZB,EUR,1574277,2479256,4053533,1979993,1524055,821041,646871,517399,251764,5741123,1485671,2360190,3845861,1902163,1487187,805168,720599,598136,446261,5959514,11700637,19600028,19600028
Uzbekistan,1989,UZ,UZB,EUR,1607150,2543678,4150828,2009941,1582364,873410,642968,532926,261160,5902769,1516075,2420397,3936472,1929657,1542462,861768,704199,615158,459587,6112831,12015600,20102902,20102902
Uzbekistan,1990,UZ,UZB,EUR,1631759,2615216,4246975,2037311,1631760,928471,635571,544189,275023,6052325,1539057,2487009,4026066,1953960,1588843,921650,683750,630392,475132,6253727,12306052,20579100,20579100
Uzbekistan,1991,UZ,UZB,EUR,1652629,2693934,4346563,2070973,1676156,988790,627307,550906,294006,6208138,1558785,2560262,4119047,1984390,1630352,986259,661801,644483,493272,6400557,12608695,21074304,21074304
Uzbekistan,1992,UZ,UZB,EUR,1667458,2775821,4443279,2113322,1717162,1054247,619399,553358,318386,6375874,1573191,2636629,4209820,2023515,1668629,1054234,641096,657350,514336,6559160,12935034,21588138,21588138
Uzbekistan,1993,UZ,UZB,EUR,1677351,2854149,4531500,2158245,1749944,1120719,614027,552648,345102,6540685,1583552,2709863,4293415,2066881,1700868,1122811,625577,667331,536850,6720318,13261003,22085918,22085918
Uzbekistan,1994,UZ,UZB,EUR,1682570,2926256,4608826,2205404,1774922,1188800,614044,549970,370039,6703179,1589546,2777450,4366996,2114262,1727743,1190596,621778,672354,558991,6885724,13588903,22564732,22564732
Uzbekistan,1995,UZ,UZB,EUR,1677262,2996994,4674256,2254085,1795354,1250551,629845,545970,391691,6867496,1585505,2843753,4429258,2163100,1750723,1250835,638582,671255,580706,7055201,13922697,23026206,23026206
Uzbekistan,1996,UZ,UZB,EUR,1656045,3070172,4726217,2302829,1812858,1304843,660524,541433,410217,7032704,1566963,2912311,4479274,2211913,1771411,1305834,671060,665623,601898,7227739,14260443,23465926,23465926
Uzbekistan,1997,UZ,UZB,EUR,1621046,3138276,4759322,2353025,1829256,1360494,696163,537296,425192,7201426,1535615,2976345,4511960,2261640,1791359,1362540,710408,656792,621848,7404587,14606013,23877289,23877289
Uzbekistan,1998,UZ,UZB,EUR,1574899,3193538,4768437,2407428,1847575,1414351,737276,533147,437736,7377513,1493209,3028813,4522022,2314745,1813338,1417744,757175,644514,641278,7588794,14966307,24256775,24256775
Uzbekistan,1999,UZ,UZB,EUR,1520619,3231627,4752246,2468008,1868029,1464026,783136,527455,450052,7560706,1442847,3065182,4508029,2373695,1838080,1469475,810461,628394,661631,7781736,15342442,24602708,24602708
Uzbekistan,2000,UZ,UZB,EUR,1464220,3251836,4716056,2535589,1889590,1509395,833640,520001,462720,7750935,1390223,3084862,4475085,2439201,1864624,1517739,869230,609878,682806,7983478,15734413,24925554,24925554
Uzbekistan,2001,UZ,UZB,EUR,1413233,3252676,4665909,2612258,1917702,1549564,888954,512139,475476,7956093,1342073,3086907,4428980,2512067,1896638,1560792,932415,590447,705108,8197467,16153560,25248445,25248445
Uzbekistan,2002,UZ,UZB,EUR,1374727,3233917,4608644,2694096,1953677,1584331,948133,504660,488746,8173643,1305186,3070853,4376039,2588727,1934956,1598179,997848,572338,728660,8420708,16594351,25579030,25579030
Uzbekistan,2003,UZ,UZB,EUR,1349058,3199572,4548630,2773253,1994841,1613040,1009311,500133,501773,8392351,1280157,3040048,4320205,2662605,1977617,1629597,1064038,559416,751448,8644721,17037072,25905904,25905904
Uzbekistan,2004,UZ,UZB,EUR,1336554,3152855,4489409,2847285,2041386,1636582,1073117,500773,512334,8611477,1267582,2997262,4264844,2731373,2024616,1655758,1129695,557426,770332,8869200,17480677,26234923,26234923
Uzbekistan,2005,UZ,UZB,EUR,1335581,3093972,4429553,2921027,2091849,1657381,1132049,515567,519697,8837570,1266005,2942554,4208559,2799412,2074288,1678777,1188562,574350,782351,9097740,17935310,26573423,26573423
Uzbekistan,2006,UZ,UZB,EUR,1344650,3024856,4369506,2997961,2144728,1677037,1185158,543841,524936,9073661,1273792,2877932,4151724,2870064,2125072,1700227,1242701,605497,788373,9331934,18405595,26926819,26926819
Uzbekistan,2007,UZ,UZB,EUR,1368654,2954553,4323207,3070054,2200387,1696526,1239919,576560,528288,9311734,1295455,2811833,4107288,2936327,2177494,1721405,1298670,642807,790694,9567397,18879131,27309616,27309616
Uzbekistan,2008,UZ,UZB,EUR,1412365,2886147,4298512,3129335,2261081,1718411,1293175,614164,530115,9546281,1335525,2746722,4082247,2991057,2233763,1744906,1353285,686831,789926,9799768,19346049,27726810,27726810
Uzbekistan,2009,UZ,UZB,EUR,1468776,2822873,4291649,3171698,2330187,1744373,1343231,656136,530430,9776055,1386977,2686240,4073217,3029882,2297093,1772149,1404879,736768,786152,10026923,19802978,28167842,28167842
Uzbekistan,2010,UZ,UZB,EUR,1524925,2768893,4293818,3196118,2408308,1773746,1390213,702476,529560,10000421,1437433,2634494,4071927,3052046,2368103,1802313,1453542,791699,780359,10248062,20248483,28614227,28614227
Uzbekistan,2011,UZ,UZB,EUR,1573071,2729956,4303027,3200474,2493930,1808594,1431966,753004,528759,10216727,1479748,2596266,4076014,3056160,2445684,1837395,1496971,850616,774861,10461687,20678414,29057458,29057458
Uzbekistan,2012,UZ,UZB,EUR,1609381,2717902,4327283,3184512,2582530,1849429,1467839,806594,528359,10419263,1510360,2582769,4093129,3041754,2525979,1877897,1534559,911575,771609,10663373,21082636,29503051,29503051
Uzbekistan,2013,UZ,UZB,EUR,1638409,2738112,4376521,3152414,2667732,1894975,1497679,861598,529045,10603443,1533774,2599369,4133143,3012340,2603230,1922622,1566347,973436,772134,10850109,21453552,29963226,29963226
Uzbekistan,2014,UZ,UZB,EUR,1668906,2783910,4452816,3107494,2746721,1945018,1522321,918478,531514,10771546,1558532,2639624,4198156,2970712,2674874,1971334,1592986,1035132,778989,11024027,21795573,30446542,30446542
Uzbekistan,2015,UZ,UZB,EUR,1706811,2840715,4547526,3050135,2824200,1998039,1544263,971581,543253,10931471,1590406,2689700,4280106,2917008,2745195,2022349,1616587,1091259,797910,11190308,22121779,30949417,30949417
Uzbekistan,2016,UZ,UZB,EUR,1750829,2899209,4650038,2980937,2902098,2051822,1564636,1019980,564329,11083802,1628359,2740705,4369064,2852501,2816742,2073784,1638497,1143428,825718,11350670,22434472,31453574,31453574
Uzbekistan,2017,UZ,UZB,EUR,1794034,2960262,4754296,2907824,2971266,2106244,1584072,1069288,587750,11226444,1665921,2793439,4459360,2784993,2881881,2125855,1659818,1197025,856015,11505587,22732031,31945682,31945682
Uzbekistan,2018,UZ,UZB,EUR,1841389,3033247,4874636,2834544,3024161,2163644,1604902,1116574,613888,11357713,1707409,2856930,4564339,2717301,2933672,2180750,1683003,1248890,889265,11652881,23010594,32449576,32449576
Uzbekistan,2019,UZ,UZB,EUR,1893750,3120005,5013755,2765035,3057019,2227340,1628763,1160503,642896,11481556,1754135,2932755,4686890,2653439,2967882,2241634,1709336,1297407,925041,11794739,23276295,32976948,32976948
Uzbekistan,2020,UZ,UZB,EUR,1948180,3214068,5162248,2707970,3073831,2300228,1655471,1200042,671745,11609287,1803912,3014755,4818667,2599951,2986215,2310180,1738059,1341865,960173,11936443,23545730,33526656,33526656
Uzbekistan,2021,UZ,UZB,EUR,1997381,3306617,5303998,2669775,3074049,2381766,1687398,1233805,701106,11747899,1849659,3094968,4944627,2562058,2988162,2385871,1771501,1380562,996771,12084925,23832824,34081449,34081449
Uzbekistan,2022,UZ,UZB,EUR,2030306,3386719,5417025,2660488,3056148,2467120,1725987,1264233,736898,11910874,1881078,3163372,5044450,2550049,2972738,2464760,1810908,1415090,1041763,12255308,24166182,34627652,34627652
Uzbekistan,2023,UZ,UZB,EUR,2036666,3463775,5500441,2685087,3024506,2549985,1769926,1291024,778184,12098712,1888766,3228733,5117499,2569041,2943497,2540992,1854901,1445215,1093650,12447296,24546008,35163944,35163944
Uzbekistan,2024,UZ,UZB,EUR,2012382,3547269,5559651,2734799,2980720,2626666,1818106,1313655,822435,12296381,1868301,3300758,5169059,2611416,2902374,2611555,1902708,1470612,1150042,12648707,24945088,35673804,35673804
Uzbekistan,2025,UZ,UZB,EUR,1964220,3639946,5604166,2794969,2925269,2701760,1869015,1334255,870115,12495383,1825406,3382744,5208150,2663298,2849596,2680725,1952731,1493420,1211541,12851311,25346694,36159016,36159016
Uzbekistan,2026,UZ,UZB,EUR,1906996,3733284,5640280,2856369,2860231,2778722,1921252,1353932,920245,12690751,1773953,3466636,5240589,2715897,2787289,2751840,2003524,1515042,1276865,13050457,25741208,36622074,36622074
Uzbekistan,2027,UZ,UZB,EUR,1856294,3809695,5665989,2919959,2794588,2850076,1975472,1373481,971871,12885447,1728366,3535989,5264355,2770099,2723810,2818138,2055623,1536601,1344686,13248957,26134404,37064740,37064740
Uzbekistan,2028,UZ,UZB,EUR,1812971,3863812,5676783,2994999,2731305,2908285,2033918,1394904,1023115,13086526,1689401,3585677,5275078,2834907,2661583,2872693,2111173,1560345,1412808,13453509,26540035,37491898,37491898
Uzbekistan,2029,UZ,UZB,EUR,1778032,3892510,5670542,3083338,2673485,2949406,2099675,1419505,1072711,13298120,1657992,3612687,5270679,2911902,2604183,2911226,2173278,1587423,1479901,13667913,26966033,37907251,37907251
Uzbekistan,2030,UZ,UZB,EUR,1751801,3899269,5651070,3178204,2625168,2972897,2173566,1446899,1121015,13517749,1634474,3620185,5254659,2994647,2555650,2933223,2242702,1617137,1546384,13889743,27407492,38313228,38313228
Uzbekistan,1950,UZ,UZB,EUR,368489,621086,989575,661664,301383,284945,336466,236728,181601,2002787,337276,617954,955230,675389,407266,351551,440095,240304,185360,2299965,4302752,6247550,6247550
Uzbekistan,1951,UZ,UZB,EUR,419246,613238,1032484,667921,335568,275362,333243,240717,187354,2040165,391910,594269,986179,687241,435061,342551,441806,251991,191323,2349973,4390138,6408801,6408801
Uzbekistan,1952,UZ,UZB,EUR,471069,606494,1077563,666954,380132,265802,326694,245959,193135,2078676,446161,572777,1018938,697058,468639,336574,436056,265283,197926,2401536,4480212,6576712,6576712
Uzbekistan,1953,UZ,UZB,EUR,522906,604733,1127639,661293,430266,257002,317980,251933,198606,2117080,499171,558559,1057730,703425,505000,333516,424874,280207,204799,2451821,4568901,6754273,6754273
Uzbekistan,1954,UZ,UZB,EUR,574347,611588,1185935,653689,478451,250072,308926,257952,203330,2152420,548002,558948,1106950,704303,539499,332914,411767,296654,211452,2496589,4649009,6941899,6941899
Uzbekistan,1955,UZ,UZB,EUR,615893,638735,1254628,645397,520589,246687,300219,263511,207323,2183726,585603,583749,1169352,698489,570091,335353,398428,313935,217928,2534224,4717950,7141923,7141923
Uzbekistan,1956,UZ,UZB,EUR,648259,684935,1333194,637470,557178,246061,292099,268860,210588,2212256,616341,627513,1243854,687919,596704,340723,384498,332396,224451,2566691,4778947,7355995,7355995
Uzbekistan,1957,UZ,UZB,EUR,682313,738511,1420824,631292,587986,247104,284902,274020,212959,2238263,648703,680540,1329243,674265,618467,348484,370528,352129,230689,2594562,4832825,7582900,7582900
Uzbekistan,1958,UZ,UZB,EUR,717765,799732,1517497,626211,612572,252384,278136,278189,215132,2262624,682386,743208,1425594,657294,636090,359604,357402,370912,237340,2618642,4881266,7824361,7824361
Uzbekistan,1959,UZ,UZB,EUR,756120,867958,1624078,620052,631203,266291,270873,280372,218345,2287136,718805,814541,1533346,636613,651566,376080,345625,385070,245993,2640947,4928083,8085506,8085506
Uzbekistan,1960,UZ,UZB,EUR,797251,942564,1739815,613711,645784,290291,263011,280225,222904,2315926,757883,892809,1650692,615296,666709,398561,335629,392880,256811,2665886,4981812,8372311,8372311
Uzbekistan,1961,UZ,UZB,EUR,839225,1022751,1861976,610490,657120,325896,255326,277814,228765,2355411,797797,976246,1774043,596728,683788,428226,328112,394377,269394,2700625,5056036,8692048,8692048
Uzbekistan,1962,UZ,UZB,EUR,880936,1107208,1988144,610073,664206,372881,248268,273025,235817,2404270,837456,1062240,1899696,582241,701699,464899,323969,389449,283861,2746118,5150388,9038222,9038222
Uzbekistan,1963,UZ,UZB,EUR,918631,1193518,2112149,614462,667824,425872,242242,266678,243279,2460357,873322,1148666,2021988,574887,717394,505006,322899,379929,299975,2800090,5260447,9394588,9394588
Uzbekistan,1964,UZ,UZB,EUR,949197,1282505,2231702,627140,670595,477700,238342,260315,250429,2524521,902381,1233835,2136216,581803,728836,544086,324566,369083,317327,2865701,5390222,9758147,9758147
Uzbekistan,1965,UZ,UZB,EUR,972704,1364807,2337511,659402,673571,524430,238172,254497,257011,2607083,924606,1310788,2235394,612492,734634,580091,329512,358316,335063,2950108,5557191,10130096,10130096
Uzbekistan,1966,UZ,UZB,EUR,988227,1439087,2427314,710015,677592,566492,240969,249368,262983,2707419,939198,1381881,2321079,661513,736500,612923,337609,347274,353336,3049155,5756574,10504969,10504969
Uzbekistan,1967,UZ,UZB,EUR,996526,1514775,2511301,767585,683919,603701,245746,245182,268151,2814284,946927,1454317,2401244,719329,736074,641861,348452,336612,372373,3154701,5968985,10881533,10881533
Uzbekistan,1968,UZ,UZB,EUR,1001147,1588230,2589377,832321,691777,635713,254917,241521,272603,2928852,951129,1524584,2475713,786266,732947,667611,362954,327007,390872,3267657,6196509,11261600,11261600
Uzbekistan,1969,UZ,UZB,EUR,1005912,1657373,2663285,902244,697440,662082,272229,237366,276214,3047575,955394,1590683,2546077,859935,725106,691435,382687,318583,406955,3384701,6432276,11641640,11641640
Uzbekistan,2031,UZ,UZB,EUR,1733192,3891494,5624686,3270890,2591858,2977110,2254386,1478673,1166502,13739419,1617913,3614844,5232757,3075208,2520647,2937540,2318498,1651229,1610392,14113514,27852933,38710380,38710380
Uzbekistan,2032,UZ,UZB,EUR,1720474,3873904,5594378,3350915,2585033,2961856,2337822,1515204,1208623,13959453,1606711,3600945,5207656,3143781,2510181,2923742,2396846,1690128,1671196,14335874,28295327,39097348,39097348
Uzbekistan,2033,UZ,UZB,EUR,1712598,3837088,5549686,3427768,2609807,2931274,2417827,1555497,1247725,14189898,1599876,3569826,5169702,3209154,2529441,2895289,2472063,1732717,1729057,14567721,28757619,39477006,39477006
Uzbekistan,2034,UZ,UZB,EUR,1708918,3778067,5486985,3511072,2659392,2888712,2491817,1599528,1285308,14435829,1596842,3518130,5114972,3281188,2571911,2855001,2541685,1778862,1785527,14814174,29250003,39851948,39851948
Uzbekistan,2035,UZ,UZB,EUR,1708065,3703905,5411970,3603512,2719280,2834743,2564300,1646179,1323627,14691641,1596416,3451900,5048316,3363147,2623789,2803173,2609944,1827220,1843194,15070467,29762108,40222392,40222392
Uzbekistan,2036,UZ,UZB,EUR,1710532,3628319,5338851,3696571,2780340,2771473,2638574,1694150,1362935,14944043,1599057,3384060,4983117,3446983,2676345,2741924,2680097,1876407,1902229,15323985,30268028,40589997,40589997
Uzbekistan,2037,UZ,UZB,EUR,1717378,3565107,5282485,3772710,2843529,2707663,2707401,1744028,1403176,15178507,1605771,3327421,4933192,3516272,2730464,2679517,2745490,1926925,1962530,15561198,30739705,40955389,40955389
Uzbekistan,2038,UZ,UZB,EUR,1728312,3514086,5242398,3826615,2918040,2646187,2763576,1797896,1444497,15396811,1616264,3281743,4898007,3565915,2795116,2618334,2799351,1980826,2024178,15783720,31180531,41320935,41320935
Uzbekistan,2039,UZ,UZB,EUR,1743581,3475602,5219183,3855203,3005711,2590100,2803440,1858578,1486990,15600022,1630760,3247397,4878157,3592927,2871882,2561926,2837564,2041085,2087063,15992447,31592469,41689808,41689808
Uzbekistan,2040,UZ,UZB,EUR,1762769,3448633,5211402,3861941,3099852,2543388,2826570,1926822,1530767,15789340,1648911,3223537,4872448,3600464,2954366,2514307,2859660,2108428,2151139,16188364,31977704,42061549,42061549
Uzbekistan,2041,UZ,UZB,EUR,1784267,3432580,5216847,3854192,3191824,2511443,2831381,2001497,1576074,15966411,1669176,3209679,4878855,3595174,3034675,2480090,2864508,2181906,2216459,16372812,32339223,42434927,42434927
Uzbekistan,2042,UZ,UZB,EUR,1806970,3426771,5233741,3836665,3271271,2505522,2817561,2078520,1622838,16132377,1690481,3205240,4895721,3581338,3103055,2470176,2851613,2257790,2282862,16546834,32679211,42808673,42808673
Uzbekistan,2043,UZ,UZB,EUR,1828813,3429879,5258692,3800024,3347642,2530604,2788906,2152155,1670490,16289821,1710969,3208935,4919904,3550333,3168276,2489685,2824291,2330560,2349769,16712914,33002735,43181331,43181331
Uzbekistan,2044,UZ,UZB,EUR,1846993,3441492,5288485,3741335,3430461,2580007,2748668,2220159,1720300,16440930,1728080,3220419,4948499,3498816,3240157,2532154,2785321,2397921,2418635,16873004,33313934,43550919,43550919
Uzbekistan,2045,UZ,UZB,EUR,1860972,3459853,5320825,3667644,3522349,2639459,2697654,2286878,1773249,16587233,1741219,3238166,4979385,3432832,3321929,2583910,2735110,2464038,2490666,17028485,33615718,43915921,43915921
Uzbekistan,2046,UZ,UZB,EUR,1870545,3483829,5354374,3592562,3614819,2700006,2638053,2355263,1828417,16729120,1750178,3261085,5011263,3365254,3405545,2636303,2675810,2531982,2564847,17179741,33908861,44274499,44274499
Uzbekistan,2047,UZ,UZB,EUR,1874494,3513385,5387879,3529799,3690474,2762619,2578161,2418625,1886340,16866018,1753868,3289110,5042978,3308841,3474657,2690231,2615468,2595340,2641670,17326207,34192225,44623081,44623081
Uzbekistan,2048,UZ,UZB,EUR,1872165,3546166,5418331,3479172,3744085,2836339,2520608,2470515,1948900,16999619,1751663,3320098,5071761,3263362,3524204,2754574,2556353,2647708,2723202,17469403,34469022,44959113,44959113
Uzbekistan,2049,UZ,UZB,EUR,1864773,3579617,5444390,3441034,3772621,2923004,2468338,2507870,2018433,17131300,1744676,3351705,5096381,3229192,3551220,2830920,2501944,2685282,2812061,17610619,34741919,45282690,45282690
Uzbekistan,2050,UZ,UZB,EUR,1852811,3612795,5465606,3414358,3779513,3016043,2425231,2530478,2095478,17261101,1733388,3382998,5116386,3205476,3558849,2912942,2456212,2707702,2908883,17750064,35011165,45593149,45593149
Saint Vincent and the Grenadines,1970,VC,VCT,AMR,8667,16012,24679,9652,4252,3209,2810,2296,1652,23871,8419,15475,23894,9262,4152,3575,3256,2700,3069,26014,49885,98459,98459
Saint Vincent and the Grenadines,1971,VC,VCT,AMR,8611,16204,24815,9986,4349,3223,2842,2355,1747,24502,8370,15652,24022,9598,4086,3524,3247,2736,3163,26354,50856,99699,99699
Saint Vincent and the Grenadines,1972,VC,VCT,AMR,8532,16348,24880,10304,4491,3233,2876,2406,1848,25158,8297,15791,24088,9925,4072,3461,3233,2767,3258,26716,51874,100843,100843
Saint Vincent and the Grenadines,1973,VC,VCT,AMR,8434,16441,24875,10631,4668,3246,2903,2452,1954,25854,8206,15884,24090,10264,4095,3393,3217,2798,3342,27109,52963,101924,101924
Saint Vincent and the Grenadines,1974,VC,VCT,AMR,8321,16472,24793,10957,4894,3259,2929,2495,2059,26593,8098,15915,24013,10582,4199,3313,3195,2824,3437,27550,54143,102951,102951
Saint Vincent and the Grenadines,1975,VC,VCT,AMR,8199,16425,24624,11274,5164,3273,2953,2542,2171,27377,7979,15870,23849,10879,4377,3220,3172,2849,3537,28034,55411,103879,103879
Saint Vincent and the Grenadines,1976,VC,VCT,AMR,8076,16317,24393,11603,5440,3289,2978,2587,2276,28173,7858,15774,23632,11185,4576,3111,3139,2870,3636,28517,56690,104709,104709
Saint Vincent and the Grenadines,1977,VC,VCT,AMR,7963,16199,24162,11910,5726,3302,2998,2628,2389,28953,7745,15662,23407,11470,4805,2984,3105,2886,3729,28979,57932,105499,105499
Saint Vincent and the Grenadines,1978,VC,VCT,AMR,7881,16071,23952,12168,6022,3315,3016,2666,2495,29682,7663,15535,23198,11719,5063,2843,3063,2896,3815,29399,59081,106236,106236
Saint Vincent and the Grenadines,1979,VC,VCT,AMR,7840,15919,23759,12373,6314,3341,3036,2703,2603,30370,7625,15388,23013,11906,5327,2698,3016,2901,3890,29738,60108,106882,106882
Saint Vincent and the Grenadines,1980,VC,VCT,AMR,7817,15746,23563,12547,6599,3390,3051,2740,2708,31035,7604,15223,22827,12060,5605,2568,2960,2898,3957,30048,61083,107480,107480
Saint Vincent and the Grenadines,1981,VC,VCT,AMR,7783,15517,23300,12733,6902,3480,3050,2748,2806,31719,7572,14992,22564,12226,5978,2565,2933,2885,4018,30605,62324,108191,108191
Saint Vincent and the Grenadines,1982,VC,VCT,AMR,7733,15252,22985,12908,7208,3619,3035,2729,2891,32390,7526,14713,22239,12366,6427,2703,2928,2876,4053,31353,63743,108974,108974
Saint Vincent and the Grenadines,1983,VC,VCT,AMR,7671,15044,22715,12986,7523,3779,3025,2715,2959,32987,7469,14489,21958,12414,6857,2879,2925,2875,4084,32034,65021,109684,109684
Saint Vincent and the Grenadines,1984,VC,VCT,AMR,7590,14904,22494,12971,7830,3966,3014,2700,3002,33483,7390,14340,21730,12368,7238,3115,2920,2877,4103,32621,66104,110329,110329
Saint Vincent and the Grenadines,1985,VC,VCT,AMR,7507,14810,22317,12870,8133,4168,3010,2688,3056,33925,7297,14244,21541,12240,7575,3395,2918,2888,4104,33120,67045,110906,110906
Saint Vincent and the Grenadines,1986,VC,VCT,AMR,7409,14760,22169,12722,8437,4354,3013,2677,3084,34287,7176,14196,21372,12070,7888,3681,2918,2904,4100,33561,67848,111388,111388
Saint Vincent and the Grenadines,1987,VC,VCT,AMR,7278,14753,22031,12569,8710,4528,3020,2665,3106,34598,7015,14189,21204,11895,8141,3966,2923,2915,4095,33935,68533,111770,111770
Saint Vincent and the Grenadines,1988,VC,VCT,AMR,7131,14763,21894,12422,8942,4690,3037,2656,3115,34862,6828,14200,21028,11730,8343,4240,2955,2922,4107,34297,69159,112076,112076
Saint Vincent and the Grenadines,1989,VC,VCT,AMR,6973,14774,21747,12304,9120,4844,3074,2641,3108,35091,6628,14202,20830,11603,8475,4500,3014,2923,4129,34644,69735,112320,112320
Saint Vincent and the Grenadines,1990,VC,VCT,AMR,6819,14754,21573,12237,9226,4997,3131,2624,3095,35310,6451,14165,20616,11535,8533,4737,3110,2926,4162,35003,70313,112487,112487
Saint Vincent and the Grenadines,1991,VC,VCT,AMR,6701,14618,21319,12224,9342,5222,3215,2622,3112,35737,6345,14017,20362,11512,8579,4958,3183,2918,4211,35361,71098,112780,112780
Saint Vincent and the Grenadines,1992,VC,VCT,AMR,6648,14368,21016,12237,9457,5510,3319,2646,3170,36339,6326,13775,20101,11514,8647,5183,3222,2907,4285,35758,72097,113222,113222
Saint Vincent and the Grenadines,1993,VC,VCT,AMR,6627,14100,20727,12249,9499,5798,3418,2664,3242,36870,6346,13518,19864,11531,8679,5426,3270,2903,4347,36156,73026,113621,113621
Saint Vincent and the Grenadines,1994,VC,VCT,AMR,6606,13845,20451,12244,9501,6098,3526,2687,3309,37365,6369,13257,19626,11540,8673,5677,3326,2901,4390,36507,73872,113944,113944
Saint Vincent and the Grenadines,1995,VC,VCT,AMR,6575,13582,20157,12230,9476,6407,3639,2713,3360,37825,6372,12994,19366,11544,8643,5924,3401,2893,4425,36830,74655,114174,114174
Saint Vincent and the Grenadines,1996,VC,VCT,AMR,6504,13322,19826,12205,9434,6715,3765,2739,3401,38259,6312,12747,19059,11550,8598,6166,3503,2883,4448,37148,75407,114290,114290
Saint Vincent and the Grenadines,1997,VC,VCT,AMR,6375,13090,19465,12166,9376,7019,3905,2765,3435,38666,6185,12522,18707,11542,8540,6407,3628,2866,4459,37442,76108,114276,114276
Saint Vincent and the Grenadines,1998,VC,VCT,AMR,6211,12871,19082,12095,9309,7312,4057,2796,3469,39038,6022,12313,18335,11496,8485,6640,3772,2854,4460,37707,76745,114165,114165
Saint Vincent and the Grenadines,1999,VC,VCT,AMR,6036,12663,18699,11988,9248,7573,4231,2837,3494,39371,5850,12118,17968,11403,8440,6849,3935,2858,4472,37957,77328,113995,113995
Saint Vincent and the Grenadines,2000,VC,VCT,AMR,5871,12468,18339,11836,9209,7784,4428,2888,3519,39664,5685,11948,17633,11263,8416,7017,4121,2873,4487,38177,77841,113813,113813
Saint Vincent and the Grenadines,2001,VC,VCT,AMR,5720,12289,18009,11639,9202,7944,4651,2948,3549,39933,5538,11802,17340,11075,8412,7141,4322,2898,4509,38357,78290,113641,113641
Saint Vincent and the Grenadines,2002,VC,VCT,AMR,5560,12120,17680,11434,9196,8031,4894,3023,3605,40183,5384,11659,17043,10891,8433,7223,4526,2930,4537,38540,78723,113450,113450
Saint Vincent and the Grenadines,2003,VC,VCT,AMR,5383,11931,17314,11230,9165,8048,5147,3112,3695,40397,5214,11494,16708,10708,8458,7241,4741,2963,4575,38686,79083,113108,113108
Saint Vincent and the Grenadines,2004,VC,VCT,AMR,5198,11711,16909,11024,9118,8024,5416,3211,3791,40584,5041,11299,16340,10504,8482,7225,4959,3001,4606,38777,79361,112608,112608
Saint Vincent and the Grenadines,2005,VC,VCT,AMR,5015,11474,16489,10816,9060,7972,5687,3321,3896,40752,4867,11078,15945,10290,8504,7182,5177,3065,4631,38849,79601,112043,112043
Saint Vincent and the Grenadines,2006,VC,VCT,AMR,4842,11202,16044,10605,9005,7903,5961,3449,3998,40921,4707,10806,15513,10079,8533,7132,5388,3159,4659,38950,79871,111427,111427
Saint Vincent and the Grenadines,2007,VC,VCT,AMR,4705,10868,15573,10418,8947,7823,6228,3588,4105,41109,4577,10472,15049,9892,8557,7076,5600,3277,4694,39096,80205,110824,110824
Saint Vincent and the Grenadines,2008,VC,VCT,AMR,4620,10506,15126,10255,8883,7737,6486,3741,4214,41316,4496,10110,14606,9725,8559,7021,5809,3413,4738,39265,80581,110316,110316
Saint Vincent and the Grenadines,2009,VC,VCT,AMR,4582,10129,14711,10101,8800,7655,6715,3910,4335,41516,4460,9737,14197,9564,8527,6984,5997,3567,4782,39421,80937,109840,109840
Saint Vincent and the Grenadines,2010,VC,VCT,AMR,4560,9752,14312,9947,8681,7583,6901,4098,4449,41659,4441,9368,13809,9409,8447,6965,6146,3737,4828,39532,81191,109308,109308
Saint Vincent and the Grenadines,2011,VC,VCT,AMR,4536,9398,13934,9785,8520,7532,7032,4300,4573,41742,4418,9027,13445,9264,8312,6960,6256,3913,4877,39582,81324,108703,108703
Saint Vincent and the Grenadines,2012,VC,VCT,AMR,4508,9089,13597,9627,8334,7495,7108,4513,4690,41767,4388,8732,13120,9119,8152,6973,6322,4100,4927,39593,81360,108083,108083
Saint Vincent and the Grenadines,2013,VC,VCT,AMR,4464,8837,13301,9457,8148,7468,7129,4737,4812,41751,4343,8496,12839,8963,7977,6999,6345,4297,4972,39553,81304,107450,107450
Saint Vincent and the Grenadines,2014,VC,VCT,AMR,4401,8638,13039,9286,7995,7441,7119,4964,4930,41735,4279,8312,12591,8817,7815,7046,6341,4502,5028,39549,81284,106912,106912
Saint Vincent and the Grenadines,2015,VC,VCT,AMR,4332,8473,12805,9125,7866,7419,7091,5192,5046,41739,4213,8162,12375,8673,7668,7106,6320,4697,5110,39574,81313,106482,106482
Saint Vincent and the Grenadines,2016,VC,VCT,AMR,4253,8316,12569,8930,7739,7404,7044,5415,5159,41691,4139,8018,12157,8471,7529,7170,6290,4885,5196,39541,81232,105963,105963
Saint Vincent and the Grenadines,2017,VC,VCT,AMR,4145,8212,12357,8709,7668,7397,6986,5637,5273,41670,4035,7919,11954,8247,7443,7242,6260,5076,5299,39567,81237,105549,105549
Saint Vincent and the Grenadines,2018,VC,VCT,AMR,4010,8163,12173,8488,7647,7395,6926,5851,5378,41685,3902,7879,11781,8026,7401,7303,6238,5263,5417,39648,81333,105281,105281
Saint Vincent and the Grenadines,2019,VC,VCT,AMR,3859,8136,11995,8243,7643,7378,6863,6035,5477,41639,3752,7859,11611,7791,7368,7332,6233,5427,5525,39676,81315,104924,104924
Saint Vincent and the Grenadines,2020,VC,VCT,AMR,3708,8137,11845,8035,7674,7345,6814,6167,5553,41588,3599,7867,11466,7597,7381,7331,6249,5557,5617,39732,81320,104632,104632
Saint Vincent and the Grenadines,2021,VC,VCT,AMR,3573,8137,11710,7879,7737,7288,6777,6239,5578,41498,3466,7876,11342,7456,7425,7294,6283,5641,5686,39785,81283,104332,104332
Saint Vincent and the Grenadines,2022,VC,VCT,AMR,3470,8106,11576,7774,7805,7211,6751,6250,5568,41359,3365,7850,11215,7370,7478,7231,6329,5682,5715,39805,81164,103948,103948
Saint Vincent and the Grenadines,2023,VC,VCT,AMR,3394,8033,11427,7729,7867,7134,6739,6220,5592,41281,3291,7784,11075,7343,7533,7158,6394,5692,5784,39904,81185,103698,103698
Saint Vincent and the Grenadines,2024,VC,VCT,AMR,3336,7912,11248,7714,7914,7088,6737,6197,5729,41379,3235,7675,10910,7351,7580,7092,6484,5692,5946,40145,81524,103683,103683
Saint Vincent and the Grenadines,2025,VC,VCT,AMR,3287,7770,11057,7713,7954,7056,6748,6175,5935,41581,3188,7541,10729,7369,7614,7028,6587,5694,6166,40458,82039,103823,103823
Saint Vincent and the Grenadines,2026,VC,VCT,AMR,3248,7620,10868,7712,7960,7039,6771,6135,6156,41773,3152,7396,10548,7388,7599,6984,6702,5691,6398,40762,82535,103952,103952
Saint Vincent and the Grenadines,2027,VC,VCT,AMR,3219,7456,10675,7732,7907,7057,6797,6085,6374,41952,3126,7241,10367,7420,7523,6976,6813,5681,6646,41059,83011,104062,104062
Saint Vincent and the Grenadines,2028,VC,VCT,AMR,3201,7280,10481,7775,7806,7097,6823,6036,6602,42139,3106,7071,10177,7476,7409,6983,6905,5677,6914,41364,83503,104161,104161
Saint Vincent and the Grenadines,2029,VC,VCT,AMR,3187,7099,10286,7831,7682,7155,6838,5987,6824,42317,3093,6892,9985,7548,7278,7006,6961,5690,7173,41656,83973,104251,104251
Saint Vincent and the Grenadines,2030,VC,VCT,AMR,3174,6916,10090,7894,7551,7226,6824,5953,7036,42484,3082,6713,9795,7622,7152,7050,6983,5725,7425,41957,84441,104322,104322
Saint Vincent and the Grenadines,1950,VC,VCT,AMR,6012,7113,13125,4235,3268,2703,1781,1044,1619,14650,5766,7551,13317,5238,4123,3406,2725,1839,3114,20445,35095,61538,61538
Saint Vincent and the Grenadines,1951,VC,VCT,AMR,6357,7563,13920,4397,3309,2740,1853,1049,1534,14882,6114,7856,13970,5415,4171,3452,2751,1862,2974,20625,35507,63405,63405
Saint Vincent and the Grenadines,1952,VC,VCT,AMR,6650,8063,14713,4586,3352,2766,1925,1063,1471,15163,6421,8204,14625,5608,4225,3503,2776,1904,2847,20863,36026,65362,65362
Saint Vincent and the Grenadines,1953,VC,VCT,AMR,6916,8589,15505,4795,3406,2793,1994,1089,1400,15477,6703,8586,15289,5818,4285,3553,2801,1944,2737,21138,36615,67414,67414
Saint Vincent and the Grenadines,1954,VC,VCT,AMR,7135,9164,16299,5035,3465,2821,2063,1124,1352,15860,6927,9035,15962,6036,4358,3600,2833,1991,2651,21469,37329,69584,69584
Saint Vincent and the Grenadines,1955,VC,VCT,AMR,7307,9769,17076,5302,3533,2848,2126,1166,1305,16280,7093,9543,16636,6260,4439,3647,2864,2042,2571,21823,38103,71822,71822
Saint Vincent and the Grenadines,1956,VC,VCT,AMR,7495,10364,17859,5589,3608,2879,2192,1220,1271,16759,7274,10056,17330,6487,4534,3695,2901,2094,2509,22220,38979,74160,74160
Saint Vincent and the Grenadines,1957,VC,VCT,AMR,7700,10963,18663,5898,3697,2909,2249,1275,1232,17260,7475,10591,18066,6713,4646,3744,2946,2155,2460,22664,39924,76651,76651
Saint Vincent and the Grenadines,1958,VC,VCT,AMR,7920,11549,19469,6230,3799,2946,2303,1345,1206,17829,7687,11137,18824,6934,4774,3792,2991,2210,2434,23135,40964,79257,79257
Saint Vincent and the Grenadines,1959,VC,VCT,AMR,8152,12122,20274,6588,3918,2984,2352,1408,1191,18441,7914,11688,19602,7170,4921,3842,3042,2261,2421,23657,42098,81984,81984
Saint Vincent and the Grenadines,1960,VC,VCT,AMR,8397,12599,20996,6834,3989,3016,2402,1484,1181,18906,8149,12159,20308,7267,4979,3867,3082,2309,2426,23930,42836,84141,84141
Saint Vincent and the Grenadines,1961,VC,VCT,AMR,8614,12982,21596,6973,4003,3041,2453,1572,1177,19219,8352,12545,20897,7249,4939,3855,3111,2354,2444,23952,43171,85666,85666
Saint Vincent and the Grenadines,1962,VC,VCT,AMR,8772,13355,22127,7162,4025,3066,2501,1655,1188,19597,8504,12921,21425,7288,4895,3842,3141,2395,2478,24039,43636,87183,87183
Saint Vincent and the Grenadines,1963,VC,VCT,AMR,8867,13726,22593,7375,4044,3091,2542,1743,1205,20000,8594,13303,21897,7359,4836,3824,3165,2432,2527,24143,44143,88638,88638
Saint Vincent and the Grenadines,1964,VC,VCT,AMR,8899,14091,22990,7638,4062,3112,2583,1834,1237,20466,8626,13658,22284,7505,4767,3796,3191,2468,2586,24313,44779,90053,90053
Saint Vincent and the Grenadines,1965,VC,VCT,AMR,8868,14458,23326,7954,4085,3130,2621,1923,1285,20998,8603,14003,22606,7731,4691,3772,3212,2505,2649,24560,45558,91495,91495
Saint Vincent and the Grenadines,1966,VC,VCT,AMR,8811,14841,23652,8283,4109,3151,2663,2005,1339,21550,8550,14365,22915,7990,4605,3740,3230,2545,2724,24834,46384,92957,92957
Saint Vincent and the Grenadines,1967,VC,VCT,AMR,8763,15194,23957,8615,4131,3167,2700,2086,1408,22107,8506,14700,23206,8270,4500,3702,3243,2583,2808,25106,47213,94382,94382
Saint Vincent and the Grenadines,1968,VC,VCT,AMR,8733,15506,24239,8951,4150,3178,2741,2163,1477,22660,8479,14992,23471,8578,4375,3664,3251,2623,2890,25381,48041,95758,95758
Saint Vincent and the Grenadines,1969,VC,VCT,AMR,8705,15780,24485,9299,4188,3196,2777,2235,1561,23256,8453,15251,23704,8914,4254,3621,3259,2662,2976,25686,48942,97126,97126
Saint Vincent and the Grenadines,2031,VC,VCT,AMR,3163,6753,9916,7934,7434,7305,6784,5941,7228,42626,3072,6555,9627,7669,7046,7108,6959,5774,7658,42214,84840,104376,104376
Saint Vincent and the Grenadines,2032,VC,VCT,AMR,3152,6627,9779,7923,7352,7381,6722,5948,7391,42717,3061,6430,9491,7666,6978,7167,6909,5837,7873,42430,85147,104417,104417
Saint Vincent and the Grenadines,2033,VC,VCT,AMR,3139,6530,9669,7853,7310,7449,6662,5965,7539,42778,3049,6339,9388,7599,6954,7224,6845,5913,8062,42597,85375,104441,104441
Saint Vincent and the Grenadines,2034,VC,VCT,AMR,3126,6456,9582,7734,7299,7500,6626,5976,7670,42805,3036,6269,9305,7492,6962,7272,6783,6007,8238,42754,85559,104447,104447
Saint Vincent and the Grenadines,2035,VC,VCT,AMR,3116,6399,9515,7591,7297,7540,6604,5996,7788,42816,3026,6214,9240,7357,6979,7307,6723,6110,8400,42876,85692,104438,104438
Saint Vincent and the Grenadines,2036,VC,VCT,AMR,3100,6350,9450,7442,7296,7546,6588,6024,7903,42799,3010,6165,9175,7214,7001,7290,6687,6223,8560,42975,85774,104401,104401
Saint Vincent and the Grenadines,2037,VC,VCT,AMR,3083,6310,9393,7281,7318,7494,6609,6058,8013,42773,2995,6127,9122,7060,7034,7215,6682,6333,8737,43061,85834,104348,104348
Saint Vincent and the Grenadines,2038,VC,VCT,AMR,3068,6277,9345,7104,7363,7399,6655,6087,8121,42729,2978,6096,9074,6889,7093,7107,6693,6422,8925,43129,85858,104277,104277
Saint Vincent and the Grenadines,2039,VC,VCT,AMR,3046,6253,9299,6923,7419,7278,6716,6106,8233,42675,2958,6072,9030,6712,7160,6976,6720,6484,9124,43176,85851,104183,104183
Saint Vincent and the Grenadines,2040,VC,VCT,AMR,3026,6228,9254,6741,7482,7151,6787,6105,8348,42614,2936,6050,8986,6535,7233,6851,6764,6508,9330,43221,85835,104070,104070
Saint Vincent and the Grenadines,2041,VC,VCT,AMR,3001,6203,9204,6578,7522,7039,6869,6072,8460,42540,2914,6026,8940,6376,7280,6750,6823,6494,9526,43249,85789,103931,103931
Saint Vincent and the Grenadines,2042,VC,VCT,AMR,2977,6178,9155,6453,7512,6960,6944,6027,8565,42461,2889,5999,8888,6251,7278,6684,6886,6449,9718,43266,85727,103770,103770
Saint Vincent and the Grenadines,2043,VC,VCT,AMR,2950,6148,9098,6359,7440,6921,7012,5981,8670,42383,2864,5971,8835,6158,7214,6660,6941,6396,9907,43276,85659,103586,103586
Saint Vincent and the Grenadines,2044,VC,VCT,AMR,2922,6116,9038,6284,7322,6914,7061,5953,8754,42288,2838,5940,8778,6090,7105,6669,6990,6338,10083,43275,85563,103384,103384
Saint Vincent and the Grenadines,2045,VC,VCT,AMR,2893,6079,8972,6225,7182,6917,7100,5939,8838,42201,2810,5906,8716,6034,6971,6689,7025,6291,10266,43276,85477,103158,103158
Saint Vincent and the Grenadines,2046,VC,VCT,AMR,2863,6042,8905,6177,7034,6919,7111,5938,8916,42095,2780,5866,8646,5986,6831,6711,7012,6260,10457,43257,85352,102902,102902
Saint Vincent and the Grenadines,2047,VC,VCT,AMR,2833,6003,8836,6138,6874,6940,7065,5965,9004,41986,2750,5830,8580,5948,6674,6745,6938,6263,10647,43215,85201,102627,102627
Saint Vincent and the Grenadines,2048,VC,VCT,AMR,2802,5959,8761,6107,6701,6988,6977,6015,9092,41880,2721,5788,8509,5918,6506,6804,6831,6284,10845,43188,85068,102337,102337
Saint Vincent and the Grenadines,2049,VC,VCT,AMR,2769,5912,8681,6081,6523,7045,6866,6079,9170,41764,2688,5740,8428,5894,6328,6876,6710,6315,11026,43149,84913,102025,102025
Saint Vincent and the Grenadines,2050,VC,VCT,AMR,2735,5862,8597,6057,6343,7106,6750,6159,9241,41656,2655,5692,8347,5873,6153,6945,6595,6360,11166,43092,84748,101691,101691
Venezuela (Bolivarian Republic of),1970,VE,VEN,AMR,978363,1653028,2631391,1115000,711009,517542,364299,223326,146587,3077763,951592,1607744,2559336,1096786,725049,535710,362661,217768,149021,3086995,6164758,11355475,11355475
Venezuela (Bolivarian Republic of),1971,VE,VEN,AMR,993629,1694399,2688028,1166470,736644,530882,376177,231400,153867,3195440,966156,1648177,2614333,1146561,749789,550983,376699,227020,156812,3207864,6403304,11705674,11705674
Venezuela (Bolivarian Republic of),1972,VE,VEN,AMR,1008986,1733019,2742005,1220226,764279,544655,388271,239830,161438,3318699,980413,1686127,2666540,1198570,776593,566333,391114,236694,165076,3334380,6653079,12061621,12061621
Venezuela (Bolivarian Republic of),1973,VE,VEN,AMR,1025280,1768931,2794211,1276606,793351,558944,400527,248664,169201,3447293,995347,1721580,2716927,1253126,804982,581812,405870,246819,173760,3466369,6913662,12424804,12424804
Venezuela (Bolivarian Republic of),1974,VE,VEN,AMR,1042991,1803569,2846560,1332765,825117,573853,412954,257997,177225,3579911,1011620,1755798,2767418,1307794,835813,597464,420929,257447,182880,3602327,7182238,12796220,12796220
Venezuela (Bolivarian Republic of),1975,VE,VEN,AMR,1062486,1838365,2900851,1386617,859932,589570,425539,267850,185531,3715039,1029701,1789864,2819565,1360511,869540,613503,436256,268613,192516,3740939,7455978,13176387,13176387
Venezuela (Bolivarian Republic of),1976,VE,VEN,AMR,1084273,1872934,2957207,1438661,897388,606357,438289,278199,194191,3853085,1050125,1823358,2873483,1411361,906084,630258,451772,280269,202596,3882340,7735425,13566112,13566112
Venezuela (Bolivarian Republic of),1977,VE,VEN,AMR,1108088,1906887,3014975,1488558,938154,624431,451186,288937,203115,3994381,1072536,1856123,2928659,1460070,946039,648050,467425,292428,213229,4027241,8021622,13965250,13965250
Venezuela (Bolivarian Republic of),1978,VE,VEN,AMR,1132904,1941139,3074043,1536246,981747,644034,464194,299949,212254,4138424,1095703,1889159,2984862,1506644,989009,667212,483140,305089,224534,4175628,8314052,14372959,14372959
Venezuela (Bolivarian Republic of),1979,VE,VEN,AMR,1158059,1976261,3134320,1581798,1027721,665442,477331,311207,221799,4285298,1119039,1922948,3041987,1551165,1034467,688046,498778,318135,236335,4326926,8612224,14788523,14788523
Venezuela (Bolivarian Republic of),1980,VE,VEN,AMR,1182667,2012653,3195320,1625198,1075704,688812,490596,322636,231704,4434650,1142004,1957712,3099716,1593699,1081980,710796,514252,331502,248538,4480767,8915417,15210443,15210443
Venezuela (Bolivarian Republic of),1981,VE,VEN,AMR,1205546,2050898,3256444,1666402,1125670,714176,504160,334272,242187,4586867,1163451,1993937,3157388,1634226,1131466,735580,529709,345266,261477,4637724,9224591,15638426,15638426
Venezuela (Bolivarian Republic of),1982,VE,VEN,AMR,1226085,2091159,3317244,1704966,1178023,741407,518198,346132,253361,4742087,1182741,2031708,3214449,1672324,1183236,762354,545297,359404,275258,4797873,9539960,16071654,16071654
Venezuela (Bolivarian Republic of),1983,VE,VEN,AMR,1244536,2133231,3377767,1740925,1233065,769931,532764,358160,265150,4899995,1200197,2070772,3270969,1707969,1237569,790628,561046,373860,289800,4960872,9860867,16509596,16509596
Venezuela (Bolivarian Republic of),1984,VE,VEN,AMR,1261733,2176996,3438729,1775697,1288044,800931,547946,370377,277636,5060631,1216457,2111266,3327723,1742393,1292002,821245,576959,388568,304986,5126153,10186784,16953234,16953234
Venezuela (Bolivarian Republic of),1985,VE,VEN,AMR,1278646,2221892,3500538,1810623,1340848,834736,563865,382727,290653,5223452,1232193,2153111,3385304,1776652,1344430,854646,593199,403438,320646,5293011,10516463,17402304,17402304
Venezuela (Bolivarian Republic of),1986,VE,VEN,AMR,1297753,2267258,3565011,1845303,1391955,870996,580776,395251,304289,5388570,1249790,2195701,3445491,1810328,1395014,890788,610137,418504,337018,5461789,10850359,17860872,17860872
Venezuela (Bolivarian Republic of),1987,VE,VEN,AMR,1319693,2312238,3631931,1879313,1441048,910422,598886,407930,318432,5556031,1269911,2238003,3507914,1843240,1443491,930237,628054,433700,354062,5632784,11188815,18328655,18328655
Venezuela (Bolivarian Republic of),1988,VE,VEN,AMR,1342408,2356047,3698455,1913497,1488015,952574,618391,420701,332818,5725996,1290524,2279131,3569655,1876375,1489821,972606,647244,448928,371689,5806663,11532659,18800770,18800770
Venezuela (Bolivarian Republic of),1989,VE,VEN,AMR,1364397,2398928,3763325,1948396,1532832,996992,639518,433546,347369,5898653,1310023,2319225,3629248,1910262,1534124,1017431,668047,464164,390038,5984066,11882719,19275292,19275292
Venezuela (Bolivarian Republic of),1990,VE,VEN,AMR,1384808,2440962,3825770,1984464,1575550,1043374,662459,446550,362315,6074712,1327121,2358412,3685533,1945100,1576431,1064279,690660,479281,408820,6164571,12239283,19750579,19750579
Venezuela (Bolivarian Republic of),1991,VE,VEN,AMR,1401550,2483417,3884967,2022302,1616083,1091710,687216,459875,377765,6254951,1339307,2397923,3737230,1981356,1616717,1113087,715175,494427,428297,6349059,12604010,20226214,20226214
Venezuela (Bolivarian Republic of),1992,VE,VEN,AMR,1413674,2526342,3940016,2061991,1653868,1142318,713576,473575,393447,6438775,1346233,2437787,3784020,2019111,1654567,1164167,741534,509737,448527,6537643,12976418,20700461,20700461
Venezuela (Bolivarian Republic of),1993,VE,VEN,AMR,1422406,2567933,3990339,2103339,1688973,1195497,740942,487680,409247,6625678,1350080,2476296,3826376,2058123,1689984,1217777,769226,525224,469373,6729707,13355385,21172100,21172100
Venezuela (Bolivarian Republic of),1994,VE,VEN,AMR,1428266,2607498,4035764,2146213,1722731,1248526,770383,502207,425006,6815066,1352305,2512487,3864792,2098555,1724228,1271471,799122,540924,490907,6925207,13740273,21640833,21640833
Venezuela (Bolivarian Republic of),1995,VE,VEN,AMR,1431818,2645178,4076996,2190189,1756557,1299481,802298,517414,441209,7007148,1353899,2545741,3899640,2140351,1758330,1323151,831713,556984,512981,7123510,14130658,22107286,22107286
Venezuela (Bolivarian Republic of),1996,VE,VEN,AMR,1434092,2681347,4115439,2234648,1790085,1348809,836411,533543,458050,7201546,1355679,2575886,3931565,2182875,1791803,1372965,866873,573666,535375,7323557,14525103,22572110,22572110
Venezuela (Bolivarian Republic of),1997,VE,VEN,AMR,1436482,2715706,4152188,2278752,1822933,1396250,873490,550825,475718,7397968,1358404,2603279,3961683,2225124,1824531,1420778,905236,591364,558678,7525711,14923679,23037561,23037561
Venezuela (Bolivarian Republic of),1998,VE,VEN,AMR,1440006,2747461,4187467,2321688,1855903,1441669,913112,569370,493837,7595579,1362160,2628128,3990288,2266252,1857536,1466566,946518,610423,583189,7730484,15326063,23503819,23503819
Venezuela (Bolivarian Republic of),1999,VE,VEN,AMR,1445318,2775546,4220864,2363475,1889299,1484849,954669,589119,511443,7792854,1366866,2650198,4017064,2306269,1891214,1510259,990094,630838,607505,7936179,15729033,23966960,23966960
Venezuela (Bolivarian Republic of),2000,VE,VEN,AMR,1452344,2799694,4252038,2404190,1923443,1525784,997836,610171,528490,7989914,1372587,2669214,4041801,2345343,1925801,1551986,1035688,652942,632220,8143980,16133894,24427729,24427729
Venezuela (Bolivarian Republic of),2001,VE,VEN,AMR,1459994,2818771,4278765,2444751,1958507,1564016,1042245,632046,543463,8185028,1378896,2683466,4062362,2384630,1961637,1591594,1083106,676592,656488,8354047,16539075,24880203,24880203
Venezuela (Bolivarian Republic of),2002,VE,VEN,AMR,1467572,2833305,4300877,2485818,1995161,1599545,1088861,655212,559191,8383788,1385273,2693342,4078615,2424168,1998795,1628758,1132785,701834,681311,8567651,16951439,25330929,25330929
Venezuela (Bolivarian Republic of),2003,VE,VEN,AMR,1474724,2845584,4320308,2525772,2033331,1632596,1138147,679232,576532,8585610,1391623,2701139,4092762,2462253,2037008,1663543,1185031,728251,707260,8783346,17368956,25782029,25782029
Venezuela (Bolivarian Republic of),2004,VE,VEN,AMR,1480982,2856771,4337753,2563353,2072327,1664052,1187223,704651,594162,8785768,1397770,2708226,4105996,2497533,2076035,1696904,1237170,756475,733288,8997405,17783173,26226927,26226927
Venezuela (Bolivarian Republic of),2005,VE,VEN,AMR,1486771,2867374,4354145,2598616,2111502,1695180,1234404,732089,613591,8985382,1404141,2715562,4119703,2529075,2115437,1729740,1287171,787257,760871,9209551,18194933,26668785,26668785
Venezuela (Bolivarian Republic of),2006,VE,VEN,AMR,1492453,2877150,4369603,2631465,2149600,1725142,1279666,760908,633704,9180485,1411154,2723403,4134557,2556503,2154209,1761325,1335160,820397,789844,9417438,18597923,27102081,27102081
Venezuela (Bolivarian Republic of),2007,VE,VEN,AMR,1497271,2886749,4384020,2661662,2185721,1753444,1322720,791875,654777,9370199,1418202,2731997,4150199,2580197,2191161,1791395,1380989,856406,820530,9620678,18990877,27525097,27525097
Venezuela (Bolivarian Republic of),2008,VE,VEN,AMR,1500698,2896851,4397549,2688442,2219108,1780738,1363233,824430,676095,9552046,1424760,2741348,4166108,2600551,2225439,1820841,1424402,894812,852084,9818129,19370175,27933833,27933833
Venezuela (Bolivarian Republic of),2009,VE,VEN,AMR,1503042,2907750,4410792,2711138,2250237,1807546,1401182,858255,697786,9726144,1429904,2751294,4181198,2617661,2257296,1850164,1465378,935139,884117,10009755,19735899,28327892,28327892
Venezuela (Bolivarian Republic of),2010,VE,VEN,AMR,1504183,2919951,4424134,2730320,2280081,1834691,1437152,893766,721743,9897753,1432476,2762400,4194876,2631761,2287380,1879791,1504184,977321,917816,10198253,20096006,28715022,28715022
Venezuela (Bolivarian Republic of),2011,VE,VEN,AMR,1503684,2932681,4436365,2745337,2310346,1862844,1471014,931069,747625,10068235,1432413,2774667,4207080,2641605,2317351,1910267,1540818,1021373,953056,10384470,20452705,29096159,29096159
Venezuela (Bolivarian Republic of),2012,VE,VEN,AMR,1501937,2944509,4446446,2756597,2341197,1892149,1502160,970420,774483,10237006,1430193,2787078,4217271,2647721,2347507,1941694,1574982,1067716,990082,10569702,20806708,29470426,29470426
Venezuela (Bolivarian Republic of),2013,VE,VEN,AMR,1499453,2954551,4454004,2766271,2371080,1922465,1530840,1012297,802092,10405045,1426220,2799024,4225244,2652232,2376195,1973772,1606739,1116515,1028274,10753727,21158772,29838021,29838021
Venezuela (Bolivarian Republic of),2014,VE,VEN,AMR,1495826,2962543,4458369,2775252,2398975,1953454,1558027,1054224,830456,10570388,1420960,2809342,4230302,2656172,2402172,2006443,1637057,1165018,1067337,10934199,21504587,30193258,30193258
Venezuela (Bolivarian Republic of),2015,VE,VEN,AMR,1490485,2968618,4459103,2783102,2424003,1984141,1584519,1094245,859476,10729486,1414819,2817169,4231988,2659530,2423993,2039253,1666712,1211069,1108580,11109137,21838623,30529716,30529716
Venezuela (Bolivarian Republic of),2016,VE,VEN,AMR,1480825,2970132,4450957,2774971,2430241,2005557,1605946,1130327,885988,10833030,1404954,2820188,4225142,2646938,2425305,2064011,1692033,1253662,1150391,11232340,22065370,30741464,30741464
Venezuela (Bolivarian Republic of),2017,VE,VEN,AMR,1458034,2959991,4418025,2715636,2375365,1995794,1612667,1158312,907974,10765748,1382367,2811345,4193712,2579672,2363577,2059595,1704537,1289236,1189334,11185951,21951699,30563433,30563433
Venezuela (Bolivarian Republic of),2018,VE,VEN,AMR,1412331,2933717,4346048,2587867,2230082,1939231,1599182,1176015,925701,10458078,1337618,2786052,4123670,2437746,2209089,2010476,1699425,1315576,1225531,10897843,21355921,29825653,29825653
Venezuela (Bolivarian Republic of),2019,VE,VEN,AMR,1351095,2902117,4253212,2466972,2063172,1868862,1580059,1189481,944111,10112657,1278595,2755301,4033896,2301836,2031408,1947022,1689473,1337906,1264270,10571915,20684572,28971683,28971683
Venezuela (Bolivarian Republic of),2020,VE,VEN,AMR,1289842,2875243,4165085,2423508,1952613,1823237,1573257,1207618,968448,9948681,1220752,2729456,3950208,2251519,1910321,1904644,1688904,1361920,1309181,10426489,20375170,28490453,28490453
Venezuela (Bolivarian Republic of),2021,VE,VEN,AMR,1230474,2846565,4077039,2422104,1871722,1790595,1573169,1226991,995187,9879768,1165460,2701609,3867069,2250237,1818955,1872705,1692913,1385026,1356154,10375990,20255758,28199867,28199867
Venezuela (Bolivarian Republic of),2022,VE,VEN,AMR,1184102,2820555,4004657,2486884,1855628,1786792,1585686,1248623,1028524,9992137,1123338,2675982,3799320,2321395,1792209,1866754,1707663,1409731,1407831,10505583,20497720,28301696,28301696
Venezuela (Bolivarian Republic of),2023,VE,VEN,AMR,1161001,2795250,3956251,2611797,1914147,1814042,1612201,1273897,1072593,10298677,1103851,2650672,3754523,2457504,1840228,1889043,1734822,1438133,1469316,10829046,21127723,28838499,28838499
Venezuela (Bolivarian Republic of),2024,VE,VEN,AMR,1158007,2756693,3914700,2724928,1985024,1841168,1639298,1297961,1120174,10608553,1103091,2612788,3715879,2580920,1901237,1910119,1762880,1466264,1534786,11156206,21764759,29395334,29395334
Venezuela (Bolivarian Republic of),2025,VE,VEN,AMR,1172474,2706357,3878831,2817102,2063128,1865945,1665645,1321225,1166588,10899633,1118390,2564983,3683373,2682155,1971560,1927155,1790434,1493528,1599694,11464526,22364159,29926368,29926368
Venezuela (Bolivarian Republic of),2026,VE,VEN,AMR,1197859,2651167,3849026,2885543,2146284,1888291,1690120,1343103,1212087,11165428,1143622,2513490,3657112,2758230,2049810,1939645,1816366,1519140,1664411,11747602,22913030,30419164,30419164
Venezuela (Bolivarian Republic of),2027,VE,VEN,AMR,1229482,2595746,3825228,2930017,2233975,1908384,1711910,1363195,1257321,11404802,1174449,2462330,3636779,2808804,2135376,1948424,1839529,1542826,1729532,12004491,23409293,30871303,30871303
Venezuela (Bolivarian Republic of),2028,VE,VEN,AMR,1261604,2545657,3807261,2952933,2326295,1926780,1730764,1382274,1302253,11621299,1205504,2416591,3622095,2836159,2227751,1955028,1859297,1565599,1794878,12238712,23860011,31289368,31289368
Venezuela (Bolivarian Republic of),2029,VE,VEN,AMR,1289411,2505221,3794632,2956794,2421561,1943743,1747179,1400749,1346725,11816751,1232334,2380360,3612694,2842564,2324696,1960581,1875906,1587933,1860198,12451878,24268629,31675964,31675964
Venezuela (Bolivarian Republic of),2030,VE,VEN,AMR,1312000,2474431,3786431,2943279,2516341,1959840,1761329,1418862,1390692,11990343,1254120,2353617,3607737,2829737,2422618,1965823,1889492,1609907,1925357,12642934,24633277,32027461,32027461
Venezuela (Bolivarian Republic of),1950,VE,VEN,AMR,519426,739764,1259190,524479,384229,279784,185050,99994,60783,1534319,506864,728941,1235805,512412,365480,255498,165454,95561,64898,1459303,2993622,5488614,5488614
Venezuela (Bolivarian Republic of),1951,VE,VEN,AMR,543761,769719,1313480,546348,402222,290804,193292,104627,63213,1600506,529485,758207,1287692,537373,385906,267601,172884,99444,67215,1530423,3130929,5732104,5732104
Venezuela (Bolivarian Republic of),1952,VE,VEN,AMR,570231,801226,1371457,567371,419715,301733,201471,109420,65727,1665437,554202,788887,1343089,561048,406019,279752,180474,103501,69591,1600385,3265822,5980378,5980378
Venezuela (Bolivarian Republic of),1953,VE,VEN,AMR,599064,833844,1432908,587712,436623,312635,209558,114385,68331,1729244,581263,820507,1401770,583531,425752,291977,188230,107729,72048,1669267,3398511,6233183,6233183
Venezuela (Bolivarian Republic of),1954,VE,VEN,AMR,628572,868956,1497528,607509,452875,323554,217497,119499,71008,1791942,609506,854032,1463538,604931,445029,304326,196124,112117,74586,1737113,3529055,6490130,6490130
Venezuela (Bolivarian Republic of),1955,VE,VEN,AMR,658062,907008,1565070,627162,468531,334591,225376,124839,73910,1854409,638148,890056,1528204,625581,463827,316860,204197,116703,77292,1804460,3658869,6752139,6752139
Venezuela (Bolivarian Republic of),1956,VE,VEN,AMR,687826,947578,1635404,647092,483668,345806,233235,130415,77080,1917296,666995,928520,1595515,645963,482126,329623,212460,121498,80196,1871866,3789162,7020074,7020074
Venezuela (Bolivarian Republic of),1957,VE,VEN,AMR,717356,991370,1708726,667625,498287,357146,240987,136135,80347,1980527,695638,970089,1665727,666529,499893,342608,220874,126444,83174,1939522,3920049,7294502,7294502
Venezuela (Bolivarian Republic of),1958,VE,VEN,AMR,746807,1037938,1784745,689231,512513,368647,248720,142006,83802,2044919,724206,1014414,1738620,687823,517173,355910,229521,131634,86392,2008453,4053372,7576740,7576740
Venezuela (Bolivarian Republic of),1959,VE,VEN,AMR,774793,1086789,1861582,712384,526486,380369,256629,148054,87611,2111533,751365,1061045,1812410,710362,533974,369605,238476,137167,90015,2079599,4191132,7865124,7865124
Venezuela (Bolivarian Republic of),1960,VE,VEN,AMR,799869,1137546,1937415,737376,540273,392301,264783,154263,91816,2180812,775810,1109562,1885372,734499,550273,383687,247766,143055,94056,2153336,4334148,8156937,8156937
Venezuela (Bolivarian Republic of),1961,VE,VEN,AMR,822415,1190127,2012542,764301,554052,404419,273198,160685,96377,2253032,797853,1159867,1957720,760390,566171,398116,257396,149282,98462,2229817,4482849,8453106,8453106
Venezuela (Bolivarian Republic of),1962,VE,VEN,AMR,842734,1244884,2087618,793027,567943,416619,281832,167221,101109,2327751,817678,1212268,2029946,788054,581831,412801,267316,155756,103004,2308762,4636513,8754082,8754082
Venezuela (Bolivarian Republic of),1963,VE,VEN,AMR,860761,1302163,2162924,823121,582153,428884,290741,173815,105925,2404639,835253,1267116,2102369,817121,597410,427734,277591,162482,107671,2390009,4794648,9059953,9059953
Venezuela (Bolivarian Republic of),1964,VE,VEN,AMR,877893,1359023,2236916,856042,596919,441261,300050,180492,110916,2485680,851981,1321983,2173964,848517,613012,442909,288305,169485,112544,2474772,4960452,9371333,9371333
Venezuela (Bolivarian Republic of),1965,VE,VEN,AMR,895540,1413329,2308869,892116,612401,453701,309770,187256,116083,2571327,869206,1374807,2244013,882700,628900,458291,299508,176803,117733,2563935,5135262,9688138,9688138
Venezuela (Bolivarian Republic of),1966,VE,VEN,AMR,913280,1465660,2378940,930867,628901,466219,319915,194122,121480,2661504,886621,1425729,2312350,919645,645446,473827,311218,184454,123293,2657883,5319387,10010685,10010685
Venezuela (Bolivarian Republic of),1967,VE,VEN,AMR,930305,1515768,2446073,973011,646730,478860,330496,201122,127235,2757454,903593,1474424,2378017,959955,662977,489422,323404,192381,129174,2757313,5514767,10338848,10338848
Venezuela (Bolivarian Republic of),1968,VE,VEN,AMR,946754,1563677,2510431,1018078,666194,491636,341463,208298,133372,2859041,920168,1520910,2441078,1003233,681855,504986,336049,200570,135399,2862092,5721133,10672654,10672654
Venezuela (Bolivarian Republic of),1969,VE,VEN,AMR,962753,1609422,2572175,1065510,687542,504511,352730,215653,139774,2965720,936241,1565318,2501559,1048975,702439,520420,349115,208986,141935,2971870,5937590,11011335,11011335
Venezuela (Bolivarian Republic of),2031,VE,VEN,AMR,1328343,2453288,3781631,2915400,2606196,1975410,1774555,1437094,1434200,12142855,1269915,2336247,3606162,2801040,2517427,1970545,1901352,1631835,1990407,12812606,24955461,32343259,32343259
Venezuela (Bolivarian Republic of),2032,VE,VEN,AMR,1338673,2442324,3780997,2876764,2686931,1992603,1787311,1455695,1477148,12276452,1279939,2328672,3608611,2760305,2604819,1977108,1911873,1653726,2055317,12963148,25239600,32629217,32629217
Venezuela (Bolivarian Republic of),2033,VE,VEN,AMR,1344270,2444142,3788412,2828926,2756020,2015544,1798666,1474613,1519580,12393349,1285433,2333051,3618484,2709697,2682015,1990075,1919976,1675428,2119901,13097092,25490441,32897334,32897334
Venezuela (Bolivarian Republic of),2034,VE,VEN,AMR,1345621,2461515,3807136,2770896,2811893,2047087,1808543,1493827,1561332,12493578,1286858,2351720,3638578,2649945,2745954,2012826,1925247,1697146,2183757,13214875,25708453,33154162,33154162
Venezuela (Bolivarian Republic of),2035,VE,VEN,AMR,1342867,2491951,3834818,2704982,2853358,2088495,1817418,1512926,1602182,12579361,1284341,2382234,3666575,2584480,2793917,2047487,1927610,1718807,2246391,13318692,25898053,33399450,33399450
Venezuela (Bolivarian Republic of),2036,VE,VEN,AMR,1337724,2528304,3866028,2637869,2879655,2139751,1826182,1531279,1642140,12656876,1279536,2417932,3697468,2519292,2825169,2094841,1927510,1739724,2307674,13414210,26071086,33634577,33634577
Venezuela (Bolivarian Republic of),2037,VE,VEN,AMR,1330511,2566139,3896650,2573722,2890720,2200838,1835233,1548239,1681394,12730146,1272701,2454703,3727404,2457903,2839602,2154802,1926009,1758867,2367917,13505100,26235246,33859303,33859303
Venezuela (Bolivarian Republic of),2038,VE,VEN,AMR,1320111,2600612,3920723,2517484,2887664,2270927,1844663,1563414,1720353,12804505,1262769,2488032,3750801,2404735,2838224,2225961,1924215,1775497,2427706,13596338,26400843,34072370,34072370
Venezuela (Bolivarian Republic of),2039,VE,VEN,AMR,1307593,2627177,3934770,2472973,2872213,2348000,1854559,1577205,1759185,12884135,1250771,2513697,3764468,2363340,2822565,2305699,1923077,1789796,2487227,13691704,26575839,34275073,34275073
Venezuela (Bolivarian Republic of),2040,VE,VEN,AMR,1293939,2645161,3939100,2439882,2846124,2429266,1865748,1589878,1797943,12968841,1237651,2531112,3768763,2333350,2794533,2391043,1923606,1801995,2546441,13790968,26759809,34467670,34467670
Venezuela (Bolivarian Republic of),2041,VE,VEN,AMR,1278591,2655297,3933888,2417851,2811780,2510394,1878610,1602713,1836991,13058339,1222876,2541008,3763884,2314267,2756929,2477921,1925646,1813369,2605664,13893796,26952135,34649900,34649900
Venezuela (Bolivarian Republic of),2042,VE,VEN,AMR,1262041,2657997,3920038,2406952,2771252,2586362,1894814,1615964,1876466,13151810,1206968,2543742,3750710,2306034,2712040,2561141,1931135,1824138,2664898,13999386,27151196,34821950,34821950
Venezuela (Bolivarian Republic of),2043,VE,VEN,AMR,1245668,2653125,3898793,2409248,2723999,2653023,1917503,1628389,1916114,13248276,1191237,2539182,3730419,2310303,2659816,2636213,1943797,1832942,2723701,14106772,27355048,34984268,34984268
Venezuela (Bolivarian Republic of),2044,VE,VEN,AMR,1230531,2642025,3872556,2427127,2667699,2707651,1948844,1639662,1955686,13346669,1176651,2528616,3705267,2329083,2599529,2698902,1966429,1839161,2781850,14214954,27561623,35139454,35139454
Venezuela (Bolivarian Republic of),2045,VE,VEN,AMR,1217268,2625776,3843044,2458017,2604324,2748850,1989948,1650126,1994702,13445967,1163858,2513077,3676935,2359852,2534273,2746297,2001003,1842660,2838915,14323000,27768967,35288946,35288946
Venezuela (Bolivarian Republic of),2046,VE,VEN,AMR,1205706,2605514,3811220,2494797,2540283,2775776,2040755,1660557,2032672,13544840,1152708,2493653,3646361,2395903,2469870,2777566,2048245,1843831,2894201,14429616,27974456,35432031,35432031
Venezuela (Bolivarian Republic of),2047,VE,VEN,AMR,1195853,2582027,3777880,2533032,2479456,2788215,2101180,1671259,2069271,13642413,1143200,2471114,3614314,2433074,2409618,2792482,2108018,1843666,2947139,14533997,28176410,35568603,35568603
Venezuela (Bolivarian Republic of),2048,VE,VEN,AMR,1187502,2555550,3743052,2567879,2426489,2787064,2170343,1682288,2104590,13738653,1135136,2445674,3580810,2466780,2357698,2791876,2178856,1843203,2997704,14636117,28374770,35698639,35698639
Venezuela (Bolivarian Republic of),2049,VE,VEN,AMR,1179043,2528181,3707224,2594819,2384977,2773880,2246229,1693740,2139145,13832790,1126981,2419307,3546288,2492778,2317486,2777153,2258132,1843367,3046335,14735251,28568041,35821554,35821554
Venezuela (Bolivarian Republic of),2050,VE,VEN,AMR,1169799,2501535,3671334,2613198,2354538,2750302,2326141,1706405,2173324,13923908,1118075,2393585,3511660,2510485,2288556,2750138,2342895,1845140,3093288,14830502,28754410,35937404,35937404
British Virgin Islands,1970,VG,VGB,AMR,1223,1061,2284,1096,564,436,310,188,197,2791,1254,1011,2265,789,460,342,294,170,181,2236,5027,9581,9581
British Virgin Islands,1971,VG,VGB,AMR,1178,1112,2290,1130,595,451,313,200,203,2892,1215,1088,2303,818,494,338,316,169,192,2327,5219,9813,9813
British Virgin Islands,1972,VG,VGB,AMR,1029,1194,2223,1150,640,448,323,213,219,2993,1058,1189,2247,862,543,339,330,172,203,2449,5442,9907,9907
British Virgin Islands,1973,VG,VGB,AMR,880,1289,2169,1150,695,440,338,231,233,3087,896,1299,2195,900,591,352,335,183,207,2568,5655,10018,10018
British Virgin Islands,1974,VG,VGB,AMR,741,1383,2124,1140,755,441,351,247,247,3181,740,1412,2152,930,639,369,339,200,207,2684,5865,10146,10146
British Virgin Islands,1975,VG,VGB,AMR,650,1431,2081,1120,821,446,363,264,264,3278,636,1474,2110,959,692,389,336,220,215,2811,6089,10282,10282
British Virgin Islands,1976,VG,VGB,AMR,638,1406,2044,1100,879,466,373,288,278,3384,613,1452,2065,986,746,408,331,242,227,2940,6324,10428,10428
British Virgin Islands,1977,VG,VGB,AMR,654,1348,2002,1081,936,490,376,312,293,3488,621,1399,2020,1014,793,433,334,259,240,3073,6561,10578,10578
British Virgin Islands,1978,VG,VGB,AMR,664,1297,1961,1066,984,522,372,326,313,3583,626,1344,1970,1040,845,461,335,275,255,3211,6794,10727,10727
British Virgin Islands,1979,VG,VGB,AMR,668,1253,1921,1055,1017,568,372,345,333,3690,630,1285,1915,1061,897,503,333,292,266,3352,7042,10876,10876
British Virgin Islands,1980,VG,VGB,AMR,667,1240,1907,1068,1045,615,374,358,347,3807,634,1255,1889,1094,951,541,339,302,281,3508,7315,11109,11109
British Virgin Islands,1981,VG,VGB,AMR,671,1261,1932,1125,1083,660,385,355,353,3961,641,1266,1907,1152,1004,579,342,311,294,3682,7643,11472,11472
British Virgin Islands,1982,VG,VGB,AMR,674,1286,1960,1192,1132,719,393,354,358,4148,650,1280,1930,1212,1058,627,347,316,295,3855,8003,11889,11889
British Virgin Islands,1983,VG,VGB,AMR,683,1298,1981,1259,1180,776,400,356,361,4332,662,1283,1945,1278,1110,678,363,313,305,4047,8379,12315,12315
British Virgin Islands,1984,VG,VGB,AMR,694,1305,1999,1325,1240,840,406,363,373,4547,672,1280,1952,1344,1171,731,381,315,318,4260,8807,12753,12753
British Virgin Islands,1985,VG,VGB,AMR,706,1307,2013,1386,1304,898,426,371,379,4764,676,1284,1960,1398,1242,782,402,316,327,4467,9231,13202,13202
British Virgin Islands,1986,VG,VGB,AMR,713,1313,2026,1433,1377,957,457,367,401,4992,681,1285,1966,1443,1318,841,419,316,336,4673,9665,13656,13656
British Virgin Islands,1987,VG,VGB,AMR,725,1317,2042,1449,1471,1013,488,362,418,5201,687,1287,1974,1475,1402,905,438,318,350,4888,10089,14117,14117
British Virgin Islands,1988,VG,VGB,AMR,738,1331,2069,1450,1580,1073,530,353,440,5426,701,1300,2001,1480,1496,970,468,318,365,5097,10523,14593,14593
British Virgin Islands,1989,VG,VGB,AMR,757,1353,2110,1439,1674,1135,584,351,461,5644,726,1319,2045,1460,1589,1041,510,321,374,5295,10939,15091,15091
British Virgin Islands,1990,VG,VGB,AMR,783,1378,2161,1413,1762,1204,636,363,477,5855,765,1348,2113,1426,1686,1111,556,324,390,5493,11348,15617,15617
British Virgin Islands,1991,VG,VGB,AMR,798,1413,2211,1386,1830,1288,682,382,479,6047,797,1375,2172,1398,1757,1182,601,323,410,5671,11718,16090,16090
British Virgin Islands,1992,VG,VGB,AMR,794,1450,2244,1370,1860,1366,736,396,474,6202,800,1410,2210,1379,1784,1261,656,324,417,5821,12023,16476,16476
British Virgin Islands,1993,VG,VGB,AMR,787,1493,2280,1372,1868,1443,802,400,477,6362,793,1443,2236,1376,1790,1339,707,339,429,5980,12342,16855,16855
British Virgin Islands,1994,VG,VGB,AMR,783,1528,2311,1388,1876,1517,872,401,490,6544,784,1481,2265,1371,1793,1423,762,360,426,6135,12679,17255,17255
British Virgin Islands,1995,VG,VGB,AMR,786,1564,2350,1408,1875,1597,940,415,492,6727,773,1526,2299,1367,1796,1503,819,383,428,6296,13023,17674,17674
British Virgin Islands,1996,VG,VGB,AMR,802,1591,2393,1430,1855,1680,1012,443,495,6915,777,1575,2352,1372,1791,1579,881,406,434,6463,13378,18120,18120
British Virgin Islands,1997,VG,VGB,AMR,827,1622,2449,1457,1823,1772,1080,480,489,7101,797,1609,2406,1386,1772,1660,943,433,443,6637,13738,18591,18591
British Virgin Islands,1998,VG,VGB,AMR,852,1657,2509,1484,1789,1863,1146,522,495,7299,823,1647,2470,1404,1741,1740,1004,470,447,6806,14105,19079,19079
British Virgin Islands,1999,VG,VGB,AMR,876,1701,2577,1505,1764,1935,1216,574,490,7484,845,1696,2541,1425,1711,1812,1072,510,455,6985,14469,19586,19586
British Virgin Islands,2000,VG,VGB,AMR,898,1751,2649,1527,1741,1993,1291,626,498,7676,867,1750,2617,1455,1676,1868,1147,553,460,7159,14835,20104,20104
British Virgin Islands,2001,VG,VGB,AMR,896,1797,2693,1570,1733,2057,1357,672,507,7896,864,1792,2656,1518,1676,1917,1231,596,471,7409,15305,20657,20657
British Virgin Islands,2002,VG,VGB,AMR,864,1820,2684,1633,1760,2109,1416,734,520,8172,839,1819,2658,1620,1732,1966,1318,650,490,7776,15948,21288,21288
British Virgin Islands,2003,VG,VGB,AMR,835,1828,2663,1698,1814,2148,1481,798,531,8470,819,1830,2649,1724,1831,2023,1397,709,520,8204,16674,21982,21982
British Virgin Islands,2004,VG,VGB,AMR,829,1845,2674,1741,1885,2182,1555,859,543,8765,811,1839,2650,1797,1939,2088,1478,765,558,8625,17390,22715,22715
British Virgin Islands,2005,VG,VGB,AMR,844,1866,2710,1759,1958,2219,1637,922,566,9061,815,1859,2674,1851,2049,2166,1563,823,601,9053,18114,23497,23497
British Virgin Islands,2006,VG,VGB,AMR,886,1888,2774,1755,2038,2258,1731,978,595,9355,839,1882,2721,1878,2162,2246,1659,886,642,9473,18828,24323,24323
British Virgin Islands,2007,VG,VGB,AMR,958,1900,2858,1736,2125,2301,1824,1037,630,9653,884,1905,2789,1891,2279,2327,1765,948,685,9895,19548,25191,25191
British Virgin Islands,2008,VG,VGB,AMR,1040,1931,2971,1712,2203,2348,1915,1090,678,9946,944,1939,2883,1881,2391,2424,1868,1015,731,10310,20256,26115,26115
British Virgin Islands,2009,VG,VGB,AMR,1097,1983,3080,1688,2273,2406,2003,1142,739,10251,990,1984,2974,1868,2488,2536,1966,1088,789,10735,20986,27044,27044
British Virgin Islands,2010,VG,VGB,AMR,1062,2048,3110,1677,2267,2440,2088,1190,784,10446,968,2015,2983,1848,2521,2599,2051,1157,837,11013,21459,27556,27556
British Virgin Islands,2011,VG,VGB,AMR,990,2094,3084,1697,2250,2461,2171,1229,835,10643,920,2031,2951,1858,2542,2639,2136,1229,882,11286,21929,27962,27962
British Virgin Islands,2012,VG,VGB,AMR,920,2129,3049,1750,2231,2484,2240,1280,882,10867,860,2051,2911,1892,2548,2694,2212,1308,935,11589,22456,28421,28421
British Virgin Islands,2013,VG,VGB,AMR,814,2163,2977,1797,2187,2493,2288,1350,922,11037,768,2080,2848,1910,2489,2748,2278,1380,991,11796,22833,28657,28657
British Virgin Islands,2014,VG,VGB,AMR,733,2188,2921,1843,2144,2507,2330,1430,968,11222,699,2090,2789,1939,2442,2801,2351,1455,1046,12034,23256,28971,28971
British Virgin Islands,2015,VG,VGB,AMR,710,2165,2875,1893,2105,2515,2379,1518,1021,11431,681,2059,2740,1986,2411,2850,2431,1541,1108,12327,23758,29366,29366
British Virgin Islands,2016,VG,VGB,AMR,699,2125,2824,1934,2063,2537,2413,1614,1066,11627,669,2009,2678,2027,2389,2885,2497,1636,1179,12613,24240,29739,29739
British Virgin Islands,2017,VG,VGB,AMR,676,2085,2761,1959,2027,2570,2431,1705,1119,11811,647,1959,2606,2058,2371,2913,2548,1737,1244,12871,24682,30060,30060
British Virgin Islands,2018,VG,VGB,AMR,656,2040,2696,1974,2002,2594,2443,1791,1179,11983,627,1905,2532,2081,2352,2942,2600,1827,1319,13121,25104,30335,30335
British Virgin Islands,2019,VG,VGB,AMR,630,1983,2613,2004,1992,2611,2450,1867,1244,12168,603,1856,2459,2098,2345,2961,2651,1906,1406,13367,25535,30610,30610
British Virgin Islands,2020,VG,VGB,AMR,607,1915,2522,2054,2002,2605,2473,1938,1314,12386,580,1808,2388,2114,2349,2992,2698,1980,1494,13627,26013,30910,30910
British Virgin Islands,2021,VG,VGB,AMR,595,1828,2423,2097,2009,2578,2489,2010,1363,12546,568,1744,2312,2121,2343,3006,2730,2055,1580,13835,26381,31122,31122
British Virgin Islands,2022,VG,VGB,AMR,596,1722,2318,2143,2045,2545,2504,2077,1432,12746,571,1650,2221,2134,2333,2975,2776,2127,1677,14022,26768,31305,31305
British Virgin Islands,2023,VG,VGB,AMR,603,1596,2199,2205,2098,2512,2528,2126,1525,12994,574,1535,2109,2164,2324,2920,2838,2197,1788,14231,27225,31538,31538
British Virgin Islands,2024,VG,VGB,AMR,608,1485,2093,2265,2155,2473,2555,2171,1618,13237,582,1431,2013,2182,2320,2854,2892,2270,1898,14416,27653,31763,31763
British Virgin Islands,2025,VG,VGB,AMR,615,1421,2036,2267,2208,2427,2572,2221,1725,13420,587,1371,1958,2156,2330,2787,2937,2350,2014,14574,27994,31984,31984
British Virgin Islands,2026,VG,VGB,AMR,619,1384,2003,2253,2260,2367,2598,2260,1837,13575,592,1331,1923,2112,2335,2723,2966,2413,2142,14691,28266,32197,32197
British Virgin Islands,2027,VG,VGB,AMR,625,1349,1974,2234,2301,2323,2632,2289,1946,13725,600,1298,1898,2067,2342,2663,2985,2470,2285,14812,28537,32406,32406
British Virgin Islands,2028,VG,VGB,AMR,633,1324,1957,2206,2336,2294,2664,2304,2054,13858,603,1272,1875,2017,2347,2608,3004,2526,2418,14920,28778,32608,32608
British Virgin Islands,2029,VG,VGB,AMR,636,1298,1934,2161,2390,2277,2683,2320,2164,13995,608,1242,1850,1972,2346,2560,3016,2579,2550,15023,29018,32806,32806
British Virgin Islands,2030,VG,VGB,AMR,644,1264,1908,2104,2466,2273,2677,2349,2269,14138,616,1211,1827,1925,2351,2522,3031,2621,2679,15129,29267,32995,32995
British Virgin Islands,1950,VG,VGB,AMR,658,996,1654,539,484,310,216,170,332,2051,617,936,1553,594,480,334,234,160,299,2101,4152,7358,7358
British Virgin Islands,1951,VG,VGB,AMR,643,1041,1684,554,464,319,217,168,315,2037,623,967,1590,591,466,334,235,160,276,2062,4099,7364,7364
British Virgin Islands,1952,VG,VGB,AMR,628,1083,1711,575,435,327,215,162,290,2004,621,996,1617,597,447,332,237,161,258,2032,4036,7370,7370
British Virgin Islands,1953,VG,VGB,AMR,611,1126,1737,608,411,342,220,161,275,2017,610,1029,1639,609,429,335,239,164,242,2018,4035,7411,7411
British Virgin Islands,1954,VG,VGB,AMR,605,1156,1761,651,386,358,222,162,256,2035,607,1055,1662,630,418,335,240,166,224,2013,4048,7470,7470
British Virgin Islands,1955,VG,VGB,AMR,620,1151,1771,674,376,365,229,164,246,2054,610,1065,1675,645,409,338,241,169,220,2022,4076,7516,7516
British Virgin Islands,1956,VG,VGB,AMR,642,1127,1769,671,369,367,239,167,235,2048,621,1062,1683,657,409,342,249,177,220,2054,4102,7546,7546
British Virgin Islands,1957,VG,VGB,AMR,664,1119,1783,657,370,363,245,170,223,2028,639,1063,1702,662,411,345,253,181,226,2078,4106,7590,7590
British Virgin Islands,1958,VG,VGB,AMR,687,1124,1811,647,367,356,255,174,217,2016,661,1077,1738,665,413,346,254,187,236,2101,4117,7663,7663
British Virgin Islands,1959,VG,VGB,AMR,711,1140,1851,633,369,344,267,177,209,1999,685,1100,1785,663,415,351,254,195,244,2122,4121,7765,7765
British Virgin Islands,1960,VG,VGB,AMR,718,1168,1886,639,372,333,276,183,204,2007,692,1121,1813,669,416,357,254,198,248,2142,4149,7850,7850
British Virgin Islands,1961,VG,VGB,AMR,686,1198,1884,675,386,327,280,188,201,2057,660,1126,1786,689,413,361,252,200,245,2160,4217,7885,7885
British Virgin Islands,1962,VG,VGB,AMR,636,1224,1860,720,404,326,276,198,199,2123,614,1122,1736,714,415,365,247,199,240,2180,4303,7902,7902
British Virgin Islands,1963,VG,VGB,AMR,592,1253,1845,759,421,328,275,205,195,2183,576,1114,1690,734,421,371,242,201,233,2202,4385,7919,7919
British Virgin Islands,1964,VG,VGB,AMR,569,1262,1831,801,437,334,275,209,189,2245,554,1100,1654,749,427,375,240,203,225,2219,4464,7949,7949
British Virgin Islands,1965,VG,VGB,AMR,577,1248,1825,839,452,348,277,209,191,2316,561,1078,1639,765,433,370,243,206,217,2234,4550,8018,8018
British Virgin Islands,1966,VG,VGB,AMR,630,1210,1840,885,473,362,282,212,190,2404,610,1043,1653,778,434,364,251,204,203,2234,4638,8139,8139
British Virgin Islands,1967,VG,VGB,AMR,727,1153,1880,944,494,377,291,206,192,2504,711,1011,1722,782,436,360,257,201,199,2235,4739,8337,8337
British Virgin Islands,1968,VG,VGB,AMR,872,1102,1974,994,518,394,299,198,191,2594,867,988,1855,783,437,353,266,191,193,2223,4817,8649,8649
British Virgin Islands,1969,VG,VGB,AMR,1075,1062,2137,1046,544,416,307,190,197,2700,1088,977,2065,784,443,348,278,179,182,2214,4914,9117,9117
British Virgin Islands,2031,VG,VGB,AMR,648,1248,1896,2021,2539,2291,2655,2376,2368,14250,619,1195,1814,1855,2362,2487,3032,2659,2815,15210,29460,33176,33176
British Virgin Islands,2032,VG,VGB,AMR,654,1252,1906,1916,2603,2336,2627,2398,2466,14346,626,1201,1827,1762,2379,2475,2999,2704,2953,15272,29618,33356,33356
British Virgin Islands,2033,VG,VGB,AMR,660,1265,1925,1794,2667,2393,2596,2426,2556,14432,630,1210,1840,1650,2412,2466,2944,2767,3086,15325,29757,33526,33526
British Virgin Islands,2034,VG,VGB,AMR,663,1275,1938,1684,2722,2445,2559,2448,2654,14512,633,1222,1855,1544,2427,2461,2881,2823,3233,15369,29881,33681,33681
British Virgin Islands,2035,VG,VGB,AMR,669,1288,1957,1619,2730,2502,2514,2467,2756,14588,639,1232,1871,1482,2400,2468,2812,2868,3382,15412,30000,33831,33831
British Virgin Islands,2036,VG,VGB,AMR,670,1301,1971,1580,2712,2554,2458,2497,2871,14672,639,1244,1883,1444,2355,2481,2752,2894,3529,15455,30127,33979,33979
British Virgin Islands,2037,VG,VGB,AMR,672,1310,1982,1548,2697,2592,2411,2532,2961,14741,641,1254,1895,1411,2310,2486,2696,2918,3678,15499,30240,34116,34116
British Virgin Islands,2038,VG,VGB,AMR,672,1323,1995,1525,2668,2628,2385,2563,3035,14804,641,1268,1909,1389,2262,2489,2636,2934,3819,15529,30333,34237,34237
British Virgin Islands,2039,VG,VGB,AMR,673,1332,2005,1494,2626,2683,2370,2586,3112,14871,643,1274,1917,1356,2217,2486,2595,2946,3953,15553,30424,34349,34349
British Virgin Islands,2040,VG,VGB,AMR,671,1342,2013,1462,2568,2760,2371,2580,3204,14945,641,1283,1924,1325,2168,2494,2555,2959,4068,15569,30514,34450,34450
British Virgin Islands,2041,VG,VGB,AMR,667,1350,2017,1448,2488,2834,2389,2560,3284,15003,636,1290,1926,1312,2103,2505,2523,2964,4196,15603,30606,34542,34542
British Virgin Islands,2042,VG,VGB,AMR,660,1357,2017,1452,2383,2893,2431,2534,3366,15059,629,1296,1925,1315,2010,2518,2510,2932,4325,15610,30669,34620,34620
British Virgin Islands,2043,VG,VGB,AMR,653,1365,2018,1464,2259,2960,2490,2508,3441,15122,622,1303,1925,1323,1896,2552,2502,2882,4462,15617,30739,34678,34678
British Virgin Islands,2044,VG,VGB,AMR,644,1366,2010,1477,2150,3016,2545,2472,3512,15172,614,1306,1920,1337,1793,2576,2497,2823,4608,15634,30806,34730,34730
British Virgin Islands,2045,VG,VGB,AMR,633,1372,2005,1485,2086,3020,2597,2431,3599,15218,603,1310,1913,1347,1731,2542,2504,2756,4750,15630,30848,34768,34768
British Virgin Islands,2046,VG,VGB,AMR,620,1368,1988,1500,2049,3005,2649,2381,3691,15275,590,1307,1897,1362,1693,2498,2514,2696,4868,15631,30906,34789,34789
British Virgin Islands,2047,VG,VGB,AMR,608,1364,1972,1509,2017,2989,2687,2345,3774,15321,580,1303,1883,1369,1658,2454,2521,2645,4976,15623,30944,34801,34801
British Virgin Islands,2048,VG,VGB,AMR,596,1358,1954,1522,1992,2961,2725,2320,3848,15368,569,1296,1865,1381,1633,2404,2527,2587,5079,15611,30979,34800,34800
British Virgin Islands,2049,VG,VGB,AMR,586,1349,1935,1532,1966,2922,2778,2308,3910,15416,557,1285,1842,1390,1606,2360,2527,2548,5166,15597,31013,34786,34786
British Virgin Islands,2050,VG,VGB,AMR,575,1335,1910,1539,1932,2861,2853,2312,3954,15451,547,1275,1822,1398,1573,2311,2531,2512,5256,15581,31032,34768,34768
Viet Nam,1970,VN,VNM,WPR,3267565,5819253,9086818,3649230,2119849,1974097,1550678,1171367,989997,11455218,3126993,5673280,8800273,3711808,2297389,2197284,1722614,1332346,1325095,12586536,24041754,41928849,41928849
Viet Nam,1971,VN,VNM,WPR,3323279,5928788,9252067,3879075,2130964,1992376,1564878,1180667,1009802,11757762,3180208,5778640,8958848,3936559,2323252,2225997,1754908,1349179,1358051,12947946,24705708,42916624,42916624
Viet Nam,1972,VN,VNM,WPR,3409753,5990515,9400268,4128960,2153101,2003966,1576180,1188217,1022335,12072759,3262533,5837628,9100161,4183254,2365702,2249664,1786104,1365578,1382534,13332836,25405595,43906019,43906019
Viet Nam,1973,VN,VNM,WPR,3511626,6025811,9537437,4386356,2189894,2006544,1586047,1195761,1032414,12397016,3359298,5870470,9229768,4437033,2423015,2264037,1816294,1382699,1403981,13727059,26124075,44891281,44891281
Viet Nam,1974,VN,VNM,WPR,3606724,6065653,9672377,4601492,2283761,2002112,1599649,1204694,1045488,12737196,3449660,5908100,9357760,4648888,2532362,2269162,1849376,1402092,1429486,14131366,26868562,45898698,45898698
Viet Nam,1975,VN,VNM,WPR,3694642,6110553,9805195,4790607,2430364,1995162,1620038,1217097,1065362,13118630,3533050,5951375,9484425,4829809,2687997,2267981,1886918,1425184,1463477,14561366,27679996,46969616,46969616
Viet Nam,1976,VN,VNM,WPR,3783018,6209746,9992764,4974802,2577318,1988701,1649795,1235232,1095264,13521112,3616199,6047889,9664088,4997615,2835084,2261985,1929671,1452812,1508443,14985610,28506722,48163573,48163573
Viet Nam,1977,VN,VNM,WPR,3858026,6332400,10190426,5147765,2751169,1978470,1685432,1254814,1129418,13947068,3686442,6166892,9853334,5153664,3006071,2250894,1976001,1482697,1558000,15427327,29374395,49418150,49418150
Viet Nam,1978,VN,VNM,WPR,3919360,6438221,10357581,5333427,2955284,1966242,1723210,1274560,1164441,14417164,3743465,6269187,10012652,5322929,3205745,2238523,2023017,1514258,1609585,15914057,30331221,50701458,50701458
Viet Nam,1979,VN,VNM,WPR,3997257,6520157,10517414,5414967,3160994,1949005,1759006,1295868,1197989,14777829,3814141,6365608,10179749,5447215,3405610,2228107,2068794,1547344,1659328,16356398,31134227,51831389,51831389
Viet Nam,1980,VN,VNM,WPR,4086624,6621956,10708580,5447197,3380435,1940755,1789392,1318750,1229439,15105968,3896242,6476401,10372643,5538323,3617043,2229545,2108206,1582424,1705539,16781080,31887048,52968270,52968270
Viet Nam,1981,VN,VNM,WPR,4171844,6787725,10959569,5524293,3606419,1951774,1814186,1341655,1259253,15497580,3976674,6626833,10603507,5632833,3832070,2248080,2139274,1618739,1748755,17219751,32717331,54280394,54280394
Viet Nam,1982,VN,VNM,WPR,4266104,6974245,11240349,5558792,3856362,1976752,1835257,1364143,1287443,15878749,4065908,6796922,10862830,5684593,4070854,2282974,2165934,1655093,1790775,17650223,33528972,55632153,55632153
Viet Nam,1983,VN,VNM,WPR,4359786,7165833,11525619,5573700,4118775,2023703,1850899,1386647,1314404,16268128,4154998,6971799,11126797,5714543,4324913,2339584,2186702,1691889,1833278,18090909,34359037,57011444,57011444
Viet Nam,1984,VN,VNM,WPR,4447352,7355177,11802529,5599559,4336093,2126782,1858869,1411326,1341966,16674595,4237384,7146236,11383620,5751098,4538884,2449351,2198496,1730791,1877485,18546105,35220700,58406863,58406863
Viet Nam,1985,VN,VNM,WPR,4526915,7543458,12070373,5636405,4514036,2275617,1859879,1438649,1371702,17096288,4311311,7321417,11632728,5793204,4717860,2602595,2201693,1771820,1924756,19011928,36108216,59811313,59811313
Viet Nam,1986,VN,VNM,WPR,4590750,7729756,12320506,5728141,4666750,2415622,1853813,1468926,1403697,17536949,4371081,7495104,11866185,5885780,4877476,2744255,2196862,1815488,1977609,19497470,37034419,61221107,61221107
Viet Nam,1987,VN,VNM,WPR,4633196,7909429,12542625,5847453,4798575,2576630,1840607,1502900,1438277,18004442,4411127,7662669,12073796,6001135,5020365,2905639,2184104,1862115,2036564,20009922,38014364,62630787,62630787
Viet Nam,1988,VN,VNM,WPR,4656865,8074779,12731644,5959759,4940834,2767405,1825056,1538667,1473744,18505465,4433927,7815899,12249826,6103040,5176403,3095536,2168897,1909245,2097452,20550573,39056038,64037514,64037514
Viet Nam,1989,VN,VNM,WPR,4667244,8240215,12907459,6099272,5062798,2978625,1814919,1571557,1508028,19035199,4444553,7967173,12411726,6220231,5315169,3303363,2160700,1952829,2159686,21111978,40147177,65466361,65466361
Viet Nam,1990,VN,VNM,WPR,4670777,8407943,13078720,6265819,5155887,3205419,1814863,1598748,1541056,19581792,4448661,8120036,12568697,6354614,5426755,3524962,2165113,1989648,2222303,21683395,41265187,66912613,66912613
Viet Nam,1991,VN,VNM,WPR,4670404,8563407,13233811,6460219,5235955,3427264,1826452,1621441,1572716,20144047,4448361,8263468,12711829,6514180,5525226,3740006,2183776,2020852,2285092,22269132,42413179,68358820,68358820
Viet Nam,1992,VN,VNM,WPR,4662723,8703224,13365947,6676620,5277271,3672799,1851469,1640161,1602089,20720409,4440017,8394226,12834243,6694366,5581886,3979276,2218462,2047460,2346697,22868147,43588556,69788747,69788747
Viet Nam,1993,VN,VNM,WPR,4638491,8822198,13460689,6897474,5300794,3930555,1897522,1653758,1630973,21311076,4415096,8507034,12922130,6879275,5616779,4234037,2274388,2068329,2409708,23482516,44793592,71176405,71176405
Viet Nam,1994,VN,VNM,WPR,4582532,8923007,13505539,7115059,5336686,4145584,1997426,1660711,1662993,21918459,4359742,8602071,12961813,7063795,5658556,4450117,2382661,2081118,2479035,24115282,46033741,72501087,72501087
Viet Nam,1995,VN,VNM,WPR,4480472,9010709,13491181,7333982,5391052,4325677,2142333,1662102,1698927,22554073,4260621,8683225,12943846,7251398,5709121,4633646,2534362,2086306,2555180,24770013,47324086,73759110,73759110
Viet Nam,1996,VN,VNM,WPR,4330736,9078787,13409523,7553134,5508907,4484612,2280537,1658125,1739333,23224648,4116124,8745361,12861485,7439655,5813540,4799687,2675556,2084157,2638202,25450797,48675445,74946448,74946448
Viet Nam,1997,VN,VNM,WPR,4151809,9118077,13269886,7761712,5658471,4624374,2439561,1648416,1785015,23917549,3943847,8778901,12722748,7620483,5941646,4949403,2836373,2074200,2726319,26148424,50065973,76058603,76058603
Viet Nam,1998,VN,VNM,WPR,3967469,9123401,13090870,7951996,5804842,4775738,2627882,1637562,1833338,24631358,3766116,8779019,12545135,7785849,6057928,5112624,3025816,2062238,2816602,26861057,51492415,77128424,77128424
Viet Nam,1999,VN,VNM,WPR,3800419,9085596,12886015,8123257,5959159,4901861,2832990,1631255,1878096,25326618,3603865,8737803,12341668,7940244,6182150,5255137,3231885,2057064,2902929,27569409,52896027,78123713,78123713
Viet Nam,2000,VN,VNM,WPR,3678637,8985122,12663759,8238082,6132624,5003515,3059583,1637390,1917115,25988309,3482725,8639105,12121830,8055129,6305859,5368599,3453449,2063220,2980997,28227253,54215562,79001142,79001142
Viet Nam,2001,VN,VNM,WPR,3612656,8825720,12438376,8292844,6343911,5101885,3291627,1658512,1951501,26640280,3412528,8484804,11897332,8125136,6441585,5469593,3671957,2082356,3051164,28841791,55482071,79817777,79817777
Viet Nam,2002,VN,VNM,WPR,3594672,8636914,12231586,8324835,6571555,5162649,3546934,1692389,1980938,27279300,3386461,8298939,11685400,8180664,6592195,5527583,3914526,2117018,3114032,29446018,56725318,80642308,80642308
Viet Nam,2003,VN,VNM,WPR,3609051,8432136,12041187,8338318,6796010,5206466,3813889,1746000,2006093,27906776,3389092,8094358,11483450,8222740,6743096,5562588,4172486,2172522,3170980,30044412,57951188,81475825,81475825
Viet Nam,2004,VN,VNM,WPR,3641322,8217192,11858514,8340986,7006345,5261978,4040113,1849860,2028683,28527965,3406435,7877380,11283815,8254047,6888399,5602462,4392519,2279066,3224446,30640939,59168904,82311227,82311227
Viet Nam,2005,VN,VNM,WPR,3673691,8003404,11677095,8341973,7199777,5330527,4230088,1994693,2049954,29147012,3421595,7659632,11081227,8279935,7028823,5646334,4578735,2427901,3275027,31236755,60383767,83142095,83142095
Viet Nam,2006,VN,VNM,WPR,3690237,7797665,11487902,8341187,7372247,5454546,4394209,2131854,2070064,29764107,3419035,7448007,10867042,8298664,7162411,5737780,4744558,2566818,3322514,31832745,61596852,83951800,83951800
Viet Nam,2007,VN,VNM,WPR,3697132,7610412,11307544,8334099,7516636,5607779,4536790,2287653,2089525,30372482,3404781,7252920,10657701,8303485,7284656,5849521,4892889,2725571,3368425,32424547,62797029,84762269,84762269
Viet Nam,2008,VN,VNM,WPR,3708904,7449141,11158045,8316621,7624723,5754316,4686531,2469285,2109582,30961058,3394356,7080780,10475136,8290039,7388212,5945416,5052569,2912416,3414346,33002998,63964056,85597241,85597241
Viet Nam,2009,VN,VNM,WPR,3724102,7327623,11051725,8300726,7705165,5911777,4809597,2665745,2131666,31524676,3388702,6942823,10331525,8266061,7490177,6049802,5190802,3116529,3461625,33574996,65099672,86482923,86482923
Viet Nam,2010,VN,VNM,WPR,3741588,7253823,10995411,8276328,7769157,6079700,4898445,2872167,2157099,32052896,3387805,6847242,10235047,8221369,7598402,6164665,5298030,3333200,3511982,34127648,66180544,87411012,87411012
Viet Nam,2011,VN,VNM,WPR,3774212,7214235,10988447,8215826,7819648,6269059,4972405,3072172,2187663,32536773,3404449,6782398,10186847,8134182,7701598,6300491,5389952,3542539,3568289,34637051,67173824,88349117,88349117
Viet Nam,2012,VN,VNM,WPR,3817987,7207920,11025907,8124436,7859099,6473539,5010650,3291841,2224655,32984220,3434931,6747165,10182096,8012253,7797351,6453394,5439807,3774021,3632273,35109099,68093319,89301326,89301326
Viet Nam,2013,VN,VNM,WPR,3863089,7235655,11098744,8010168,7888878,6675090,5034053,3521415,2274473,33404077,3469344,6742710,10212054,7865575,7883057,6607946,5467620,4019459,3709210,35552867,68956944,90267739,90267739
Viet Nam,2014,VN,VNM,WPR,3906957,7283251,11190208,7875969,7917909,6862936,5069901,3714364,2364524,33805603,3504627,6756527,10261154,7699405,7961319,6758482,5501002,4228089,3830239,35978536,69784139,91235504,91235504
Viet Nam,2015,VN,VNM,WPR,3947110,7332976,11280086,7730869,7955787,7034000,5119349,3874470,2486948,34201423,3538148,6772273,10310421,7524734,8037279,6905985,5539245,4403873,3988352,36399468,70600891,92191398,92191398
Viet Nam,2016,VN,VNM,WPR,3975379,7382305,11357684,7580408,7999989,7185070,5222660,4008865,2600264,34597256,3562462,6787835,10350297,7347875,8106935,7048154,5624828,4558655,4134835,36821282,71418538,93126529,93126529
Viet Nam,2017,VN,VNM,WPR,3981872,7433443,11415315,7435489,8043322,7310350,5355892,4124201,2728114,34997368,3568601,6805505,10374106,7179472,8161426,7180252,5731200,4696334,4297580,37246264,72243632,94033048,94033048
Viet Nam,2018,VN,VNM,WPR,3967903,7490935,11458838,7304791,8077879,7402880,5485879,4248482,2877520,35397431,3557456,6830824,10388280,7026681,8194048,7294714,5823271,4845597,4485466,37669777,73067208,94914330,94914330
Viet Nam,2019,VN,VNM,WPR,3943704,7550535,11494239,7198661,8092437,7475915,5631907,4353656,3041615,35794191,3538032,6861245,10399277,6898193,8195488,7403196,5924937,4976126,4691067,38089007,73883198,95776716,95776716
Viet Nam,2020,VN,VNM,WPR,3914416,7608843,11523259,7130171,8074448,7540621,5795766,4437365,3224525,36202896,3515182,6894176,10409358,6805035,8155171,7512638,6038988,5080886,4920451,38513169,74716065,96648685,96648685
Viet Nam,2021,VN,VNM,WPR,3879653,7670686,11550339,7094803,8016158,7592527,5980654,4507032,3394677,36585851,3488505,6935471,10423976,6741939,8068955,7616016,6173855,5170269,5136833,38907867,75493718,97468029,97468029
Viet Nam,2022,VN,VNM,WPR,3842402,7714053,11556455,7080255,7947531,7632593,6171065,4534136,3579255,36944835,3459538,6968179,10427717,6698046,7950568,7705229,6318469,5213137,5372405,39257854,76202689,98186856,98186856
Viet Nam,2023,VN,VNM,WPR,3800726,7732418,11533144,7084577,7878298,7664985,6353575,4543252,3792425,37317112,3426580,6984375,10410955,6673204,7811068,7778420,6459055,5231305,5644700,39597752,76914864,98858950,98858950
Viet Nam,2024,VN,VNM,WPR,3750495,7743301,11493796,7103097,7789409,7699462,6524275,4564177,4006402,37686822,3386783,6995273,10382056,6664452,7653097,7844733,6595963,5254293,5922461,39934999,77621821,99497680,99497680
Viet Nam,2025,VN,VNM,WPR,3693731,7749114,11442845,7120088,7687710,7746120,6680208,4598239,4217712,38050077,3341724,7002719,10344443,6656565,7486536,7909592,6729986,5281546,6202394,40266619,78316696,100103979,100103979
Viet Nam,2026,VN,VNM,WPR,3636881,7740922,11377803,7135038,7576452,7803323,6818492,4681075,4396111,38410491,3296986,6998476,10295462,6648555,7316485,7969499,6858799,5353478,6449313,40596129,79006620,100679892,100679892
Viet Nam,2027,VN,VNM,WPR,3583414,7710616,11294030,7151996,7464089,7864607,6933628,4792160,4567619,38774099,3255795,6974952,10230747,6643790,7152335,8016217,6977752,5445431,6693672,40929197,79703296,101228069,101228069
Viet Nam,2028,VN,VNM,WPR,3532481,7656740,11189221,7177115,7357396,7922803,7019187,4903083,4762942,39142526,3217169,6930901,10148070,6648643,7000131,8043547,7079384,5524655,6970947,41267307,80409833,101747121,101747121
Viet Nam,2029,VN,VNM,WPR,3485414,7585095,11070509,7207663,7265581,7966638,7087703,5029938,4951259,39508782,3181997,6871951,10053948,6661242,6867942,8042464,7175086,5613435,7243638,41603807,81112589,102237046,102237046
Viet Nam,2030,VN,VNM,WPR,3442905,7502166,10945071,7240888,7199924,7982539,7148103,5171178,5124298,39866930,3150808,6804358,9955166,6679228,6766040,8002286,7271041,5713336,7500811,41932742,81799672,102699905,102699905
Viet Nam,1950,VN,VNM,WPR,1716183,2400598,4116781,2339688,1909944,1584971,1245251,756635,454768,8291257,1690025,2429692,4119717,2363735,1914126,1582667,1296236,843577,581113,8581454,16872711,25109200,25109200
Viet Nam,1951,VN,VNM,WPR,1850365,2412706,4263071,2349199,1917794,1592579,1267197,776838,473998,8377605,1808631,2446667,4255298,2387656,1945082,1598777,1322252,869394,608398,8731559,17109164,25627533,25627533
Viet Nam,1952,VN,VNM,WPR,1996423,2441953,4438376,2355937,1925259,1601668,1284347,795740,494079,8457030,1937132,2481902,4419034,2407358,1976351,1616679,1343587,894076,637104,8875155,17332185,26189593,26189593
Viet Nam,1953,VN,VNM,WPR,2157723,2497051,4654774,2358385,1933181,1612137,1297394,814786,514884,8530767,2081314,2540913,4622227,2421136,2008326,1636599,1361149,918833,667045,9013088,17543855,26820851,26820851
Viet Nam,1954,VN,VNM,WPR,2277932,2617246,4895178,2357349,1948957,1625149,1310350,837392,536912,8616109,2191968,2656548,4848516,2425806,2043072,1658145,1377129,945925,697569,9147646,17763755,27507453,27507453
Viet Nam,1955,VN,VNM,WPR,2368803,2789485,5158288,2354650,1975142,1641910,1325884,865119,561323,8724028,2278076,2818372,5096448,2422245,2080825,1681624,1393401,976411,729776,9284282,18008310,28263031,28263031
Viet Nam,1956,VN,VNM,WPR,2474928,2948764,5423692,2345914,2007513,1659832,1342034,897134,587662,8840089,2379036,2967702,5346738,2411133,2121581,1707056,1409904,1010855,764633,9425162,18265251,29035681,29035681
Viet Nam,1957,VN,VNM,WPR,2598260,3129233,5727493,2329071,2044601,1677274,1357579,932682,614918,8956125,2495979,3137243,5633222,2392477,2164842,1734052,1426068,1048939,800870,9567248,18523373,29884089,29884089
Viet Nam,1958,VN,VNM,WPR,2724392,3341111,6065503,2310029,2084449,1694905,1372943,969350,642907,9074583,2615400,3336566,5951966,2372463,2208554,1762684,1442283,1087979,838062,9712025,18786608,30804081,30804081
Viet Nam,1959,VN,VNM,WPR,2839904,3572158,6412062,2298762,2121900,1713598,1388770,1003225,671242,9197497,2724758,3553730,6278488,2361525,2248384,1793061,1459318,1124061,876026,9862375,19059872,31750430,31750430
Viet Nam,1960,VN,VNM,WPR,2945228,3818163,6763391,2300872,2153237,1733890,1405379,1032811,700077,9326266,2824315,3784391,6608706,2365556,2281043,1825309,1477637,1155645,914920,10020110,19346376,32718461,32718461
Viet Nam,1961,VN,VNM,WPR,3016046,4057459,7073505,2317075,2179656,1755432,1422521,1058615,729162,9462461,2891378,4007210,6898588,2385489,2308073,1859149,1497129,1183038,954542,10187420,19649881,33621982,33621982
Viet Nam,1962,VN,VNM,WPR,3056405,4324260,7380665,2348531,2201692,1776365,1440540,1079927,757577,9604632,2928709,4254920,7183629,2423149,2330857,1893164,1518037,1205952,993802,10364961,19969593,34533889,34533889
Viet Nam,1963,VN,VNM,WPR,3111902,4606650,7718552,2402711,2216119,1796239,1458362,1096330,785007,9754768,2979799,4518282,7498081,2483778,2347383,1927365,1540124,1224599,1032070,10555319,20310087,35526727,35526727
Viet Nam,1964,VN,VNM,WPR,3157711,4841169,7998880,2518050,2220304,1817907,1475039,1110455,813733,9955488,3021879,4740108,7761987,2599125,2353811,1963446,1563009,1241348,1072073,10792812,20748300,36509166,36509166
Viet Nam,1965,VN,VNM,WPR,3184616,5036727,8221343,2682767,2215557,1842294,1490742,1123954,844471,10199785,3046369,4927027,7973396,2759247,2351289,2001733,1586988,1257789,1114497,11071543,21271328,37466077,37466077
Viet Nam,1966,VN,VNM,WPR,3229651,5213421,8443072,2834609,2202212,1869582,1505342,1136303,876756,10424804,3089256,5095677,8184933,2907239,2341299,2042435,1612098,1273573,1158759,11335403,21760207,38388210,38388210
Viet Nam,1967,VN,VNM,WPR,3260173,5373007,8633180,3006712,2180517,1900443,1518952,1147886,911073,10665583,3118740,5247616,8366356,3075062,2323802,2085326,1638464,1288983,1205815,11617452,22283035,39282564,39282564
Viet Nam,1968,VN,VNM,WPR,3247698,5544967,8792665,3204384,2151934,1929596,1529321,1156121,941546,10912902,3107230,5411487,8518717,3271390,2304226,2127690,1665162,1302964,1249570,11921002,22833904,40145287,40145287
Viet Nam,1969,VN,VNM,WPR,3245823,5696367,8942190,3418478,2128500,1954127,1538770,1162915,966876,11169666,3105994,5555939,8661933,3484891,2293277,2165807,1692817,1316827,1288462,12242081,23411747,41015865,41015865
Viet Nam,2031,VN,VNM,WPR,3402525,7413784,10816309,7281574,7156512,7963983,7197862,5332240,5280214,40212385,3121373,6733267,9854640,6708279,6689109,7919325,7360903,5833421,7738740,42249777,82462162,103133107,103133107
Viet Nam,2032,VN,VNM,WPR,3363933,7325785,10689718,7316023,7136887,7919104,7239301,5506642,5422728,40540685,3093278,6663649,9756927,6735688,6637585,7804425,7443601,5969488,7960195,42550982,83091667,103538310,103538310
Viet Nam,2033,VN,VNM,WPR,3329150,7235333,10564483,7335775,7143351,7854135,7274140,5679542,5567154,40854097,3068361,6592812,9661173,6752208,6613458,7666881,7516798,6107394,8181312,42838051,83692148,103917806,103917806
Viet Nam,2034,VN,VNM,WPR,3297797,7140214,10438011,7348120,7163722,7770067,7311157,5841760,5720381,41155207,3046144,6518590,9564734,6763444,6605302,7511050,7583272,6241841,8408155,43113064,84268271,104271016,104271016
Viet Nam,2035,VN,VNM,WPR,3268967,7043103,10312070,7355407,7182620,7673594,7359982,5990370,5880602,41442575,3025686,6443068,9468754,6771230,6598000,7346749,7648347,6373496,8637035,43374857,84817432,104598253,104598253
Viet Nam,2036,VN,VNM,WPR,3244391,6947966,10192357,7348817,7199570,7567917,7419116,6123051,6052973,41711444,3008552,6369585,9378137,6767358,6590596,7179050,7708618,6500253,8872899,43618774,85330218,104900707,104900707
Viet Nam,2037,VN,VNM,WPR,3223739,6857892,10081631,7320385,7218554,7461274,7482330,6235056,6242906,41960505,2994509,6300945,9295454,6744269,6586434,7017263,7755978,6617756,9121309,43843009,85803514,105180604,105180604
Viet Nam,2038,VN,VNM,WPR,3205451,6774066,9979517,7268682,7245582,7360205,7542580,6320571,6452743,42190363,2982152,6238009,9220161,6700739,6591841,6867344,7784247,6718821,9384642,44047634,86237997,105437667,105437667
Viet Nam,2039,VN,VNM,WPR,3190154,6697441,9887595,7199412,7277934,7273612,7588869,6390696,6669647,42400170,2972059,6181190,9153249,6642365,6604943,6737246,7784481,6814220,9648611,44231866,86632036,105672878,105672878
Viet Nam,2040,VN,VNM,WPR,3178020,6627801,9805821,7118957,7312885,7212418,7607981,6453335,6885287,42590863,2964446,6130080,9094526,6575369,6623373,6637101,7746128,6909777,9904808,44396556,86987419,105887768,105887768
Viet Nam,2041,VN,VNM,WPR,3167318,6564452,9731770,7033061,7355103,7172769,7593614,6506344,7103375,42764266,2957720,6084018,9041738,6504873,6652771,6561615,7665523,6999429,10158564,44542775,87307041,106080557,106080557
Viet Nam,2042,VN,VNM,WPR,3157339,6506751,9664090,6947495,7391187,7156224,7553672,6551827,7322060,42922465,2951120,6042365,8993485,6435839,6680514,6511235,7553403,7082108,10409270,44672369,87594834,106252410,106252410
Viet Nam,2043,VN,VNM,WPR,3149432,6455138,9604570,6859465,7412872,7165094,7494250,6591461,7542179,43065321,2945926,6005542,8951468,6365581,6697437,6487974,7418967,7155622,10659548,44785129,87850450,106406496,106406496
Viet Nam,2044,VN,VNM,WPR,3143806,6409872,9553678,6766792,7427298,7187511,7416469,6633463,7761987,43193520,2942524,5973663,8916187,6291944,6709103,6480520,7266570,7222703,10910710,44881550,88075070,106544934,106544934
Viet Nam,2045,VN,VNM,WPR,3139497,6370219,9509716,6672136,7436753,7208498,7327000,6686738,7977717,43308842,2940102,5945996,8886098,6217004,6717331,6473909,7105960,7288496,11160374,44963074,88271916,106667721,106667721
Viet Nam,2046,VN,VNM,WPR,3136275,6336181,9472456,6579388,7432575,7227616,7229025,6749978,8192159,43410741,2938503,5922517,8861020,6144091,6713969,6467201,6942159,7349739,11411785,45028944,88439685,106773162,106773162
Viet Nam,2047,VN,VNM,WPR,3133098,6306733,9439831,6491603,7406931,7248784,7130463,6817261,8405781,43500823,2936887,5902240,8839127,6075991,6691504,6463742,6784325,7398552,11666742,45080856,88581679,106860645,106860645
Viet Nam,2048,VN,VNM,WPR,3128426,6281664,9410090,6409967,7358432,7277885,7037490,6881694,8615571,43581039,2933824,5885032,8818856,6013570,6648727,6469806,6638261,7428823,11921581,45120768,88701807,106930754,106930754
Viet Nam,2049,VN,VNM,WPR,3120262,6261805,9382067,6335422,7292673,7312249,6958547,6932756,8820235,43651882,2927325,5871862,8799187,5957245,6591194,6483514,6511717,7431743,12173645,45149058,88800940,106982197,106982197
Viet Nam,2050,VN,VNM,WPR,3107666,6246360,9354026,6267752,7215900,7349191,6903963,6957819,9019316,43713941,2916621,5862133,8778754,5906593,6525091,6502514,6414571,7396918,12420534,45166221,88880162,107012939,107012939
Vanuatu,1970,VU,VUT,WPR,8123,12495,20618,8598,6030,4377,3062,1748,1287,25102,7705,11798,19503,7905,5544,3813,2332,1303,900,21797,46899,87019,87019
Vanuatu,1971,VU,VUT,WPR,8337,12865,21202,8938,6163,4504,3162,1803,1237,25807,7943,12215,20158,8193,5695,4004,2460,1374,902,22628,48435,89796,89796
Vanuatu,1972,VU,VUT,WPR,8553,13240,21793,9292,6303,4642,3268,1862,1179,26546,8182,12661,20843,8501,5839,4211,2605,1447,904,23507,50053,92687,92687
Vanuatu,1973,VU,VUT,WPR,8770,13612,22382,9647,6474,4784,3374,1929,1115,27323,8416,13124,21540,8815,5992,4424,2766,1531,915,24443,51766,95687,95687
Vanuatu,1974,VU,VUT,WPR,8990,13978,22968,10013,6659,4927,3489,2002,1054,28144,8652,13609,22261,9134,6154,4644,2947,1617,921,25417,53561,98790,98790
Vanuatu,1975,VU,VUT,WPR,9212,14352,23564,10405,6843,5069,3607,2082,1011,29017,8884,14105,22989,9467,6319,4865,3143,1712,929,26435,55452,102010,102010
Vanuatu,1976,VU,VUT,WPR,9440,14732,24172,10800,7055,5207,3732,2165,977,29936,9116,14609,23725,9818,6489,5084,3349,1814,950,27504,57440,105341,105341
Vanuatu,1977,VU,VUT,WPR,9674,15122,24796,11188,7293,5341,3858,2256,959,30895,9343,15125,24468,10185,6678,5290,3557,1917,982,28609,59504,108769,108769
Vanuatu,1978,VU,VUT,WPR,9994,15586,25580,11527,7592,5425,3938,2364,1134,31980,9480,15560,25040,10642,6863,5331,3669,2002,1078,29585,61565,112185,112185
Vanuatu,1979,VU,VUT,WPR,10540,16280,26820,11714,8011,5385,3855,2537,1849,33351,9370,15717,25087,11344,7024,4891,3464,2016,1349,30088,63439,115344,115344
Vanuatu,1980,VU,VUT,WPR,10954,16936,27890,11804,8374,5388,3770,2676,2413,34425,9380,15787,25167,11952,7287,4543,3271,2039,1580,30672,65097,118156,118156
Vanuatu,1981,VU,VUT,WPR,11100,17412,28512,11902,8597,5528,3796,2745,2465,35033,9704,15945,25649,12290,7685,4614,3308,2130,1663,31690,66723,120887,120887
Vanuatu,1982,VU,VUT,WPR,11250,17930,29180,12003,8803,5681,3827,2808,2525,35647,10090,16075,26165,12618,8108,4699,3340,2226,1750,32741,68388,123748,123748
Vanuatu,1983,VU,VUT,WPR,11428,18467,29895,12125,8972,5872,3871,2861,2602,36303,10513,16208,26721,12937,8536,4808,3371,2324,1845,33821,70124,126743,126743
Vanuatu,1984,VU,VUT,WPR,11690,18959,30649,12266,9120,6069,3923,2909,2685,36972,10879,16454,27333,13235,8969,4942,3410,2422,1945,34923,71895,129873,129873
Vanuatu,1985,VU,VUT,WPR,12020,19408,31428,12437,9265,6265,3994,2948,2763,37672,11190,16796,27986,13509,9400,5103,3453,2514,2044,36023,73695,133119,133119
Vanuatu,1986,VU,VUT,WPR,12360,19867,32227,12650,9391,6478,4074,2980,2854,38427,11507,17183,28690,13763,9827,5309,3497,2598,2154,37148,75575,136488,136488
Vanuatu,1987,VU,VUT,WPR,12692,20343,33035,12914,9498,6702,4166,3002,2937,39219,11815,17622,29437,13989,10240,5560,3542,2670,2265,38266,77485,139956,139956
Vanuatu,1988,VU,VUT,WPR,13008,20825,33833,13231,9594,6938,4266,3026,3030,40085,12109,18114,30223,14196,10635,5854,3594,2733,2384,39396,79481,143528,143528
Vanuatu,1989,VU,VUT,WPR,13300,21314,34614,13596,9682,7168,4376,3051,3119,40992,12382,18660,31042,14389,11011,6186,3654,2786,2504,40530,81522,147181,147181
Vanuatu,1990,VU,VUT,WPR,13581,21815,35396,14039,9817,7391,4494,3060,3186,41987,12661,19260,31921,14578,11361,6515,3714,2816,2595,41579,83566,150882,150882
Vanuatu,1991,VU,VUT,WPR,13853,22328,36181,14542,10012,7598,4627,3062,3237,43078,12942,19938,32880,14753,11692,6839,3778,2821,2657,42540,85618,154678,154678
Vanuatu,1992,VU,VUT,WPR,14111,22849,36960,15072,10231,7791,4780,3074,3280,44228,13204,20694,33898,14883,12028,7186,3849,2827,2721,43494,87722,158577,158577
Vanuatu,1993,VU,VUT,WPR,14356,23386,37742,15601,10475,7953,4965,3095,3322,45411,13444,21480,34924,15008,12358,7532,3942,2835,2790,44465,89876,162548,162548
Vanuatu,1994,VU,VUT,WPR,14585,23982,38567,16078,10741,8107,5155,3130,3366,46577,13658,22201,35859,15230,12682,7883,4051,2852,2857,45555,92132,166560,166560
Vanuatu,1995,VU,VUT,WPR,14788,24634,39422,16507,11042,8270,5338,3181,3403,47741,13845,22863,36708,15538,12995,8233,4182,2870,2920,46738,94479,170612,170612
Vanuatu,1996,VU,VUT,WPR,14958,25274,40232,16949,11378,8424,5536,3248,3436,48971,14002,23513,37515,15896,13288,8592,4342,2900,2981,47999,96970,174714,174714
Vanuatu,1997,VU,VUT,WPR,15100,25894,40994,17411,11751,8575,5748,3331,3467,50283,14134,24138,38272,16308,13563,8940,4540,2936,3031,49318,99601,178871,178871
Vanuatu,1998,VU,VUT,WPR,15231,26485,41716,17892,12160,8734,5962,3424,3486,51658,14258,24740,38998,16782,13818,9283,4779,2974,3080,50716,102374,183088,183088
Vanuatu,1999,VU,VUT,WPR,15362,27046,42408,18410,12610,8905,6181,3524,3504,53134,14385,25301,39686,17326,14052,9635,5048,3023,3119,52203,105337,187432,187432
Vanuatu,2000,VU,VUT,WPR,15483,27553,43036,18947,13111,9098,6423,3643,3573,54795,14480,25798,40278,17976,14280,10030,5377,3089,3218,53970,108765,192074,192074
Vanuatu,2001,VU,VUT,WPR,15639,28008,43647,19503,13655,9328,6675,3780,3672,56613,14598,26220,40818,18734,14498,10452,5749,3171,3353,55957,112570,197034,197034
Vanuatu,2002,VU,VUT,WPR,15849,28429,44278,20087,14219,9582,6910,3933,3750,58481,14783,26583,41366,19567,14675,10877,6153,3260,3469,58001,116482,202125,202125
Vanuatu,2003,VU,VUT,WPR,16082,28792,44874,20685,14790,9855,7124,4117,3844,60415,14994,26879,41873,20441,14847,11294,6566,3365,3585,60098,120513,207258,207258
Vanuatu,2004,VU,VUT,WPR,16350,29099,45449,21333,15312,10147,7324,4312,3942,62370,15239,27110,42349,21253,15112,11692,6985,3495,3712,62249,124619,212422,212422
Vanuatu,2005,VU,VUT,WPR,16632,29374,46006,22012,15791,10472,7526,4505,4062,64368,15497,27315,42812,22004,15471,12070,7413,3641,3845,64444,128812,217632,217632
Vanuatu,2006,VU,VUT,WPR,16914,29653,46567,22672,16282,10827,7718,4713,4189,66401,15754,27519,43273,22734,15880,12423,7842,3822,3971,66672,133073,222923,222923
Vanuatu,2007,VU,VUT,WPR,17238,29935,47173,23288,16799,11221,7904,4932,4322,68466,16052,27722,43774,23431,16349,12738,8269,4039,4100,68926,137392,228345,228345
Vanuatu,2008,VU,VUT,WPR,17640,30212,47852,23852,17326,11653,8090,5163,4469,70553,16422,27926,44348,24078,16889,13022,8693,4296,4227,71205,141758,233952,233952
Vanuatu,2009,VU,VUT,WPR,18111,30482,48593,24316,17870,12115,8280,5393,4641,72615,16850,28129,44979,24661,17504,13272,9114,4584,4364,73499,146114,239689,239689
Vanuatu,2010,VU,VUT,WPR,18738,30818,49556,24678,18351,12578,8459,5598,4808,74472,17457,28426,45883,25223,18138,13429,9450,4836,4463,75539,150011,245453,245453
Vanuatu,2011,VU,VUT,WPR,19502,31287,50789,24960,18761,13028,8630,5765,4964,76108,18220,28892,47112,25747,18794,13496,9699,5042,4511,77289,153397,251294,251294
Vanuatu,2012,VU,VUT,WPR,20237,31902,52139,25162,19170,13500,8827,5919,5120,77698,18940,29508,48448,26171,19551,13530,9946,5267,4558,79023,156721,257313,257313
Vanuatu,2013,VU,VUT,WPR,20888,32689,53577,25330,19607,13981,9048,6053,5292,79311,19571,30296,49867,26492,20375,13586,10203,5502,4610,80768,160079,263534,263534
Vanuatu,2014,VU,VUT,WPR,21436,33657,55093,25481,20122,14414,9292,6185,5456,80950,20094,31266,51360,26726,21174,13754,10455,5747,4671,82527,163477,269927,269927
Vanuatu,2015,VU,VUT,WPR,21893,34741,56634,25637,20692,14798,9562,6317,5612,82618,20524,32356,52880,26906,21937,14027,10688,6002,4738,84298,166916,276438,276438
Vanuatu,2016,VU,VUT,WPR,22258,35914,58172,25883,21284,15209,9870,6456,5736,84438,20868,33510,54378,27048,22742,14392,10931,6288,4822,86223,170661,283218,283218
Vanuatu,2017,VU,VUT,WPR,22546,37145,59691,26233,21875,15647,10219,6595,5837,86406,21140,34717,55857,27169,23558,14851,11179,6603,4923,88283,174689,290239,290239
Vanuatu,2018,VU,VUT,WPR,22792,38371,61163,26651,22423,16092,10597,6742,5946,88451,21372,35922,57294,27328,24323,15368,11395,6919,5053,90386,178837,297298,297298
Vanuatu,2019,VU,VUT,WPR,23002,39570,62572,27157,22907,16544,11008,6898,6064,90578,21569,37104,58673,27576,25011,15957,11586,7240,5209,92579,183157,304404,304404
Vanuatu,2020,VU,VUT,WPR,23190,40741,63931,27796,23329,17017,11456,7073,6181,92852,21741,38245,59986,27913,25616,16633,11779,7584,5390,94915,187767,311685,311685
Vanuatu,2021,VU,VUT,WPR,23352,41860,65212,28587,23692,17520,11941,7275,6281,95296,21898,39317,61215,28378,26109,17409,11970,7943,5602,97411,192707,319137,319137
Vanuatu,2022,VU,VUT,WPR,23502,42886,66388,29552,24003,18034,12452,7501,6373,97915,22043,40283,62326,29000,26488,18313,12152,8317,5835,100105,198020,326740,326740
Vanuatu,2023,VU,VUT,WPR,23661,43771,67432,30706,24291,18583,12974,7748,6470,100772,22196,41098,63294,29793,26760,19289,12358,8705,6102,103007,203779,334506,334506
Vanuatu,2024,VU,VUT,WPR,23832,44481,68313,32016,24553,19197,13450,8015,6578,103809,22364,41755,64119,30787,26924,20228,12673,9085,6384,106081,209890,342325,342325
Vanuatu,2025,VU,VUT,WPR,24013,45058,69071,33421,24829,19871,13877,8302,6702,107002,22536,42292,64828,31917,27020,21128,13090,9446,6700,109301,216303,350202,350202
Vanuatu,2026,VU,VUT,WPR,24208,45539,69747,34847,25164,20534,14316,8615,6828,110304,22728,42744,65472,33109,27096,22033,13556,9783,7052,112629,222933,358162,358162
Vanuatu,2027,VU,VUT,WPR,24439,45953,70392,36274,25561,21176,14770,8955,6980,113716,22945,43133,66078,34344,27173,22917,14077,10096,7435,116042,229758,366230,366230
Vanuatu,2028,VU,VUT,WPR,24706,46328,71034,37681,26032,21776,15230,9322,7141,117182,23199,43491,66690,35596,27273,23753,14663,10373,7844,119502,236684,374415,374415
Vanuatu,2029,VU,VUT,WPR,25011,46672,71683,39039,26606,22310,15703,9715,7323,120696,23491,43819,67310,36833,27447,24513,15315,10631,8290,123029,243725,382716,382716
Vanuatu,2030,VU,VUT,WPR,25356,47004,72360,40322,27298,22778,16191,10141,7524,124254,23815,44132,67947,38015,27728,25167,16038,10872,8758,126578,250832,391135,391135
Vanuatu,1950,VU,VUT,WPR,4462,6878,11340,5255,3914,2682,2078,1776,1768,17473,4138,6356,10494,4470,2870,1774,1082,929,1137,12262,29735,51568,51568
Vanuatu,1951,VU,VUT,WPR,4585,6991,11576,5349,3982,2731,2065,1732,1743,17602,4259,6475,10734,4604,2953,1838,1108,909,1111,12523,30125,52432,52432
Vanuatu,1952,VU,VUT,WPR,4709,7114,11823,5454,4049,2796,2053,1687,1711,17750,4391,6592,10983,4740,3041,1908,1140,887,1087,12803,30553,53361,53361
Vanuatu,1953,VU,VUT,WPR,4838,7272,12110,5563,4113,2863,2046,1645,1682,17912,4539,6730,11269,4878,3140,1975,1178,870,1070,13111,31023,54411,54411
Vanuatu,1954,VU,VUT,WPR,4979,7439,12418,5677,4186,2945,2047,1610,1652,18117,4690,6885,11575,5013,3246,2047,1224,853,1057,13440,31557,55547,55547
Vanuatu,1955,VU,VUT,WPR,5149,7604,12753,5794,4252,3022,2057,1577,1632,18334,4848,7052,11900,5149,3361,2116,1272,841,1034,13773,32107,56770,56770
Vanuatu,1956,VU,VUT,WPR,5324,7794,13118,5909,4332,3109,2071,1549,1606,18576,5011,7232,12243,5287,3483,2192,1321,834,1016,14133,32709,58071,58071
Vanuatu,1957,VU,VUT,WPR,5507,8019,13526,6035,4416,3195,2094,1534,1582,18856,5182,7445,12627,5427,3614,2271,1369,838,1005,14524,33380,59529,59529
Vanuatu,1958,VU,VUT,WPR,5697,8278,13975,6163,4516,3281,2126,1533,1560,19179,5360,7691,13051,5579,3749,2354,1418,850,985,14935,34114,61140,61140
Vanuatu,1959,VU,VUT,WPR,5885,8565,14450,6295,4617,3366,2168,1532,1533,19511,5538,7962,13500,5728,3891,2439,1470,867,969,15364,34875,62831,62831
Vanuatu,1960,VU,VUT,WPR,6074,8874,14948,6432,4725,3450,2222,1535,1513,19877,5714,8252,13966,5878,4033,2529,1529,889,956,15814,35691,64608,64608
Vanuatu,1961,VU,VUT,WPR,6265,9203,15468,6569,4841,3533,2286,1542,1493,20264,5890,8561,14451,6029,4176,2622,1594,914,938,16273,36537,66462,66462
Vanuatu,1962,VU,VUT,WPR,6458,9539,15997,6720,4967,3617,2359,1546,1466,20675,6073,8891,14964,6178,4330,2720,1660,943,929,16760,37435,68391,68391
Vanuatu,1963,VU,VUT,WPR,6652,9872,16524,6900,5098,3698,2440,1557,1442,21135,6256,9226,15482,6336,4475,2828,1729,979,910,17257,38392,70400,70400
Vanuatu,1964,VU,VUT,WPR,6849,10215,17064,7089,5229,3779,2524,1572,1427,21620,6444,9565,16009,6515,4626,2946,1803,1019,897,17806,39426,72493,72493
Vanuatu,1965,VU,VUT,WPR,7052,10589,17641,7275,5366,3865,2609,1590,1402,22107,6633,9919,16552,6702,4780,3065,1878,1059,885,18369,40476,74677,74677
Vanuatu,1966,VU,VUT,WPR,7259,10970,18229,7485,5505,3955,2696,1613,1390,22644,6827,10276,17103,6906,4929,3193,1957,1099,881,18965,41609,76945,76945
Vanuatu,1967,VU,VUT,WPR,7475,11353,18828,7721,5641,4047,2787,1641,1375,23212,7031,10636,17667,7131,5083,3324,2034,1144,883,19599,42811,79311,79311
Vanuatu,1968,VU,VUT,WPR,7692,11737,19429,7984,5772,4147,2870,1671,1365,23809,7246,11011,18257,7374,5239,3471,2120,1190,893,20287,44096,81782,81782
Vanuatu,1969,VU,VUT,WPR,7906,12117,20023,8279,5900,4257,2964,1704,1334,24438,7471,11399,18870,7631,5389,3634,2220,1242,903,21019,45457,84350,84350
Vanuatu,2031,VU,VUT,WPR,25735,47342,73077,41507,28124,23165,16694,10588,7748,127826,24177,44458,68635,39109,28147,25696,16847,11093,9253,130145,257971,399683,399683
Vanuatu,2032,VU,VUT,WPR,26138,47714,73852,42558,29106,23492,17207,11053,7995,131411,24557,44819,69376,40086,28748,26088,17745,11288,9770,133725,265136,408365,408365
Vanuatu,2033,VU,VUT,WPR,26538,48139,74677,43441,30253,23778,17743,11529,8258,135002,24935,45230,70165,40908,29545,26369,18700,11495,10293,137310,272312,417158,417158
Vanuatu,2034,VU,VUT,WPR,26941,48620,75561,44152,31553,24044,18343,11960,8543,138595,25314,45695,71009,41564,30537,26537,19622,11803,10818,140881,279476,426050,426050
Vanuatu,2035,VU,VUT,WPR,27348,49147,76495,44730,32949,24322,18993,12354,8847,142195,25695,46197,71892,42104,31662,26639,20510,12206,11349,144470,286665,435047,435047
Vanuatu,2036,VU,VUT,WPR,27745,49728,77473,45215,34362,24655,19638,12754,9169,145793,26068,46753,72821,42561,32854,26725,21396,12657,11872,148065,293858,444151,444151
Vanuatu,2037,VU,VUT,WPR,28139,50363,78502,45633,35777,25055,20260,13167,9527,149419,26440,47353,73793,42957,34087,26807,22263,13160,12386,151660,301079,453374,453374
Vanuatu,2038,VU,VUT,WPR,28545,51032,79577,46008,37174,25524,20843,13593,9914,153056,26820,47991,74811,43312,35336,26914,23088,13730,12897,155277,308333,462717,462717
Vanuatu,2039,VU,VUT,WPR,28951,51740,80691,46357,38519,26096,21365,14033,10330,156700,27198,48663,75861,43644,36565,27091,23836,14359,13401,158896,315596,472147,472147
Vanuatu,2040,VU,VUT,WPR,29341,52488,81829,46690,39791,26783,21816,14487,10783,160350,27565,49372,76937,43964,37744,27377,24479,15052,13909,162525,322875,481641,481641
Vanuatu,2041,VU,VUT,WPR,29703,53269,82972,47029,40967,27604,22199,14958,11266,164023,27908,50106,78014,44292,38834,27801,25001,15827,14412,166167,330190,491182,491182
Vanuatu,2042,VU,VUT,WPR,30035,54069,84104,47402,42013,28574,22522,15446,11788,167745,28219,50860,79079,44654,39814,28403,25396,16688,14904,169859,337604,500781,500781
Vanuatu,2043,VU,VUT,WPR,30339,54877,85216,47833,42891,29706,22805,15951,12321,171507,28502,51621,80123,45068,40630,29195,25675,17605,15414,173587,345094,510431,510431
Vanuatu,2044,VU,VUT,WPR,30626,55682,86308,48317,43599,30992,23071,16515,12828,175322,28771,52378,81149,45531,41289,30179,25846,18489,16009,177343,352665,520124,520124
Vanuatu,2045,VU,VUT,WPR,30895,56482,87377,48843,44177,32367,23351,17122,13309,179169,29018,53129,82147,46037,41829,31300,25957,19340,16683,181146,360315,529838,529838
Vanuatu,2046,VU,VUT,WPR,31155,57246,88401,49424,44664,33764,23684,17719,13818,183073,29262,53843,83105,46595,42285,32482,26049,20198,17391,185000,368073,539582,539582
Vanuatu,2047,VU,VUT,WPR,31410,57973,89383,50057,45083,35162,24081,18302,14346,187031,29494,54531,84025,47199,42678,33707,26142,21036,18141,188903,375934,549346,549346
Vanuatu,2048,VU,VUT,WPR,31619,58684,90303,50733,45460,36540,24547,18846,14910,191036,29688,55195,84883,47835,43041,34949,26256,21831,18939,192851,383887,559073,559073
Vanuatu,2049,VU,VUT,WPR,31811,59378,91189,51441,45808,37873,25116,19336,15506,195080,29865,55845,85710,48504,43374,36170,26442,22553,19792,196835,391915,568810,568810
Vanuatu,2050,VU,VUT,WPR,32006,60039,92045,52189,46147,39133,25793,19764,16136,199162,30043,56458,86501,49213,43693,37339,26733,23178,20701,200857,400019,578567,578567
Wallis and Futuna Islands,1970,WF,WLF,WPR,930,1409,2339,830,457,295,348,228,110,2268,889,1361,2250,849,557,463,343,202,102,2516,4784,9377,9377
Wallis and Futuna Islands,1971,WF,WLF,WPR,927,1433,2360,822,484,287,353,243,118,2307,884,1372,2256,842,560,463,341,218,110,2534,4841,9460,9460
Wallis and Futuna Islands,1972,WF,WLF,WPR,922,1455,2377,819,505,292,346,260,124,2346,882,1379,2261,838,559,466,344,232,113,2552,4898,9536,9536
Wallis and Futuna Islands,1973,WF,WLF,WPR,921,1467,2388,824,519,305,334,276,133,2391,876,1387,2263,840,548,467,344,244,119,2562,4953,9610,9610
Wallis and Futuna Islands,1974,WF,WLF,WPR,912,1479,2391,841,518,323,318,290,144,2434,869,1387,2256,851,537,474,344,259,130,2595,5029,9676,9676
Wallis and Futuna Islands,1975,WF,WLF,WPR,899,1483,2382,873,510,344,293,307,154,2481,855,1390,2245,860,528,480,335,270,141,2614,5095,9723,9723
Wallis and Futuna Islands,1976,WF,WLF,WPR,890,1507,2397,913,517,362,276,326,163,2557,843,1411,2254,881,534,483,342,276,151,2667,5224,9868,9868
Wallis and Futuna Islands,1977,WF,WLF,WPR,883,1563,2446,957,551,376,271,337,172,2664,841,1460,2301,915,556,486,361,279,154,2751,5415,10169,10169
Wallis and Futuna Islands,1978,WF,WLF,WPR,887,1630,2517,992,589,396,275,339,190,2781,850,1521,2371,949,585,487,385,283,167,2856,5637,10528,10528
Wallis and Futuna Islands,1979,WF,WLF,WPR,903,1698,2601,1016,620,428,275,339,205,2883,871,1580,2451,986,616,485,411,287,180,2965,5848,10909,10909
Wallis and Futuna Islands,1980,WF,WLF,WPR,933,1763,2696,1047,650,471,278,340,224,3010,901,1638,2539,1026,642,484,431,296,194,3073,6083,11315,11315
Wallis and Futuna Islands,1981,WF,WLF,WPR,972,1819,2791,1083,679,515,282,335,241,3135,938,1693,2631,1068,663,484,447,308,212,3182,6317,11743,11743
Wallis and Futuna Islands,1982,WF,WLF,WPR,1014,1872,2886,1128,713,552,293,331,262,3279,975,1750,2725,1117,690,482,466,328,231,3314,6593,12194,12194
Wallis and Futuna Islands,1983,WF,WLF,WPR,1037,1875,2912,1182,734,582,306,322,283,3409,985,1778,2763,1164,717,488,476,342,241,3428,6837,12511,12511
Wallis and Futuna Islands,1984,WF,WLF,WPR,1031,1834,2865,1242,754,600,327,308,293,3524,971,1776,2747,1204,743,513,477,349,250,3536,7060,12665,12665
Wallis and Futuna Islands,1985,WF,WLF,WPR,1014,1802,2816,1288,771,614,348,292,299,3612,945,1765,2710,1243,773,541,478,356,257,3648,7260,12794,12794
Wallis and Futuna Islands,1986,WF,WLF,WPR,995,1784,2779,1322,791,630,372,280,312,3707,922,1761,2683,1275,801,568,479,357,267,3747,7454,12919,12919
Wallis and Futuna Islands,1987,WF,WLF,WPR,966,1777,2743,1351,806,645,403,265,317,3787,899,1761,2660,1302,830,592,479,367,281,3851,7638,13046,13046
Wallis and Futuna Islands,1988,WF,WLF,WPR,944,1784,2728,1353,820,665,431,266,320,3855,882,1768,2650,1323,863,616,472,379,293,3946,7801,13175,13175
Wallis and Futuna Islands,1989,WF,WLF,WPR,927,1799,2726,1341,832,690,459,268,326,3916,873,1772,2645,1338,890,641,467,389,305,4030,7946,13312,13312
Wallis and Futuna Islands,1990,WF,WLF,WPR,918,1828,2746,1320,834,707,498,267,333,3959,870,1777,2647,1355,911,654,476,394,319,4109,8068,13454,13454
Wallis and Futuna Islands,1991,WF,WLF,WPR,907,1865,2772,1293,840,714,541,270,334,3992,867,1790,2657,1362,931,661,491,397,337,4179,8171,13598,13598
Wallis and Futuna Islands,1992,WF,WLF,WPR,897,1904,2801,1266,840,718,580,280,336,4020,866,1797,2663,1371,954,676,500,401,358,4260,8280,13748,13748
Wallis and Futuna Islands,1993,WF,WLF,WPR,899,1936,2835,1249,837,722,610,304,338,4060,870,1795,2665,1381,970,701,512,406,379,4349,8409,13900,13900
Wallis and Futuna Islands,1994,WF,WLF,WPR,898,1944,2842,1255,827,731,631,332,337,4113,872,1780,2652,1398,978,731,531,415,387,4440,8553,14046,14046
Wallis and Futuna Islands,1995,WF,WLF,WPR,891,1949,2840,1284,807,738,647,364,334,4174,859,1772,2631,1425,974,761,548,427,400,4535,8709,14180,14180
Wallis and Futuna Islands,1996,WF,WLF,WPR,879,1937,2816,1326,798,739,662,394,338,4257,827,1772,2599,1454,964,786,567,439,413,4623,8880,14291,14291
Wallis and Futuna Islands,1997,WF,WLF,WPR,851,1909,2760,1373,816,744,682,417,336,4368,788,1769,2557,1468,983,799,592,443,424,4709,9077,14390,14390
Wallis and Futuna Islands,1998,WF,WLF,WPR,822,1879,2701,1402,854,749,701,432,340,4478,751,1757,2508,1466,1018,811,629,433,446,4803,9281,14490,14490
Wallis and Futuna Islands,1999,WF,WLF,WPR,801,1860,2661,1416,895,744,732,452,351,4590,724,1754,2478,1445,1052,829,660,434,456,4876,9466,14601,14601
Wallis and Futuna Islands,2000,WF,WLF,WPR,793,1842,2635,1425,935,733,756,480,359,4688,712,1751,2463,1408,1094,850,673,451,462,4938,9626,14723,14723
Wallis and Futuna Islands,2001,WF,WLF,WPR,793,1824,2617,1424,981,738,756,519,367,4785,712,1734,2446,1382,1130,866,678,473,475,5004,9789,14852,14852
Wallis and Futuna Islands,2002,WF,WLF,WPR,795,1809,2604,1421,1021,749,751,565,376,4883,717,1708,2425,1365,1150,890,683,491,498,5077,9960,14988,14988
Wallis and Futuna Islands,2003,WF,WLF,WPR,787,1788,2575,1414,1032,761,753,597,391,4948,704,1664,2368,1349,1152,912,706,502,513,5134,10082,15031,15031
Wallis and Futuna Islands,2004,WF,WLF,WPR,752,1748,2500,1367,1014,765,758,609,420,4933,668,1611,2279,1309,1129,933,727,511,531,5140,10073,14853,14853
Wallis and Futuna Islands,2005,WF,WLF,WPR,705,1710,2415,1285,984,769,755,619,434,4846,626,1566,2192,1249,1098,943,743,517,543,5093,9939,14553,14553
Wallis and Futuna Islands,2006,WF,WLF,WPR,670,1676,2346,1204,938,785,753,636,443,4759,595,1515,2110,1188,1069,953,760,534,550,5054,9813,14260,14260
Wallis and Futuna Islands,2007,WF,WLF,WPR,646,1636,2282,1136,869,801,742,654,452,4654,577,1449,2026,1137,1024,966,766,559,545,4997,9651,13964,13964
Wallis and Futuna Islands,2008,WF,WLF,WPR,613,1591,2204,1089,801,810,733,674,465,4572,562,1375,1937,1103,972,984,773,580,544,4956,9528,13665,13665
Wallis and Futuna Islands,2009,WF,WLF,WPR,571,1534,2105,1050,749,821,714,691,483,4508,531,1321,1852,1083,926,984,789,593,551,4926,9434,13392,13392
Wallis and Futuna Islands,2010,WF,WLF,WPR,536,1475,2011,1006,713,839,696,699,506,4459,501,1288,1789,1056,878,996,800,588,568,4886,9345,13142,13142
Wallis and Futuna Islands,2011,WF,WLF,WPR,519,1419,1938,955,665,861,685,688,529,4383,486,1263,1749,1008,835,1009,809,575,597,4833,9216,12900,12900
Wallis and Futuna Islands,2012,WF,WLF,WPR,513,1359,1872,910,629,867,680,676,554,4316,486,1234,1720,952,798,1010,821,574,606,4761,9077,12671,12671
Wallis and Futuna Islands,2013,WF,WLF,WPR,504,1297,1801,882,598,855,674,671,579,4259,489,1204,1693,912,765,992,834,588,627,4718,8977,12464,12464
Wallis and Futuna Islands,2014,WF,WLF,WPR,487,1240,1727,875,580,840,683,663,596,4237,480,1160,1640,898,740,971,844,609,639,4701,8938,12307,12307
Wallis and Futuna Islands,2015,WF,WLF,WPR,468,1197,1665,870,565,825,699,655,626,4240,459,1125,1584,884,722,966,846,626,654,4698,8938,12182,12182
Wallis and Futuna Islands,2016,WF,WLF,WPR,456,1165,1621,855,551,808,717,646,640,4217,439,1099,1538,859,709,959,844,639,679,4689,8906,12060,12060
Wallis and Futuna Islands,2017,WF,WLF,WPR,446,1134,1580,826,548,779,736,647,652,4188,421,1079,1500,830,703,928,860,649,695,4665,8853,11936,11936
Wallis and Futuna Islands,2018,WF,WLF,WPR,433,1102,1535,812,541,751,749,643,669,4165,405,1047,1452,819,695,901,875,658,712,4660,8825,11816,11816
Wallis and Futuna Islands,2019,WF,WLF,WPR,421,1067,1488,801,541,726,762,628,696,4154,389,1014,1403,811,689,876,882,675,731,4664,8818,11714,11714
Wallis and Futuna Islands,2020,WF,WLF,WPR,405,1036,1441,805,539,698,788,613,724,4167,376,976,1352,813,689,842,902,687,748,4681,8848,11655,11655
Wallis and Futuna Islands,2021,WF,WLF,WPR,388,1013,1401,824,535,664,817,612,741,4193,364,947,1311,826,685,811,931,699,771,4723,8916,11627,11627
Wallis and Futuna Islands,2022,WF,WLF,WPR,371,985,1356,843,524,631,834,604,755,4191,348,922,1270,842,669,787,942,721,791,4752,8943,11572,11572
Wallis and Futuna Islands,2023,WF,WLF,WPR,355,953,1308,880,495,601,823,601,787,4187,333,897,1230,870,635,761,936,745,829,4776,8963,11502,11502
Wallis and Futuna Islands,2024,WF,WLF,WPR,342,919,1261,913,472,569,807,612,810,4183,324,869,1193,900,611,734,926,764,867,4802,8985,11439,11439
Wallis and Futuna Islands,2025,WF,WLF,WPR,336,883,1219,938,463,531,791,631,832,4186,316,837,1153,922,590,706,924,778,906,4826,9012,11387,11387
Wallis and Futuna Islands,2026,WF,WLF,WPR,329,849,1178,953,464,506,768,653,845,4189,312,800,1112,944,588,683,920,783,946,4864,9053,11348,11348
Wallis and Futuna Islands,2027,WF,WLF,WPR,325,816,1141,964,473,482,736,674,873,4202,308,762,1070,953,591,666,898,804,982,4894,9096,11308,11308
Wallis and Futuna Islands,2028,WF,WLF,WPR,323,786,1109,964,495,457,702,688,896,4202,308,729,1037,953,613,648,870,827,1014,4925,9127,11268,11268
Wallis and Futuna Islands,2029,WF,WLF,WPR,324,757,1081,960,523,436,668,704,910,4201,306,701,1007,940,640,636,845,839,1052,4952,9153,11242,11242
Wallis and Futuna Islands,2030,WF,WLF,WPR,327,730,1057,948,560,417,635,729,928,4217,309,679,988,921,675,629,808,859,1079,4971,9188,11229,11229
Wallis and Futuna Islands,1950,WF,WLF,WPR,869,1285,2154,872,566,361,217,119,58,2193,816,1211,2027,818,545,355,226,131,87,2162,4355,8535,8535
Wallis and Futuna Islands,1951,WF,WLF,WPR,873,1338,2211,907,587,376,222,118,62,2272,823,1264,2087,848,570,368,233,134,89,2242,4514,8810,8810
Wallis and Futuna Islands,1952,WF,WLF,WPR,878,1412,2290,959,613,388,227,117,63,2367,834,1333,2167,901,595,380,237,139,90,2342,4709,9169,9169
Wallis and Futuna Islands,1953,WF,WLF,WPR,886,1485,2371,1010,642,400,231,113,62,2458,846,1402,2248,953,620,394,242,142,90,2441,4899,9528,9528
Wallis and Futuna Islands,1954,WF,WLF,WPR,903,1498,2401,1013,666,414,243,122,70,2528,865,1414,2279,955,629,405,248,149,97,2483,5011,9693,9693
Wallis and Futuna Islands,1955,WF,WLF,WPR,930,1454,2384,966,674,428,253,139,84,2544,887,1356,2243,907,620,403,249,159,108,2446,4990,9616,9616
Wallis and Futuna Islands,1956,WF,WLF,WPR,948,1405,2353,919,668,445,260,157,96,2545,905,1296,2201,849,608,402,251,173,116,2399,4944,9504,9504
Wallis and Futuna Islands,1957,WF,WLF,WPR,954,1357,2311,868,658,470,267,178,110,2551,914,1238,2152,790,589,405,249,185,124,2342,4893,9361,9361
Wallis and Futuna Islands,1958,WF,WLF,WPR,948,1317,2265,823,634,487,268,201,124,2537,904,1195,2099,735,561,415,246,195,138,2290,4827,9185,9185
Wallis and Futuna Islands,1959,WF,WLF,WPR,920,1286,2206,781,604,515,269,226,134,2529,880,1161,2041,675,528,422,244,204,148,2221,4750,8995,8995
Wallis and Futuna Islands,1960,WF,WLF,WPR,885,1261,2146,736,565,545,273,248,144,2511,845,1137,1982,618,483,431,239,208,155,2134,4645,8780,8780
Wallis and Futuna Islands,1961,WF,WLF,WPR,842,1241,2083,692,518,566,275,268,157,2476,805,1110,1915,565,431,437,234,210,170,2047,4523,8533,8533
Wallis and Futuna Islands,1962,WF,WLF,WPR,804,1257,2061,694,477,588,279,276,163,2477,768,1137,1905,554,397,447,237,208,180,2023,4500,8473,8473
Wallis and Futuna Islands,1963,WF,WLF,WPR,771,1318,2089,746,451,608,283,274,161,2523,736,1211,1947,596,375,457,247,204,184,2063,4586,8621,8621
Wallis and Futuna Islands,1964,WF,WLF,WPR,744,1384,2128,789,431,618,298,268,163,2567,711,1288,1999,634,360,465,255,196,183,2093,4660,8785,8785
Wallis and Futuna Islands,1965,WF,WLF,WPR,748,1413,2161,807,416,588,318,253,160,2542,711,1332,2043,670,377,458,273,187,177,2142,4684,8887,8887
Wallis and Futuna Islands,1966,WF,WLF,WPR,790,1390,2180,807,404,516,340,234,150,2451,750,1334,2084,714,420,453,296,177,164,2224,4675,8944,8944
Wallis and Futuna Islands,1967,WF,WLF,WPR,847,1367,2214,814,403,441,353,220,133,2364,804,1331,2135,761,469,450,317,173,146,2316,4680,9032,9032
Wallis and Futuna Islands,1968,WF,WLF,WPR,906,1359,2265,826,413,364,351,213,117,2284,861,1335,2196,810,517,454,331,175,113,2400,4684,9148,9148
Wallis and Futuna Islands,1969,WF,WLF,WPR,933,1379,2312,830,430,315,346,218,109,2248,888,1349,2237,843,549,461,341,185,100,2479,4727,9273,9273
Wallis and Futuna Islands,2031,WF,WLF,WPR,330,706,1036,934,605,398,594,756,936,4223,314,659,973,901,704,618,771,887,1107,4988,9211,11220,11220
Wallis and Futuna Islands,2032,WF,WLF,WPR,335,684,1019,917,651,384,561,769,946,4228,318,640,958,881,736,598,746,898,1148,5007,9235,11219,11219
Wallis and Futuna Islands,2033,WF,WLF,WPR,340,667,1007,895,710,372,541,763,965,4246,324,627,951,860,778,575,723,891,1189,5016,9262,11222,11222
Wallis and Futuna Islands,2034,WF,WLF,WPR,346,658,1004,866,761,364,512,749,992,4244,328,620,948,839,817,554,699,885,1238,5032,9276,11227,11227
Wallis and Futuna Islands,2035,WF,WLF,WPR,352,651,1003,835,800,365,480,736,1022,4238,333,616,949,810,850,544,678,885,1276,5043,9281,11232,11232
Wallis and Futuna Islands,2036,WF,WLF,WPR,357,650,1007,807,833,377,460,720,1046,4243,338,615,953,772,876,542,656,883,1311,5040,9283,11245,11245
Wallis and Futuna Islands,2037,WF,WLF,WPR,362,652,1014,776,857,397,444,687,1084,4245,342,617,959,736,895,553,640,860,1358,5042,9287,11262,11262
Wallis and Futuna Islands,2038,WF,WLF,WPR,365,657,1022,750,869,426,420,661,1119,4245,346,621,967,708,900,578,626,833,1403,5048,9293,11281,11281
Wallis and Futuna Islands,2039,WF,WLF,WPR,367,665,1032,728,873,463,401,633,1143,4241,348,629,977,686,895,608,616,810,1438,5053,9294,11300,11300
Wallis and Futuna Islands,2040,WF,WLF,WPR,369,673,1042,705,872,508,386,598,1174,4243,349,637,986,665,880,645,610,778,1477,5055,9298,11319,11319
Wallis and Futuna Islands,2041,WF,WLF,WPR,369,683,1052,680,865,557,372,562,1202,4238,350,646,996,646,864,678,601,745,1518,5052,9290,11336,11336
Wallis and Futuna Islands,2042,WF,WLF,WPR,367,692,1059,660,856,609,363,532,1220,4240,347,656,1003,629,848,714,583,720,1553,5047,9287,11346,11346
Wallis and Futuna Islands,2043,WF,WLF,WPR,365,700,1065,648,838,668,350,511,1223,4238,345,665,1010,617,831,755,561,696,1584,5044,9282,11355,11355
Wallis and Futuna Islands,2044,WF,WLF,WPR,361,710,1071,638,817,726,343,486,1231,4241,341,673,1014,611,809,797,539,674,1603,5033,9274,11368,11368
Wallis and Futuna Islands,2045,WF,WLF,WPR,356,718,1074,634,793,771,347,460,1247,4252,337,681,1018,606,784,832,531,654,1633,5040,9292,11377,11377
Wallis and Futuna Islands,2046,WF,WLF,WPR,350,722,1072,635,767,802,361,438,1255,4258,332,685,1017,607,752,861,529,637,1653,5039,9297,11381,11381
Wallis and Futuna Islands,2047,WF,WLF,WPR,343,724,1067,640,741,829,380,421,1247,4258,326,688,1014,609,717,881,542,624,1669,5042,9300,11383,11383
Wallis and Futuna Islands,2048,WF,WLF,WPR,336,725,1061,645,717,844,411,403,1251,4271,319,690,1009,615,688,884,568,607,1669,5031,9302,11375,11375
Wallis and Futuna Islands,2049,WF,WLF,WPR,327,724,1051,652,694,850,449,388,1247,4280,312,688,1000,621,667,878,599,593,1668,5026,9306,11361,11361
Wallis and Futuna Islands,2050,WF,WLF,WPR,321,719,1040,660,674,850,494,375,1239,4292,305,684,989,629,648,864,634,589,1665,5029,9321,11349,11349
Samoa,1970,WS,WSM,WPR,13840,24640,38480,14423,7059,5666,4108,2298,1787,35341,12860,22424,35284,12762,7012,5870,3729,2151,2140,33664,69005,142771,142771
Samoa,1971,WS,WSM,WPR,13916,24891,38807,15026,7082,5638,4233,2385,1820,36184,12932,22680,35612,13320,6961,5927,3865,2224,2164,34461,70645,145064,145064
Samoa,1972,WS,WSM,WPR,13986,25088,39074,15633,7115,5621,4359,2481,1859,37068,12992,22897,35889,13890,6928,5962,4018,2309,2185,35292,72360,147332,147332
Samoa,1973,WS,WSM,WPR,14036,25266,39302,16202,7191,5619,4490,2586,1900,37988,13031,23100,36131,14438,6942,5978,4192,2409,2209,36168,74156,149587,149587
Samoa,1974,WS,WSM,WPR,14043,25547,39590,16642,7372,5750,4656,2717,1967,39104,12968,23409,36377,14794,7116,6042,4425,2535,2255,37167,76271,152240,152240
Samoa,1975,WS,WSM,WPR,14008,25928,39936,17042,7563,6028,4851,2860,2061,40405,12819,23793,36612,15015,7405,6181,4701,2682,2331,38315,78720,155263,155263
Samoa,1976,WS,WSM,WPR,13938,26251,40189,17582,7642,6310,5025,3000,2164,41723,12701,24055,36756,15336,7619,6346,4931,2831,2417,39480,81203,158136,158136
Samoa,1977,WS,WSM,WPR,13851,26416,40267,18134,7753,6444,5133,3124,2221,42809,12643,24121,36764,15862,7740,6427,5050,2958,2483,40520,83329,160362,160362
Samoa,1978,WS,WSM,WPR,13774,26470,40244,18601,7975,6432,5191,3240,2243,43682,12596,24078,36674,16457,7850,6416,5085,3068,2510,41386,85068,161988,161988
Samoa,1979,WS,WSM,WPR,13688,26505,40193,19012,8233,6413,5221,3359,2263,44501,12528,24031,36559,16987,8005,6404,5113,3180,2548,42237,86738,163489,163489
Samoa,1980,WS,WSM,WPR,13612,26502,40114,19399,8515,6384,5232,3490,2290,45310,12479,23968,36447,17451,8200,6390,5140,3275,2583,43039,88349,164905,164905
Samoa,1981,WS,WSM,WPR,13536,26443,39979,19795,8810,6342,5228,3620,2317,46112,12442,23850,36292,17860,8431,6372,5158,3366,2618,43805,89917,166190,166190
Samoa,1982,WS,WSM,WPR,13404,26229,39633,20112,9210,6316,5237,3749,2381,47005,12315,23470,35785,18098,8752,6349,5158,3440,2661,44458,91463,166885,166885
Samoa,1983,WS,WSM,WPR,13227,25854,39081,20327,9697,6307,5268,3858,2478,47935,12106,22861,34967,18139,9141,6329,5151,3500,2703,44963,92898,166944,166944
Samoa,1984,WS,WSM,WPR,13065,25389,38454,20529,10156,6302,5310,3947,2576,48820,11941,22213,34154,18092,9513,6315,5152,3551,2723,45346,94166,166779,166779
Samoa,1985,WS,WSM,WPR,12958,24844,37802,20749,10555,6319,5349,4006,2683,49661,11895,21528,33423,17990,9827,6322,5164,3589,2737,45629,95290,166517,166517
Samoa,1986,WS,WSM,WPR,12946,24264,37210,20980,10879,6364,5374,4048,2794,50439,12012,20871,32883,17870,10066,6353,5178,3619,2746,45832,96271,166365,166365
Samoa,1987,WS,WSM,WPR,12997,23877,36874,21075,11217,6435,5373,4078,2879,51057,12127,20589,32716,17736,10300,6408,5193,3685,2804,46126,97183,166773,166773
Samoa,1988,WS,WSM,WPR,12991,23716,36707,21001,11585,6537,5347,4083,2937,51490,12075,20686,32761,17553,10559,6484,5206,3769,2921,46492,97982,167452,167452
Samoa,1989,WS,WSM,WPR,12896,23605,36501,20892,11905,6674,5316,4057,3017,51861,11918,20824,32742,17338,10777,6594,5213,3809,3052,46783,98644,167886,167886
Samoa,1990,WS,WSM,WPR,12788,23478,36266,20805,12153,6849,5272,4011,3104,52194,11761,20913,32674,17165,10933,6732,5211,3826,3196,47063,99257,168186,168186
Samoa,1991,WS,WSM,WPR,12778,23342,36120,20716,12380,7063,5224,3967,3180,52530,11722,20950,32672,17050,11054,6898,5200,3836,3340,47378,99908,168701,168701
Samoa,1992,WS,WSM,WPR,12974,23183,36157,20615,12631,7314,5204,3952,3258,52974,11928,20881,32809,17044,11201,7093,5201,3855,3470,47864,100838,169799,169799
Samoa,1993,WS,WSM,WPR,13304,23037,36341,20509,12880,7598,5219,3967,3323,53496,12294,20754,33048,17133,11358,7321,5210,3879,3577,48478,101974,171362,171362
Samoa,1994,WS,WSM,WPR,13651,22984,36635,20351,13129,7898,5251,3997,3378,54004,12661,20715,33376,17201,11496,7569,5229,3917,3680,49092,103096,173107,173107
Samoa,1995,WS,WSM,WPR,13978,23039,37017,20125,13363,8214,5301,4035,3423,54461,12999,20767,33766,17216,11625,7827,5249,3960,3783,49660,104121,174902,174902
Samoa,1996,WS,WSM,WPR,14210,23242,37452,19840,13587,8533,5373,4070,3465,54868,13231,20973,34204,17172,11748,8095,5293,4005,3878,50191,105059,176713,176713
Samoa,1997,WS,WSM,WPR,14355,23568,37923,19500,13810,8846,5477,4097,3509,55239,13371,21315,34686,17051,11891,8362,5365,4047,3977,50693,105932,178543,178543
Samoa,1998,WS,WSM,WPR,14461,23948,38409,19135,14030,9153,5610,4125,3559,55612,13473,21717,35190,16867,12059,8628,5465,4087,4064,51170,106782,180385,180385
Samoa,1999,WS,WSM,WPR,14519,24387,38906,18762,14225,9458,5774,4144,3614,55977,13525,22179,35704,16641,12228,8889,5593,4123,4153,51627,107604,182211,182211
Samoa,2000,WS,WSM,WPR,14534,24851,39385,18406,14375,9750,5965,4162,3672,56330,13535,22670,36205,16407,12394,9139,5743,4156,4240,52079,108409,184008,184008
Samoa,2001,WS,WSM,WPR,14516,25308,39824,18054,14428,10029,6185,4175,3731,56602,13510,23148,36658,16144,12529,9355,5914,4177,4329,52448,109050,185530,185530
Samoa,2002,WS,WSM,WPR,14381,25624,40005,17765,14416,10268,6447,4189,3790,56875,13390,23533,36923,15906,12629,9533,6135,4195,4435,52833,109708,186630,186630
Samoa,2003,WS,WSM,WPR,14159,25778,39937,17569,14373,10479,6727,4222,3848,57218,13202,23807,37009,15728,12710,9672,6400,4213,4553,53276,110494,187440,187440
Samoa,2004,WS,WSM,WPR,13969,25842,39811,17412,14264,10676,7011,4271,3896,57530,13035,23984,37019,15587,12774,9778,6667,4231,4674,53711,111241,188073,188073
Samoa,2005,WS,WSM,WPR,13814,25806,39620,17325,14105,10856,7297,4340,3950,57873,12897,24055,36952,15525,12814,9853,6937,4261,4793,54183,112056,188626,188626
Samoa,2006,WS,WSM,WPR,13713,25648,39361,17424,13920,11037,7576,4439,3997,58393,12805,23987,36792,15647,12839,9926,7202,4316,4903,54833,113226,189379,189379
Samoa,2007,WS,WSM,WPR,13723,25453,39176,17693,13748,11207,7804,4544,4035,59031,12814,23873,36687,15952,12843,9981,7410,4399,4995,55580,114611,190478,190478
Samoa,2008,WS,WSM,WPR,13831,25291,39122,18018,13577,11363,7984,4647,4068,59657,12912,23786,36698,16335,12811,10021,7567,4498,5074,56306,115963,191787,191787
Samoa,2009,WS,WSM,WPR,13979,25120,39099,18374,13386,11515,8165,4764,4090,60294,13047,23687,36734,16754,12735,10076,7722,4618,5139,57044,117338,193176,193176
Samoa,2010,WS,WSM,WPR,14179,24963,39142,18735,13195,11655,8342,4896,4112,60935,13227,23599,36826,17177,12636,10144,7866,4760,5185,57768,118703,194672,194672
Samoa,2011,WS,WSM,WPR,14423,24844,39267,19073,13032,11770,8516,5054,4138,61583,13456,23548,37004,17586,12538,10234,7999,4918,5231,58506,120089,196351,196351
Samoa,2012,WS,WSM,WPR,14703,24774,39477,19317,12905,11856,8704,5244,4162,62188,13694,23496,37190,17957,12472,10369,8125,5096,5248,59267,121455,198124,198124
Samoa,2013,WS,WSM,WPR,14969,24765,39734,19470,12826,11904,8909,5466,4200,62775,13912,23458,37370,18277,12444,10550,8239,5293,5256,60059,122834,199939,199939
Samoa,2014,WS,WSM,WPR,15163,24863,40026,19568,12807,11909,9105,5694,4247,63330,14076,23496,37572,18528,12466,10741,8331,5497,5269,60832,124162,201757,201757
Samoa,2015,WS,WSM,WPR,15273,25069,40342,19594,12858,11878,9290,5926,4314,63860,14171,23614,37785,18682,12564,10927,8408,5703,5300,61584,125444,203571,203571
Samoa,2016,WS,WSM,WPR,15298,25402,40700,19539,13043,11814,9475,6159,4395,64425,14197,23842,38039,18723,12795,11095,8486,5916,5355,62370,126795,205544,205544
Samoa,2017,WS,WSM,WPR,15265,25826,41091,19434,13326,11708,9677,6385,4501,65031,14168,24151,38319,18687,13136,11218,8584,6124,5444,63193,128224,207630,207630
Samoa,2018,WS,WSM,WPR,15210,26253,41463,19332,13631,11561,9880,6604,4629,65637,14121,24473,38594,18636,13511,11271,8709,6335,5550,64012,129649,209701,209701
Samoa,2019,WS,WSM,WPR,15154,26667,41821,19282,13968,11405,10080,6821,4764,66320,14073,24794,38867,18614,13929,11277,8855,6540,5680,64895,131215,211905,211905
Samoa,2020,WS,WSM,WPR,15124,27148,42272,19440,14384,11277,10278,7044,4935,67358,14054,25186,39240,18748,14401,11282,9034,6754,5843,66062,133420,214929,214929
Samoa,2021,WS,WSM,WPR,15128,27681,42809,19815,14854,11210,10460,7268,5136,68743,14070,25638,39708,19049,14909,11304,9242,6961,6045,67510,136253,218764,218764
Samoa,2022,WS,WSM,WPR,15138,28219,43357,20231,15219,11158,10583,7486,5343,70020,14090,26105,40195,19349,15319,11287,9451,7144,6260,68810,138830,222382,222382
Samoa,2023,WS,WSM,WPR,15143,28718,43861,20701,15476,11126,10646,7687,5557,71193,14106,26560,40666,19662,15596,11253,9653,7300,6491,69955,141148,225681,225681
Samoa,2024,WS,WSM,WPR,15155,29109,44264,21268,15705,11142,10672,7881,5792,72460,14118,26931,41049,20077,15809,11267,9862,7434,6734,71183,143643,228966,228966
Samoa,2025,WS,WSM,WPR,15169,29392,44561,21931,15901,11228,10666,8064,6033,73823,14134,27212,41346,20589,15951,11345,10066,7550,6997,72498,146321,232231,232231
Samoa,2026,WS,WSM,WPR,15193,29577,44770,22683,16015,11427,10629,8240,6281,75275,14157,27401,41558,21191,15974,11540,10248,7657,7282,73892,149167,235495,235495
Samoa,2027,WS,WSM,WPR,15221,29683,44904,23483,16094,11708,10544,8424,6540,76793,14185,27526,41711,21854,15931,11828,10372,7783,7591,75359,152152,238761,238761
Samoa,2028,WS,WSM,WPR,15253,29751,45004,24269,16220,12006,10428,8613,6801,78337,14216,27621,41837,22510,15929,12146,10425,7927,7911,76848,155185,242024,242024
Samoa,2029,WS,WSM,WPR,15307,29796,45103,25000,16411,12329,10294,8794,7065,79893,14268,27687,41955,23127,15975,12492,10427,8087,8245,78353,158246,245308,245308
Samoa,2030,WS,WSM,WPR,15392,29825,45217,25676,16663,12663,10153,8965,7340,81460,14346,27732,42078,23700,16086,12844,10396,8257,8586,79869,161329,248627,248627
Samoa,1950,WS,WSM,WPR,9218,13139,22357,8086,5928,4039,2347,1397,1183,22980,8710,11486,20196,8401,5945,3514,2173,1354,1027,22414,45394,87951,87951
Samoa,1951,WS,WSM,WPR,9494,13444,22938,8198,6034,4117,2429,1418,1210,23406,8896,11798,20694,8480,6066,3588,2233,1390,1095,22852,46258,89907,89907
Samoa,1952,WS,WSM,WPR,9772,13735,23507,8364,6135,4197,2510,1438,1241,23885,9095,12126,21221,8567,6196,3665,2299,1430,1169,23326,47211,91942,91942
Samoa,1953,WS,WSM,WPR,10011,14036,24047,8559,6235,4270,2587,1465,1273,24389,9278,12466,21744,8662,6321,3735,2362,1469,1244,23793,48182,93972,93972
Samoa,1954,WS,WSM,WPR,10249,14320,24569,8765,6331,4341,2665,1499,1296,24897,9481,12781,22262,8768,6442,3799,2423,1514,1319,24265,49162,95999,95999
Samoa,1955,WS,WSM,WPR,10506,14584,25090,8981,6427,4413,2732,1540,1323,25416,9712,13067,22779,8893,6562,3860,2481,1565,1397,24758,50174,98037,98037
Samoa,1956,WS,WSM,WPR,10768,14928,25696,9213,6521,4493,2802,1587,1345,25961,9960,13402,23362,9043,6695,3933,2543,1614,1453,25281,51242,100301,100301
Samoa,1957,WS,WSM,WPR,11164,15453,26617,9403,6597,4579,2867,1648,1382,26476,10304,13895,24199,9158,6828,4017,2589,1678,1520,25790,52266,103087,103087
Samoa,1958,WS,WSM,WPR,11614,16162,27776,9593,6655,4678,2928,1715,1441,27010,10697,14556,25253,9257,6966,4125,2632,1739,1588,26307,53317,106345,106345
Samoa,1959,WS,WSM,WPR,11992,16972,28964,9863,6711,4794,3000,1783,1465,27616,11041,15288,26329,9419,7112,4257,2693,1795,1624,26900,54516,109811,109811
Samoa,1960,WS,WSM,WPR,12323,17837,30160,10161,6757,4908,3074,1846,1497,28243,11343,16071,27414,9618,7237,4391,2761,1853,1660,27520,55763,113335,113335
Samoa,1961,WS,WSM,WPR,12625,18729,31354,10427,6808,5003,3148,1913,1549,28848,11603,16883,28486,9833,7319,4521,2828,1904,1726,28131,56979,116820,116820
Samoa,1962,WS,WSM,WPR,12891,19612,32503,10713,6859,5110,3233,1963,1569,29447,11851,17693,29544,10007,7372,4669,2910,1939,1774,28671,58118,120163,120163
Samoa,1963,WS,WSM,WPR,13125,20438,33563,11091,6896,5236,3329,1989,1570,30111,12101,18460,30561,10186,7396,4836,3006,1957,1803,29184,59295,123416,123416
Samoa,1964,WS,WSM,WPR,13313,21219,34532,11505,6946,5358,3429,2013,1581,30832,12305,19202,31507,10402,7387,5006,3107,1965,1847,29714,60546,126582,126582
Samoa,1965,WS,WSM,WPR,13478,21991,35469,11947,7003,5472,3531,2038,1598,31589,12480,19941,32421,10674,7352,5190,3202,1977,1909,30304,61893,129789,129789
Samoa,1966,WS,WSM,WPR,13654,22724,36378,12432,7036,5573,3628,2067,1643,32379,12635,20649,33284,10994,7281,5369,3296,2000,1999,30939,63318,132976,132976
Samoa,1967,WS,WSM,WPR,13733,23365,37098,12900,7043,5646,3739,2104,1685,33117,12710,21259,33969,11353,7202,5535,3389,2022,2060,31561,64678,135752,135752
Samoa,1968,WS,WSM,WPR,13741,23883,37624,13359,7044,5691,3863,2161,1719,33837,12739,21726,34465,11770,7144,5679,3497,2050,2088,32228,66065,138154,138154
Samoa,1969,WS,WSM,WPR,13779,24303,38082,13860,7045,5692,3985,2226,1751,34559,12791,22111,34902,12234,7073,5789,3611,2092,2116,32915,67474,140457,140457
Samoa,2031,WS,WSM,WPR,15494,29852,45346,26294,16991,12981,10030,9108,7618,83022,14444,27782,42226,24235,16265,13176,10352,8444,8919,81391,164413,251982,251982
Samoa,2032,WS,WSM,WPR,15614,29883,45497,26865,17381,13263,9953,9211,7899,84572,14553,27827,42380,24735,16509,13492,10307,8634,9228,82905,167477,255362,255362
Samoa,2033,WS,WSM,WPR,15755,29921,45676,27364,17848,13520,9927,9273,8183,86115,14685,27873,42558,25191,16824,13769,10278,8832,9530,84424,170539,258775,258775
Samoa,2034,WS,WSM,WPR,15905,29990,45895,27756,18407,13746,9950,9303,8467,87629,14823,27943,42766,25562,17240,13982,10293,9035,9822,85934,173563,262233,262233
Samoa,2035,WS,WSM,WPR,16065,30090,46155,28039,19071,13937,10038,9304,8752,89141,14973,28039,43012,25844,17749,14122,10374,9232,10107,87428,176569,265731,265731
Samoa,2036,WS,WSM,WPR,16225,30217,46442,28222,19818,14054,10235,9275,9030,90634,15126,28161,43287,26033,18350,14148,10571,9408,10397,88907,179541,269262,269262
Samoa,2037,WS,WSM,WPR,16396,30364,46760,28331,20610,14131,10512,9205,9318,92107,15283,28298,43581,26160,19009,14108,10858,9534,10717,90386,182493,272837,272837
Samoa,2038,WS,WSM,WPR,16564,30541,47105,28406,21389,14262,10808,9109,9618,93592,15439,28462,43901,26253,19658,14106,11172,9593,11073,91855,185447,276442,276442
Samoa,2039,WS,WSM,WPR,16726,30749,47475,28452,22112,14450,11126,8995,9914,95049,15590,28658,44248,26322,20274,14154,11514,9596,11442,93302,188351,280077,280077
Samoa,2040,WS,WSM,WPR,16882,30992,47874,28481,22783,14703,11451,8880,10200,96498,15735,28884,44619,26372,20848,14265,11863,9575,11819,94742,191240,283738,283738
Samoa,2041,WS,WSM,WPR,17025,31260,48285,28510,23396,15028,11760,8781,10469,97944,15866,29135,45001,26421,21382,14446,12192,9537,12193,96171,194115,287404,287404
Samoa,2042,WS,WSM,WPR,17140,31549,48689,28543,23965,15417,12035,8725,10701,99386,15973,29405,45378,26468,21883,14690,12503,9500,12563,97607,196993,291054,291054
Samoa,2043,WS,WSM,WPR,17234,31857,49091,28584,24467,15877,12286,8714,10910,100838,16061,29691,45752,26518,22336,15004,12774,9481,12919,99032,199870,294704,294704
Samoa,2044,WS,WSM,WPR,17323,32175,49498,28655,24856,16435,12507,8751,11085,102289,16141,29985,46126,26589,22706,15419,12983,9503,13266,100466,202755,298373,298373
Samoa,2045,WS,WSM,WPR,17397,32491,49888,28756,25139,17088,12694,8846,11235,103758,16210,30278,46488,26687,22985,15927,13121,9591,13603,101914,205672,302043,302043
Samoa,2046,WS,WSM,WPR,17460,32797,50257,28888,25318,17823,12813,9042,11360,105244,16266,30564,46830,26806,23179,16523,13150,9790,13919,103367,208611,305699,305699
Samoa,2047,WS,WSM,WPR,17513,33081,50594,29036,25433,18610,12895,9310,11464,106748,16314,30827,47141,26947,23306,17176,13116,10075,14215,104835,211583,309327,309327
Samoa,2048,WS,WSM,WPR,17551,33345,50896,29212,25509,19379,13029,9596,11557,108282,16347,31074,47421,27114,23404,17822,13120,10386,14483,106329,214611,312927,312927
Samoa,2049,WS,WSM,WPR,17566,33598,51164,29421,25563,20097,13214,9900,11644,109839,16359,31306,47665,27308,23470,18438,13172,10719,14723,107830,217669,316493,316493
Samoa,2050,WS,WSM,WPR,17555,33829,51384,29671,25593,20763,13468,10205,11715,111415,16348,31522,47870,27538,23520,19005,13286,11060,14934,109343,220758,320016,320016
Yemen,1970,YE,YEM,EMR,646014,852397,1498411,624181,470807,327965,226812,144996,97835,1892596,626578,848018,1474596,629031,472156,333971,241154,165159,136536,1978007,3870603,6843607,6843607
Yemen,1971,YE,YEM,EMR,671005,884724,1555729,631534,481018,334580,230961,147638,99583,1925314,649481,878331,1527812,637304,483341,341218,245964,168537,138964,2015328,3940642,7024196,7024196
Yemen,1972,YE,YEM,EMR,696853,919979,1616832,639405,491780,341857,235308,150369,101501,1960220,673265,911253,1584518,645675,495068,349083,250881,172024,141534,2054265,4014485,7215835,7215835
Yemen,1973,YE,YEM,EMR,723420,957712,1681132,649685,501400,349622,239812,153195,103564,1997278,697742,946389,1644131,656261,505684,357437,255931,175621,144266,2095200,4092478,7417736,7417736
Yemen,1974,YE,YEM,EMR,750993,997410,1748403,663222,509745,357580,244506,156158,105759,2036970,723187,983234,1706421,670054,514793,365937,261125,179332,147157,2138398,4175368,7630190,7630190
Yemen,1975,YE,YEM,EMR,780448,1039360,1819808,680587,516322,365692,249395,159273,108091,2079360,750443,1022063,1772506,687118,522451,374553,266496,183163,150210,2183991,4263351,7855657,7855657
Yemen,1976,YE,YEM,EMR,811811,1083841,1895652,701371,521576,373944,254516,162499,110521,2124427,779505,1063225,1842730,706991,529212,383319,272094,187120,153447,2232183,4356610,8094985,8094985
Yemen,1977,YE,YEM,EMR,845129,1131088,1976217,723771,527282,382160,259934,165854,113091,2172092,810314,1106948,1917262,728346,536251,392044,277945,191189,156841,2282616,4454708,8348182,8348182
Yemen,1978,YE,YEM,EMR,880621,1180904,2061525,747788,533490,390448,265657,169370,115821,2222574,843112,1152945,1996057,751027,543586,400784,284029,195336,160370,2335132,4557706,8615301,8615301
Yemen,1979,YE,YEM,EMR,919802,1232751,2152553,774011,540085,399064,271595,173032,118687,2276474,879410,1200689,2080099,775737,551164,409887,290334,199599,164082,2390803,4667277,8899922,8899922
Yemen,1980,YE,YEM,EMR,962452,1287413,2249865,802936,547063,408270,277752,176864,121685,2334570,919070,1251019,2170089,802986,558932,419630,296868,204000,168000,2450416,4784986,9204938,9204938
Yemen,1981,YE,YEM,EMR,1006797,1345205,2352002,834849,554400,418363,284363,180898,124851,2397724,960515,1304323,2264838,832917,566763,430331,303841,208546,172134,2514532,4912256,9529105,9529105
Yemen,1982,YE,YEM,EMR,1052661,1405950,2458611,869921,562448,429055,291609,185098,128129,2466260,1003746,1360351,2364097,865663,574967,441676,311429,213196,176391,2583322,5049582,9872292,9872292
Yemen,1983,YE,YEM,EMR,1100580,1470058,2570638,907768,573198,438951,299442,189503,131556,2540418,1049475,1419483,2468958,900963,585705,452187,319589,218030,180908,2657382,5197800,10237391,10237391
Yemen,1984,YE,YEM,EMR,1148960,1539319,2688279,948010,587589,447953,307623,194163,135206,2620544,1096167,1483486,2579653,938493,600153,461607,328070,223131,185760,2737214,5357758,10625687,10625687
Yemen,1985,YE,YEM,EMR,1196886,1614048,2810934,991000,606383,455702,316151,199095,139087,2707418,1142755,1552748,2695503,978518,618493,469996,336807,228443,190807,2823064,5530482,11036918,11036918
Yemen,1986,YE,YEM,EMR,1245682,1692592,2938274,1035212,627506,461698,324483,203995,142875,2795769,1190261,1625933,2816194,1021283,640284,477832,345779,233983,196040,2915201,5710970,11465444,11465444
Yemen,1987,YE,YEM,EMR,1294726,1774967,3069693,1082626,650789,468520,332977,209233,146848,2890993,1238062,1703087,2941149,1066841,664265,486401,354904,239833,201488,3013732,5904725,11915563,11915563
Yemen,1988,YE,YEM,EMR,1343475,1861558,3205033,1133893,677024,476737,342084,215061,151233,2996032,1285456,1784645,3070101,1113973,689407,495424,364186,245962,207121,3116073,6112105,12387238,12387238
Yemen,1989,YE,YEM,EMR,1391799,1951777,3343576,1186481,704945,485244,351484,221072,155744,3104970,1331914,1870183,3202097,1162046,716076,504630,373800,252281,212883,3221716,6326686,12872362,12872362
Yemen,1990,YE,YEM,EMR,1439582,2044655,3484237,1241872,735631,494273,361500,227300,160446,3221022,1377240,1958834,3336074,1212674,745321,514168,384072,258801,218756,3333792,6554814,13375121,13375121
Yemen,1991,YE,YEM,EMR,1486857,2139762,3626619,1300256,769145,503581,372286,233866,165290,3344424,1421628,2050166,3471794,1266271,777133,523802,395272,265725,224815,3453018,6797442,13895851,13895851
Yemen,1992,YE,YEM,EMR,1533708,2236483,3770191,1361530,805632,513449,383574,240946,170270,3475401,1465250,2143479,3608729,1322709,811589,533782,407109,273223,231041,3579453,7054854,14433771,14433771
Yemen,1993,YE,YEM,EMR,1579513,2334905,3914418,1425999,844635,525694,394040,248498,175455,3614321,1507839,2238508,3746347,1382111,848185,545996,418063,281172,237431,3712958,7327279,14988047,14988047
Yemen,1994,YE,YEM,EMR,1622340,2433082,4055422,1495049,885372,540907,403385,256180,180760,3761653,1547956,2333154,3881110,1446096,886463,561395,427762,289283,243987,3854986,7616639,15553171,15553171
Yemen,1995,YE,YEM,EMR,1659084,2529340,4188424,1566316,924925,558095,410539,263693,185972,3909540,1582462,2425788,4008250,1511956,923227,578489,435638,297280,250536,3997126,7906666,16103339,16103339
Yemen,1996,YE,YEM,EMR,1681890,2624656,4306546,1637345,962026,576094,415578,270940,191054,4053037,1603642,2517253,4120895,1577086,956925,595953,441828,305048,256997,4133837,8186874,16614326,16614326
Yemen,1997,YE,YEM,EMR,1693043,2719140,4412183,1711306,999678,594662,420677,278023,196293,4200639,1613628,2607678,4221306,1645310,990845,613971,448051,312706,263670,4274553,8475192,17108681,17108681
Yemen,1998,YE,YEM,EMR,1699877,2812143,4512020,1790138,1039020,614374,426182,285157,201787,4356658,1619388,2696441,4315829,1718790,1026114,632999,454610,320458,270653,4423624,8780282,17608133,17608133
Yemen,1999,YE,YEM,EMR,1706080,2901739,4607819,1873251,1079486,635613,431936,292529,207478,4520293,1624407,2781687,4406094,1797008,1062120,653439,461350,328529,277900,4580346,9100639,18114552,18114552
Yemen,2000,YE,YEM,EMR,1714944,2985273,4700217,1959469,1121741,658617,437813,300308,213375,4691323,1631832,2860688,4492520,1878897,1099591,675486,468079,337124,285461,4744638,9435961,18628700,18628700
Yemen,2001,YE,YEM,EMR,1730315,3055637,4785952,2048266,1165995,683371,443579,308669,219600,4869480,1645408,2926587,4571995,1963809,1138852,698973,474492,346458,293445,4916029,9785509,19143457,19143457
Yemen,2002,YE,YEM,EMR,1752026,3114397,4866423,2138977,1212258,709959,449460,317380,226293,5054327,1664971,2980961,4645932,2050994,1179925,723932,480802,356270,302041,5093964,10148291,19660653,19660653
Yemen,2003,YE,YEM,EMR,1777811,3167577,4945388,2231616,1261076,737935,457067,325185,233372,5246251,1688677,3029901,4718578,2140248,1223277,749928,488792,365164,311169,5278578,10524829,20188799,20188799
Yemen,2004,YE,YEM,EMR,1807148,3217212,5024360,2324845,1314880,767067,467153,331930,240694,5446569,1716426,3075584,4792010,2229946,1271240,776663,499356,372742,320521,5470468,10917037,20733406,20733406
Yemen,2005,YE,YEM,EMR,1839473,3264904,5104377,2421424,1378774,799766,481162,337644,248591,5667361,1747699,3119338,4867037,2323254,1329174,806403,513377,379361,330323,5681892,11349253,21320671,21320671
Yemen,2006,YE,YEM,EMR,1879807,3307768,5187575,2523690,1453582,837427,499228,342865,257180,5913972,1786988,3158513,4945501,2422713,1398399,840623,530897,385735,340883,5919250,11833222,21966298,21966298
Yemen,2007,YE,YEM,EMR,1925414,3346367,5271781,2626562,1535453,878425,519099,348707,266092,6174338,1831397,3193601,5024998,2522770,1475133,877848,550147,392652,351864,6170414,12344752,22641538,22641538
Yemen,2008,YE,YEM,EMR,1970335,3384792,5355127,2726890,1622833,921648,540351,355091,275272,6442085,1874949,3228605,5103554,2619875,1557764,916910,570586,399977,363122,6428234,12870319,23329004,23329004
Yemen,2009,YE,YEM,EMR,2013682,3426292,5439974,2822785,1715257,966757,563417,361872,284751,6714839,1916562,3266986,5183548,2712388,1646111,957512,592732,407620,374870,6691233,13406072,24029589,24029589
Yemen,2010,YE,YEM,EMR,2056071,3472794,5528865,2911702,1811742,1014646,588581,368910,294552,6990133,1956874,3310648,5267522,2797790,1739390,1000699,616894,415439,387211,6957423,13947556,24743946,24743946
Yemen,2011,YE,YEM,EMR,2096832,3532780,5629612,2987017,1912086,1065954,616077,376176,305070,7262380,1995477,3367537,5363014,2869549,1837211,1047161,643068,423208,400408,7220605,14482985,25475610,25475610
Yemen,2012,YE,YEM,EMR,2136831,3603984,5740815,3050164,2015246,1120750,646035,383889,316210,7532294,2033556,3435259,5468815,2929153,1938507,1097008,671342,431144,414314,7481468,15013762,26223391,26223391
Yemen,2013,YE,YEM,EMR,2177436,3678449,5855885,3106936,2120569,1179348,677949,393328,326786,7804916,2072548,3506195,5578743,2982238,2042162,1150471,701229,440787,427570,7744457,15549373,26984002,26984002
Yemen,2014,YE,YEM,EMR,2218567,3754484,5973051,3158861,2225200,1243220,711196,404975,336414,8079866,2112174,3578794,5690968,3030600,2145120,1209055,732155,452868,439622,8009420,16089286,27753304,27753304
Yemen,2015,YE,YEM,EMR,2258487,3831007,6089494,3204584,2324803,1311691,745368,418850,344362,8349658,2150607,3652108,5802715,3074589,2245241,1273218,764134,467281,450216,8274679,16624337,28516545,28516545
Yemen,2016,YE,YEM,EMR,2294533,3911988,6206521,3242395,2420777,1383678,780904,434762,351123,8613639,2185253,3729935,5915188,3111926,2343531,1342063,797557,483681,459901,8538659,17152298,29274002,29274002
Yemen,2017,YE,YEM,EMR,2325927,3996782,6322709,3276224,2514697,1460258,818549,451836,358222,8879786,2215246,3811709,6026955,3144836,2439946,1416176,832905,501248,469833,8804944,17684730,30034389,30034389
Yemen,2018,YE,YEM,EMR,2353494,4080981,6434475,3308289,2602901,1540660,857561,469682,365391,9144484,2241298,3893037,6134335,3177838,2533445,1496112,869962,519833,480030,9077220,18221704,30790513,30790513
Yemen,2019,YE,YEM,EMR,2377672,4163440,6541112,3343355,2684841,1624816,897825,488840,372788,9412465,2263995,3972387,6236382,3214326,2622150,1581449,908361,539882,490564,9356732,18769197,31546691,31546691
Yemen,2020,YE,YEM,EMR,2398636,4243428,6642064,3383263,2757998,1711117,939600,508737,378195,9678910,2283608,4048932,6332540,3252761,2699840,1669514,948156,560845,499410,9630526,19309436,32284046,32284046
Yemen,2021,YE,YEM,EMR,2415050,4317115,6732165,3433586,2812989,1797464,982424,528886,380914,9936263,2299010,4119301,6418311,3300031,2758301,1758819,989436,582337,505972,9894896,19831159,32981641,32981641
Yemen,2022,YE,YEM,EMR,2427767,4385412,6813179,3499636,2859642,1887064,1028575,551010,384097,10210024,2311337,4184719,6496056,3363359,2808371,1852604,1034292,605745,512988,10177359,20387383,33696614,33696614
Yemen,2023,YE,YEM,EMR,2438422,4451367,6889789,3574589,2905840,1980769,1079510,575829,390130,10506667,2322021,4248010,6570031,3436171,2858014,1951222,1083860,631502,522568,10483337,20990004,34449825,34449825
Yemen,2024,YE,YEM,EMR,2448479,4514818,6963297,3651392,2948857,2074358,1136404,603324,400631,10814966,2332197,4308812,6641009,3510974,2904487,2050162,1139279,659384,536288,10800574,21615540,35219853,35219853
Yemen,2025,YE,YEM,EMR,2457588,4574853,7032441,3729513,2990407,2166397,1199460,633073,414143,11132993,2341566,4366322,6707888,3587018,2948787,2147937,1201136,689183,553060,11127121,22260114,36000452,36000452
Yemen,2026,YE,YEM,EMR,2466813,4628243,7095056,3812350,3027731,2257351,1266843,664493,428813,11457581,2351004,4417664,6768668,3667711,2988031,2244965,1268037,720583,571155,11460482,22918063,36781795,36781795
Yemen,2027,YE,YEM,EMR,2478127,4673716,7151843,3898773,3062227,2346613,1338608,697779,444611,11788611,2362330,4461643,6823973,3752050,3023606,2340487,1340176,753835,590525,11800679,23589290,37565099,37565099
Yemen,2028,YE,YEM,EMR,2489540,4713341,7202881,3984539,3098148,2433260,1415177,732802,461569,12125495,2373787,4499966,6873753,3835697,3059911,2433492,1418152,788801,611189,12147242,24272737,38349376,38349376
Yemen,2029,YE,YEM,EMR,2500223,4748863,7249086,4068473,3138569,2515586,1496020,769291,480045,12467984,2384675,4534361,6919036,3917119,3100235,2522133,1501536,825156,633593,12499772,24967756,39135876,39135876
Yemen,2030,YE,YEM,EMR,2511301,4779840,7291141,4150006,3185170,2591258,1580041,807979,500180,12814634,2395991,4564590,6960581,3995750,3146335,2603736,1589363,863776,657927,12856887,25671521,39923245,39923245
Yemen,1950,YE,YEM,EMR,399456,592269,991725,452457,328989,238482,168882,112165,86889,1387864,388983,572521,961504,434556,315996,228990,168751,122561,100852,1371706,2759570,4712810,4712810
Yemen,1951,YE,YEM,EMR,397598,604294,1001892,461192,334485,242172,171302,112662,87658,1409471,389255,585303,974558,443396,321855,233227,171370,123557,103460,1396865,2806336,4782787,4782787
Yemen,1952,YE,YEM,EMR,396274,616524,1012798,470575,340102,245878,173653,113436,88367,1432011,389484,598598,988082,452887,327807,237563,174020,124681,105975,1422933,2854944,4855822,4855822
Yemen,1953,YE,YEM,EMR,397240,627218,1024458,480474,345847,249625,176021,114460,88979,1455406,391554,610604,1002158,462886,333860,242011,176745,125968,108346,1449816,2905222,4931833,4931833
Yemen,1954,YE,YEM,EMR,400856,636207,1037063,490513,351729,253469,178503,115699,89406,1479319,396154,620913,1017067,473004,340043,246561,179603,127416,110491,1477118,2956437,5010564,5010564
Yemen,1955,YE,YEM,EMR,407369,642999,1050368,500631,357764,257428,181111,117104,89654,1503692,403080,629589,1032669,483200,346378,251217,182623,129026,112425,1504869,3008561,5091603,5091603
Yemen,1956,YE,YEM,EMR,416254,648156,1064410,510818,364029,261485,183840,118692,89747,1528611,411738,637217,1048955,493496,352912,255963,185791,130791,114159,1533112,3061723,5175088,5175088
Yemen,1957,YE,YEM,EMR,425504,653759,1079263,520849,370575,265622,186680,120428,89699,1553853,420765,645184,1065949,503709,359708,260788,189096,132710,115703,1561714,3115567,5260779,5260779
Yemen,1958,YE,YEM,EMR,435552,659916,1095468,530811,377393,269859,189611,122238,89626,1579538,430494,653576,1084070,513960,366758,265687,192522,134754,117092,1590773,3170311,5349846,5349846
Yemen,1959,YE,YEM,EMR,446972,666523,1113495,540979,384404,274202,192561,124045,89667,1605858,441434,662236,1103670,524569,374018,270666,196050,136846,118477,1620626,3226484,5443654,5443654
Yemen,1960,YE,YEM,EMR,459754,673431,1133185,551558,391562,278668,195522,125834,89899,1633043,453620,670980,1124600,535788,381466,275743,199693,138996,119938,1651624,3284667,5542459,5542459
Yemen,1961,YE,YEM,EMR,473914,680405,1154319,562729,399082,283247,198501,127604,90309,1661472,467075,679500,1146575,547901,389326,280922,203455,141214,121483,1684301,3345773,5646668,5646668
Yemen,1962,YE,YEM,EMR,488880,687708,1176588,573688,406744,287680,201316,129205,90763,1689396,481235,688013,1169248,560495,397780,286158,207275,143437,123011,1718156,3407552,5753386,5753386
Yemen,1963,YE,YEM,EMR,503958,697415,1201373,582520,414096,291780,203874,130597,91108,1713975,495403,698590,1193993,571784,406625,291406,211088,145609,124340,1750852,3464827,5860197,5860197
Yemen,1964,YE,YEM,EMR,520143,710587,1230730,589906,421563,296041,206565,132136,91588,1737799,510434,712446,1222880,581443,415576,296783,215000,147910,125688,1782400,3520199,5973803,5973803
Yemen,1965,YE,YEM,EMR,537902,727930,1265832,595734,429445,300675,209561,133955,92323,1761693,526810,729743,1256553,589575,424644,302349,219063,150414,127180,1813225,3574918,6097298,6097298
Yemen,1966,YE,YEM,EMR,556867,748903,1305770,600125,437388,305525,212675,135889,93134,1784736,544347,749880,1294227,596714,433814,308122,223234,153060,128750,1843694,3628430,6228430,6228430
Yemen,1967,YE,YEM,EMR,577482,771611,1349093,605033,445181,310629,215886,137933,94005,1808667,563450,771610,1335060,604237,442958,314181,227519,155860,130431,1875186,3683853,6368014,6368014
Yemen,1968,YE,YEM,EMR,599448,796028,1395476,610631,453024,316022,219236,140102,94999,1834014,583765,794808,1378573,612222,452188,320518,231913,158790,132208,1907839,3741853,6515904,6515904
Yemen,1969,YE,YEM,EMR,622179,822831,1445010,617090,461513,321816,222878,142464,96266,1862027,604730,820144,1424874,620549,461837,327123,236451,161888,134225,1942073,3804100,6673981,6673981
Yemen,2031,YE,YEM,EMR,2522915,4807671,7330586,4225941,3245568,2654068,1666714,849236,522084,13163611,2407792,4592023,6999815,4068664,3205864,2671816,1681031,905192,684215,13216782,26380393,40710798,40710798
Yemen,2032,YE,YEM,EMR,2535168,4834344,7369512,4296045,3317327,2705824,1755218,893165,545904,13513483,2420143,4618638,7038781,4135859,3276370,2728079,1775636,949576,712628,13578148,27091631,41499929,41499929
Yemen,2033,YE,YEM,EMR,2547219,4858765,7405984,4362885,3392827,2752500,1845248,940155,571490,13865105,2432231,4643330,7075561,4199917,3350279,2778660,1872597,997316,743026,13941795,27806900,42288449,42288449
Yemen,2034,YE,YEM,EMR,2557480,4881364,7438844,4427084,3470383,2796365,1934882,991689,598603,14219006,2442563,4666505,7109068,4261461,3426071,2825979,1969612,1050017,775174,14308314,28527320,43075225,43075225
Yemen,2035,YE,YEM,EMR,2567041,4902740,7469781,4487864,3549173,2838706,2022820,1048252,627420,14574235,2452183,4688673,7140856,4319798,3503070,2871017,2065318,1108429,809245,14676877,29251112,43861748,43861748
Yemen,2036,YE,YEM,EMR,2576824,4924788,7501612,4542279,3632698,2877044,2109811,1108707,658179,14928718,2461953,4711404,7173357,4372223,3584845,2911135,2160359,1171606,845567,15045735,29974453,44649427,44649427
Yemen,2037,YE,YEM,EMR,2585500,4949546,7535046,4589007,3719857,2912726,2195298,1173085,690936,15280909,2470639,4736543,7207182,4417471,3670410,2947708,2254013,1239725,884243,15413570,30694479,45436698,45436698
Yemen,2038,YE,YEM,EMR,2593912,4974225,7568137,4629944,3806493,2949834,2278400,1241728,725558,15631957,2479095,4761564,7240659,4457082,3755399,2985080,2345303,1313337,925129,15781330,31413287,46222091,46222091
Yemen,2039,YE,YEM,EMR,2603729,4996381,7600110,4666760,3891403,2991327,2357476,1314131,762053,15983150,2488862,4784234,7273096,4492661,3838231,3026492,2432414,1392018,968310,16150126,32133276,47006482,47006482
Yemen,2040,YE,YEM,EMR,2615092,5018201,7633293,4698975,3974007,3038825,2430311,1389359,801122,16332599,2500069,4806560,7306629,4523971,3918326,3073651,2512742,1474883,1014613,16518186,32850785,47790708,47790708
Yemen,2041,YE,YEM,EMR,2625812,5040710,7666522,4727976,4051185,3099632,2490968,1466952,843087,16679800,2510641,4829457,7340098,4552372,3992763,3134088,2579944,1561394,1064526,16885087,33564887,48571507,48571507
Yemen,2042,YE,YEM,EMR,2634956,5062707,7697663,4755743,4122686,3171414,2541185,1546165,888094,17025287,2519658,4851749,7371407,4579846,4061516,3205377,2635706,1650686,1118293,17251424,34276711,49345776,49345776
Yemen,2043,YE,YEM,EMR,2645057,5084258,7729315,4781217,4190974,3246844,2586691,1626717,936278,17368721,2529574,4873541,7403115,4605316,4127108,3280065,2686035,1742219,1176076,17616819,34985540,50117967,50117967
Yemen,2044,YE,YEM,EMR,2653881,5105419,7759300,4804847,4256568,3324238,2629636,1706990,988640,17710919,2538260,4894874,7433134,4629192,4190040,3356562,2733255,1833861,1239019,17981929,35692848,50885281,50885281
Yemen,2045,YE,YEM,EMR,2659144,5127379,7786523,4827213,4318593,3402678,2671181,1785831,1045627,18051123,2543539,4916868,7460407,4651973,4249486,3434076,2778269,1924359,1307908,18346071,36397194,51644122,51644122
Yemen,2046,YE,YEM,EMR,2662915,5148862,7811777,4850155,4374124,3485455,2708924,1863847,1106404,18388909,2547414,4938307,7485721,4675227,4302706,3516029,2818469,2014287,1382103,18708821,37097730,52395228,52395228
Yemen,2047,YE,YEM,EMR,2665850,5167634,7833484,4875703,4421944,3571549,2744177,1940550,1170991,18724914,2550477,4957042,7507519,4700816,4348518,3601489,2855216,2102980,1461778,19070797,37795711,53136711,53136711
Yemen,2048,YE,YEM,EMR,2664551,5187063,7851614,4901132,4464048,3657093,2780922,2015208,1239540,19057943,2549372,4976396,7525768,4726258,4388607,3686300,2892823,2189558,1547260,19430806,38488749,53866133,53866133
Yemen,2049,YE,YEM,EMR,2661193,5206588,7867781,4924067,4502154,3741020,2821977,2086329,1311624,19387171,2546297,4995785,7542082,4749350,4424690,3768999,2934478,2272302,1638175,19787994,39175165,54585033,54585033
Yemen,2050,YE,YEM,EMR,2659006,5224102,7883108,4946659,4535810,3822783,2868836,2151896,1387001,19712985,2544361,5013187,7557548,4772091,4456528,3849029,2981805,2348752,1734486,20142691,39855676,55296331,55296331
South Africa,1970,ZA,ZAF,AFR,1881722,2892150,4773872,2178188,1542805,1099063,811033,533489,359170,6523748,1831595,2814047,4645642,2151002,1494071,1039665,764723,545456,430127,6425044,12948792,22368306,22368306
South Africa,1971,ZA,ZAF,AFR,1933824,2972060,4905884,2248199,1615028,1124567,826922,545032,373542,6733290,1881686,2888491,4770177,2202357,1565705,1062898,782955,560125,448056,6622096,13355386,23031441,23031441
South Africa,1972,ZA,ZAF,AFR,1982832,3042804,5025636,2330982,1702247,1158398,845291,557744,388041,6982703,1928365,2951107,4879472,2248485,1635735,1085064,800595,574626,466198,6810703,13793406,23698507,23698507
South Africa,1973,ZA,ZAF,AFR,2030264,3112571,5142835,2415953,1797321,1197450,864257,570709,402712,7248402,1973351,3013678,4987029,2294935,1707333,1109260,818553,589337,484828,7004246,14252648,24382513,24382513
South Africa,1974,ZA,ZAF,AFR,2074640,3187034,5261674,2501166,1889686,1241025,883955,583973,417585,7517390,2015319,3082422,5097741,2344866,1773351,1136860,837005,604174,503961,7200217,14717607,25077016,25077016
South Africa,1975,ZA,ZAF,AFR,2114744,3267934,5382678,2586633,1974834,1289147,904374,597471,432501,7784960,2053186,3158902,5212088,2399639,1830870,1169147,855978,619080,523526,7398240,15183200,25777964,25777964
South Africa,1976,ZA,ZAF,AFR,2149600,3355170,5504770,2664245,2054730,1340702,925415,611147,447589,8043828,2086574,3243351,5329925,2456105,1885261,1207450,875559,633764,543641,7601780,15645608,26480300,26480300
South Africa,1977,ZA,ZAF,AFR,2176778,3438973,5615751,2753161,2145465,1403276,948002,625648,462869,8338421,2112505,3321526,5434031,2514149,1936653,1252106,895015,649357,564353,7811633,16150054,27199838,27199838
South Africa,1978,ZA,ZAF,AFR,2199330,3514801,5714131,2856553,2252109,1479427,972884,641116,478207,8680296,2133521,3388623,5522144,2572466,1985526,1303217,913793,666303,585574,8026879,16707175,27943445,27943445
South Africa,1979,ZA,ZAF,AFR,2224883,3590245,5815128,2951833,2356610,1561107,999851,656764,493546,9019711,2157692,3457564,5615256,2631119,2032323,1360769,932426,683233,607042,8246912,17266623,28697014,28697014
South Africa,1980,ZA,ZAF,AFR,2256420,3665701,5922121,3039186,2457912,1647435,1029431,672313,508768,9355045,2187719,3528361,5716080,2690127,2077234,1423415,951463,699711,628350,8470300,17825345,29463549,29463549
South Africa,1981,ZA,ZAF,AFR,2305116,3737568,6042684,3107654,2508321,1715460,1049892,683787,523788,9588902,2235655,3602240,5837895,2786114,2133785,1501234,973132,718973,649844,8763082,18351984,30232561,30232561
South Africa,1982,ZA,ZAF,AFR,2376804,3800469,6177273,3172239,2497093,1759211,1057821,689745,538702,9714811,2307804,3670148,5977952,2935976,2205766,1597511,998561,743040,671522,9152376,18867187,31022417,31022417
South Africa,1983,ZA,ZAF,AFR,2465539,3848956,6314495,3266936,2450007,1791575,1058008,691107,553587,9811220,2397683,3718187,6115870,3133750,2286869,1709134,1028223,772247,693369,9623592,19434812,31865176,31865176
South Africa,1984,ZA,ZAF,AFR,2567407,3887552,6454959,3397012,2371976,1805903,1051603,687070,568365,9881929,2501208,3751468,6252676,3379485,2379433,1829559,1063686,809050,717426,10178639,20060568,32768207,32768207
South Africa,1985,ZA,ZAF,AFR,2686367,3914924,6601291,3567454,2254877,1793263,1034731,675333,582683,9908341,2622536,3769371,6391907,3684642,2489720,1961037,1107140,860601,748281,10851421,20759762,33752964,33752964
South Africa,1986,ZA,ZAF,AFR,2803808,3974552,6778360,3751595,2227233,1812386,1048947,669099,597147,10106407,2739769,3816482,6556251,3920310,2590785,2079093,1163939,904330,778364,11436821,21543228,34877834,34877834
South Africa,1987,ZA,ZAF,AFR,2907284,4096346,7003630,3903255,2336249,1879717,1105835,674554,611872,10511482,2839287,3928367,6767654,4021070,2679496,2169455,1234557,928666,803325,11836569,22348051,36119333,36119333
South Africa,1988,ZA,ZAF,AFR,3006122,4253043,7259165,4008111,2475900,1945375,1166220,681944,625802,10903352,2932637,4082641,7015278,4075529,2788279,2255136,1315752,951144,830227,12216067,23119419,37393853,37393853
South Africa,1989,ZA,ZAF,AFR,3087611,4443178,7530789,4064869,2649467,2005375,1229205,692097,638335,11279348,3007657,4275971,7283628,4083196,2922069,2332747,1405900,971549,859460,12574921,23854269,38668684,38668684
South Africa,1990,ZA,ZAF,AFR,3132207,4667072,7799279,4070494,2850379,2054251,1293244,705892,649069,11623329,3045269,4506893,7552162,4044967,3079496,2397434,1500736,989191,890972,12902796,24526125,39877570,39877570
South Africa,1991,ZA,ZAF,AFR,3121867,4930546,8052413,4010999,3053206,2085859,1356222,722685,657476,11886447,3031940,4775927,7807867,3956336,3246729,2442801,1592810,1000336,925215,13164227,25050674,40910959,40910959
South Africa,1992,ZA,ZAF,AFR,3072331,5200202,8272533,3920375,3224790,2078594,1397624,730824,664062,12016269,2984602,5055730,8040332,3872115,3430333,2473456,1674761,1015237,965724,13431626,25447895,41760755,41760755
South Africa,1993,ZA,ZAF,AFR,3013949,5429451,8443400,3854331,3368350,2038152,1416289,729376,669474,12075972,2929329,5302446,8231775,3838531,3632300,2500849,1750350,1040743,1011521,13774294,25850266,42525440,42525440
South Africa,1994,ZA,ZAF,AFR,2956336,5610202,8566538,3829963,3507640,2005559,1431421,730787,673279,12178649,2874652,5497220,8371872,3839692,3829057,2534076,1821886,1068940,1057271,14150922,26329571,43267982,43267982
South Africa,1995,ZA,ZAF,AFR,2910691,5732335,8643026,3854866,3625922,1986945,1439780,734896,675530,12317939,2831498,5631140,8462638,3887950,4007102,2578814,1886380,1100089,1102147,14562482,26880421,43986084,43986084
South Africa,1996,ZA,ZAF,AFR,2866260,5813049,8679309,3923224,3706372,1981923,1444264,741393,677665,12474841,2789371,5719829,8509200,3983103,4149821,2635295,1947299,1135497,1147243,14998258,27473099,44661603,44661603
South Africa,1997,ZA,ZAF,AFR,2791717,5865376,8657093,4031381,3775978,2027724,1470373,764444,678727,12748627,2717597,5771262,8488859,4089727,4227428,2704306,2012446,1170551,1186012,15390470,28139097,45285048,45285048
South Africa,1998,ZA,ZAF,AFR,2696702,5885137,8581839,4177657,3825844,2123206,1513881,803078,677984,13121650,2625408,5786022,8411430,4212288,4235932,2786654,2078911,1207866,1215595,15737246,28858896,45852166,45852166
South Africa,1999,ZA,ZAF,AFR,2603051,5873200,8476251,4358003,3827522,2243417,1550059,844427,677349,13500777,2534263,5770811,8305074,4375693,4189562,2885750,2135861,1254412,1241301,16082579,29583356,46364681,46364681
South Africa,2000,ZA,ZAF,AFR,2506656,5827500,8334156,4567252,3788316,2387899,1576322,887544,679883,13887216,2439249,5723870,8163119,4572967,4095227,3003240,2181604,1309601,1266123,16428762,30315978,46813266,46813266
South Africa,2001,ZA,ZAF,AFR,2420590,5750274,8170864,4799114,3721414,2546944,1591481,930697,687289,14276939,2351450,5647106,7998556,4793632,3974171,3136091,2216890,1370709,1291856,16783349,31060288,47229714,47229714
South Africa,2002,ZA,ZAF,AFR,2366607,5641411,8008018,5043773,3650703,2709404,1597858,972834,699191,14673763,2294035,5536739,7830774,5024434,3850529,3275607,2243562,1435201,1319625,17148958,31822721,47661514,47661514
South Africa,2003,ZA,ZAF,AFR,2342323,5513891,7856214,5273269,3600196,2866422,1599402,1015192,714689,15069170,2266886,5404460,7671346,5238409,3742639,3409390,2263782,1503029,1350071,17507320,32576490,48104048,48104048
South Africa,2004,ZA,ZAF,AFR,2343154,5383989,7727143,5460839,3586612,3009698,1604625,1054282,733380,15449436,2265501,5269550,7535051,5410571,3669274,3527438,2283947,1568189,1385014,17844433,33293869,48556071,48556071
South Africa,2005,ZA,ZAF,AFR,2374622,5255554,7630176,5592139,3617349,3128701,1621055,1088341,755538,15803123,2294640,5136680,7431320,5529449,3643009,3619138,2309635,1627484,1423821,18152536,33955659,49017147,49017147
South Africa,2006,ZA,ZAF,AFR,2434864,5126916,7561780,5683614,3686360,3214476,1650576,1120733,778712,16134471,2352178,5004694,7356872,5609411,3664341,3674729,2342623,1684160,1463371,18438635,34573106,49491756,49491756
South Africa,2007,ZA,ZAF,AFR,2514535,5004741,7519276,5747653,3793188,3262849,1695846,1151156,802142,16452834,2428723,4878751,7307474,5661856,3735130,3690186,2386336,1738070,1504932,18716510,35169344,49996094,49996094
South Africa,2008,ZA,ZAF,AFR,2617553,4901404,7518957,5783455,3938749,3272987,1758482,1178620,826843,16759136,2527453,4770736,7298189,5687182,3854763,3664843,2443842,1787818,1551086,18989534,35748670,50565812,50565812
South Africa,2009,ZA,ZAF,AFR,2711794,4827870,7539664,5797606,4119909,3249531,1840741,1200317,852151,17060255,2617893,4691657,7309550,5689977,4018491,3602245,2518893,1830401,1601307,19261314,36321569,51170779,51170779
South Africa,2010,ZA,ZAF,AFR,2772649,4787939,7560588,5791561,4333535,3204891,1943664,1214612,878652,17366915,2676109,4644134,7320243,5670399,4220490,3513155,2613027,1864674,1655423,19537168,36904083,51784921,51784921
South Africa,2011,ZA,ZAF,AFR,2821205,4783779,7604984,5750636,4575235,3154616,2064333,1222708,906393,17673921,2721491,4630999,7352490,5619164,4451670,3412905,2723718,1891356,1713109,19811922,37485843,52443325,52443325
South Africa,2012,ZA,ZAF,AFR,2865589,4820574,7686163,5659630,4828414,3114887,2197575,1227568,937154,17965228,2762916,4659124,7422040,5522712,4695388,3318678,2845230,1913379,1776211,20071598,38036826,53145033,53145033
South Africa,2013,ZA,ZAF,AFR,2886836,4906622,7793458,5539239,5062028,3101699,2334964,1231810,972928,18242668,2782813,4736631,7519444,5397827,4924151,3248094,2968662,1933295,1846026,20318055,38560723,53873616,53873616
South Africa,2014,ZA,ZAF,AFR,2901504,5009108,7910612,5435713,5285002,3142290,2474197,1242971,1009898,18590071,2796584,4833202,7629786,5280618,5133161,3223779,3088269,1956377,1916880,20599084,39189155,54729551,54729551
South Africa,2015,ZA,ZAF,AFR,2929920,5112267,8042187,5388638,5528458,3261771,2615506,1270610,1048249,19113232,2824371,4932721,7757092,5194802,5332330,3263403,3197589,1988790,1987078,20963992,40077224,55876504,55876504
South Africa,2016,ZA,ZAF,AFR,2928694,5216555,8145249,5215713,5609913,3356240,2708141,1298845,1084062,19272914,2823509,5035901,7859410,5040922,5432505,3319731,3267934,2024811,2058795,21144698,40417612,56422274,56422274
South Africa,2017,ZA,ZAF,AFR,2910503,5328618,8239121,4984580,5586466,3446559,2756972,1334277,1117299,19226153,2805705,5146684,7952389,4857139,5464982,3403398,3297282,2068355,2132397,21223553,40449706,56641209,56641209
South Africa,2018,ZA,ZAF,AFR,2913591,5455105,8368696,4873062,5625506,3614457,2795054,1393662,1151915,19453656,2809339,5267852,8077191,4745520,5512973,3551117,3297861,2127806,2204819,21440096,40893752,57339635,57339635
South Africa,2019,ZA,ZAF,AFR,2928914,5567815,8496729,4797121,5641804,3812494,2805407,1470627,1183771,19711224,2825231,5375318,8200549,4666058,5535357,3737913,3263513,2203284,2272430,21678555,41389779,58087055,58087055
South Africa,2020,ZA,ZAF,AFR,2943870,5655906,8599776,4755542,5631941,4034847,2793692,1561719,1203269,19981010,2840382,5459323,8299705,4618671,5529232,3957181,3199980,2291214,2325160,21921438,41902448,58801927,58801927
South Africa,2021,ZA,ZAF,AFR,2957962,5708075,8666037,4747811,5579800,4274763,2767472,1658498,1200229,20228573,2854694,5508784,8363478,4604504,5484426,4198351,3117264,2382864,2346756,22134165,42362738,59392255,59392255
South Africa,2022,ZA,ZAF,AFR,2960601,5741022,8701623,4782764,5478340,4520290,2743479,1757864,1183649,20466386,2858085,5540474,8398559,4632468,5392436,4446918,3033957,2475651,2345893,22327323,42793709,59893885,59893885
South Africa,2023,ZA,ZAF,AFR,2936699,5762673,8699372,4871405,5353103,4745433,2742519,1862133,1178007,20752600,2835666,5561901,8397567,4711863,5271090,4678440,2973353,2572967,2357240,22564953,43317553,60414495,60414495
South Africa,2024,ZA,ZAF,AFR,2892857,5789615,8682472,4978434,5228420,4932848,2779346,1972607,1198772,21090427,2793692,5588374,8382066,4810176,5145463,4874723,2953989,2676381,2404523,22865255,43955682,61020221,61020221
South Africa,2025,ZA,ZAF,AFR,2848496,5824870,8673366,5083340,5110735,5074721,2856338,2077660,1237581,21440375,2751363,5623117,8374480,4907780,5023069,5026351,2980568,2771548,2475546,23184862,44625237,61673081,61673081
South Africa,2026,ZA,ZAF,AFR,2814165,5839677,8653842,5200644,4995368,5181612,2963076,2163696,1285190,21789586,2718580,5638970,8357550,5018289,4901364,5141454,3047367,2841676,2553906,23504056,45293642,62305039,62305039
South Africa,2027,ZA,ZAF,AFR,2787052,5834279,8621331,5328975,4886993,5260711,3097208,2225869,1342257,22142013,2692378,5635725,8328103,5140146,4785045,5226703,3154298,2880913,2640361,23827466,45969479,62918916,62918916
South Africa,2028,ZA,ZAF,AFR,2764147,5815582,8579729,5456326,4797814,5311073,3258360,2261839,1408223,22493635,2670252,5619655,8289907,5261689,4686297,5281569,3300076,2886784,2734818,24151233,46644868,63514502,63514502
South Africa,2029,ZA,ZAF,AFR,2743055,5788305,8531360,5567550,4738409,5338021,3442944,2273390,1482743,22843057,2650168,5594931,8245099,5368410,4616141,5310328,3480270,2861112,2837951,24474212,47317269,64093732,64093732
South Africa,2030,ZA,ZAF,AFR,2725470,5758263,8483733,5653605,4710530,5340062,3647491,2267203,1565236,23184127,2633604,5567216,8200820,5451506,4576381,5311498,3689794,2811314,2950107,24790600,47974727,64659278,64659278
South Africa,1950,ZA,ZAF,AFR,1090503,1578517,2669020,1246222,1043229,790782,496566,274291,248186,4099276,1067111,1490794,2557905,1121626,894832,672080,454498,293463,281147,3717646,7816922,13043844,13043844
South Africa,1951,ZA,ZAF,AFR,1117809,1618376,2736185,1272629,1063017,807908,507569,277499,247347,4175969,1091446,1532268,2623714,1148397,914713,687202,463994,296530,278357,3789193,7965162,13325058,13325058
South Africa,1952,ZA,ZAF,AFR,1145043,1666252,2811295,1295163,1080868,825744,521739,282386,246820,4252720,1116400,1583792,2700192,1170839,933428,702501,474693,300599,276650,3858710,8111430,13622914,13622914
South Africa,1953,ZA,ZAF,AFR,1168629,1727005,2895634,1309148,1092274,844636,543536,290719,246572,4326885,1139514,1653125,2792639,1185125,946719,716896,487941,305410,275995,3918086,8244971,13933246,13933246
South Africa,1954,ZA,ZAF,AFR,1194821,1790393,2985214,1320696,1099740,863289,569036,301848,246679,4401288,1165954,1727221,2893175,1197641,957312,730707,502830,311318,276389,3976197,8377485,14255876,14255876
South Africa,1955,ZA,ZAF,AFR,1227458,1848654,3076112,1337417,1107914,880593,592755,314231,247247,4480157,1198075,1794363,2992438,1216099,969810,744783,517952,318838,277932,4045414,8525571,14594129,14594129
South Africa,1956,ZA,ZAF,AFR,1260659,1908493,3169152,1358663,1116135,896793,615695,328191,248130,4563607,1230564,1861226,3091790,1240472,983254,758796,533499,327749,280618,4124388,8687995,14948934,14948934
South Africa,1957,ZA,ZAF,AFR,1293206,1971001,3264207,1384486,1124020,911999,638431,343953,249264,4652153,1262458,1928986,3191444,1271352,996742,772512,549524,337807,284397,4212334,8864487,15320138,15320138
South Africa,1958,ZA,ZAF,AFR,1322238,2040410,3362648,1408053,1125848,927241,667194,363407,250820,4742563,1291591,2007101,3298692,1303063,1003921,784688,567554,348606,289144,4296976,9039539,15700877,15700877
South Africa,1959,ZA,ZAF,AFR,1351532,2105997,3457529,1443627,1130908,940351,690882,383062,253165,4841995,1320335,2076392,3396727,1348769,1013763,797365,584607,360900,294800,4400204,9242199,16096455,16096455
South Africa,1960,ZA,ZAF,AFR,1387296,2156759,3544055,1506034,1152250,949763,696373,397453,256532,4958405,1353701,2115530,3469231,1420963,1039096,813747,597126,375829,301991,4548752,9507157,16520441,16520441
South Africa,1961,ZA,ZAF,AFR,1426007,2211243,3637250,1575286,1177253,960743,701993,411994,261203,5088472,1390516,2159065,3549581,1500950,1067645,832495,610645,392160,310269,4714164,9802636,16989464,16989464
South Africa,1962,ZA,ZAF,AFR,1465396,2276223,3741619,1643748,1200176,974422,714636,429132,267378,5229492,1428940,2220058,3648998,1581356,1094036,852411,627104,409005,319114,4883026,10112518,17503133,17503133
South Africa,1963,ZA,ZAF,AFR,1507557,2340948,3848505,1718053,1226527,988183,726664,445495,274897,5379819,1469967,2281487,3751454,1666356,1123611,873416,643617,426408,329026,5062434,10442253,18042215,18042215
South Africa,1964,ZA,ZAF,AFR,1555286,2409027,3964313,1789765,1256716,1002211,738420,460671,283978,5531761,1516246,2346819,3863065,1747276,1157185,895378,660139,444143,339831,5243952,10775713,18603097,18603097
South Africa,1965,ZA,ZAF,AFR,1608376,2483232,4091608,1855808,1291630,1016722,749957,474661,294553,5683331,1567476,2418150,3985626,1821265,1196364,918420,676805,462074,351700,5426628,11109959,19187194,19187194
South Africa,1966,ZA,ZAF,AFR,1662614,2560457,4223071,1921073,1331544,1031586,761584,487850,306077,5839714,1619770,2492549,4112319,1892301,1241936,942145,693607,479695,364973,5614657,11454371,19789771,19789771
South Africa,1967,ZA,ZAF,AFR,1717149,2640261,4357410,1986356,1376834,1046858,773351,500260,318378,6002037,1672430,2569602,4242032,1960960,1294749,966258,710646,496923,379660,5809196,11811233,20410677,20410677
South Africa,1968,ZA,ZAF,AFR,1772187,2721509,4493696,2052322,1427682,1062950,785295,511887,331435,6171571,1725620,2648281,4373901,2028072,1355203,990617,728113,513786,395577,6011368,12182939,21050540,21050540
South Africa,1969,ZA,ZAF,AFR,1827129,2805293,4632422,2116658,1483300,1080221,797813,522909,345094,6345995,1778753,2729634,4508387,2091660,1422142,1014977,746099,530045,412489,6217412,12563407,21704214,21704214
South Africa,2031,ZA,ZAF,AFR,2712054,5737268,8449322,5704724,4716079,5305516,3869663,2253855,1654731,23504568,2621047,5548086,8169133,5500912,4569770,5276841,3920940,2749451,3070586,25088500,48593068,65211526,65211526
South Africa,2032,ZA,ZAF,AFR,2702719,5713935,8416654,5738459,4760907,5223995,4097822,2246318,1749572,23817073,2612396,5526451,8138847,5533697,4603576,5195716,4159832,2690228,3197305,25380354,49197427,65752924,65752924
South Africa,2033,ZA,ZAF,AFR,2697919,5669266,8367185,5761408,4852597,5115307,4306873,2257528,1846822,24140535,2608000,5483967,8091967,5556384,4685322,5084871,4382721,2649490,3325722,25684510,49825045,66284189,66284189
South Africa,2034,ZA,ZAF,AFR,2696045,5606176,8302221,5789389,4960228,5003947,4480058,2296774,1942694,24473090,2606356,5423668,8030024,5583838,4784697,4969147,4570811,2640442,3449891,25998826,50471916,66804167,66804167
South Africa,2035,ZA,ZAF,AFR,2696352,5545205,8241557,5825108,5064060,4896335,4609864,2367057,2033174,24795598,2606805,5365700,7972505,5619091,4882275,4854917,4715006,2669590,3563598,26304477,51100075,67314133,67314133
South Africa,2036,ZA,ZAF,AFR,2699384,5498336,8197720,5840502,5179650,4790837,4708187,2462024,2115145,25096345,2609856,5321198,7931054,5635542,4992299,4741252,4825191,2734951,3661581,26590816,51687161,67815933,67815933
South Africa,2037,ZA,ZAF,AFR,2703222,5462677,8165899,5835881,5305746,4691904,4781359,2578979,2185572,25379441,2613756,5287108,7900864,5633000,5113315,4632706,4907511,2835947,3739563,26862042,52241483,68308246,68308246
South Africa,2038,ZA,ZAF,AFR,2706283,5435693,8141976,5818062,5430750,4611049,4828381,2717034,2242465,25647741,2616938,5261295,7878233,5617689,5233907,4540977,4961340,2971037,3795594,27120544,52768285,68788495,68788495
South Africa,2039,ZA,ZAF,AFR,2709095,5413413,8122508,5791749,5540161,4558489,4854177,2872999,2287160,25904735,2619853,5240239,7860092,5593771,5339994,4476819,4990726,3136092,3832075,27369477,53274212,69256823,69256823
South Africa,2040,ZA,ZAF,AFR,2711450,5396769,8108219,5762653,5625204,4535922,4857607,3044230,2324474,26150090,2622326,5224754,7847080,5566849,5422936,4441991,4994327,3326681,3855770,27608554,53758644,69713937,69713937
South Africa,2041,ZA,ZAF,AFR,2712869,5386979,8099848,5742377,5676284,4545013,4828419,3229493,2361867,26383453,2623906,5215840,7839746,5548368,5472769,4439064,4964460,3536230,3876721,27837612,54221065,70160652,70160652
South Africa,2042,ZA,ZAF,AFR,2712848,5382047,8094895,5719746,5710570,4591009,4757176,3419752,2408139,26606392,2624033,5211647,7835680,5527373,5506332,4474821,4891051,3752631,3905960,28058168,54664560,70595132,70595132
South Africa,2043,ZA,ZAF,AFR,2712056,5380851,8092907,5676106,5734844,4681254,4661545,3594169,2470758,26818676,2623342,5210974,7834316,5485720,5530301,4556660,4789737,3954625,3953224,28270267,55088943,71016168,71016168
South Africa,2044,ZA,ZAF,AFR,2710485,5382320,8092805,5614374,5764231,4786404,4563702,3738920,2553740,27021371,2621834,5212777,7834611,5426437,5559108,4655347,4683851,4125382,4024760,28474885,55496256,71423671,71423671
South Africa,2045,ZA,ZAF,AFR,2707023,5385498,8092521,5554771,5800851,4887438,4469131,3847642,2656013,27215846,2618456,5216219,7834675,5369468,5595379,4751916,4579204,4256627,4120573,28673167,55889013,71816201,71816201
South Africa,2046,ZA,ZAF,AFR,2700506,5390434,8090940,5509071,5817517,4999291,4376445,3930056,2769989,27402369,2612165,5221362,7833527,5325844,5613022,4860250,4474961,4357177,4234067,28865321,56267690,72192155,72192155
South Africa,2047,ZA,ZAF,AFR,2691772,5394749,8086521,5474440,5814674,5120932,4289888,3991404,2891180,27582518,2603718,5225894,7829612,5292555,5611969,4979079,4375557,4432590,4360995,29052745,56635263,72551393,72551393
South Africa,2048,ZA,ZAF,AFR,2681345,5397527,8078872,5448397,5798986,5241437,4219980,4030778,3017319,27756897,2593658,5228898,7822556,5267478,5598354,5097465,4292063,4482252,4498280,29235892,56992789,72894219,72894219
South Africa,2049,ZA,ZAF,AFR,2669254,5399283,8068537,5427012,5775061,5347265,4176341,4052471,3146905,27925055,2582045,5230817,7812862,5247127,5576281,5201948,4234788,4509900,4644361,29414405,57339460,73220860,73220860
South Africa,2050,ZA,ZAF,AFR,2655527,5398697,8054224,5411204,5748372,5430058,4160508,4055837,3281541,28087520,2568837,5230424,7799261,5232298,5551194,5284162,4205402,4514530,4801162,29588748,57676268,73529753,73529753
Zambia,1970,ZM,ZMB,AFR,423510,604700,1028210,391002,259118,175517,121956,79564,54363,1081520,424631,611325,1035956,397235,264395,189122,133812,86854,64561,1135979,2217499,4281671,4281671
Zambia,1971,ZM,ZMB,AFR,437424,626625,1064049,399907,261465,177259,123379,81243,56218,1099471,438574,633358,1071932,409803,269349,192320,136985,89114,66901,1164472,2263943,4399919,4399919
Zambia,1972,ZM,ZMB,AFR,451870,649025,1100895,410349,263835,179109,124810,82861,58153,1119117,453005,655841,1108846,423675,274548,195654,140146,91425,69269,1194717,2313834,4523581,4523581
Zambia,1973,ZM,ZMB,AFR,466744,672031,1138775,423193,265697,181040,126278,84434,60180,1140822,467857,678930,1146787,439410,279615,199101,143287,93814,71680,1226907,2367729,4653289,4653289
Zambia,1974,ZM,ZMB,AFR,481652,695833,1177485,438320,267500,182937,127795,85963,62255,1164770,482762,702822,1185584,456321,285409,202556,146404,96326,74177,1261193,2425963,4789038,4789038
Zambia,1975,ZM,ZMB,AFR,496699,720526,1217225,454745,270326,184750,129350,87436,64327,1190934,497822,727603,1225425,473696,292704,206013,149504,98961,76784,1297662,2488596,4931249,4931249
Zambia,1976,ZM,ZMB,AFR,511907,745907,1257814,472446,274109,186560,130955,88839,66393,1219302,513086,753082,1266168,492092,300900,209547,152604,101742,79511,1336396,2555698,5079672,5079672
Zambia,1977,ZM,ZMB,AFR,526909,771859,1298768,491394,278740,188439,132617,90172,68439,1249801,528217,779141,1307358,511539,309849,213232,155713,104666,82369,1377368,2627169,5233292,5233292
Zambia,1978,ZM,ZMB,AFR,541529,798408,1339937,511298,284340,190406,134311,91448,70445,1282248,543027,805805,1348832,531798,319608,217136,158821,107679,85293,1420335,2702583,5391355,5391355
Zambia,1979,ZM,ZMB,AFR,555741,825416,1381157,531993,291045,192538,136027,92706,72419,1316728,557468,832949,1390417,552704,330229,221388,161939,110686,88210,1465156,2781884,5553462,5553462
Zambia,1980,ZM,ZMB,AFR,568971,853120,1422091,553639,299327,195098,137809,93999,74344,1354216,570987,860822,1431809,574330,341986,226153,165098,113663,91087,1512317,2866533,5720438,5720438
Zambia,1981,ZM,ZMB,AFR,581991,881505,1463496,576860,310206,198511,139906,95401,76206,1397090,584386,889404,1473790,596995,355446,231598,168440,116654,93958,1563091,2960181,5897481,5897481
Zambia,1982,ZM,ZMB,AFR,596302,910231,1506533,602247,324812,203124,142594,97020,78060,1447857,599226,918353,1517579,621027,371308,237832,172128,119713,96840,1618848,3066705,6090818,6090818
Zambia,1983,ZM,ZMB,AFR,611890,938751,1550641,627819,341930,207425,145396,98658,79853,1501081,615473,947173,1562646,645390,389037,243989,175906,122715,99664,1676701,3177782,6291070,6291070
Zambia,1984,ZM,ZMB,AFR,628495,966403,1594898,651856,359292,210778,147742,100107,81519,1551294,632767,975273,1608040,669198,406855,250364,179455,125540,102424,1733836,3285130,6488072,6488072
Zambia,1985,ZM,ZMB,AFR,646557,992769,1639326,675656,376953,214681,149777,101446,83060,1601573,651521,1002212,1653733,693178,424546,257878,182828,128212,105177,1791819,3393392,6686449,6686449
Zambia,1986,ZM,ZMB,AFR,665611,1018590,1684201,700205,395968,219619,151819,102790,84481,1654882,671209,1028767,1699976,717769,443142,266166,186163,130741,107930,1851911,3506793,6890967,6890967
Zambia,1987,ZM,ZMB,AFR,684117,1044726,1728843,724321,415082,224907,153688,104031,85761,1707790,690250,1055887,1746137,742300,462068,274834,189424,133117,110677,1912420,3620210,7095185,7095185
Zambia,1988,ZM,ZMB,AFR,701742,1071138,1772880,747321,433012,230184,155210,105068,86902,1757697,708349,1083500,1791849,766419,480551,283686,192590,135290,113365,1971901,3729598,7294325,7294325
Zambia,1989,ZM,ZMB,AFR,719131,1097902,1817033,769786,449955,235686,156492,105911,87934,1805764,726168,1111617,1837785,790386,498599,292809,195787,137259,115854,2030694,3836458,7491275,7491275
Zambia,1990,ZM,ZMB,AFR,736083,1124916,1860999,792270,465869,241514,157622,106542,88855,1852672,743467,1140132,1883599,814610,516127,302238,199060,139005,118091,2089131,3941803,7686401,7686401
Zambia,1991,ZM,ZMB,AFR,752659,1152279,1904938,814998,480813,247804,158603,107012,89637,1898867,760299,1169089,1929388,839154,533093,312055,202349,140562,120064,2147277,4046144,7880466,7880466
Zambia,1992,ZM,ZMB,AFR,769680,1179985,1949665,837621,494685,254638,159256,107353,90291,1943844,777518,1198488,1976006,863692,549466,322383,205513,141994,121773,2204821,4148665,8074337,8074337
Zambia,1993,ZM,ZMB,AFR,787700,1208137,1995837,860247,507982,262762,159145,107551,90807,1988494,795756,1228389,2024145,888201,565641,333760,208261,143307,123276,2262446,4250940,8270917,8270917
Zambia,1994,ZM,ZMB,AFR,807088,1237392,2044480,883006,521607,272274,158745,107572,91168,2034372,815359,1259394,2074753,912570,582084,345610,211320,144417,124608,2320609,4354981,8474216,8474216
Zambia,1995,ZM,ZMB,AFR,827935,1268038,2095973,905371,535817,282269,158931,107371,91366,2081125,836275,1291755,2128030,936327,598997,357264,215316,145325,125788,2379017,4460142,8684135,8684135
Zambia,1996,ZM,ZMB,AFR,849612,1299782,2149394,928315,551110,292891,159720,107041,91407,2130484,857890,1325125,2183015,960386,616640,369335,219775,146140,126855,2439131,4569615,8902019,8902019
Zambia,1997,ZM,ZMB,AFR,871414,1332346,2203760,953896,568983,304822,161340,106808,91325,2187174,879596,1359130,2238726,986326,635672,382099,224658,146934,127802,2503491,4690665,9133156,9133156
Zambia,1998,ZM,ZMB,AFR,893266,1365811,2259077,980686,588448,317265,163662,106612,91155,2247828,901319,1394009,2295328,1013406,655565,395013,229870,147729,128616,2570199,4818027,9372430,9372430
Zambia,1999,ZM,ZMB,AFR,915144,1400858,2316002,1008562,609608,330137,166772,106520,90936,2312535,923031,1430433,2353464,1041512,676373,407975,235456,148647,129272,2639235,4951770,9621238,9621238
Zambia,2000,ZM,ZMB,AFR,937600,1437670,2375270,1039242,634985,344495,171228,106834,90717,2387501,945374,1468271,2413645,1071519,699779,421742,241859,149958,129858,2714715,5102216,9891136,9891136
Zambia,2001,ZM,ZMB,AFR,961092,1476139,2437231,1074308,666669,361432,177591,107767,90586,2478353,968937,1507396,2476333,1104388,726965,436955,249454,151777,130512,2800051,5278404,10191964,10191964
Zambia,2002,ZM,ZMB,AFR,986183,1516110,2502293,1109865,700701,379332,185245,108895,90607,2574645,994099,1547990,2542089,1138070,755549,452616,257925,153820,131289,2889269,5463914,10508294,10508294
Zambia,2003,ZM,ZMB,AFR,1013542,1558155,2571697,1144733,735590,397933,194462,109733,90741,2673192,1021237,1590546,2611783,1171880,784878,468885,267620,155818,132221,2981302,5654494,10837973,10837973
Zambia,2004,ZM,ZMB,AFR,1043842,1602707,2646549,1180314,771741,418089,205347,110651,90927,2777069,1050947,1635397,2686344,1206767,815090,486354,278186,158390,133297,3078084,5855153,11188040,11188040
Zambia,2005,ZM,ZMB,AFR,1077607,1650319,2727926,1217893,809585,440639,217534,112459,91174,2889284,1083873,1683095,2766968,1243460,846001,505336,289209,162101,134576,3180683,6069967,11564870,11564870
Zambia,2006,ZM,ZMB,AFR,1114936,1700525,2815461,1257852,850184,465957,231180,115193,91568,3011934,1120162,1733144,2853306,1281939,878708,526230,301271,166597,136128,3290873,6302807,11971567,11971567
Zambia,2007,ZM,ZMB,AFR,1154368,1752894,2907262,1298928,893342,493769,246133,118721,92169,3143062,1158341,1785135,2943476,1321378,913805,549053,314384,171706,137944,3408270,6551332,12402073,12402073
Zambia,2008,ZM,ZMB,AFR,1194111,1807959,3002070,1340828,938307,524088,262190,123102,93025,3281540,1196718,1839457,3036175,1361889,951167,574123,328497,177469,140037,3533182,6814722,12852966,12852966
Zambia,2009,ZM,ZMB,AFR,1232760,1866348,3099108,1382832,983420,556461,279100,128298,94173,3424284,1234065,1896589,3130654,1403264,989686,601147,343482,183964,142508,3664051,7088335,13318087,13318087
Zambia,2010,ZM,ZMB,AFR,1269210,1928628,3197838,1423915,1027037,590620,296605,134244,95634,3568055,1269279,1957411,3226690,1444744,1028444,630210,359343,191300,145462,3799503,7367558,13792086,13792086
Zambia,2011,ZM,ZMB,AFR,1303075,1994496,3297571,1462459,1067051,625513,314291,140836,97384,3707534,1301935,2021854,3323789,1485303,1066472,660925,375923,199451,148845,3936919,7644453,14265814,14265814
Zambia,2012,ZM,ZMB,AFR,1334110,2063353,3397463,1500872,1105045,661681,332669,148373,99384,3848024,1331983,2089027,3421010,1526254,1104234,693209,393377,208539,152553,4078166,7926190,14744658,14744658
Zambia,2013,ZM,ZMB,AFR,1362343,2134364,3496707,1541677,1142579,699594,352330,157409,101337,3994926,1359482,2157919,3517401,1569216,1142346,727097,412015,218915,156359,4225948,8220874,15234976,15234976
Zambia,2014,ZM,ZMB,AFR,1387402,2206811,3594213,1585815,1180583,738881,373628,167905,103360,4150172,1384035,2227933,3611968,1614855,1181376,762186,432093,230240,160695,4381445,8531617,15737793,15737793
Zambia,2015,ZM,ZMB,AFR,1409349,2279642,3688991,1632924,1218390,778330,396516,179296,105896,4311352,1405722,2298302,3704024,1663158,1221082,797743,453758,242157,165967,4543865,8855217,16248230,16248230
Zambia,2016,ZM,ZMB,AFR,1429756,2352716,3782472,1682475,1255802,818125,421037,191598,108952,4477989,1425918,2368940,3794858,1713622,1261031,834028,476946,254943,171859,4712429,9190418,16767761,16767761
Zambia,2017,ZM,ZMB,AFR,1449976,2424871,3874847,1734548,1292994,858882,447308,204838,112513,4651083,1445885,2438706,3884591,1766110,1301013,871746,501699,268636,178324,4887528,9538611,17298054,17298054
Zambia,2018,ZM,ZMB,AFR,1470256,2494154,3964410,1789336,1330027,900065,475381,218845,116651,4830305,1466051,2505831,3971882,1820797,1341201,910571,528137,283133,185448,5069287,9899592,17835893,17835893
Zambia,2019,ZM,ZMB,AFR,1491449,2558599,4050048,1847326,1367594,941271,505216,233527,121414,5016348,1487282,2568442,4055724,1878126,1382183,950130,556237,298379,193300,5258355,10274703,18380477,18380477
Zambia,2020,ZM,ZMB,AFR,1514353,2617538,4131891,1908700,1405381,981688,536535,248275,126142,5206721,1510051,2625755,4135806,1938742,1423547,989844,585907,313982,201275,5453297,10660018,18927715,18927715
Zambia,2021,ZM,ZMB,AFR,1538867,2672511,4211378,1973049,1442769,1020555,568586,262545,130126,5397630,1534033,2679125,4213158,2002573,1464722,1029106,616647,329415,208503,5650966,11048596,19473125,19473125
Zambia,2022,ZM,ZMB,AFR,1565046,2724567,4289613,2039043,1479360,1057430,601234,276839,134124,5588030,1559522,2729749,4289271,2068393,1505695,1067622,648298,345061,215690,5850759,11438789,20017675,20017675
Zambia,2023,ZM,ZMB,AFR,1592652,2774079,4366731,2106120,1516265,1092823,635175,292271,139477,5782131,1586697,2778190,4364887,2135384,1547474,1105760,681188,361852,224333,6055991,11838122,20569737,20569737
Zambia,2024,ZM,ZMB,AFR,1620145,2821442,4441587,2174979,1555304,1127813,670451,309526,146712,5984785,1614254,2824734,4438988,2203650,1591131,1144212,715142,380279,234914,6269328,12254113,21134695,21134695
Zambia,2025,ZM,ZMB,AFR,1645853,2867148,4513001,2244523,1596716,1162276,706207,328734,155773,6194229,1640558,2869760,4510318,2272360,1636909,1182872,749454,400408,247364,6489367,12683596,21706928,21706928
Zambia,2026,ZM,ZMB,AFR,1670469,2912046,4582515,2314627,1640111,1195924,742298,349546,166148,6408654,1666043,2914119,4580162,2341455,1684416,1221344,784286,421967,261148,6714616,13123270,22285947,22285947
Zambia,2027,ZM,ZMB,AFR,1695628,2957472,4653100,2384239,1685502,1228646,778929,371710,177308,6626334,1691978,2959255,4651233,2409880,1733549,1259326,820167,444763,275776,6943461,13569795,22874132,22874132
Zambia,2028,ZM,ZMB,AFR,1720383,3004226,4724609,2451512,1733570,1260874,815802,395353,189246,6846357,1717281,3006100,4723381,2475948,1784781,1297179,856888,468924,291230,7174950,14021307,23469301,23469301
Zambia,2029,ZM,ZMB,AFR,1744804,3052083,4796887,2514464,1785104,1293441,852563,420461,201922,7067955,1742085,3054424,4796509,2537806,1838786,1335645,894158,494436,307504,7408335,14476290,24069686,24069686
Zambia,2030,ZM,ZMB,AFR,1770121,3100496,4870617,2572291,1840786,1326531,888842,447193,215355,7290998,1767728,3103538,4871266,2594605,1896527,1374649,931672,521497,324588,7643538,14934536,24676417,24676417
Zambia,1950,ZM,ZMB,AFR,214567,308954,523521,218900,156356,110894,71026,41295,30537,629008,210685,303263,513948,223960,162331,112442,75907,43931,33396,651967,1280975,2318448,2318448
Zambia,1951,ZM,ZMB,AFR,220088,318474,538562,225016,159968,113982,73470,42388,31575,646399,217916,312013,529929,229343,166740,115490,78516,45282,34578,669949,1316348,2384836,2384836
Zambia,1952,ZM,ZMB,AFR,225963,328169,554132,231474,163695,117028,75887,43682,32623,664389,225533,321107,546640,234984,171170,118623,80991,46845,35731,688344,1352733,2453511,2453511
Zambia,1953,ZM,ZMB,AFR,233201,337329,570530,238234,167557,120024,78324,45165,33651,682955,234235,330091,564326,240855,175624,121869,83381,48624,36860,707213,1390168,2525024,2525024
Zambia,1954,ZM,ZMB,AFR,241655,346360,588015,245150,171568,122987,80841,46782,34583,701911,243267,339849,583116,246830,180092,125266,85778,50583,37949,726498,1428409,2599541,2599541
Zambia,1955,ZM,ZMB,AFR,250326,356361,606687,252177,175746,125920,83452,48488,35446,721229,251907,351164,603071,252906,184570,128817,88226,52688,39018,746225,1467454,2677209,2677209
Zambia,1956,ZM,ZMB,AFR,259359,367176,626535,259424,180115,128827,86142,50294,36229,741031,260883,363321,624204,259152,189073,132522,90715,54943,40066,766471,1507502,2758241,2758241
Zambia,1957,ZM,ZMB,AFR,268956,378597,647553,266976,184707,131709,88922,52207,36930,761451,270409,376103,646512,265638,193597,136382,93232,57365,41084,787298,1548749,2842807,2842807
Zambia,1958,ZM,ZMB,AFR,279064,390669,669733,274872,189516,134599,91750,54190,37633,782560,280440,389553,669993,272485,198190,140362,95804,59875,42133,808849,1591409,2931128,2931128
Zambia,1959,ZM,ZMB,AFR,289677,403384,693061,283128,194505,137550,94558,56194,38453,804388,290980,403677,694657,279845,202890,144399,98448,62348,43305,831235,1635623,3023340,3023340
Zambia,1960,ZM,ZMB,AFR,300765,416754,717519,291798,199627,140576,97297,58209,39443,826950,302018,418497,720515,287784,207693,148443,101174,64729,44629,854452,1681402,3119430,3119430
Zambia,1961,ZM,ZMB,AFR,312274,430848,743122,300821,204948,143667,99979,60223,40584,850222,313482,434110,747592,296231,212655,152506,103983,67015,46119,878509,1728731,3219451,3219451
Zambia,1962,ZM,ZMB,AFR,324119,445864,769983,310009,210551,146849,102621,62238,41918,874186,325287,450714,776001,305013,217838,156583,106864,69189,47770,903257,1777443,3323427,3323427
Zambia,1963,ZM,ZMB,AFR,336176,462643,798819,318696,216399,150142,105220,64278,43383,898118,337317,468850,806167,313691,223217,160670,109837,71292,49563,928270,1826388,3431381,3431381
Zambia,1964,ZM,ZMB,AFR,348260,481020,829280,327215,222320,153526,107754,66360,44859,922034,349370,487764,837134,323113,228680,164754,112938,73393,51439,954317,1876351,3542764,3542764
Zambia,1965,ZM,ZMB,AFR,360352,500044,860396,336694,228348,157040,110259,68512,46344,947197,361413,506753,868166,334043,234242,168852,116179,75543,53403,982262,1929459,3658024,3658024
Zambia,1966,ZM,ZMB,AFR,372481,519789,892270,347045,234647,160769,112756,70748,47860,973825,373520,526450,899970,345810,239992,172988,119583,77747,55501,1011621,1985446,3777680,3777680
Zambia,1967,ZM,ZMB,AFR,384639,540308,924947,357995,241254,164701,115237,73051,49379,1001617,385680,546927,932607,358188,245969,177150,123134,79985,57689,1042115,2043732,3901288,3901288
Zambia,1968,ZM,ZMB,AFR,397066,561440,958506,369589,248197,168823,117711,75384,50945,1030649,398115,568017,966132,371213,252295,181369,126792,82269,59955,1073893,2104542,4029173,4029173
Zambia,1969,ZM,ZMB,AFR,410023,582996,993019,381214,254860,172797,120098,77629,52606,1059204,411099,589557,1000656,384561,258780,185524,130429,84581,62255,1106130,2165334,4159007,4159007
Zambia,2031,ZM,ZMB,AFR,1794748,3149402,4944150,2626309,1900524,1360041,924436,475497,229561,7516368,1792647,3153308,4945955,2647579,1958119,1413944,969287,550072,342527,7881528,15397896,25288002,25288002
Zambia,2032,ZM,ZMB,AFR,1817922,3199808,5017730,2677501,1963621,1394304,959090,505053,244624,7744193,1816119,3204718,5020837,2697892,2022641,1453856,1006749,579862,361401,8122401,15866594,25905154,25905154
Zambia,2033,ZM,ZMB,AFR,1840838,3250827,5091665,2726265,2029106,1430036,992650,535571,260680,7974308,1839370,3256837,5096207,2746075,2088990,1495072,1043889,610611,381351,8365988,16340296,26528160,26528160
Zambia,2034,ZM,ZMB,AFR,1862906,3301317,5164223,2772960,2096285,1467701,1025468,566618,277918,8206950,1861766,3308605,5170371,2792392,2156521,1537999,1081041,641954,402593,8612500,16819450,27154050,27154050
Zambia,2035,ZM,ZMB,AFR,1883194,3351622,5234816,2818290,2164355,1507830,1057730,597642,296479,8442326,1882352,3360412,5242764,2837389,2224631,1583105,1118334,673401,425274,8862134,17304460,27782051,27782051
Zambia,2036,ZM,ZMB,AFR,1902782,3400762,5303544,2863015,2233151,1550020,1089309,628796,316364,8680655,1902241,3411158,5313399,2881872,2293245,1630016,1155484,705275,449382,9115274,17795929,28412879,28412879
Zambia,2037,ZM,ZMB,AFR,1921970,3448962,5370932,2908276,2301468,1594140,1120103,660477,337596,8922060,1921704,3460892,5382596,2927138,2361215,1678539,1192224,738154,474913,9372183,18294243,29047769,29047769
Zambia,2038,ZM,ZMB,AFR,1940796,3496510,5437306,2954850,2367525,1640851,1150514,692421,360220,9166381,1940776,3509785,5450561,2974106,2426892,1729139,1228901,771850,501939,9632827,18799208,29687072,29687072
Zambia,2039,ZM,ZMB,AFR,1960418,3542939,5503357,3002512,2429409,1690920,1181309,724327,384196,9412673,1960661,3557380,5518041,3022539,2488445,1782480,1266210,806092,530411,9896177,19308850,30330252,30330252
Zambia,2040,ZM,ZMB,AFR,1979340,3588512,5567852,3050721,2486345,1744999,1212652,755880,409654,9660251,1979885,3604026,5583911,3071759,2545051,1839504,1304087,840621,560515,10161537,19821788,30973549,30973549
Zambia,2041,ZM,ZMB,AFR,1996738,3632730,5629468,3099412,2539610,1802996,1244438,786923,436551,9909930,1997606,3649288,5646894,3121635,2597926,1900315,1342290,875302,592228,10429696,20339626,31615986,31615986
Zambia,2042,ZM,ZMB,AFR,2013510,3675106,5688616,3149581,2590160,1864222,1276957,817213,464692,10162825,2014715,3692681,5707396,3173140,2648201,1964013,1381122,909900,625357,10701733,20864558,32260579,32260579
Zambia,2043,ZM,ZMB,AFR,2029258,3716855,5746113,3200368,2638382,1927759,1310875,846610,493945,10417939,2030822,3735453,5766275,3225357,2696407,2029523,1421236,944249,659807,10976579,21394518,32906910,32906910
Zambia,2044,ZM,ZMB,AFR,2044121,3758588,5802709,3250637,2684627,1992957,1346622,875422,524102,10674367,2046108,3778222,5824330,3277233,2742799,2096228,1463032,978647,695397,11253336,21927703,33554740,33554740
Zambia,2045,ZM,ZMB,AFR,2060379,3797913,5858292,3300720,2729566,2059029,1384682,903777,554851,10932625,2062807,3818578,5881385,3329161,2787917,2163529,1506946,1013189,731826,11532568,22465193,34204865,34204865
Zambia,2046,ZM,ZMB,AFR,2078405,3835073,5913478,3349653,2773936,2125806,1424681,931590,586302,11191968,2081263,3856779,5938042,3380038,2832550,2231353,1552620,1047639,769377,11813577,23005545,34857072,34857072
Zambia,2047,ZM,ZMB,AFR,2096071,3871193,5967264,3397662,2818845,2192137,1466504,958823,618797,11452768,2099352,3893929,5993281,3429916,2877958,2298567,1599876,1081805,808579,12096701,23549469,35510018,35510018
Zambia,2048,ZM,ZMB,AFR,2113205,3905899,6019104,3445024,2865038,2256314,1510773,985830,652203,11715182,2116855,3929671,6046526,3478962,2925052,2363561,1649164,1116004,849331,12382074,24097256,36162890,36162890
Zambia,2049,ZM,ZMB,AFR,2128595,3940498,6069093,3491276,2912275,2316521,1558232,1013270,686228,11977802,2132549,3965391,6097940,3526714,2973584,2424554,1701146,1150882,891352,12668232,24646034,36813065,36813065
Zambia,2050,ZM,ZMB,AFR,2141694,3975818,6117512,3536673,2960034,2372034,1609495,1041290,720734,12240260,2145956,4001871,6147827,3573527,3022894,2480753,1756727,1186369,934561,12954831,25195091,37460435,37460435
Zimbabwe,1970,ZW,ZWE,AFR,507123,756005,1263128,496932,294612,198227,144438,92253,72208,1298670,500591,757923,1258514,507326,304814,215494,158477,104375,92123,1382609,2681279,5202918,5202918
Zimbabwe,1971,ZW,ZWE,AFR,524807,774269,1299076,510494,299191,202543,149474,98735,74309,1334746,518434,782386,1300820,532640,312888,218133,161076,109575,94476,1428788,2763534,5363423,5363423
Zimbabwe,1972,ZW,ZWE,AFR,543419,795342,1338761,526026,303514,206258,154111,105485,76692,1372086,537107,807986,1345093,559580,321206,220448,163492,115116,97055,1476897,2848983,5532842,5532842
Zimbabwe,1973,ZW,ZWE,AFR,563357,819328,1382685,544546,306890,209691,158454,112121,79329,1411031,556988,834897,1391885,588763,329055,222911,165916,120652,99809,1527106,2938137,5712712,5712712
Zimbabwe,1974,ZW,ZWE,AFR,584515,846200,1430715,560592,315153,213494,162617,118089,82173,1452118,577931,863212,1441143,613835,342482,226334,168541,125642,102713,1579547,3031665,5903530,5903530
Zimbabwe,1975,ZW,ZWE,AFR,606647,873183,1479830,569116,327712,217676,167592,124249,85343,1491688,599801,892828,1492629,633201,361941,230224,171324,130410,105836,1632936,3124624,6097083,6097083
Zimbabwe,1976,ZW,ZWE,AFR,629268,899430,1528698,573795,338096,221681,173652,130989,88837,1527050,622205,923665,1545870,652638,381483,234016,174251,135182,109208,1686778,3213828,6288387,6288387
Zimbabwe,1977,ZW,ZWE,AFR,651392,918930,1570322,564059,338655,224426,183262,141294,92907,1544603,644759,956123,1600882,672585,397568,235514,177001,141532,113040,1737240,3281843,6453044,6453044
Zimbabwe,1978,ZW,ZWE,AFR,672118,922057,1594175,519700,316490,223558,200367,160566,98452,1519133,667351,991290,1658641,692833,405030,230690,178427,152266,118160,1777406,3296539,6549349,6549349
Zimbabwe,1979,ZW,ZWE,AFR,688790,937466,1626256,480584,294997,219946,214671,177623,105517,1493338,685239,1029678,1714917,714294,415683,226857,178801,161061,124626,1821322,3314660,6655833,6655833
Zimbabwe,1980,ZW,ZWE,AFR,699337,1046145,1745482,584878,357773,223824,195038,155120,110780,1627413,690084,1069590,1759674,739209,467122,250878,182648,147880,129618,1917355,3544768,7049926,7049926
Zimbabwe,1981,ZW,ZWE,AFR,715693,1155288,1870981,717232,437201,234165,171962,127718,113865,1802143,700780,1108415,1809195,764480,524096,280907,188696,133005,133026,2024210,3826353,7506526,7506526
Zimbabwe,1982,ZW,ZWE,AFR,742778,1193896,1936674,766626,467357,243871,171064,126077,116963,1891958,727189,1144949,1872138,788672,555913,295048,193488,133271,136691,2103083,3995041,7803855,7803855
Zimbabwe,1983,ZW,ZWE,AFR,773372,1230122,2003494,804492,494540,254794,172296,127258,120073,1973453,761084,1191145,1952229,815191,580192,305819,198745,136633,140600,2177180,4150633,8106356,8106356
Zimbabwe,1984,ZW,ZWE,AFR,804562,1260565,2065127,833276,512004,270529,176508,131401,123093,2046811,797012,1238989,2036001,845533,594582,319059,204640,142160,144656,2250630,4297441,8398567,8398567
Zimbabwe,1985,ZW,ZWE,AFR,829544,1292788,2122332,870381,525943,291345,180769,134484,125846,2128768,824864,1281435,2106299,879905,607160,339774,211165,146539,148577,2333120,4461888,8690515,8690515
Zimbabwe,1986,ZW,ZWE,AFR,844267,1332751,2177018,907293,539619,313165,185944,137870,128333,2212224,841732,1332820,2174552,917265,618466,361210,218337,151567,152408,2419253,4631477,8983044,8983044
Zimbabwe,1987,ZW,ZWE,AFR,850813,1383359,2234172,925452,547994,336936,194403,144720,130746,2280251,854974,1410872,2265846,958028,616642,378573,226598,160877,156498,2497216,4777467,9277488,9277488
Zimbabwe,1988,ZW,ZWE,AFR,849364,1442499,2291863,927366,550751,361505,206107,154399,133533,2333661,865104,1508949,2374053,1004589,603039,391044,235743,173317,161429,2569161,4902822,9568739,9568739
Zimbabwe,1989,ZW,ZWE,AFR,842278,1495581,2337859,950594,559023,382233,216318,159960,136759,2404887,860152,1584117,2444269,1057583,603879,405758,244473,180645,166995,2659333,5064220,9846346,9846346
Zimbabwe,1990,ZW,ZWE,AFR,835402,1538250,2373652,991815,573818,399666,225056,161855,140181,2492391,847725,1635240,2482965,1113570,619298,422704,252749,183774,172786,2764881,5257272,10113893,10113893
Zimbabwe,1991,ZW,ZWE,AFR,832350,1572849,2405199,1036413,592156,415775,233786,162695,143616,2584441,837522,1675435,2512957,1169717,641021,439397,260754,185838,178492,2875219,5459660,10377815,10377815
Zimbabwe,1992,ZW,ZWE,AFR,832076,1607702,2439778,1064473,607541,432868,244334,165826,147207,2662249,837406,1725603,2563009,1224958,655992,451928,268506,190647,184439,2976470,5638719,10641501,10641501
Zimbabwe,1993,ZW,ZWE,AFR,825659,1627616,2453275,1072443,610949,443150,253012,169659,150898,2700111,834990,1760134,2595124,1267863,658157,458631,275954,195257,190552,3046414,5746525,10794918,10794918
Zimbabwe,1994,ZW,ZWE,AFR,817209,1626966,2444175,1087030,612172,440527,261341,170568,154213,2725851,824458,1758866,2583324,1300918,666648,458715,287062,195920,195977,3105240,5831091,10858594,10858594
Zimbabwe,1995,ZW,ZWE,AFR,817592,1626081,2443673,1124099,625739,435108,273033,170300,156935,2785214,820468,1753117,2573585,1343887,695108,454770,301050,196423,200331,3191569,5976783,10994041,10994041
Zimbabwe,1996,ZW,ZWE,AFR,825788,1619175,2444963,1180236,648491,431175,283669,169277,158766,2871614,822801,1737565,2560366,1398557,737453,451800,313066,196897,203457,3301230,6172844,11178171,11178171
Zimbabwe,1997,ZW,ZWE,AFR,838361,1605826,2444187,1238499,673601,427256,292622,168616,159630,2960224,831291,1712559,2543850,1455823,782572,448648,323623,197978,205496,3414140,6374364,11362401,11362401
Zimbabwe,1998,ZW,ZWE,AFR,855240,1590541,2445781,1294978,700958,423504,299246,168545,159683,3046914,846419,1684016,2530435,1509874,830102,446164,332750,199738,206609,3525237,6572151,11548364,11548364
Zimbabwe,1999,ZW,ZWE,AFR,877304,1572782,2450086,1342677,727705,419254,303029,169111,158971,3120747,868044,1653924,2521968,1555247,875299,443933,340217,202041,206913,3623650,6744397,11716454,11716454
Zimbabwe,2000,ZW,ZWE,AFR,901958,1551999,2453957,1371641,749437,414105,304384,170495,157588,3167650,893782,1623305,2517087,1586330,910989,441476,346147,204631,206410,3695983,6863633,11834676,11834676
Zimbabwe,2001,ZW,ZWE,AFR,926481,1534617,2461098,1384635,767600,408756,303371,171921,155621,3191904,919842,1597661,2517503,1604520,936585,438250,349218,206628,205262,3740463,6932367,11910978,11910978
Zimbabwe,2002,ZW,ZWE,AFR,948351,1526221,2474572,1389695,786147,405335,301581,173202,153603,3209563,942948,1582541,2525489,1614386,959677,438068,351042,207955,203891,3775019,6984582,11984644,11984644
Zimbabwe,2003,ZW,ZWE,AFR,966078,1530648,2496726,1387080,805619,405165,300813,174913,152138,3225728,962011,1582417,2544428,1615102,983349,442906,354304,210325,202967,3808953,7034681,12075828,12075828
Zimbabwe,2004,ZW,ZWE,AFR,976674,1548731,2525405,1371063,822497,406940,297415,180258,151449,3229622,974709,1597612,2572321,1603982,1002668,451141,354740,218095,202907,3833533,7063155,12160881,12160881
Zimbabwe,2005,ZW,ZWE,AFR,978832,1574085,2552917,1340261,838923,410424,290605,189267,151524,3221004,979519,1621915,2601434,1581653,1019536,462932,351173,230365,203736,3849395,7070399,12224753,12224753
Zimbabwe,2006,ZW,ZWE,AFR,979202,1607542,2586744,1314705,866771,418973,283057,196603,152019,3232128,980309,1652733,2633042,1556584,1050944,480441,344934,240487,205181,3878571,7110699,12330490,12330490
Zimbabwe,2007,ZW,ZWE,AFR,979828,1641528,2621356,1290579,897378,431280,275989,203040,152865,3251131,980611,1686107,2666718,1526392,1088347,501311,338219,249880,207213,3911362,7162493,12450568,12450568
Zimbabwe,2008,ZW,ZWE,AFR,982281,1670841,2653122,1258158,920862,445269,270328,209903,154332,3258852,983768,1719442,2703210,1489257,1118626,523394,333406,260529,209952,3935164,7194016,12550347,12550347
Zimbabwe,2009,ZW,ZWE,AFR,993317,1699940,2693257,1231293,940325,462501,266100,215762,156549,3272530,994941,1753056,2747997,1455453,1147371,549279,329827,270634,213452,3966016,7238546,12679810,12679810
Zimbabwe,2010,ZW,ZWE,AFR,1013426,1728514,2741940,1211533,953610,482563,264179,220828,159511,3292224,1015137,1785857,2800994,1427165,1171980,578221,328847,280367,218024,4004604,7296828,12839771,12839771
Zimbabwe,2011,ZW,ZWE,AFR,1040969,1753134,2794103,1200935,960221,505250,265127,225418,163056,3320007,1042638,1814334,2856972,1407703,1191904,609879,331653,289973,223589,4054701,7374708,13025785,13025785
Zimbabwe,2012,ZW,ZWE,AFR,1074129,1776501,2850630,1211201,966742,531313,268443,228653,166821,3373173,1074244,1839435,2913679,1405872,1212581,644660,336977,298064,229693,4127847,7501020,13265331,13265331
Zimbabwe,2013,ZW,ZWE,AFR,1106849,1803045,2909894,1242042,976194,559954,274067,230704,170287,3453248,1104191,1864962,2969153,1422699,1234210,681298,344829,304453,235639,4223128,7676376,13555422,13555422
Zimbabwe,2014,ZW,ZWE,AFR,1131022,1832564,2963586,1283700,983033,589301,282483,230659,175462,3544638,1125922,1892348,3018270,1451916,1250994,717656,356977,307598,244114,4329255,7873893,13855753,13855753
Zimbabwe,2015,ZW,ZWE,AFR,1143907,1865441,3009348,1332541,984031,622211,293707,228218,182780,3643488,1137005,1922247,3059252,1489333,1260870,756434,373428,307090,255692,4442847,8086335,14154937,14154937
Zimbabwe,2016,ZW,ZWE,AFR,1148346,1901708,3050054,1384120,978558,660576,307757,225453,190141,3746605,1140325,1954607,3094932,1530629,1260846,802459,393744,305799,267642,4561119,8307724,14452704,14452704
Zimbabwe,2017,ZW,ZWE,AFR,1148135,1941178,3089313,1433578,972606,700365,324784,222765,197215,3851313,1139269,1989346,3128615,1572861,1253874,853667,417639,304110,279704,4681855,8533168,14751101,14751101
Zimbabwe,2018,ZW,ZWE,AFR,1146702,1982550,3129252,1478865,969907,738526,344994,220578,203879,3956749,1136874,2025505,3162379,1614634,1244741,905135,445172,302276,291845,4803803,8760552,15052184,15052184
Zimbabwe,2019,ZW,ZWE,AFR,1146287,2024024,3170311,1520896,971005,772492,368043,219317,209922,4061675,1135452,2061632,3197084,1655119,1235693,953860,476153,300898,303808,4925531,8987206,15354608,15354608
Zimbabwe,2020,ZW,ZWE,AFR,1149743,2065021,3214764,1564404,979849,800385,392826,218660,214335,4170459,1137363,2096896,3234259,1695712,1231868,998466,509246,300181,314716,5050189,9220648,15669666,15669666
Zimbabwe,2021,ZW,ZWE,AFR,1157307,2107869,3265176,1608389,998637,820782,417528,217720,215458,4278514,1142407,2132701,3275108,1734047,1238286,1037922,542331,299685,322460,5174731,9453245,15993524,15993524
Zimbabwe,2022,ZW,ZWE,AFR,1166098,2149944,3316042,1650510,1028599,835880,442314,217737,214517,4389557,1148611,2167031,3315642,1768235,1256135,1071309,575167,300822,327631,5299299,9688856,16320537,16320537
Zimbabwe,2023,ZW,ZWE,AFR,1174272,2186806,3361078,1693622,1069998,849739,468609,220870,215337,4518175,1154993,2196478,3351471,1801401,1285595,1099306,608523,305947,333909,5434681,9952856,16665409,16665409
Zimbabwe,2024,ZW,ZWE,AFR,1181725,2215862,3397587,1738180,1121801,860725,495818,226820,217630,4660974,1161445,2218488,3379933,1835522,1326139,1122075,641890,315195,341005,5581826,10242800,17020321,17020321
Zimbabwe,2025,ZW,ZWE,AFR,1188598,2236994,3425592,1784414,1181478,866165,526062,234819,219345,4812283,1167898,2233043,3400941,1871226,1374273,1138368,677683,327867,347055,5736472,10548755,17375285,17375285
Zimbabwe,2026,ZW,ZWE,AFR,1195906,2252090,3447996,1832134,1244873,865930,561261,245054,220614,4969866,1175028,2242363,3417391,1908405,1425781,1145712,720538,343650,352256,5896342,10866208,17731592,17731592
Zimbabwe,2027,ZW,ZWE,AFR,1204401,2263294,3467695,1881067,1307310,865727,597964,257762,221594,5131424,1183383,2248462,3431845,1946991,1477753,1147002,768625,362331,356785,6059487,11190911,18090446,18090446
Zimbabwe,2028,ZW,ZWE,AFR,1213592,2273136,3486728,1930001,1366638,868998,633357,273122,222456,5294572,1192435,2253634,3446069,1986084,1528742,1146771,817421,384022,360822,6223862,11518434,18451235,18451235
Zimbabwe,2029,ZW,ZWE,AFR,1223509,2283843,3507352,1977445,1423505,876430,665308,290984,223474,5457146,1202209,2260135,3462344,2024387,1577913,1147247,864232,408679,364763,6387221,11844367,18814068,18814068
Zimbabwe,2030,ZW,ZWE,AFR,1234829,2297232,3532061,2022070,1477551,889652,691734,310863,225002,5616872,1213364,2269846,3483210,2060847,1624049,1150448,906859,435808,369251,6547262,12164134,19179393,19179393
Zimbabwe,1950,ZW,ZWE,AFR,249066,360497,609563,261516,193600,132478,93814,61358,38678,781444,243555,349227,592782,259273,193830,133897,100172,70212,50147,807531,1588975,2791326,2791326
Zimbabwe,1951,ZW,ZWE,AFR,265334,371157,636491,267215,196186,136458,95391,62838,40335,798423,260699,360018,620717,264667,197316,138175,101882,71827,52211,826078,1624501,2881713,2881713
Zimbabwe,1952,ZW,ZWE,AFR,282640,381213,663853,272713,198631,141126,97023,64276,41962,815731,278826,370436,649262,269613,200714,143224,103597,73372,54341,844861,1660592,2973713,2973713
Zimbabwe,1953,ZW,ZWE,AFR,301937,389822,691759,278365,201157,146078,98689,65679,43587,833555,298836,379614,678450,274557,204213,148651,105317,74881,56512,864131,1697686,3067899,3067899
Zimbabwe,1954,ZW,ZWE,AFR,316890,403132,720022,284805,204023,150699,100364,67052,45249,852192,314045,393947,707992,280313,208017,153864,107050,76394,58672,884310,1736502,3164517,3164517
Zimbabwe,1955,ZW,ZWE,AFR,325798,422877,748675,292192,207337,154687,102099,68390,46938,871643,322823,415028,737851,287117,212204,158536,108875,77922,60805,905459,1777102,3263625,3263625
Zimbabwe,1956,ZW,ZWE,AFR,334464,443497,777961,300286,211191,158092,103850,69706,48665,891790,331347,436934,768281,294724,216873,162727,110739,79476,62905,927444,1819234,3365477,3365477
Zimbabwe,1957,ZW,ZWE,AFR,343550,464431,807981,309119,215704,160932,105531,71007,50437,912730,340275,459092,799367,303174,222157,166443,112557,81076,65007,950414,1863144,3470494,3470494
Zimbabwe,1958,ZW,ZWE,AFR,353070,485676,838746,318737,220643,163325,107340,72295,52229,934569,349592,481480,831072,312537,227771,169770,114553,82688,67093,974412,1908981,3578800,3578800
Zimbabwe,1959,ZW,ZWE,AFR,363061,507413,870474,328895,225583,165526,109648,73588,53983,957223,359354,504274,863628,322615,233198,172953,117111,84262,69176,999315,1956538,3690640,3690640
Zimbabwe,1960,ZW,ZWE,AFR,373574,529967,903541,339203,230432,167713,112511,74877,55697,980433,369648,527791,897439,333022,238344,176167,120313,85785,71260,1024891,2005324,3806310,3806310
Zimbabwe,1961,ZW,ZWE,AFR,384620,553745,938365,349373,235205,169777,115969,76183,57360,1003867,380469,552431,932900,343482,243206,179294,124209,87283,73352,1050826,2054693,3925952,3925952
Zimbabwe,1962,ZW,ZWE,AFR,396136,579341,975477,358985,239807,171732,120056,77542,58981,1027103,391764,578792,970556,353605,247661,182348,128813,88786,75428,1076641,2103744,4049778,4049778
Zimbabwe,1963,ZW,ZWE,AFR,408090,607518,1015608,367212,244569,173779,124401,78926,60576,1049463,403497,607595,1011092,362544,252130,185518,133773,90298,77502,1101765,2151228,4177931,4177931
Zimbabwe,1964,ZW,ZWE,AFR,420478,632132,1052610,379928,250052,176121,128441,80317,62180,1077039,415630,632339,1047969,376451,257366,188969,138526,91824,79582,1132718,2209757,4310332,4310332
Zimbabwe,1965,ZW,ZWE,AFR,433363,651541,1084904,398797,256355,178834,131888,81762,63789,1111425,428230,651475,1079705,396884,263585,192770,142776,93435,81660,1171110,2282535,4447149,4447149
Zimbabwe,1966,ZW,ZWE,AFR,446719,671308,1118027,418502,263247,181996,134795,83214,65427,1147181,441277,670947,1112224,418143,270540,197003,146578,95086,83749,1211099,2358280,4588529,4588529
Zimbabwe,1967,ZW,ZWE,AFR,460562,692011,1152573,438524,270771,185717,137160,84598,67084,1183854,454794,691330,1146124,439669,278260,201780,149908,96673,85851,1252141,2435995,4734694,4734694
Zimbabwe,1968,ZW,ZWE,AFR,475105,713613,1188718,458902,279019,189806,139105,86089,68755,1221676,469002,712581,1181583,461471,286850,206849,152862,98405,87940,1294377,2516053,4886347,4886347
Zimbabwe,1969,ZW,ZWE,AFR,490528,736096,1226624,479854,287815,193900,140892,88010,70407,1260878,484078,734691,1218769,483722,296134,211742,155679,100624,89991,1337892,2598770,5044163,5044163
Zimbabwe,2031,ZW,ZWE,AFR,1247267,2313084,3560351,2065796,1525895,911254,712119,332265,227274,5774603,1225630,2282604,3508234,2096906,1664139,1159827,944399,464735,374778,6704784,12479387,19547971,19547971
Zimbabwe,2032,ZW,ZWE,AFR,1260104,2330417,3590521,2107540,1569011,942490,727997,354541,230327,5931906,1238356,2297533,3535889,2131198,1698729,1178654,976531,494566,381593,6861271,12793177,19919582,19919582
Zimbabwe,2033,ZW,ZWE,AFR,1273130,2347798,3620928,2143965,1611183,982329,741278,376967,234204,6089926,1251307,2313275,3564582,2160585,1731769,1207920,1003181,524367,389937,7017759,13107685,20293203,20293203
Zimbabwe,2034,ZW,ZWE,AFR,1286019,2365077,3651096,2172727,1654759,1031546,751380,399449,239045,6248906,1264135,2329672,3593807,2182648,1765776,1247590,1024651,553798,400061,7174524,13423430,20668334,20668334
Zimbabwe,2035,ZW,ZWE,AFR,1298212,2383187,3681399,2193756,1700090,1088075,756711,424476,244986,6408094,1276307,2347460,3623767,2197385,1801437,1294476,1040229,585442,412069,7331038,13739132,21044297,21044297
Zimbabwe,2036,ZW,ZWE,AFR,1308968,2402826,3711794,2208897,1746941,1148049,757317,453696,252276,6567176,1287102,2367014,3654116,2206991,1838600,1344586,1047789,623430,425887,7487283,14054459,21420364,21420364
Zimbabwe,2037,ZW,ZWE,AFR,1318010,2424013,3742023,2220238,1794984,1207144,758211,484217,261198,6725992,1296164,2388223,3684387,2213430,1877157,1395141,1049987,666115,441478,7643308,14369300,21795710,21795710
Zimbabwe,2038,ZW,ZWE,AFR,1325384,2446085,3771469,2230262,1843004,1263364,762385,513684,272005,6884704,1303518,2410353,3713871,2218964,1916184,1444756,1050917,709444,459077,7799342,14684046,22169385,22169385
Zimbabwe,2039,ZW,ZWE,AFR,1331460,2468753,3800213,2241147,1889535,1317286,770339,540309,284752,7043368,1309617,2433093,3742710,2225825,1954420,1492633,1052588,751025,478939,7955430,14998798,22541721,22541721
Zimbabwe,2040,ZW,ZWE,AFR,1336389,2492131,3828520,2254647,1933264,1368538,783422,562335,299317,7201523,1314630,2456561,3771191,2235840,1990787,1537590,1056818,788913,501192,8111140,15312663,22912369,22912369
Zimbabwe,2041,ZW,ZWE,AFR,1339915,2515183,3855098,2270550,1976023,1414443,803924,579321,315474,7359735,1318259,2479760,3798019,2248856,2026699,1576787,1066807,822291,525684,8267124,15626859,23279976,23279976
Zimbabwe,2042,ZW,ZWE,AFR,1342401,2536933,3879334,2287908,2016828,1455560,833011,592540,332740,7518587,1320875,2501702,3822577,2264016,2060859,1610802,1085577,850833,551862,8423949,15942536,23644449,23644449
Zimbabwe,2043,ZW,ZWE,AFR,1344739,2557237,3901976,2305317,2052551,1495984,869806,603576,350562,7677796,1323376,2522198,3845574,2279979,2090258,1643459,1114031,874426,579133,8581286,16259082,24006629,24006629
Zimbabwe,2044,ZW,ZWE,AFR,1347076,2576128,3923204,2322634,2080964,1537957,914958,611943,368937,7837393,1325851,2541328,3867179,2296589,2112568,1677195,1152120,893353,607404,8739229,16576622,24367005,24367005
Zimbabwe,2045,ZW,ZWE,AFR,1348777,2593202,3941979,2340773,2101991,1581781,966610,616567,389852,7997574,1327679,2558728,3886407,2314574,2127787,1712642,1196909,907178,638859,8897949,16895523,24723911,24723911
Zimbabwe,2046,ZW,ZWE,AFR,1349637,2607482,3957119,2360416,2117384,1627143,1021323,617710,414687,8158663,1328695,2573408,3902103,2334312,2138026,1749608,1244703,914342,676803,9057794,17216457,25075678,25075678
Zimbabwe,2047,ZW,ZWE,AFR,1350295,2619063,3969358,2381590,2129152,1673660,1075254,619472,441360,8320488,1329513,2585386,3914899,2355688,2145206,1787945,1292904,917184,719748,9218675,17539163,25423417,25423417
Zimbabwe,2048,ZW,ZWE,AFR,1350227,2628852,3979079,2403628,2139659,1720134,1126631,624231,468237,8482520,1329631,2595562,3925193,2377979,2151509,1826731,1340219,919156,764428,9380022,17862542,25766806,25766806
Zimbabwe,2049,ZW,ZWE,AFR,1348874,2637342,3986216,2426244,2150978,1765126,1175905,632257,493986,8644496,1328509,2604461,3932970,2400866,2159100,1864711,1385871,921952,809067,9541567,18186063,26105252,26105252
Zimbabwe,2050,ZW,ZWE,AFR,1346936,2644073,3991009,2449551,2164793,1807370,1222725,644518,517184,8806141,1326803,2611639,3938442,2424468,2169748,1900833,1428749,927095,852105,9702998,18509139,26438589,26438589
